,enrollment_id,username,course_id,no_of_objects,bno_access,bno_pageclose,bno_problem,bno_video,bno_discussion,bno_navigate,bno_wiki,bno_total,bno_avg,no_of_active_days,time_consumption,browser_access,browser_pageclose,browser_problem,browser_video,server_access,server_discussion,server_problem,server_navigate,server_wiki,bno_browser,bno_server,label
0,34,OeLBIzS0gNQ56euxy5b66gAZMzQCGE7n,7GRhBDsirIGkRZBtSMEzNTyDr2JQm4xx,96,205,59,120,59,9,41,3,496,70.85714285714286,18,1818649.0,111,59,104,59,94,9,16,41,3,333,163,0
1,66,cGrHiRjztN9fSltHujpfWaaWfYWiidiG,7GRhBDsirIGkRZBtSMEzNTyDr2JQm4xx,161,550,114,292,82,299,63,0,1400,200.0,21,0.0,207,114,226,82,343,299,66,63,0,629,771,0
2,85,OdsEBh425XZxll0hTUv04OAotDf6aGtE,7GRhBDsirIGkRZBtSMEzNTyDr2JQm4xx,10,14,4,2,3,0,5,0,28,4.0,3,0.0,1,4,2,3,13,0,0,5,0,10,18,1
3,89,Po17baTutQqG3KBkMaahpxQ7IpjhFfZa,7GRhBDsirIGkRZBtSMEzNTyDr2JQm4xx,54,137,7,101,30,11,8,0,294,42.0,10,0.0,77,7,84,30,60,11,17,8,0,198,96,1
4,108,tIzV4oVJd7GebOZj2uw51WJCx59QGqJ5,5X6FeZozNMgE2VRi3MJYjkkFK8SETtu2,38,58,15,29,27,0,5,0,134,19.142857142857142,8,0.0,36,15,28,27,22,0,1,5,0,106,28,1
5,145,TZOWoG0yzTTzAfx5K054mpl5rZTlZIcZ,7GRhBDsirIGkRZBtSMEzNTyDr2JQm4xx,85,243,85,136,47,55,20,4,590,84.28571428571429,16,0.0,79,85,119,47,164,55,17,20,4,330,260,1
6,163,jJZ8z8M2beLy33Z7JJbNFq1bQd8o43FV,7GRhBDsirIGkRZBtSMEzNTyDr2JQm4xx,7,15,5,0,0,1,7,0,28,4.0,4,0.0,5,5,0,0,10,1,0,7,0,10,18,1
7,312,BCPhbcVTukJPsOtUJJbyOWvpso8GiEV1,7GRhBDsirIGkRZBtSMEzNTyDr2JQm4xx,84,277,82,223,61,366,83,3,1095,156.42857142857142,21,0.0,147,82,188,61,130,366,35,83,3,478,617,0
8,348,PUFh3BsQaDVIJMDvwsFTqkrgAzvjO9ME,5X6FeZozNMgE2VRi3MJYjkkFK8SETtu2,6,2,1,0,0,0,12,0,15,2.142857142857143,5,0.0,0,1,0,0,2,0,0,12,0,1,14,0
9,384,zcVNiJm0X4Vm9oBHkuQez1iW6Hb7iAYl,7GRhBDsirIGkRZBtSMEzNTyDr2JQm4xx,45,96,35,65,33,3,6,0,238,34.0,2,0.0,59,35,61,33,37,3,4,6,0,188,50,1
10,388,wgquDoatKrYebgYKJ0rgOYOEZftOC88l,5X6FeZozNMgE2VRi3MJYjkkFK8SETtu2,1,0,0,0,0,0,1,0,1,0.14285714285714285,1,0.0,0,0,0,0,0,0,0,1,0,0,1,0
11,397,9JGDpM8F0Ioe7WqwIugLWqE5Qa4gQNAo,7GRhBDsirIGkRZBtSMEzNTyDr2JQm4xx,5,0,0,0,0,0,6,0,6,0.8571428571428571,1,0.0,0,0,0,0,0,0,0,6,0,0,6,1
12,405,jWgeQ7calOYQcs5lv7T9mWy3KUSp4lwk,7GRhBDsirIGkRZBtSMEzNTyDr2JQm4xx,7,4,1,0,1,0,3,0,9,1.2857142857142858,2,0.0,0,1,0,1,4,0,0,3,0,2,7,1
13,457,LP0dfF7fyuhmmsZ61rjoy3gAmrNgZfWE,7GRhBDsirIGkRZBtSMEzNTyDr2JQm4xx,5,3,0,0,0,0,2,0,5,0.7142857142857143,1,0.0,0,0,0,0,3,0,0,2,0,0,5,1
14,488,j2rHuSroJ2LNNnea5uXtGt5k8dfNg0dE,7GRhBDsirIGkRZBtSMEzNTyDr2JQm4xx,28,28,11,18,10,0,5,0,72,10.285714285714286,3,0.0,10,11,9,10,18,0,9,5,0,40,32,1
15,508,hbwWiZJx2DqUaUjG4c2EvTFTwMA32fWP,7GRhBDsirIGkRZBtSMEzNTyDr2JQm4xx,71,203,75,155,25,2,12,1,473,67.57142857142857,6,0.0,104,75,139,25,99,2,16,12,1,343,130,1
16,529,VjgzAw2H8q9OHgJwlSzUGU3MhKciCosm,7GRhBDsirIGkRZBtSMEzNTyDr2JQm4xx,1,0,0,0,0,0,1,0,1,0.14285714285714285,1,0.0,0,0,0,0,0,0,0,1,0,0,1,1
17,537,v3GklML26dWmsHrBRgfyBOOufNAhOXE8,5X6FeZozNMgE2VRi3MJYjkkFK8SETtu2,27,49,4,22,6,0,15,0,96,13.714285714285714,5,0.0,16,4,18,6,33,0,4,15,0,44,52,1
18,559,gZhclo8obnDdq4Hpc6ohnKIqNEyfFli3,7GRhBDsirIGkRZBtSMEzNTyDr2JQm4xx,39,49,24,47,19,0,6,0,145,20.714285714285715,2,0.0,21,24,39,19,28,0,8,6,0,103,42,1
19,571,cuuYGTWWAmhidQoRHdGzANriCatcPrlK,7GRhBDsirIGkRZBtSMEzNTyDr2JQm4xx,104,215,92,168,77,24,13,0,589,84.14285714285714,15,0.0,110,92,142,77,105,24,26,13,0,421,168,0
20,578,eER8RoiVQhlBLlO4WV7kKfWOx4XE0E9c,7GRhBDsirIGkRZBtSMEzNTyDr2JQm4xx,42,108,46,60,28,61,18,0,321,45.857142857142854,10,0.0,45,46,50,28,63,61,10,18,0,169,152,1
21,618,M5ID2aNMWGm5ShsGkFPYgTgN2UReXK8g,7GRhBDsirIGkRZBtSMEzNTyDr2JQm4xx,80,153,66,143,60,6,14,0,442,63.142857142857146,7,0.0,67,66,120,60,86,6,23,14,0,313,129,1
22,665,SEjaVSZpDJnFuz955p2IN1SjKQ5n5iQT,5X6FeZozNMgE2VRi3MJYjkkFK8SETtu2,32,64,1,32,14,0,13,0,124,17.714285714285715,9,0.0,32,1,30,14,32,0,2,13,0,77,47,1
23,694,DVxZxPUgYsodJVtjUg4HG3ZucfJoWgwo,7GRhBDsirIGkRZBtSMEzNTyDr2JQm4xx,62,84,22,185,20,4,44,0,359,51.285714285714285,9,0.0,36,22,175,20,48,4,10,44,0,253,106,1
24,696,0PrF4PViZdaRQhbt6FYXwLbcetJ8RnwC,5X6FeZozNMgE2VRi3MJYjkkFK8SETtu2,130,151,2,273,12,0,12,0,450,64.28571428571429,8,0.0,91,2,247,12,60,0,26,12,0,352,98,0
25,698,vbTgITzq6jZRj0oUV5gFotgOlwSXnjML,5X6FeZozNMgE2VRi3MJYjkkFK8SETtu2,127,214,12,303,20,17,42,0,608,86.85714285714286,13,0.0,127,12,269,20,87,17,34,42,0,428,180,0
26,706,gaQ5NcChRgJEDIbUzrzkc0uxMk5PhjhH,5X6FeZozNMgE2VRi3MJYjkkFK8SETtu2,25,75,40,4,16,140,17,0,292,41.714285714285715,13,0.0,20,40,3,16,55,140,1,17,0,79,213,0
27,755,qVDHsjIzoOtZnTwpJtbJGpvapy4sRYpW,7GRhBDsirIGkRZBtSMEzNTyDr2JQm4xx,64,158,48,110,36,12,25,1,390,55.714285714285715,11,0.0,82,48,99,36,76,12,11,25,1,265,125,1
28,794,1dxQmK9WwlHWuIG7ZTn4PsJ2vflQBDH3,5X6FeZozNMgE2VRi3MJYjkkFK8SETtu2,8,19,5,2,3,0,9,0,38,5.428571428571429,6,0.0,2,5,2,3,17,0,0,9,0,12,26,1
29,836,jWgeQ7calOYQcs5lv7T9mWy3KUSp4lwk,5X6FeZozNMgE2VRi3MJYjkkFK8SETtu2,5,2,1,0,1,0,2,0,6,0.8571428571428571,1,0.0,0,1,0,1,2,0,0,2,0,2,4,1
30,849,se5zs87qj8m5HDpiAuY9fHW8e8hfOFuJ,7GRhBDsirIGkRZBtSMEzNTyDr2JQm4xx,38,143,64,60,20,62,22,1,372,53.142857142857146,4,0.0,55,64,53,20,88,62,7,22,1,192,180,0
31,874,QpsLmP3WeC01C1T5jY6uw1yDvPjAiorO,7GRhBDsirIGkRZBtSMEzNTyDr2JQm4xx,1,0,0,0,0,0,1,0,1,0.14285714285714285,1,0.0,0,0,0,0,0,0,0,1,0,0,1,1
32,948,iYWLR7w0j5yEEe1bCu5IYYyXjnXbv448,7GRhBDsirIGkRZBtSMEzNTyDr2JQm4xx,93,225,82,109,48,67,27,4,562,80.28571428571429,14,0.0,113,82,88,48,112,67,21,27,4,331,231,0
33,959,SIuVkNKTY2J1cPfs6wUSNXAjh8XyxgwI,5X6FeZozNMgE2VRi3MJYjkkFK8SETtu2,1,0,0,0,0,0,1,0,1,0.14285714285714285,1,0.0,0,0,0,0,0,0,0,1,0,0,1,1
34,998,RJ1FVW8gXQIpK321uzh2Sh69ojlsqnvg,7GRhBDsirIGkRZBtSMEzNTyDr2JQm4xx,1,0,0,0,0,0,1,0,1,0.14285714285714285,1,0.0,0,0,0,0,0,0,0,1,0,0,1,1
35,1042,ypoGZw2r9uT31DVWRK8Ak5IwBPQDf2ZW,7GRhBDsirIGkRZBtSMEzNTyDr2JQm4xx,29,104,33,45,12,3,8,0,205,29.285714285714285,4,0.0,58,33,40,12,46,3,5,8,0,143,62,1
36,1067,9XUvtVr9N38jFL9d3KSBLe5NN0NI5Xv8,7GRhBDsirIGkRZBtSMEzNTyDr2JQm4xx,1,0,0,0,0,0,2,0,2,0.2857142857142857,2,0.0,0,0,0,0,0,0,0,2,0,0,2,1
37,1130,aaJeZnIT5e0GpVZyGMksW5aGfCnXK0Ln,7GRhBDsirIGkRZBtSMEzNTyDr2JQm4xx,49,185,2,134,0,63,23,3,410,58.57142857142857,4,0.0,108,2,98,0,77,63,36,23,3,208,202,1
38,1165,ONITjjzK5mBJXCjV8dV3cxn5gSx54mVg,5X6FeZozNMgE2VRi3MJYjkkFK8SETtu2,8,5,1,8,0,0,3,0,17,2.4285714285714284,2,0.0,0,1,7,0,5,0,1,3,0,8,9,1
39,1194,WFh9KL1sDhp4NpPSjJuGtUwdjU2As3jU,7GRhBDsirIGkRZBtSMEzNTyDr2JQm4xx,85,170,27,199,43,9,44,1,493,70.42857142857143,12,0.0,84,27,177,43,86,9,22,44,1,331,162,1
40,1197,x9GXQQjoWNWecF7wnG4Lnubsxy4Sbicl,7GRhBDsirIGkRZBtSMEzNTyDr2JQm4xx,71,172,55,155,44,20,32,0,478,68.28571428571429,5,0.0,99,55,132,44,73,20,23,32,0,330,148,1
41,1237,UFv1bKZxvNXWxAHJe8kps3jRxbYwJ8co,5X6FeZozNMgE2VRi3MJYjkkFK8SETtu2,6,9,7,0,4,0,2,0,22,3.142857142857143,1,0.0,0,7,0,4,9,0,0,2,0,11,11,1
42,1261,YxEAEqB4R6GTRBWDvga1GWE0URAxGc6U,5X6FeZozNMgE2VRi3MJYjkkFK8SETtu2,14,38,14,6,1,7,11,0,77,11.0,8,0.0,7,14,5,1,31,7,1,11,0,27,50,0
43,1293,2CIqPxwfpdleLKAwuxTPlDujU1ToKMCe,7GRhBDsirIGkRZBtSMEzNTyDr2JQm4xx,97,175,74,171,40,107,62,3,632,90.28571428571429,15,0.0,70,74,147,40,105,107,24,62,3,331,301,0
44,1298,xdVF44pcmC57LxybIN6S03WC3lkijhye,7GRhBDsirIGkRZBtSMEzNTyDr2JQm4xx,9,7,5,0,4,0,4,0,20,2.857142857142857,2,0.0,0,5,0,4,7,0,0,4,0,9,11,0
45,1304,CSh5hGbaSFu2yCb31iVMOVwKocrH471Q,7GRhBDsirIGkRZBtSMEzNTyDr2JQm4xx,8,23,14,0,7,0,9,0,53,7.571428571428571,7,0.0,2,14,0,7,21,0,0,9,0,23,30,1
46,1327,2cWT2r9kI6XDpveso7mwMhmCGJDMpJ6X,7GRhBDsirIGkRZBtSMEzNTyDr2JQm4xx,27,52,1,68,5,6,15,1,148,21.142857142857142,2,0.0,23,1,59,5,29,6,9,15,1,88,60,1
47,1334,BdwcZr5MO8X0sPJO0Tqucc1g1g6IA4vq,7GRhBDsirIGkRZBtSMEzNTyDr2JQm4xx,75,366,95,127,17,34,23,0,662,94.57142857142857,14,0.0,181,95,117,17,185,34,10,23,0,410,252,0
48,1382,JvCKYcuVOlSTBNmxLAtFrakOFOWMnICM,5X6FeZozNMgE2VRi3MJYjkkFK8SETtu2,6,3,1,0,2,0,2,0,8,1.1428571428571428,1,0.0,1,1,0,2,2,0,0,2,0,4,4,1
49,1384,UUY3BPLR7A3Xa6FGsztMCn6xCbxtdCYu,5X6FeZozNMgE2VRi3MJYjkkFK8SETtu2,27,44,7,30,25,0,3,0,109,15.571428571428571,6,0.0,35,7,26,25,9,0,4,3,0,93,16,1
50,1388,8W0dKFntzVy5gs8nAvO6lyUGOY4SLHwO,5X6FeZozNMgE2VRi3MJYjkkFK8SETtu2,2,0,0,0,0,0,2,0,2,0.2857142857142857,1,0.0,0,0,0,0,0,0,0,2,0,0,2,1
51,1395,YAuAlaDad79jVXW80O0RGtQjJBBOLDit,7GRhBDsirIGkRZBtSMEzNTyDr2JQm4xx,5,4,1,0,0,0,3,1,9,1.2857142857142858,1,0.0,1,1,0,0,3,0,0,3,1,2,7,1
52,1396,4pgEahxP0BMucPOaES4iKt1glSEl2goc,7GRhBDsirIGkRZBtSMEzNTyDr2JQm4xx,154,562,150,237,79,66,88,5,1187,169.57142857142858,18,0.0,247,150,188,79,315,66,49,88,5,664,523,0
53,1434,M3xTB6LenTJvMpybZKparVtRZKzrRM1R,7GRhBDsirIGkRZBtSMEzNTyDr2JQm4xx,1,0,0,0,0,0,2,0,2,0.2857142857142857,2,0.0,0,0,0,0,0,0,0,2,0,0,2,1
54,1436,hmtOqZVjWQ6rLJb3YkFWytQIy20ogszh,7GRhBDsirIGkRZBtSMEzNTyDr2JQm4xx,43,47,17,75,19,10,17,0,185,26.428571428571427,4,0.0,20,17,64,19,27,10,11,17,0,120,65,1
55,1644,P18honwQPPbELUE86qFIATuZK3YDtjvG,7GRhBDsirIGkRZBtSMEzNTyDr2JQm4xx,34,61,7,52,7,7,8,0,142,20.285714285714285,7,0.0,30,7,42,7,31,7,10,8,0,86,56,1
56,1682,rGP2g0AMaZmMVMjLaxKJkSmzZgbB3U4e,7GRhBDsirIGkRZBtSMEzNTyDr2JQm4xx,4,0,0,0,0,0,4,0,4,0.5714285714285714,1,0.0,0,0,0,0,0,0,0,4,0,0,4,0
57,1739,MSwjf2I17FAgMFqknSNlHHVpwcQKsxyQ,7GRhBDsirIGkRZBtSMEzNTyDr2JQm4xx,106,192,59,174,62,112,23,5,627,89.57142857142857,7,0.0,90,59,141,62,102,112,33,23,5,352,275,1
58,1765,8nlNDsWSaxHCvsMKtqhBs81sknEiTCeb,7GRhBDsirIGkRZBtSMEzNTyDr2JQm4xx,117,147,71,96,82,0,17,0,413,59.0,12,0.0,56,71,76,82,91,0,20,17,0,285,128,0
59,1771,jImHfNEIObE674KdIbKVj7cCJ4ufqzHJ,7GRhBDsirIGkRZBtSMEzNTyDr2JQm4xx,63,158,76,83,11,785,98,7,1218,174.0,27,0.0,51,76,71,11,107,785,12,98,7,209,1009,0
60,1775,mIe8dQN3qDFpsTsivIoOXC4yOCPP2RyG,7GRhBDsirIGkRZBtSMEzNTyDr2JQm4xx,110,427,58,106,60,40,43,3,737,105.28571428571429,13,0.0,203,58,93,60,224,40,13,43,3,414,323,0
61,1784,UfAib2ALXY0xvrv3U33IqXbLFQct6ZlR,5X6FeZozNMgE2VRi3MJYjkkFK8SETtu2,106,157,63,203,61,0,22,0,506,72.28571428571429,15,0.0,71,63,168,61,86,0,35,22,0,363,143,1
62,1802,STdhsQG5tLZHsan5xGUL8YXDFoc6MDRe,fbPkOYLVPtPgIt0MxizjfFJov3JbHyAi,63,196,5,119,21,112,29,0,482,68.85714285714286,10,0.0,86,5,118,21,110,112,1,29,0,230,252,0
63,1808,Slk5JcZSYHmDLQZXaNVmcMDmjJ16kBhI,fbPkOYLVPtPgIt0MxizjfFJov3JbHyAi,43,222,5,68,10,45,32,3,385,55.0,15,0.0,77,5,56,10,145,45,12,32,3,148,237,1
64,1809,oo6yDppb7lwtVg5iRhFytpMjmAuhJrAW,fbPkOYLVPtPgIt0MxizjfFJov3JbHyAi,41,166,68,38,20,178,46,7,523,74.71428571428571,7,0.0,28,68,34,20,138,178,4,46,7,150,373,0
65,1810,EaMlaC9qHLvL6wupBNJ0TiXUKnGXhVo4,fbPkOYLVPtPgIt0MxizjfFJov3JbHyAi,27,53,1,0,0,0,1,0,55,7.857142857142857,1,0.0,0,1,0,0,53,0,0,1,0,1,54,1
66,1814,KVMcZ0CphnUUs4jbRYRdgMvMogJko09j,fbPkOYLVPtPgIt0MxizjfFJov3JbHyAi,77,159,104,59,48,42,38,0,450,64.28571428571429,12,0.0,31,104,49,48,128,42,10,38,0,232,218,0
67,1820,wcY3GU6p1SvabYZJ4EXjB1vjnfCfIW4s,fbPkOYLVPtPgIt0MxizjfFJov3JbHyAi,1,0,0,0,0,0,1,0,1,0.14285714285714285,1,0.0,0,0,0,0,0,0,0,1,0,0,1,1
68,1824,iQpP0qT2CHD9i5LDED8ej6YadyfX6mXh,fbPkOYLVPtPgIt0MxizjfFJov3JbHyAi,25,80,30,42,18,6,12,0,188,26.857142857142858,4,0.0,15,30,35,18,65,6,7,12,0,98,90,1
69,1825,XE68NKSR0NgsUmxAP8OC135kqBLzzb9D,fbPkOYLVPtPgIt0MxizjfFJov3JbHyAi,4,2,1,0,1,0,2,0,6,0.8571428571428571,1,0.0,0,1,0,1,2,0,0,2,0,2,4,1
70,1834,XuNt1i5t4SR1AjDP4UHvsoux0R9qVf5C,fbPkOYLVPtPgIt0MxizjfFJov3JbHyAi,62,108,57,80,33,65,17,2,362,51.714285714285715,5,0.0,31,57,73,33,77,65,7,17,2,194,168,0
71,1836,XlDfnhryafmarvecZhKZMWL7AupGjwi4,fbPkOYLVPtPgIt0MxizjfFJov3JbHyAi,6,17,5,0,1,0,4,0,27,3.857142857142857,4,0.0,0,5,0,1,17,0,0,4,0,6,21,1
72,1837,QvqMF8oqvOJDLWUvXbTcLl7n0z5cypNQ,fbPkOYLVPtPgIt0MxizjfFJov3JbHyAi,16,27,18,0,13,1,17,2,78,11.142857142857142,4,0.0,1,18,0,13,26,1,0,17,2,32,46,1
73,1839,qXcFDYoJ2Tmvn4GnsFiSYxCLULI6cc20,fbPkOYLVPtPgIt0MxizjfFJov3JbHyAi,1,0,0,0,0,0,1,0,1,0.14285714285714285,1,0.0,0,0,0,0,0,0,0,1,0,0,1,1
74,1840,Iu7ZFqvdIqcN7J7qsVmoWhike7u8btfF,fbPkOYLVPtPgIt0MxizjfFJov3JbHyAi,6,6,3,0,3,0,1,0,13,1.8571428571428572,1,0.0,0,3,0,3,6,0,0,1,0,6,7,1
75,1841,gTq3Jt1elji3HMm3G6xjBSvg23Zfv1Lq,fbPkOYLVPtPgIt0MxizjfFJov3JbHyAi,4,0,0,0,0,0,3,1,4,0.5714285714285714,1,0.0,0,0,0,0,0,0,0,3,1,0,4,1
76,1843,oijvB3j3cAyuH8Lq33rEfjJgjg2BSCaL,fbPkOYLVPtPgIt0MxizjfFJov3JbHyAi,1,0,0,0,0,0,3,0,3,0.42857142857142855,1,0.0,0,0,0,0,0,0,0,3,0,0,3,0
77,1846,82UlWF6Fm1gkNum7nNbVw0yOV1BUdNoS,fbPkOYLVPtPgIt0MxizjfFJov3JbHyAi,7,11,6,0,3,18,4,0,42,6.0,3,0.0,2,6,0,3,9,18,0,4,0,11,31,1
78,1847,MFSnnewEgqB5QLFN17tBwn3frVrP2njr,fbPkOYLVPtPgIt0MxizjfFJov3JbHyAi,6,1,1,0,1,0,3,0,6,0.8571428571428571,1,0.0,0,1,0,1,1,0,0,3,0,2,4,1
79,1848,JfQVgXDVu1NGs9lcRBOD4w6V7BSaZCc2,fbPkOYLVPtPgIt0MxizjfFJov3JbHyAi,85,123,70,60,41,49,44,0,387,55.285714285714285,19,0.0,30,70,53,41,93,49,7,44,0,194,193,0
80,1850,62aEkx5hiqjq7miMyrFwVbP7Jkesq4eo,fbPkOYLVPtPgIt0MxizjfFJov3JbHyAi,46,64,34,32,20,1,17,1,169,24.142857142857142,5,0.0,21,34,29,20,43,1,3,17,1,104,65,0
81,1851,cAUuHXvOoCXwQjZWWRqNDA8udivSTUZW,fbPkOYLVPtPgIt0MxizjfFJov3JbHyAi,29,47,4,0,5,0,8,0,64,9.142857142857142,6,0.0,4,4,0,5,43,0,0,8,0,13,51,0
82,1853,fefutpRiLgvjmF5iytA8L23Z41dS6GAe,fbPkOYLVPtPgIt0MxizjfFJov3JbHyAi,9,4,2,0,2,0,7,0,15,2.142857142857143,1,0.0,1,2,0,2,3,0,0,7,0,5,10,1
83,1854,sjBn8oayOINN3T3JZLXHY4beCfaHLSkq,fbPkOYLVPtPgIt0MxizjfFJov3JbHyAi,51,106,37,38,28,19,15,1,244,34.857142857142854,9,0.0,36,37,36,28,70,19,2,15,1,137,107,0
84,1855,cy2CnLMLxJkryBCEHSwR3ZMTpAjnoO1C,fbPkOYLVPtPgIt0MxizjfFJov3JbHyAi,68,275,44,36,21,837,120,1,1334,190.57142857142858,19,0.0,28,44,31,21,247,837,5,120,1,124,1210,0
85,1857,3LBSAbcxxmlIGNLvUbxOBHP17eWw2EWo,fbPkOYLVPtPgIt0MxizjfFJov3JbHyAi,64,89,55,35,28,26,19,1,253,36.142857142857146,6,0.0,17,55,34,28,72,26,1,19,1,134,119,0
86,1858,K0OSl2yDmHYQ9TtZdxy9shErNwx3ga0n,fbPkOYLVPtPgIt0MxizjfFJov3JbHyAi,67,86,19,39,20,35,19,0,218,31.142857142857142,4,0.0,42,19,36,20,44,35,3,19,0,117,101,0
87,1860,FGqqsUrb3kPcKGZsrZzktReZzGvahk6x,fbPkOYLVPtPgIt0MxizjfFJov3JbHyAi,1,0,0,0,0,0,1,0,1,0.14285714285714285,1,0.0,0,0,0,0,0,0,0,1,0,0,1,1
88,1866,mrzCfkgyM6KyC9H5Ok54xCLYWyp2COiw,fbPkOYLVPtPgIt0MxizjfFJov3JbHyAi,9,10,4,0,3,17,4,1,39,5.571428571428571,2,0.0,2,4,0,3,8,17,0,4,1,9,30,1
89,1868,euJ8gpxfARpnWjt9X8Fyxm47A6A32cKl,fbPkOYLVPtPgIt0MxizjfFJov3JbHyAi,66,213,113,53,58,128,59,2,626,89.42857142857143,20,0.0,39,113,42,58,174,128,11,59,2,252,374,0
90,1877,BPWa0SjleiqllaywZCKubwGSdtmQ6n1j,fbPkOYLVPtPgIt0MxizjfFJov3JbHyAi,8,8,5,0,4,0,3,0,20,2.857142857142857,2,0.0,0,5,0,4,8,0,0,3,0,9,11,1
91,1881,02osjR1oAEAT2tx2XAaqACclHtsIr8rE,fbPkOYLVPtPgIt0MxizjfFJov3JbHyAi,8,3,2,0,1,0,6,1,13,1.8571428571428572,1,0.0,0,2,0,1,3,0,0,6,1,3,10,1
92,1884,Lw3OTYhUx7axX1lA5vXOpSGbloCwnp86,fbPkOYLVPtPgIt0MxizjfFJov3JbHyAi,1,0,0,0,0,0,1,0,1,0.14285714285714285,1,0.0,0,0,0,0,0,0,0,1,0,0,1,1
93,1885,9sckfYHCSe28pCKnT8xoBCq2thEZcsel,fbPkOYLVPtPgIt0MxizjfFJov3JbHyAi,12,40,7,5,4,0,5,0,61,8.714285714285714,3,0.0,5,7,4,4,35,0,1,5,0,20,41,1
94,1887,K4MChPhhtYZYK5nsYtiS9NQwcF94wGaC,fbPkOYLVPtPgIt0MxizjfFJov3JbHyAi,4,2,1,0,0,0,3,0,6,0.8571428571428571,2,0.0,0,1,0,0,2,0,0,3,0,1,5,1
95,1889,9lZ5nNFJAuEwr4dRJLRoTk52o5oWJaUg,fbPkOYLVPtPgIt0MxizjfFJov3JbHyAi,78,139,73,41,39,130,37,2,461,65.85714285714286,16,0.0,39,73,39,39,100,130,2,37,2,190,271,0
96,1890,5Je2VLAwuZruzgC8VlqQVm8FviqbC6xZ,fbPkOYLVPtPgIt0MxizjfFJov3JbHyAi,1,0,0,0,0,0,1,0,1,0.14285714285714285,1,0.0,0,0,0,0,0,0,0,1,0,0,1,1
97,1892,h8BwrBZ61dHhi5fhxZzTUeeYh9J3sER4,fbPkOYLVPtPgIt0MxizjfFJov3JbHyAi,41,51,40,0,28,5,14,0,138,19.714285714285715,6,0.0,1,40,0,28,50,5,0,14,0,69,69,0
98,1896,jUl2kLMoCTUN58qgYEYf5N92MAr4mMfa,fbPkOYLVPtPgIt0MxizjfFJov3JbHyAi,1,0,0,0,0,0,1,0,1,0.14285714285714285,1,0.0,0,0,0,0,0,0,0,1,0,0,1,1
99,1897,hcKYo6bLhlANvHE0FxLuR4YY8jocfBwJ,fbPkOYLVPtPgIt0MxizjfFJov3JbHyAi,1,0,0,0,0,0,1,0,1,0.14285714285714285,1,0.0,0,0,0,0,0,0,0,1,0,0,1,1
100,1898,ZMrMY3HH6RynOCICdOELEimn3CmP7dy3,fbPkOYLVPtPgIt0MxizjfFJov3JbHyAi,21,16,11,0,7,5,12,1,52,7.428571428571429,1,0.0,0,11,0,7,16,5,0,12,1,18,34,1
101,1900,FELnhQR0c7GZZX82ioYJEZsqujOrfyf7,fbPkOYLVPtPgIt0MxizjfFJov3JbHyAi,12,8,5,0,3,23,7,2,48,6.857142857142857,3,0.0,1,5,0,3,7,23,0,7,2,9,39,1
102,1904,BPDBF5tyty2uKhrkjUyl8tBSIG5JMhpy,fbPkOYLVPtPgIt0MxizjfFJov3JbHyAi,1,0,0,0,0,0,1,0,1,0.14285714285714285,1,0.0,0,0,0,0,0,0,0,1,0,0,1,1
103,1905,rH9yibot6cCOaAZphZeWIT7V2pydvksO,fbPkOYLVPtPgIt0MxizjfFJov3JbHyAi,7,8,5,0,3,0,3,0,19,2.7142857142857144,3,0.0,0,5,0,3,8,0,0,3,0,8,11,1
104,1907,O4E7as3W8jLvygS4k9RX6VKdAkX7GkpR,fbPkOYLVPtPgIt0MxizjfFJov3JbHyAi,32,70,25,34,19,4,27,0,179,25.571428571428573,6,0.0,24,25,26,19,46,4,8,27,0,94,85,0
105,1908,uJfbc9I7P24gwBxCb4NuFSYLPcQJXbJC,fbPkOYLVPtPgIt0MxizjfFJov3JbHyAi,71,255,158,64,93,176,79,10,835,119.28571428571429,16,0.0,64,158,52,93,191,176,12,79,10,367,468,0
106,1912,MdxqKOIqCszdaKiwqbC4Jnh5EK0S8h9R,fbPkOYLVPtPgIt0MxizjfFJov3JbHyAi,9,13,8,0,0,0,11,1,33,4.714285714285714,1,0.0,3,8,0,0,10,0,0,11,1,11,22,1
107,1914,Ms0MC4W5moiGJLWP7iE3FImeH9CHN4KT,fbPkOYLVPtPgIt0MxizjfFJov3JbHyAi,43,58,36,0,25,3,15,2,139,19.857142857142858,7,0.0,10,36,0,25,48,3,0,15,2,71,68,0
108,1916,tVqAcFuT9hhnm1hCghUIPQ6yusJDuuSu,fbPkOYLVPtPgIt0MxizjfFJov3JbHyAi,5,2,1,0,1,0,3,0,7,1.0,1,0.0,0,1,0,1,2,0,0,3,0,2,5,1
109,1919,ZVE1PX7xOz79BV4QTr7JFzHx09U83o43,fbPkOYLVPtPgIt0MxizjfFJov3JbHyAi,47,106,62,23,34,26,10,1,262,37.42857142857143,7,0.0,26,62,21,34,80,26,2,10,1,143,119,0
110,1920,3Nb5o5OohsDNIgLceYbTurAWBMiIQRDh,fbPkOYLVPtPgIt0MxizjfFJov3JbHyAi,52,75,42,36,28,26,16,0,223,31.857142857142858,8,0.0,21,42,30,28,54,26,6,16,0,121,102,0
111,1921,m5pwX7LcxwodHsYRsjS4kbbCcfNVrJK0,fbPkOYLVPtPgIt0MxizjfFJov3JbHyAi,1,0,0,0,0,0,1,0,1,0.14285714285714285,1,0.0,0,0,0,0,0,0,0,1,0,0,1,1
112,1924,bRmU4ghbgx16XrcSMiRmwAVngSF9Tm10,fbPkOYLVPtPgIt0MxizjfFJov3JbHyAi,10,13,6,0,3,12,11,0,45,6.428571428571429,4,0.0,0,6,0,3,13,12,0,11,0,9,36,0
113,1925,UHEdqIfQMlcBmdDDlAACqjd4uHB22PZR,fbPkOYLVPtPgIt0MxizjfFJov3JbHyAi,12,21,10,0,4,5,7,1,48,6.857142857142857,6,0.0,0,10,0,4,21,5,0,7,1,14,34,0
114,1927,KGKXtIu1hkHju7SCZs8gtmA9OwHIqK9w,fbPkOYLVPtPgIt0MxizjfFJov3JbHyAi,76,338,236,14,108,483,110,2,1291,184.42857142857142,24,0.0,38,236,14,108,300,483,0,110,2,396,895,0
115,1930,7Qi8MZVdpAWF6Jx24ApQvOp3KudDuUEC,fbPkOYLVPtPgIt0MxizjfFJov3JbHyAi,11,18,11,0,6,0,5,0,40,5.714285714285714,4,0.0,0,11,0,6,18,0,0,5,0,17,23,1
116,1935,IYkDwN1NqESg9tIIKef8uQFcXBsQSE34,fbPkOYLVPtPgIt0MxizjfFJov3JbHyAi,1,0,0,0,0,0,2,0,2,0.2857142857142857,1,0.0,0,0,0,0,0,0,0,2,0,0,2,0
117,1937,vtrHNbtnxRGyZem1sSOdKIp109fZtSKY,fbPkOYLVPtPgIt0MxizjfFJov3JbHyAi,31,45,21,22,10,49,27,1,175,25.0,5,0.0,9,21,18,10,36,49,4,27,1,58,117,0
118,1942,NRZZegI67zDF052JVDnfYLHjHIY2inab,fbPkOYLVPtPgIt0MxizjfFJov3JbHyAi,1,0,0,0,0,0,1,0,1,0.14285714285714285,1,0.0,0,0,0,0,0,0,0,1,0,0,1,1
119,1944,FPtAc2MhfpwZkpPIx5xZqPDLAMDq2xlZ,fbPkOYLVPtPgIt0MxizjfFJov3JbHyAi,45,112,32,29,15,30,26,2,246,35.142857142857146,9,0.0,20,32,24,15,92,30,5,26,2,91,155,0
120,1946,oNX40hvUpCseO8BHKhGJvG2jyQpYKQyk,fbPkOYLVPtPgIt0MxizjfFJov3JbHyAi,28,43,22,12,12,8,9,0,106,15.142857142857142,7,0.0,8,22,12,12,35,8,0,9,0,54,52,0
121,1958,Kw83ufYGIFIihz0PdiaJro4hz0pKGozQ,5Gyp41oLVo7Gg7vF4vpmggWP5MU70QO6,44,94,42,28,33,26,18,0,241,34.42857142857143,18,0.0,23,42,22,33,71,26,6,18,0,120,121,0
122,1994,47LBAXNnKzRCqKWIovDbM0zFAyPUjM88,5Gyp41oLVo7Gg7vF4vpmggWP5MU70QO6,32,100,45,29,7,15,32,2,230,32.857142857142854,12,0.0,14,45,25,7,86,15,4,32,2,91,139,0
123,2014,ek66b6nmpAPcdgKkBr30KolosV8yrA1B,5Gyp41oLVo7Gg7vF4vpmggWP5MU70QO6,10,17,8,0,5,0,6,0,36,5.142857142857143,2,0.0,0,8,0,5,17,0,0,6,0,13,23,1
124,2053,1pusTPLSLF5m0UuZqZkNpGlAq8VrQ1KA,5Gyp41oLVo7Gg7vF4vpmggWP5MU70QO6,10,8,6,0,3,11,8,0,36,5.142857142857143,2,0.0,0,6,0,3,8,11,0,8,0,9,27,0
125,2106,ykaUPJW4Nc9r2mv4b25QxgdHgIcQ63RQ,5Gyp41oLVo7Gg7vF4vpmggWP5MU70QO6,13,18,9,0,7,0,6,0,40,5.714285714285714,6,0.0,4,9,0,7,14,0,0,6,0,20,20,0
126,2111,0PrF4PViZdaRQhbt6FYXwLbcetJ8RnwC,5Gyp41oLVo7Gg7vF4vpmggWP5MU70QO6,37,73,43,51,13,16,18,1,215,30.714285714285715,6,0.0,17,43,36,13,56,16,15,18,1,109,106,0
127,2119,cs5iJZEgrhw6pymo9S5BmSlmIVmjOxuC,5Gyp41oLVo7Gg7vF4vpmggWP5MU70QO6,5,2,1,0,1,0,2,0,6,0.8571428571428571,1,0.0,0,1,0,1,2,0,0,2,0,2,4,1
128,2136,4BCWVZMgSyk2ZEk4MHhm6b7lpgXWTd1k,5Gyp41oLVo7Gg7vF4vpmggWP5MU70QO6,9,8,5,0,2,0,13,0,28,4.0,4,0.0,0,5,0,2,8,0,0,13,0,7,21,1
129,2151,iukICc3JPXkGjh0WhluWsphhopQF3KWw,5Gyp41oLVo7Gg7vF4vpmggWP5MU70QO6,16,25,8,4,8,46,5,0,96,13.714285714285714,1,0.0,6,8,2,8,19,46,2,5,0,24,72,1
130,2175,H2CmpQwC8u6bUYrLfEioNF80NHwY8Kda,5Gyp41oLVo7Gg7vF4vpmggWP5MU70QO6,8,12,5,0,2,0,3,0,22,3.142857142857143,3,0.0,1,5,0,2,11,0,0,3,0,8,14,1
131,2200,7fC3V6ivG07wUIMOmiYFzSlyjWvbYnYf,5Gyp41oLVo7Gg7vF4vpmggWP5MU70QO6,66,295,141,55,134,34,48,1,708,101.14285714285714,23,0.0,112,141,45,134,183,34,10,48,1,432,276,0
132,2305,TYu8VgV6TkJO1pWVABdfXnpa6VWQUK0O,5Gyp41oLVo7Gg7vF4vpmggWP5MU70QO6,10,9,5,4,3,0,4,0,25,3.5714285714285716,2,0.0,1,5,2,3,8,0,2,4,0,11,14,1
133,2325,7xNBrJLcG8Tw9PPj6SmLjDEzgSVEhwan,5Gyp41oLVo7Gg7vF4vpmggWP5MU70QO6,6,3,2,0,2,0,1,0,8,1.1428571428571428,1,0.0,0,2,0,2,3,0,0,1,0,4,4,1
134,2329,B53rQjZV2s1qM1mdslF7H0dhr2CQ3LuA,5Gyp41oLVo7Gg7vF4vpmggWP5MU70QO6,71,217,110,43,51,30,73,1,525,75.0,14,0.0,63,110,35,51,154,30,8,73,1,259,266,0
135,2357,KVKSKijrm1pqyHhwQWfTwA4kKVI4llyg,5Gyp41oLVo7Gg7vF4vpmggWP5MU70QO6,36,116,64,28,19,41,26,6,300,42.857142857142854,10,0.0,21,64,23,19,95,41,5,26,6,127,173,1
136,2378,jagu0OJDhWTGFhfCMk0ghqluLpW3kzdC,5Gyp41oLVo7Gg7vF4vpmggWP5MU70QO6,55,129,68,50,49,32,69,1,398,56.857142857142854,12,0.0,45,68,37,49,84,32,13,69,1,199,199,0
137,2414,4XD1OCm9J6eGrgnmkV8L1dJofrPXRP8h,5Gyp41oLVo7Gg7vF4vpmggWP5MU70QO6,1,0,0,0,0,0,1,0,1,0.14285714285714285,1,0.0,0,0,0,0,0,0,0,1,0,0,1,1
138,2423,VBP5PzVQEKJYFH0y5ffEek5WfP9EW7uc,5Gyp41oLVo7Gg7vF4vpmggWP5MU70QO6,9,31,17,0,6,0,14,0,68,9.714285714285714,10,0.0,0,17,0,6,31,0,0,14,0,23,45,1
139,2431,aLBCLovWtsTVGrFSP6GDPJFus2iLCsBA,5Gyp41oLVo7Gg7vF4vpmggWP5MU70QO6,39,80,55,34,27,117,63,4,380,54.285714285714285,11,0.0,21,55,28,27,59,117,6,63,4,131,249,0
140,2478,sEaRV4bDDMQNCEEDgfeSBwdLrHLpijC1,5Gyp41oLVo7Gg7vF4vpmggWP5MU70QO6,5,2,1,0,1,0,2,0,6,0.8571428571428571,1,0.0,0,1,0,1,2,0,0,2,0,2,4,1
141,2510,cxmD5n6LDACjvuY8YvfXaGJ22S8l6lkc,5Gyp41oLVo7Gg7vF4vpmggWP5MU70QO6,41,137,79,20,15,11,28,0,290,41.42857142857143,16,0.0,12,79,16,15,125,11,4,28,0,122,168,0
142,2512,whspXo2pdzqGQ7uUMsLjiaHYpjkc35JW,5Gyp41oLVo7Gg7vF4vpmggWP5MU70QO6,49,136,67,20,47,25,21,1,317,45.285714285714285,10,0.0,49,67,11,47,87,25,9,21,1,174,143,0
143,2526,kMNlJ3SUrfspLoccJm7i7Ga1vRDYYkHR,5Gyp41oLVo7Gg7vF4vpmggWP5MU70QO6,9,5,3,0,2,5,6,1,22,3.142857142857143,1,0.0,0,3,0,2,5,5,0,6,1,5,17,0
144,2532,zoIiQhCrqESOgOihvqLK9jmbvYsDyFyX,5Gyp41oLVo7Gg7vF4vpmggWP5MU70QO6,43,138,60,21,12,1,17,0,249,35.57142857142857,4,0.0,57,60,15,12,81,1,6,17,0,144,105,0
145,2543,pE8tdmsTrjN5HHRRTaQLdkGJCKxiu9pi,5Gyp41oLVo7Gg7vF4vpmggWP5MU70QO6,32,44,22,15,13,1,3,0,98,14.0,4,0.0,13,22,9,13,31,1,6,3,0,57,41,1
146,2550,NEe55fIMKdRKAmR8PwThpLdcLgrL5XJ1,5Gyp41oLVo7Gg7vF4vpmggWP5MU70QO6,2,0,0,0,0,0,2,0,2,0.2857142857142857,1,0.0,0,0,0,0,0,0,0,2,0,0,2,1
147,2563,vt827MYpYgT0JKXBC62SZ24Gxa8OJ87k,5Gyp41oLVo7Gg7vF4vpmggWP5MU70QO6,59,326,148,71,59,134,52,4,794,113.42857142857143,11,0.0,107,148,51,59,219,134,20,52,4,365,429,0
148,2604,X9z7B75ZTLkGstRvWBad2bmZQEZBZmda,5Gyp41oLVo7Gg7vF4vpmggWP5MU70QO6,44,146,88,46,18,54,54,3,409,58.42857142857143,15,0.0,28,88,33,18,118,54,13,54,3,167,242,0
149,2614,udnRYxurswpE4GUZcnc80kafg0hn3fpz,5Gyp41oLVo7Gg7vF4vpmggWP5MU70QO6,23,220,44,0,34,0,54,0,352,50.285714285714285,21,0.0,37,44,0,34,183,0,0,54,0,115,237,0
150,2617,M01QL9OpHCk7AlCLR2rtkIB8z4TgIYGl,5Gyp41oLVo7Gg7vF4vpmggWP5MU70QO6,47,290,160,95,65,97,93,17,817,116.71428571428571,15,0.0,72,160,50,65,218,97,45,93,17,347,470,0
151,2625,peOW1xVaKPULFrN5Gy7l1puUz8vUwyZz,5Gyp41oLVo7Gg7vF4vpmggWP5MU70QO6,45,193,124,28,60,74,48,5,532,76.0,22,0.0,30,124,20,60,163,74,8,48,5,234,298,0
152,2630,EMVIXb0OtQUlOTkm4BctcXpIyPV4dTGO,5Gyp41oLVo7Gg7vF4vpmggWP5MU70QO6,4,2,1,0,1,0,2,0,6,0.8571428571428571,1,0.0,0,1,0,1,2,0,0,2,0,2,4,0
153,2664,cV3n4FN1620ZqQlUNaFdXix6LZl6cUn8,5Gyp41oLVo7Gg7vF4vpmggWP5MU70QO6,8,4,3,0,3,0,3,0,13,1.8571428571428572,1,0.0,0,3,0,3,4,0,0,3,0,6,7,1
154,2668,xckq5i6cAJkmHxvopO4zZfFpDuAbJTD2,5Gyp41oLVo7Gg7vF4vpmggWP5MU70QO6,33,102,48,30,19,20,33,1,253,36.142857142857146,8,0.0,18,48,19,19,84,20,11,33,1,104,149,0
155,2675,rnJrTdDu7mP8PmEtAmyCbCH0QGpW6nHa,5Gyp41oLVo7Gg7vF4vpmggWP5MU70QO6,4,2,1,0,1,0,1,0,5,0.7142857142857143,1,0.0,0,1,0,1,2,0,0,1,0,2,3,1
156,2678,mne1Bu1F2f0U7iravmS4eQYQtLTkVvPe,5Gyp41oLVo7Gg7vF4vpmggWP5MU70QO6,4,0,0,0,0,0,7,0,7,1.0,3,0.0,0,0,0,0,0,0,0,7,0,0,7,1
157,2717,WrI30gql4CXiDrOACPqDBIcNFooNoDwk,5Gyp41oLVo7Gg7vF4vpmggWP5MU70QO6,2,0,0,0,0,0,2,0,2,0.2857142857142857,1,0.0,0,0,0,0,0,0,0,2,0,0,2,1
158,2738,96X23CFJ9JM7WmqrATM2bLmfmOiHnfrX,5Gyp41oLVo7Gg7vF4vpmggWP5MU70QO6,35,66,36,13,22,1,7,0,145,20.714285714285715,5,0.0,14,36,7,22,52,1,6,7,0,79,66,0
159,2770,3ZzNkdWgGb47Go07PRKPf0XZ6jjhVCB4,5Gyp41oLVo7Gg7vF4vpmggWP5MU70QO6,42,272,122,29,84,185,66,0,758,108.28571428571429,26,0.0,42,122,24,84,230,185,5,66,0,272,486,0
160,2795,DnDoqjJw1BNGPuZ9dcYerb1WIF0EHs8x,5Gyp41oLVo7Gg7vF4vpmggWP5MU70QO6,24,21,14,2,9,3,18,2,69,9.857142857142858,5,0.0,3,14,2,9,18,3,0,18,2,28,41,1
161,2803,0CSUGuJXm53wz281T7wy30wWcjmP6Jhd,5Gyp41oLVo7Gg7vF4vpmggWP5MU70QO6,33,103,53,18,7,28,18,0,227,32.42857142857143,9,0.0,18,53,13,7,85,28,5,18,0,91,136,0
162,2804,ONKHwhUYyLbMoYOizs3x6BRvtIjp27lG,5Gyp41oLVo7Gg7vF4vpmggWP5MU70QO6,7,5,2,0,2,0,3,0,12,1.7142857142857142,1,0.0,0,2,0,2,5,0,0,3,0,4,8,1
163,2812,hkAtGlDxhMZy9x4yCGvjJAqvDCw8DkBI,5Gyp41oLVo7Gg7vF4vpmggWP5MU70QO6,30,85,15,23,5,19,35,1,183,26.142857142857142,10,0.0,19,15,16,5,66,19,7,35,1,55,128,0
164,2819,bYjPoNbc5ILh7K7s9YR8HLOMNJGN6Ums,5Gyp41oLVo7Gg7vF4vpmggWP5MU70QO6,20,22,14,0,8,15,12,0,71,10.142857142857142,8,0.0,0,14,0,8,22,15,0,12,0,22,49,1
165,2822,t1xspb1k3lEGBshWKCwAoW44MsPqXHk5,5Gyp41oLVo7Gg7vF4vpmggWP5MU70QO6,17,28,1,8,4,0,6,0,47,6.714285714285714,4,0.0,10,1,4,4,18,0,4,6,0,19,28,0
166,2837,Edq6Echk8wEs8ShX5RBw5c8Yx8ANHVje,5Gyp41oLVo7Gg7vF4vpmggWP5MU70QO6,49,111,50,10,33,2,30,2,238,34.0,13,0.0,29,50,5,33,82,2,5,30,2,117,121,0
167,2857,60gY64MOFYUu13Ky5y4CMyoTiFvuhXp2,5Gyp41oLVo7Gg7vF4vpmggWP5MU70QO6,7,3,2,0,2,0,3,0,10,1.4285714285714286,1,0.0,0,2,0,2,3,0,0,3,0,4,6,1
168,2860,2bHG7ONGdh3befVaVcc6ibNYzkNOmb0e,5Gyp41oLVo7Gg7vF4vpmggWP5MU70QO6,13,16,9,0,3,1,7,4,40,5.714285714285714,3,0.0,1,9,0,3,15,1,0,7,4,13,27,1
169,2864,HpFGogxriXu94DUDni0GJRB2oUqWtUQx,5Gyp41oLVo7Gg7vF4vpmggWP5MU70QO6,1,0,0,0,0,0,1,0,1,0.14285714285714285,1,0.0,0,0,0,0,0,0,0,1,0,0,1,1
170,2877,G0kF4kBuM6Jj6hDV14pdfZS9sd6CrECA,5Gyp41oLVo7Gg7vF4vpmggWP5MU70QO6,20,50,21,18,9,3,12,0,113,16.142857142857142,5,0.0,20,21,9,9,30,3,9,12,0,59,54,0
171,2896,FBu5R2eGEtl9EDw0VwXtH1t5i2ELpdqI,5Gyp41oLVo7Gg7vF4vpmggWP5MU70QO6,12,23,6,0,2,0,5,0,36,5.142857142857143,2,0.0,2,6,0,2,21,0,0,5,0,10,26,1
172,2950,XR058hEVFk2cvKXahoJQvXB4I3FGEFWq,5Gyp41oLVo7Gg7vF4vpmggWP5MU70QO6,1,0,0,0,0,0,1,0,1,0.14285714285714285,1,0.0,0,0,0,0,0,0,0,1,0,0,1,0
173,2961,cGrHiRjztN9fSltHujpfWaaWfYWiidiG,5Gyp41oLVo7Gg7vF4vpmggWP5MU70QO6,2,0,0,0,0,0,3,0,3,0.42857142857142855,2,0.0,0,0,0,0,0,0,0,3,0,0,3,1
174,3003,Stmqgxft30bli2DiPibxa3LKP7KjyBRV,5Gyp41oLVo7Gg7vF4vpmggWP5MU70QO6,31,89,47,22,23,50,15,2,248,35.42857142857143,7,0.0,22,47,16,23,67,50,6,15,2,108,140,0
175,3032,5Gu4g9dtF1zjfzBwHRDyoDsx2MPMINMH,5Gyp41oLVo7Gg7vF4vpmggWP5MU70QO6,31,77,40,70,1,0,10,0,198,28.285714285714285,2,0.0,19,40,66,1,58,0,4,10,0,126,72,1
176,3041,RbFI9SCNoIyFjKexw9cTU5NZ0thYBnL5,5Gyp41oLVo7Gg7vF4vpmggWP5MU70QO6,55,204,73,41,62,7,40,3,430,61.42857142857143,13,0.0,82,73,30,62,122,7,11,40,3,247,183,0
177,3067,ew5XZC7WSosl0QdXH45kYD3syMSGbOj6,5Gyp41oLVo7Gg7vF4vpmggWP5MU70QO6,1,0,0,0,0,0,1,0,1,0.14285714285714285,1,0.0,0,0,0,0,0,0,0,1,0,0,1,0
178,3086,8wC0Vn9zhGZjzg8i1kWPjzqsyM8HCSSM,5Gyp41oLVo7Gg7vF4vpmggWP5MU70QO6,69,297,150,112,71,424,48,0,1102,157.42857142857142,21,0.0,96,150,99,71,201,424,13,48,0,416,686,0
179,3087,k3nczalTXlbSi0cYWDqkezTZw8d7MaoO,5Gyp41oLVo7Gg7vF4vpmggWP5MU70QO6,33,107,58,36,23,49,32,11,316,45.142857142857146,13,0.0,25,58,27,23,82,49,9,32,11,133,183,0
180,3091,GgocYHg42QPeXhj3QB7FBVGJqSqHh2yN,5Gyp41oLVo7Gg7vF4vpmggWP5MU70QO6,34,88,26,0,26,5,23,0,168,24.0,8,0.0,27,26,0,26,61,5,0,23,0,79,89,0
181,3103,hSrmLZQ0ouEuE46yYppuvpfSWmkaTAsV,5Gyp41oLVo7Gg7vF4vpmggWP5MU70QO6,22,83,35,13,8,0,23,0,162,23.142857142857142,14,0.0,16,35,12,8,67,0,1,23,0,71,91,0
182,3106,FZjjoikxEifQwEx2vf6LYlhg4yyTwbym,5Gyp41oLVo7Gg7vF4vpmggWP5MU70QO6,51,193,85,18,58,109,54,1,518,74.0,15,0.0,65,85,16,58,128,109,2,54,1,224,294,0
183,3117,3alUhWh257mQM5A6onXPn87mqMwnY8ws,5Gyp41oLVo7Gg7vF4vpmggWP5MU70QO6,1,0,0,0,0,0,1,0,1,0.14285714285714285,1,0.0,0,0,0,0,0,0,0,1,0,0,1,1
184,3133,C2kNfLlJQRAYF9jyyvOY33F0K0B7w85s,5Gyp41oLVo7Gg7vF4vpmggWP5MU70QO6,26,57,12,4,19,0,3,0,95,13.571428571428571,3,0.0,12,12,3,19,45,0,1,3,0,46,49,1
185,3191,fgUFzGHeNl17hqEi3W2JykpUAQc4koPg,5Gyp41oLVo7Gg7vF4vpmggWP5MU70QO6,11,14,6,0,3,0,7,1,31,4.428571428571429,2,0.0,5,6,0,3,9,0,0,7,1,14,17,1
186,3238,RqpNlPb2cCeq8CyPlsCSTNzToel5DLJg,5Gyp41oLVo7Gg7vF4vpmggWP5MU70QO6,9,7,3,0,1,0,12,2,25,3.5714285714285716,2,0.0,0,3,0,1,7,0,0,12,2,4,21,1
187,3267,OxaZt3K3Y0azvZXJrIbIeL0AeQB2p2K4,5Gyp41oLVo7Gg7vF4vpmggWP5MU70QO6,56,179,72,59,41,0,23,0,374,53.42857142857143,12,0.0,64,72,53,41,115,0,6,23,0,230,144,0
188,3271,WbJsJWqKM3lS43E1ayfblK0uOswvkrBy,5Gyp41oLVo7Gg7vF4vpmggWP5MU70QO6,1,0,0,0,0,0,1,0,1,0.14285714285714285,1,0.0,0,0,0,0,0,0,0,1,0,0,1,0
189,3301,heK7nc5k2RSdLj3SvuiNd8QLDb3Aw9tD,5Gyp41oLVo7Gg7vF4vpmggWP5MU70QO6,48,85,39,35,23,0,19,0,201,28.714285714285715,8,0.0,29,39,31,23,56,0,4,19,0,122,79,1
190,3345,3SedPvLa9rnUraW3u95r8D0TjbdwSj9M,5Gyp41oLVo7Gg7vF4vpmggWP5MU70QO6,10,5,4,0,3,0,2,0,14,2.0,1,0.0,0,4,0,3,5,0,0,2,0,7,7,1
191,3374,2r9IB6lC6Oy8Xqssc8yaSHVEOeR5k2WS,5Gyp41oLVo7Gg7vF4vpmggWP5MU70QO6,10,17,7,8,4,0,3,0,39,5.571428571428571,1,0.0,7,7,4,4,10,0,4,3,0,22,17,1
192,3385,y2sFlozPI9e5wiYk71wUsisMSmh9RNB3,5Gyp41oLVo7Gg7vF4vpmggWP5MU70QO6,6,2,1,0,1,0,6,0,10,1.4285714285714286,2,0.0,0,1,0,1,2,0,0,6,0,2,8,1
193,3423,9QYs2JnzEz1dyotEIIiqe5EglaIRqzBA,5Gyp41oLVo7Gg7vF4vpmggWP5MU70QO6,39,83,48,29,15,99,26,1,301,43.0,6,0.0,15,48,22,15,68,99,7,26,1,100,201,1
194,3448,9A7NeA8CSGMqqHgIDjiMNeFZF78KMRT6,5Gyp41oLVo7Gg7vF4vpmggWP5MU70QO6,27,93,34,32,15,13,30,8,225,32.142857142857146,6,0.0,27,34,24,15,66,13,8,30,8,100,125,0
195,3472,mSToVMacc08MhsUyEFn562K69bpANB3P,5Gyp41oLVo7Gg7vF4vpmggWP5MU70QO6,61,293,134,66,40,215,56,14,818,116.85714285714286,14,0.0,67,134,54,40,226,215,12,56,14,295,523,0
196,3480,OkJhYKwSeoxo9QfBqEGs4KQuEMzG6KCA,5Gyp41oLVo7Gg7vF4vpmggWP5MU70QO6,10,14,7,0,2,0,8,0,31,4.428571428571429,3,0.0,0,7,0,2,14,0,0,8,0,9,22,0
197,3490,tc8ZYWI5FOJIIpcsZ5SRyil7whr7RTIT,5Gyp41oLVo7Gg7vF4vpmggWP5MU70QO6,33,235,113,33,32,52,68,3,536,76.57142857142857,19,0.0,25,113,23,32,210,52,10,68,3,193,343,0
198,3493,1La5rp9ZSz9cfpqCRJiC01Rwvuq5VVrf,5Gyp41oLVo7Gg7vF4vpmggWP5MU70QO6,12,15,5,6,3,0,2,0,31,4.428571428571429,4,0.0,3,5,3,3,12,0,3,2,0,14,17,0
199,3515,iFZG4dlakJZdEEPu5PWLYLDec0A3ezk6,5Gyp41oLVo7Gg7vF4vpmggWP5MU70QO6,28,84,41,24,14,19,28,0,210,30.0,11,0.0,12,41,15,14,72,19,9,28,0,82,128,1
200,3532,Ld3sHSdq8bGwJeSrWz9af9hzp17d25R5,5Gyp41oLVo7Gg7vF4vpmggWP5MU70QO6,28,69,32,24,24,27,15,1,192,27.428571428571427,5,0.0,27,32,14,24,42,27,10,15,1,97,95,1
201,3533,6Pp97ClWigmCDyQzndUvEvRvyItrAz2A,5Gyp41oLVo7Gg7vF4vpmggWP5MU70QO6,9,9,3,2,3,0,2,0,19,2.7142857142857144,1,0.0,4,3,1,3,5,0,1,2,0,11,8,1
202,3551,DFGg7Qbju1Dz3JMqDAHjIzuroOYl6wwL,5Gyp41oLVo7Gg7vF4vpmggWP5MU70QO6,48,152,10,47,23,0,4,0,236,33.714285714285715,13,0.0,51,10,38,23,101,0,9,4,0,122,114,0
203,3560,nddmXFfQFzxAIEZ4polypNoRyjVZSqXS,5Gyp41oLVo7Gg7vF4vpmggWP5MU70QO6,17,31,1,10,3,0,6,0,51,7.285714285714286,2,0.0,11,1,5,3,20,0,5,6,0,20,31,0
204,3585,Na52PtAqm4VlTMUv1OPLGNjij0a5votC,5Gyp41oLVo7Gg7vF4vpmggWP5MU70QO6,17,26,13,20,4,20,31,5,119,17.0,7,0.0,0,13,10,4,26,20,10,31,5,27,92,0
205,3610,RgS6cN22NDcPEz2PVRWnmeNSLehqgiy4,5Gyp41oLVo7Gg7vF4vpmggWP5MU70QO6,7,10,5,0,2,0,5,0,22,3.142857142857143,4,0.0,0,5,0,2,10,0,0,5,0,7,15,1
206,3615,pqJQtDHBlTpHU5kx7RDVO2AZuCEpP1kO,5Gyp41oLVo7Gg7vF4vpmggWP5MU70QO6,4,2,1,0,1,0,1,0,5,0.7142857142857143,1,0.0,0,1,0,1,2,0,0,1,0,2,3,0
207,3678,1Ld3jQU8M0eiaLBshs8gjcgQEfdlgHyZ,5Gyp41oLVo7Gg7vF4vpmggWP5MU70QO6,7,3,2,0,2,0,2,0,9,1.2857142857142858,1,0.0,0,2,0,2,3,0,0,2,0,4,5,1
208,3695,96BILLwhKLX5Hn5XJ4XGCvMlo8QDhAAj,5Gyp41oLVo7Gg7vF4vpmggWP5MU70QO6,22,42,20,20,4,0,11,0,97,13.857142857142858,8,0.0,12,20,14,4,30,0,6,11,0,50,47,1
209,3696,TnonHqPC6G7qJ5vHeDou42rbzghbN46S,5Gyp41oLVo7Gg7vF4vpmggWP5MU70QO6,5,8,3,0,0,5,4,0,20,2.857142857142857,2,0.0,0,3,0,0,8,5,0,4,0,3,17,0
210,3765,nGnrvK97r3RMi6jeeCNoh4oNvsCIm83c,5Gyp41oLVo7Gg7vF4vpmggWP5MU70QO6,40,57,38,35,33,0,9,0,172,24.571428571428573,10,0.0,13,38,31,33,44,0,4,9,0,115,57,1
211,3786,Qs2YbK0fD6pTy64WqUQiIpZgcuos1U4U,5Gyp41oLVo7Gg7vF4vpmggWP5MU70QO6,36,100,34,22,25,1,10,1,193,27.571428571428573,6,0.0,26,34,17,25,74,1,5,10,1,102,91,0
212,3799,aQ6WrdDe9pTNwVW3vmaMOs1pxy5r3Dxa,5Gyp41oLVo7Gg7vF4vpmggWP5MU70QO6,43,96,47,41,21,14,33,1,253,36.142857142857146,13,0.0,24,47,28,21,72,14,13,33,1,120,133,0
213,3813,7TThYfyCRCrubmWYQiguJ3i3ufFK20sF,5Gyp41oLVo7Gg7vF4vpmggWP5MU70QO6,38,190,75,16,32,0,26,0,339,48.42857142857143,13,0.0,30,75,11,32,160,0,5,26,0,148,191,0
214,3864,PZd5fNdXR4d8uiQE08GO3FhBeWfKgGZa,5Gyp41oLVo7Gg7vF4vpmggWP5MU70QO6,38,127,35,28,22,14,15,1,242,34.57142857142857,5,0.0,36,35,20,22,91,14,8,15,1,113,129,0
215,3879,6d0wTeGZDr0ncgCyWQX4AMn46gB2ZbPz,5Gyp41oLVo7Gg7vF4vpmggWP5MU70QO6,7,3,2,0,2,0,2,0,9,1.2857142857142858,1,0.0,0,2,0,2,3,0,0,2,0,4,5,1
216,3884,51Zu52p8EKTqQH4hOwojJruuTYI8nSTK,5Gyp41oLVo7Gg7vF4vpmggWP5MU70QO6,9,3,2,0,2,0,9,1,17,2.4285714285714284,1,0.0,0,2,0,2,3,0,0,9,1,4,13,1
217,3885,2gXHY5qLgY96Nt3kImmboPawcy43EQXt,5Gyp41oLVo7Gg7vF4vpmggWP5MU70QO6,1,0,0,0,0,0,1,0,1,0.14285714285714285,1,0.0,0,0,0,0,0,0,0,1,0,0,1,1
218,3949,INw0ppEeVE6U7QZWmqPzkYkz5rCg79CE,5Gyp41oLVo7Gg7vF4vpmggWP5MU70QO6,5,3,1,0,1,0,2,0,7,1.0,1,0.0,0,1,0,1,3,0,0,2,0,2,5,1
219,3958,Sy0IBVghIdDN5uhsYaAtE4EZP4lbDR6C,5Gyp41oLVo7Gg7vF4vpmggWP5MU70QO6,25,72,36,2,15,11,26,1,163,23.285714285714285,8,0.0,19,36,1,15,53,11,1,26,1,71,92,0
220,3977,eEAARLmSvs9SsNUVTuHWgSwtASBchrcX,5Gyp41oLVo7Gg7vF4vpmggWP5MU70QO6,24,184,63,26,11,72,34,2,392,56.0,18,0.0,32,63,23,11,152,72,3,34,2,129,263,0
221,3978,h8n9HekAuyT08sLL5qmdMZ3BdSJVR4QF,fbPkOYLVPtPgIt0MxizjfFJov3JbHyAi,25,57,33,0,11,117,37,2,257,36.714285714285715,11,0.0,3,33,0,11,54,117,0,37,2,47,210,0
222,3979,2GATpIfDBYFyTgYmFkr0bda9mVfNXuAl,fbPkOYLVPtPgIt0MxizjfFJov3JbHyAi,90,202,83,61,61,20,32,8,467,66.71428571428571,12,0.0,74,83,58,61,128,20,3,32,8,276,191,0
223,3980,7CTS8g5RByDUjwfG52XdQusTnAWGmBhD,fbPkOYLVPtPgIt0MxizjfFJov3JbHyAi,7,8,3,0,3,0,5,0,19,2.7142857142857144,4,0.0,0,3,0,3,8,0,0,5,0,6,13,1
224,3981,fbTCtGbhuEEqIHlqmw0iRyoH7wNTYXlV,fbPkOYLVPtPgIt0MxizjfFJov3JbHyAi,7,3,2,0,2,0,3,0,10,1.4285714285714286,1,0.0,0,2,0,2,3,0,0,3,0,4,6,1
225,3983,eQnxTOv5tF733HrH1v8IIfXTQQ20WB86,fbPkOYLVPtPgIt0MxizjfFJov3JbHyAi,5,2,1,0,1,7,9,0,20,2.857142857142857,2,0.0,0,1,0,1,2,7,0,9,0,2,18,1
226,3984,oY9JHCaqebrwbBFVvySUXQvzoRiFSB12,fbPkOYLVPtPgIt0MxizjfFJov3JbHyAi,8,5,2,0,2,3,6,1,19,2.7142857142857144,1,0.0,2,2,0,2,3,3,0,6,1,6,13,1
227,3985,d4cb9OZbLbDBqzuhcJemwCaulhBw3XcA,fbPkOYLVPtPgIt0MxizjfFJov3JbHyAi,18,55,10,21,9,15,2,0,112,16.0,2,0.0,19,10,18,9,36,15,3,2,0,56,56,1
228,3996,w2cvWGtYDFIPnh2ovYoWa5sxrg1Qp0H1,fbPkOYLVPtPgIt0MxizjfFJov3JbHyAi,11,13,9,0,6,0,6,0,34,4.857142857142857,2,0.0,0,9,0,6,13,0,0,6,0,15,19,1
229,3997,ZoqTlt1YSWNa9KffVPpNehpQugTpP3Na,fbPkOYLVPtPgIt0MxizjfFJov3JbHyAi,18,14,9,0,8,0,12,0,43,6.142857142857143,2,0.0,0,9,0,8,14,0,0,12,0,17,26,1
230,3998,q4Yehmjs3jQT9rXdV6cXhcGjESMqINf5,fbPkOYLVPtPgIt0MxizjfFJov3JbHyAi,85,184,110,59,67,43,32,2,497,71.0,16,0.0,46,110,53,67,138,43,6,32,2,276,221,0
231,4004,guY4SSn1fy4TWThod7s2lBFrUtiOX15g,fbPkOYLVPtPgIt0MxizjfFJov3JbHyAi,23,24,13,1,11,3,9,1,62,8.857142857142858,4,0.0,5,13,1,11,19,3,0,9,1,30,32,1
232,4007,tfoakS3EMOjWuYWNRSgWZTjBxe3Mf9Te,fbPkOYLVPtPgIt0MxizjfFJov3JbHyAi,35,58,35,17,15,11,25,2,163,23.285714285714285,9,0.0,7,35,14,15,51,11,3,25,2,71,92,0
233,4008,54s32diFNl04mUbmkn3h7tEt4XEhQ65w,fbPkOYLVPtPgIt0MxizjfFJov3JbHyAi,13,18,4,11,5,0,4,0,42,6.0,3,0.0,8,4,10,5,10,0,1,4,0,27,15,0
234,4009,yQdl23AC4WuqLN6qLaK80XdAyoAoH1QK,fbPkOYLVPtPgIt0MxizjfFJov3JbHyAi,9,3,2,0,2,1,10,1,19,2.7142857142857144,1,0.0,0,2,0,2,3,1,0,10,1,4,15,1
235,4011,cHr4Ma0WfX0OLiO7JvZC8s1q3EauwDjN,fbPkOYLVPtPgIt0MxizjfFJov3JbHyAi,25,66,27,5,24,9,24,5,160,22.857142857142858,5,0.0,15,27,4,24,51,9,1,24,5,70,90,1
236,4012,bZSiNUbAIuydDBd77IMAJ15Hy6k2A1kT,fbPkOYLVPtPgIt0MxizjfFJov3JbHyAi,1,0,0,0,0,0,1,0,1,0.14285714285714285,1,0.0,0,0,0,0,0,0,0,1,0,0,1,1
237,4020,s7dtbhPs1iKqu788xCkGZggRAum1oJgW,fbPkOYLVPtPgIt0MxizjfFJov3JbHyAi,7,2,1,0,1,1,5,2,12,1.7142857142857142,1,0.0,0,1,0,1,2,1,0,5,2,2,10,1
238,4023,A98oANyiAwfle2kQ1TjJxeaYVrk9o9i7,fbPkOYLVPtPgIt0MxizjfFJov3JbHyAi,26,84,43,25,17,126,30,3,328,46.857142857142854,5,0.0,22,43,19,17,62,126,6,30,3,101,227,1
239,4027,WYF6gnZ4xRpre5Df26WMDKWFofwrAPRG,fbPkOYLVPtPgIt0MxizjfFJov3JbHyAi,15,107,0,8,0,19,28,1,163,23.285714285714285,11,0.0,14,0,8,0,93,19,0,28,1,22,141,1
240,4032,rLDet26H0uxPJ5dsCZ5fa0WL1GxwPxuK,fbPkOYLVPtPgIt0MxizjfFJov3JbHyAi,9,7,4,0,2,19,8,0,40,5.714285714285714,3,0.0,0,4,0,2,7,19,0,8,0,6,34,1
241,4033,OkJ0lKmMXuQ2MGftQ8Isfw1JciMpapRC,fbPkOYLVPtPgIt0MxizjfFJov3JbHyAi,5,3,2,0,2,2,2,0,11,1.5714285714285714,1,0.0,0,2,0,2,3,2,0,2,0,4,7,0
242,4034,rGQNVCuxfrzbvnkFPCMdRGiz6QMgyFzA,fbPkOYLVPtPgIt0MxizjfFJov3JbHyAi,6,5,2,0,3,0,1,0,11,1.5714285714285714,1,0.0,2,2,0,3,3,0,0,1,0,7,4,1
243,4037,87Lm8BclRnYN39dmpTmFhTgJtRlJLHVz,fbPkOYLVPtPgIt0MxizjfFJov3JbHyAi,5,2,1,0,1,0,2,0,6,0.8571428571428571,1,0.0,0,1,0,1,2,0,0,2,0,2,4,1
244,4038,RZRLmBfJaLV1U3x2iNOo982VF2lx4M5E,fbPkOYLVPtPgIt0MxizjfFJov3JbHyAi,35,45,20,26,12,65,9,1,178,25.428571428571427,9,0.0,10,20,23,12,35,65,3,9,1,65,113,0
245,4041,mmBEzZ1YFdSzzY513HhhaTI5HINoZNej,fbPkOYLVPtPgIt0MxizjfFJov3JbHyAi,6,3,0,0,0,0,5,0,8,1.1428571428571428,1,0.0,0,0,0,0,3,0,0,5,0,0,8,1
246,4043,AzVXW4kCWHtvQbdNXdZjm5qxnXDAkj3A,fbPkOYLVPtPgIt0MxizjfFJov3JbHyAi,7,5,2,0,2,0,2,0,11,1.5714285714285714,1,0.0,2,2,0,2,3,0,0,2,0,6,5,1
247,4045,hC8ztRi3EjwyWcSJecvgX15KmWpaGcdW,fbPkOYLVPtPgIt0MxizjfFJov3JbHyAi,11,15,9,0,6,1,27,1,59,8.428571428571429,6,0.0,0,9,0,6,15,1,0,27,1,15,44,1
248,4047,lHHgniZkyeFRjJGU3HLkOi9ieHbZHJUQ,fbPkOYLVPtPgIt0MxizjfFJov3JbHyAi,4,2,0,0,0,0,2,0,4,0.5714285714285714,1,0.0,0,0,0,0,2,0,0,2,0,0,4,1
249,4049,L9qMLlGWAeAI6zWAZIyJtn0wISNa3dxg,fbPkOYLVPtPgIt0MxizjfFJov3JbHyAi,4,2,1,0,1,0,3,0,7,1.0,3,0.0,0,1,0,1,2,0,0,3,0,2,5,1
250,4050,0MTpVXdT8ASYCb3Z08epLhiKNkl8GgEQ,fbPkOYLVPtPgIt0MxizjfFJov3JbHyAi,18,16,9,11,8,0,6,0,50,7.142857142857143,2,0.0,5,9,9,8,11,0,2,6,0,31,19,1
251,4051,cT78xvKkV1UFGcRKty0V03Jr4RRPh50F,fbPkOYLVPtPgIt0MxizjfFJov3JbHyAi,11,14,5,4,3,0,12,3,41,5.857142857142857,1,0.0,3,5,3,3,11,0,1,12,3,14,27,1
252,4053,AOW4X6UkiHewUAs5OuRwOBQZ55uoQosX,fbPkOYLVPtPgIt0MxizjfFJov3JbHyAi,8,4,2,0,1,2,8,1,18,2.5714285714285716,3,0.0,0,2,0,1,4,2,0,8,1,3,15,1
253,4055,rAB3GdBf2kyPvfhSALJZpfL3o8n2yfaM,fbPkOYLVPtPgIt0MxizjfFJov3JbHyAi,13,16,10,4,6,0,6,0,42,6.0,4,0.0,1,10,3,6,15,0,1,6,0,20,22,1
254,4057,FsCZ2JlPdTOKccvkXXkGRkEo9MNtfR49,fbPkOYLVPtPgIt0MxizjfFJov3JbHyAi,4,2,1,0,1,0,1,0,5,0.7142857142857143,1,0.0,0,1,0,1,2,0,0,1,0,2,3,1
255,4058,CZqROpwtMfkuBimM2AQHyYwmYC0nRQMX,fbPkOYLVPtPgIt0MxizjfFJov3JbHyAi,2,0,0,0,0,0,6,0,6,0.8571428571428571,1,0.0,0,0,0,0,0,0,0,6,0,0,6,1
256,4059,k7E3UdMFCxZGbJkrqWFVZo27sTFlZitl,fbPkOYLVPtPgIt0MxizjfFJov3JbHyAi,2,0,0,0,0,0,4,0,4,0.5714285714285714,1,0.0,0,0,0,0,0,0,0,4,0,0,4,1
257,4063,DYy3OcZHNqaAwRPZTK5mmyz2pajxcVFG,fbPkOYLVPtPgIt0MxizjfFJov3JbHyAi,10,21,14,8,10,3,3,0,59,8.428571428571429,4,0.0,3,14,5,10,18,3,3,3,0,32,27,1
258,4067,etwrJvnLVRKl99lXJcTlVgF9a5u8b4IB,fbPkOYLVPtPgIt0MxizjfFJov3JbHyAi,4,2,1,0,1,0,1,0,5,0.7142857142857143,1,0.0,0,1,0,1,2,0,0,1,0,2,3,1
259,4068,Xtya7Ut5RfqXdKIJyeRno0pknCSJ0KQ9,fbPkOYLVPtPgIt0MxizjfFJov3JbHyAi,5,2,1,0,1,0,4,0,8,1.1428571428571428,1,0.0,0,1,0,1,2,0,0,4,0,2,6,1
260,4069,cvrniaRluzl5M2YhJj6gzVR22hfoNS7o,fbPkOYLVPtPgIt0MxizjfFJov3JbHyAi,5,2,1,0,1,0,3,0,7,1.0,1,0.0,0,1,0,1,2,0,0,3,0,2,5,1
261,4073,muLa1Vo0bC9fvm6n6sXrTQPXWjmeflat,fbPkOYLVPtPgIt0MxizjfFJov3JbHyAi,2,0,0,0,0,0,2,0,2,0.2857142857142857,1,0.0,0,0,0,0,0,0,0,2,0,0,2,0
262,4074,pPhnCYGqjbUED63FvqrsKWCb9oPSb13A,fbPkOYLVPtPgIt0MxizjfFJov3JbHyAi,8,8,5,0,3,4,6,0,26,3.7142857142857144,2,0.0,0,5,0,3,8,4,0,6,0,8,18,1
263,4075,p9RSc47fxU5KZrLFjwRWdfPjsbrYYsbL,fbPkOYLVPtPgIt0MxizjfFJov3JbHyAi,17,36,11,20,10,26,16,1,120,17.142857142857142,4,0.0,12,11,16,10,24,26,4,16,1,49,71,1
264,4076,xyBRzNYMnXahEQBoehtwEHCPr5ttcqSy,fbPkOYLVPtPgIt0MxizjfFJov3JbHyAi,9,7,3,0,4,0,4,0,18,2.5714285714285716,1,0.0,3,3,0,4,4,0,0,4,0,10,8,1
265,4078,yZ6537rd8avkULuEwmDtoeWv0g2tI9No,fbPkOYLVPtPgIt0MxizjfFJov3JbHyAi,6,5,4,0,4,5,2,0,20,2.857142857142857,1,0.0,0,4,0,4,5,5,0,2,0,8,12,1
266,4079,k6RJ44LpfDefc4BqSfb5Ks3bqRLzpbPs,fbPkOYLVPtPgIt0MxizjfFJov3JbHyAi,5,4,2,0,1,0,3,0,10,1.4285714285714286,2,0.0,0,2,0,1,4,0,0,3,0,3,7,1
267,4080,wGCry3EmryoBv7Csae49tbGzHF0lQra2,fbPkOYLVPtPgIt0MxizjfFJov3JbHyAi,7,4,2,0,1,5,10,0,22,3.142857142857143,2,0.0,0,2,0,1,4,5,0,10,0,3,19,1
268,4082,Intzo0A8tpMyd3IA01YG1BctRIdPWdNV,fbPkOYLVPtPgIt0MxizjfFJov3JbHyAi,12,22,1,4,0,53,17,1,98,14.0,5,0.0,4,1,3,0,18,53,1,17,1,8,90,0
269,4085,kjoYyxOsZaiCA9S8PMK5B69QLaH15SYn,fbPkOYLVPtPgIt0MxizjfFJov3JbHyAi,10,19,12,0,6,21,9,0,67,9.571428571428571,4,0.0,0,12,0,6,19,21,0,9,0,18,49,1
270,4086,99KAycUWIde0VU3hu66xpS6f8Dw5XMUf,fbPkOYLVPtPgIt0MxizjfFJov3JbHyAi,6,3,0,0,0,9,5,1,18,2.5714285714285716,1,0.0,0,0,0,0,3,9,0,5,1,0,18,1
271,4087,kyUPY0MEVeZNvkmrQxOn0CHNXLZiD03b,fbPkOYLVPtPgIt0MxizjfFJov3JbHyAi,34,69,41,12,13,47,27,0,209,29.857142857142858,10,0.0,12,41,10,13,57,47,2,27,0,76,133,0
272,4089,xHHwDRtwZQVvSchbI5GuritLImybQBlY,fbPkOYLVPtPgIt0MxizjfFJov3JbHyAi,22,60,47,0,39,13,11,0,170,24.285714285714285,5,0.0,0,47,0,39,60,13,0,11,0,86,84,1
273,4092,FWBo1Ve6aUEc5FnBNwSlwL8Ejasy32Ah,fbPkOYLVPtPgIt0MxizjfFJov3JbHyAi,24,207,5,21,8,62,18,3,324,46.285714285714285,11,0.0,59,5,17,8,148,62,4,18,3,89,235,1
274,4094,aHy0SOLp5TIYEPrUDsA19thlT8zgE9kw,fbPkOYLVPtPgIt0MxizjfFJov3JbHyAi,7,3,2,0,2,0,2,0,9,1.2857142857142858,1,0.0,0,2,0,2,3,0,0,2,0,4,5,1
275,4096,7f5BucMg0feISwFBvqaHF0DKL8QG4WFt,fbPkOYLVPtPgIt0MxizjfFJov3JbHyAi,6,10,4,0,2,2,7,0,25,3.5714285714285716,4,0.0,0,4,0,2,10,2,0,7,0,6,19,1
276,4098,7t6XdKZrxDN4lQnu2mS0b8xNunzNVAPj,fbPkOYLVPtPgIt0MxizjfFJov3JbHyAi,6,3,2,0,2,0,1,0,8,1.1428571428571428,1,0.0,0,2,0,2,3,0,0,1,0,4,4,1
277,4099,Rp1QUon6WyfjWJdUcBo02v2P6oL5StoN,fbPkOYLVPtPgIt0MxizjfFJov3JbHyAi,40,82,47,10,33,132,39,9,352,50.285714285714285,8,0.0,19,47,8,33,63,132,2,39,9,107,245,0
278,4100,biOEnvJNbNmJmtnLohBToN5g3ppQrMj4,fbPkOYLVPtPgIt0MxizjfFJov3JbHyAi,70,280,112,77,62,63,32,5,631,90.14285714285714,10,0.0,67,112,68,62,213,63,9,32,5,309,322,0
279,4102,DQcZziMBGJTQn4VwY66mMsTqydvYxO88,fbPkOYLVPtPgIt0MxizjfFJov3JbHyAi,15,31,17,4,8,4,9,0,73,10.428571428571429,5,0.0,5,17,3,8,26,4,1,9,0,33,40,1
280,4104,cT38CQfUVEuJ2lsb0Hk89Z8ENzEcFYoN,fbPkOYLVPtPgIt0MxizjfFJov3JbHyAi,11,12,3,4,4,17,15,5,60,8.571428571428571,1,0.0,6,3,3,4,6,17,1,15,5,16,44,1
281,4107,hXZgc5Oc8L3KNvO8ElQE29RF6Exzr76M,fbPkOYLVPtPgIt0MxizjfFJov3JbHyAi,61,335,7,60,9,73,55,2,541,77.28571428571429,18,0.0,79,7,54,9,256,73,6,55,2,149,392,1
282,4109,UTHVC9ResLri50kLlwVRolzN0EU0QbSV,fbPkOYLVPtPgIt0MxizjfFJov3JbHyAi,7,9,3,0,4,0,3,0,19,2.7142857142857144,1,0.0,4,3,0,4,5,0,0,3,0,11,8,1
283,4110,IhZdPOtOeXyg0OwsQIkD0XHc4IVBLzMp,fbPkOYLVPtPgIt0MxizjfFJov3JbHyAi,12,20,12,0,3,15,4,0,54,7.714285714285714,2,0.0,4,12,0,3,16,15,0,4,0,19,35,1
284,4115,JxLtKAnMek98G5fWpyeTaKlh0zheuNnU,fbPkOYLVPtPgIt0MxizjfFJov3JbHyAi,9,14,8,0,5,2,6,0,35,5.0,3,0.0,0,8,0,5,14,2,0,6,0,13,22,1
285,4118,lJBDlJfqpfLWNzA9gJNRBPGPdfnA8FjE,fbPkOYLVPtPgIt0MxizjfFJov3JbHyAi,11,14,4,5,5,0,10,0,38,5.428571428571429,2,0.0,6,4,4,5,8,0,1,10,0,19,19,1
286,4119,NDGD5kd43PPvwOqGnZbnmRA4IWxJUUWC,fbPkOYLVPtPgIt0MxizjfFJov3JbHyAi,11,10,6,0,5,13,5,1,40,5.714285714285714,1,0.0,0,6,0,5,10,13,0,5,1,11,29,1
287,4120,PLiz4R37f42hgWuNrDCM4We21NotfdFu,fbPkOYLVPtPgIt0MxizjfFJov3JbHyAi,10,8,3,0,3,0,4,0,18,2.5714285714285716,1,0.0,0,3,0,3,8,0,0,4,0,6,12,1
288,4123,v5fgLzwSp4csuplvg9kjWtplfkZ2GwCX,fbPkOYLVPtPgIt0MxizjfFJov3JbHyAi,53,93,52,51,30,94,32,1,353,50.42857142857143,11,0.0,18,52,48,30,75,94,3,32,1,148,205,1
289,4128,QFQlbn421RXpUzVVaKhkxpBlvQfTJy18,fbPkOYLVPtPgIt0MxizjfFJov3JbHyAi,1,0,0,0,0,0,2,0,2,0.2857142857142857,2,0.0,0,0,0,0,0,0,0,2,0,0,2,1
290,4131,IeoenmsgL9uI9DnVMbUVvL3IGBjOCvft,fbPkOYLVPtPgIt0MxizjfFJov3JbHyAi,7,22,10,0,6,6,4,0,48,6.857142857142857,2,0.0,1,10,0,6,21,6,0,4,0,17,31,1
291,4132,0EnifHYs46yDInpwwIuVTnoLaWAcGzwI,fbPkOYLVPtPgIt0MxizjfFJov3JbHyAi,2,0,0,0,0,0,7,0,7,1.0,1,0.0,0,0,0,0,0,0,0,7,0,0,7,1
292,4139,KGmMkFplDRCxys7XWInR8BCBSZINLZGV,fbPkOYLVPtPgIt0MxizjfFJov3JbHyAi,7,3,2,0,2,0,6,0,13,1.8571428571428572,1,0.0,0,2,0,2,3,0,0,6,0,4,9,1
293,4142,lnvoZ2tnJVetz4XYfY83aKXEsZTCt6TJ,fbPkOYLVPtPgIt0MxizjfFJov3JbHyAi,5,2,1,0,1,0,2,0,6,0.8571428571428571,1,0.0,0,1,0,1,2,0,0,2,0,2,4,1
294,4144,8FXCmdqVnzf3TYAPHoGg8tXyARiNLHCI,fbPkOYLVPtPgIt0MxizjfFJov3JbHyAi,14,34,24,0,13,5,19,1,96,13.714285714285714,3,0.0,2,24,0,13,32,5,0,19,1,39,57,1
295,4151,Ke8VwfqDMnQ67aDANakOnH0vYOFJh9kP,fbPkOYLVPtPgIt0MxizjfFJov3JbHyAi,5,2,0,0,0,0,4,0,6,0.8571428571428571,1,0.0,0,0,0,0,2,0,0,4,0,0,6,1
296,4153,9bv4TssyKs6woXSaEFvigyhEyIkdO1mQ,fbPkOYLVPtPgIt0MxizjfFJov3JbHyAi,24,65,26,9,18,6,22,1,147,21.0,7,0.0,17,26,9,18,48,6,0,22,1,70,77,1
297,4154,P7HoHyQzVXLghYr6m3MYTEIsDQbHfDfp,fbPkOYLVPtPgIt0MxizjfFJov3JbHyAi,9,17,8,2,5,2,7,0,41,5.857142857142857,3,0.0,3,8,2,5,14,2,0,7,0,18,23,1
298,4156,7wnX5auEB03UpnNYej7D6uFMFlr0UMF4,fbPkOYLVPtPgIt0MxizjfFJov3JbHyAi,45,92,26,38,30,60,29,1,276,39.42857142857143,7,0.0,40,26,31,30,52,60,7,29,1,127,149,1
299,4158,i2lUV72IHqqXWYqLFMWv3y4XGmlq2lXa,fbPkOYLVPtPgIt0MxizjfFJov3JbHyAi,15,36,18,18,0,0,13,0,85,12.142857142857142,7,0.0,7,18,17,0,29,0,1,13,0,42,43,0
300,4159,K7x1FBngM9kl9ILUtVAk9JDodBBRiKnk,fbPkOYLVPtPgIt0MxizjfFJov3JbHyAi,5,2,0,0,1,0,2,0,5,0.7142857142857143,1,0.0,0,0,0,1,2,0,0,2,0,1,4,1
301,4165,PQXXfcguNvwGC13fUA8grymIl8Xku68T,fbPkOYLVPtPgIt0MxizjfFJov3JbHyAi,8,5,4,0,1,4,9,1,24,3.4285714285714284,1,0.0,0,4,0,1,5,4,0,9,1,5,19,1
302,4166,bUnyK1hKhmXoEcHzbj5c3xR9U7XUAY5Y,fbPkOYLVPtPgIt0MxizjfFJov3JbHyAi,17,25,6,5,5,4,0,0,45,6.428571428571429,5,0.0,3,6,4,5,22,4,1,0,0,18,27,1
303,4167,1LwHP3062AHKmQwDl3FPlP3B3adaBvx7,fbPkOYLVPtPgIt0MxizjfFJov3JbHyAi,13,7,4,0,4,0,9,1,25,3.5714285714285716,3,0.0,0,4,0,4,7,0,0,9,1,8,17,1
304,4180,vQkP6BX5beW8TPAuFxWcKaAXLl3r77bC,SpATywNh6bZuzm8s1ceuBUnMUAeoAHHw,4,3,2,0,2,0,2,0,9,1.2857142857142858,1,0.0,0,2,0,2,3,0,0,2,0,4,5,1
305,4188,Em0hjKXRkhdtpThrexhSS4wvCtqaUFMH,SpATywNh6bZuzm8s1ceuBUnMUAeoAHHw,54,74,35,53,22,0,10,0,194,27.714285714285715,6,0.0,30,35,45,22,44,0,8,10,0,132,62,0
306,4189,DMRT6aSto1hsV85RHmev1d5IWcNMIFEq,SpATywNh6bZuzm8s1ceuBUnMUAeoAHHw,28,45,17,16,5,19,9,0,111,15.857142857142858,6,0.0,11,17,15,5,34,19,1,9,0,48,63,0
307,4191,s0DIFg7W3dnddXITKcNP8LHUkKIQHugk,A3fsA9Zfv1X2fVEQhTw51lKENdNrEqT3,42,28,16,36,13,0,8,2,103,14.714285714285714,6,0.0,1,16,35,13,27,0,1,8,2,65,38,0
308,4207,0wJhtCWK60WPCeRF62m8T80DtNpWhRrg,5X6FeZozNMgE2VRi3MJYjkkFK8SETtu2,32,55,13,56,17,0,7,0,148,21.142857142857142,4,0.0,20,13,45,17,35,0,11,7,0,95,53,1
309,4240,bN6JhUz4s97Xsh7eq2ZH1ilTMaKJDuUF,A3fsA9Zfv1X2fVEQhTw51lKENdNrEqT3,69,124,47,138,26,44,28,2,409,58.42857142857143,9,0.0,6,47,109,26,118,44,29,28,2,188,221,1
310,4257,7FYMj2bFfaTXHKfoaKa59KqAPXY4BWgD,SpATywNh6bZuzm8s1ceuBUnMUAeoAHHw,38,48,31,29,13,0,19,0,140,20.0,9,0.0,4,31,27,13,44,0,2,19,0,75,65,0
311,4264,I91CCtQfetYUPwkEXIvTFBP6tbrp1spN,SpATywNh6bZuzm8s1ceuBUnMUAeoAHHw,57,84,43,29,18,3,18,2,197,28.142857142857142,12,0.0,23,43,27,18,61,3,2,18,2,111,86,0
312,4267,RGl45e2VVMMdpatWhMc5IOKclnuxXpA1,SpATywNh6bZuzm8s1ceuBUnMUAeoAHHw,26,52,14,19,9,12,26,2,134,19.142857142857142,9,0.0,5,14,15,9,47,12,4,26,2,43,91,0
313,4282,sm8Pt42lYmt5RjZttn9EWmBp0Dzh6yOg,G8EPVSXsOYB5YQWZGiz1aVq5Pgr2GrQu,35,34,19,0,16,0,5,0,74,10.571428571428571,2,0.0,3,19,0,16,31,0,0,5,0,38,36,1
314,4289,zEiNHlokNuJTLVoV4Hy4kJd9kzaIjztD,G8EPVSXsOYB5YQWZGiz1aVq5Pgr2GrQu,78,160,54,166,30,214,12,3,639,91.28571428571429,11,0.0,61,54,126,30,99,214,40,12,3,271,368,1
315,4307,T90Hs0qj1GFlvauwj06O8IdnwXmrJzdZ,SpATywNh6bZuzm8s1ceuBUnMUAeoAHHw,9,24,1,5,0,0,2,0,32,4.571428571428571,1,0.0,1,1,4,0,23,0,1,2,0,6,26,1
316,4308,UaSh8dwx8gnofYbXlmpqj9uYDbpJ89pX,5X6FeZozNMgE2VRi3MJYjkkFK8SETtu2,16,94,7,18,8,78,29,0,234,33.42857142857143,9,0.0,34,7,15,8,60,78,3,29,0,64,170,1
317,4315,BQkLFspAkEwZRgeuoSbQxFTr6POAaRzP,SpATywNh6bZuzm8s1ceuBUnMUAeoAHHw,16,24,4,38,0,5,12,3,86,12.285714285714286,5,0.0,15,4,35,0,9,5,3,12,3,54,32,0
318,4356,4K59wuCrpPJyRcx38K4BUYetxztFLpnt,SpATywNh6bZuzm8s1ceuBUnMUAeoAHHw,9,4,3,0,3,0,4,0,14,2.0,1,0.0,0,3,0,3,4,0,0,4,0,6,8,1
319,4363,TQnfaXCRCgVZx9kYYn4s6Q3eXGXW2mAu,SpATywNh6bZuzm8s1ceuBUnMUAeoAHHw,33,63,14,34,8,77,20,2,218,31.142857142857142,7,0.0,11,14,28,8,52,77,6,20,2,61,157,0
320,4367,5I2aLwWP8vG6g175Y3fJi9X9n53v6aCn,SpATywNh6bZuzm8s1ceuBUnMUAeoAHHw,46,136,79,60,19,571,119,5,989,141.28571428571428,22,0.0,21,79,47,19,115,571,13,119,5,166,823,1
321,4380,5GeMwmyzCXMcMYfcWdKaXbpNNdL8bmPq,bWdj2GDclj5ofokWjzoa5jAwMkxCykd6,63,98,49,193,13,317,98,4,772,110.28571428571429,16,0.0,20,49,155,13,78,317,38,98,4,237,535,0
322,4385,wzrtLsMLUwSE1eXDXVMESg2JjrWZl4JD,SpATywNh6bZuzm8s1ceuBUnMUAeoAHHw,41,131,70,29,13,6,22,0,271,38.714285714285715,12,0.0,26,70,25,13,105,6,4,22,0,134,137,0
323,4417,0wJhtCWK60WPCeRF62m8T80DtNpWhRrg,A3fsA9Zfv1X2fVEQhTw51lKENdNrEqT3,46,40,20,72,12,0,7,0,151,21.571428571428573,5,0.0,1,20,69,12,39,0,3,7,0,102,49,1
324,4427,8DDe6pT3DTsk8IoUaxeHbA3kSbfeV3pT,SpATywNh6bZuzm8s1ceuBUnMUAeoAHHw,15,30,9,3,2,0,25,0,69,9.857142857142858,4,0.0,5,9,3,2,25,0,0,25,0,19,50,1
325,4429,BKMLDrZrwnjIMy3sAyFHQhrFM6liXbvY,SpATywNh6bZuzm8s1ceuBUnMUAeoAHHw,17,23,0,24,0,0,3,0,50,7.142857142857143,2,0.0,9,0,24,0,14,0,0,3,0,33,17,1
326,4438,3IgwuZBiVdgdYRQ9ySaEvpMizbjCJFS0,SpATywNh6bZuzm8s1ceuBUnMUAeoAHHw,60,79,36,42,20,82,37,1,297,42.42857142857143,10,0.0,21,36,36,20,58,82,6,37,1,113,184,0
327,4460,oxOzo82Nq65tcwE6AZvxglw3lN8SeywJ,bWdj2GDclj5ofokWjzoa5jAwMkxCykd6,19,33,17,104,10,0,9,0,173,24.714285714285715,3,0.0,7,17,98,10,26,0,6,9,0,132,41,1
328,4467,ud8Y2EsnBupML3rKElwJORvnGy1H8SMp,bWdj2GDclj5ofokWjzoa5jAwMkxCykd6,4,2,1,0,1,0,1,0,5,0.7142857142857143,1,0.0,0,1,0,1,2,0,0,1,0,2,3,1
329,4471,lEIFkqeT396JMSPUyiaHNMN8g7bQ1x9p,RXDvfPUBYFlVdlueBFbLW0mhhAyGEqpt,105,154,123,142,107,11,39,3,579,82.71428571428571,8,0.0,27,123,138,107,127,11,4,39,3,395,184,0
330,4485,1iBQrizMlXsnqwBfnYHB18bqwVfkqmsq,5X6FeZozNMgE2VRi3MJYjkkFK8SETtu2,1,0,0,0,0,0,1,0,1,0.14285714285714285,1,0.0,0,0,0,0,0,0,0,1,0,0,1,1
331,4492,800Nw5pvfdV7zCXCGav7KOLaYLAdOKht,SpATywNh6bZuzm8s1ceuBUnMUAeoAHHw,36,98,3,34,1,48,73,1,258,36.857142857142854,11,0.0,23,3,34,1,75,48,0,73,1,61,197,0
332,4494,wONMmUHIYwPBmEB9lgpOY3KCldKiuZFl,G8EPVSXsOYB5YQWZGiz1aVq5Pgr2GrQu,117,119,60,151,38,53,65,4,490,70.0,14,0.0,43,60,108,38,76,53,43,65,4,249,241,0
333,4501,dQuJ0DGjqbpnmQbHBTUIoBt7YzvOBCuV,SpATywNh6bZuzm8s1ceuBUnMUAeoAHHw,12,14,7,0,4,0,2,0,27,3.857142857142857,2,0.0,3,7,0,4,11,0,0,2,0,14,13,1
334,4503,JJDRXXLRU75H8Dx2cuK7Td1V7D7QoKg9,SpATywNh6bZuzm8s1ceuBUnMUAeoAHHw,42,89,6,32,4,2,30,1,164,23.428571428571427,11,0.0,20,6,30,4,69,2,2,30,1,60,104,0
335,4529,DB1URyLII1znnmxnZlmmkOEalzIpmvtZ,A3fsA9Zfv1X2fVEQhTw51lKENdNrEqT3,18,18,9,0,5,0,9,0,41,5.857142857142857,2,0.0,0,9,0,5,18,0,0,9,0,14,27,1
336,4557,s4xNNQ4RZ35amMfmvZawsu7u8CabnIey,A3fsA9Zfv1X2fVEQhTw51lKENdNrEqT3,48,42,27,78,14,87,38,2,288,41.142857142857146,7,0.0,4,27,61,14,38,87,17,38,2,106,182,0
337,4558,oxOzo82Nq65tcwE6AZvxglw3lN8SeywJ,A3fsA9Zfv1X2fVEQhTw51lKENdNrEqT3,21,18,13,0,9,0,5,0,45,6.428571428571429,2,0.0,0,13,0,9,18,0,0,5,0,22,23,1
338,4562,sOkc0wEXSSLpxtxlqjZObJqg94IyLpuY,bWdj2GDclj5ofokWjzoa5jAwMkxCykd6,63,114,4,170,0,17,49,1,355,50.714285714285715,16,0.0,14,4,152,0,100,17,18,49,1,170,185,1
339,4576,alnogGpZqhBWQHh6ZLeZUIXk896ksLOu,RXDvfPUBYFlVdlueBFbLW0mhhAyGEqpt,14,31,2,2,1,4,17,3,60,8.571428571428571,4,0.0,2,2,2,1,29,4,0,17,3,7,53,1
340,4580,PUW0i4IuafllkJEtV0GCqmTDeLHkDmH3,A3fsA9Zfv1X2fVEQhTw51lKENdNrEqT3,69,128,27,169,9,256,61,2,652,93.14285714285714,12,0.0,3,27,133,9,125,256,36,61,2,172,480,0
341,4597,y7HHpDc09mCS3h1lthBIJASJI1RnROT7,RXDvfPUBYFlVdlueBFbLW0mhhAyGEqpt,7,4,3,0,2,0,1,0,10,1.4285714285714286,1,0.0,0,3,0,2,4,0,0,1,0,5,5,1
342,4609,UqksMVZ1lLvn2u7s6dT9SU5OFeNJnaAy,A3fsA9Zfv1X2fVEQhTw51lKENdNrEqT3,46,73,34,42,21,3,10,2,185,26.428571428571427,5,0.0,4,34,38,21,69,3,4,10,2,97,88,1
343,4639,3OcDTnCwcizCpcOtz2UR6tflsBOvlv2R,SpATywNh6bZuzm8s1ceuBUnMUAeoAHHw,49,116,8,53,4,1,50,2,234,33.42857142857143,16,0.0,21,8,49,4,95,1,4,50,2,82,152,0
344,4642,qP2KbX0Pm1BCeErne0g8Q8oALeaVx7L6,SpATywNh6bZuzm8s1ceuBUnMUAeoAHHw,17,42,9,4,3,0,4,0,62,8.857142857142858,6,0.0,3,9,4,3,39,0,0,4,0,19,43,0
345,4653,IeSddciCla7lkuGxlh3rPQuCAXyzOV2D,SpATywNh6bZuzm8s1ceuBUnMUAeoAHHw,33,52,21,35,12,16,12,2,150,21.428571428571427,6,0.0,26,21,31,12,26,16,4,12,2,90,60,1
346,4654,DsHgWZRTJ1y1l15smwhB78ZQq3d8dyKP,SpATywNh6bZuzm8s1ceuBUnMUAeoAHHw,36,110,5,58,3,26,34,3,239,34.142857142857146,14,0.0,27,5,50,3,83,26,8,34,3,85,154,0
347,4668,r5RSR6lot2jmkfKvV1hMDjuwwaPyA58W,SpATywNh6bZuzm8s1ceuBUnMUAeoAHHw,31,79,13,21,8,0,28,0,149,21.285714285714285,10,0.0,21,13,17,8,58,0,4,28,0,59,90,0
348,4678,SXmv5BCLsa8KcmJ2wx7Xg5CRI8Gu1aDd,bWdj2GDclj5ofokWjzoa5jAwMkxCykd6,27,61,29,0,13,24,21,0,148,21.142857142857142,7,0.0,0,29,0,13,61,24,0,21,0,42,106,0
349,4682,a59vIKGy87nbLYAxp6cxkmNDzOYhSXnX,SpATywNh6bZuzm8s1ceuBUnMUAeoAHHw,35,58,44,31,27,2,19,0,181,25.857142857142858,6,0.0,4,44,28,27,54,2,3,19,0,103,78,1
350,4699,7xdvqdjwrTcnpU47VRFtnMnSYVyjOAaR,SpATywNh6bZuzm8s1ceuBUnMUAeoAHHw,29,48,5,39,0,0,9,0,101,14.428571428571429,5,0.0,10,5,37,0,38,0,2,9,0,52,49,0
351,4701,eg4vjaGd0e6Yp3fu5azU2ZqedIZ6GBxl,SpATywNh6bZuzm8s1ceuBUnMUAeoAHHw,42,76,9,41,4,8,32,2,172,24.571428571428573,11,0.0,24,9,31,4,52,8,10,32,2,68,104,0
352,4703,C8ZlatATbcer8D4Z8pCX4rv1Rcx870po,RXDvfPUBYFlVdlueBFbLW0mhhAyGEqpt,48,61,31,93,16,21,24,7,253,36.142857142857146,7,0.0,12,31,74,16,49,21,19,24,7,133,120,0
353,4736,6S5hOUFtfNcFsEpLKoUFbikqDYO5OBeF,5X6FeZozNMgE2VRi3MJYjkkFK8SETtu2,24,30,8,38,8,3,3,4,94,13.428571428571429,1,0.0,20,8,31,8,10,3,7,3,4,67,27,1
354,4778,xcD6YWhnGA2xukGmX4eaYrm6VS9ffz1H,G8EPVSXsOYB5YQWZGiz1aVq5Pgr2GrQu,63,82,50,124,13,3,20,0,292,41.714285714285715,4,0.0,13,50,96,13,69,3,28,20,0,172,120,0
355,4810,2LtuchYgE8Pco2t6mZeF2PkyT5iYJ1L1,SpATywNh6bZuzm8s1ceuBUnMUAeoAHHw,39,60,9,22,5,44,23,1,164,23.428571428571427,10,0.0,6,9,22,5,54,44,0,23,1,42,122,0
356,4814,SmONSyS4YgG4Afnv6ZxU81t7p4CQPV5P,A3fsA9Zfv1X2fVEQhTw51lKENdNrEqT3,65,137,44,16,26,0,44,1,268,38.285714285714285,14,0.0,0,44,13,26,137,0,3,44,1,83,185,1
357,4821,3cB0rEpxJxC0jjqfQ9EPT6ntxFajOXrx,5X6FeZozNMgE2VRi3MJYjkkFK8SETtu2,73,278,86,142,69,27,31,0,633,90.42857142857143,6,0.0,152,86,119,69,126,27,23,31,0,426,207,0
358,4828,f2h2VLvmMjqsSE1GgoTjiV7kOBQ7ba5D,SpATywNh6bZuzm8s1ceuBUnMUAeoAHHw,31,61,17,37,12,16,9,1,153,21.857142857142858,7,0.0,26,17,32,12,35,16,5,9,1,87,66,0
359,4853,6dSQI7mEgoqnNix7RTxCbRowcn4dgEn6,SpATywNh6bZuzm8s1ceuBUnMUAeoAHHw,7,3,2,7,1,0,3,0,16,2.2857142857142856,2,0.0,0,2,6,1,3,0,1,3,0,9,7,0
360,4862,9k6Repn2h6zXTygwvpy8LAM7GzTSYQBm,G8EPVSXsOYB5YQWZGiz1aVq5Pgr2GrQu,126,170,107,209,70,8,28,3,595,85.0,13,0.0,41,107,173,70,129,8,36,28,3,391,204,0
361,4866,GmHJt2279LUj6P2OGQD6V5Y1W95kmZpl,SpATywNh6bZuzm8s1ceuBUnMUAeoAHHw,24,63,10,14,5,17,20,0,129,18.428571428571427,9,0.0,0,10,13,5,63,17,1,20,0,28,101,1
362,4870,T2tyjiaDe9s4tWUugE6FZTShWofnfMqo,bWdj2GDclj5ofokWjzoa5jAwMkxCykd6,39,112,7,180,12,66,24,3,404,57.714285714285715,16,0.0,32,7,166,12,80,66,14,24,3,217,187,0
363,4873,7gQzvY1ridUPLjuboweNhi3eMZVeaUA3,5X6FeZozNMgE2VRi3MJYjkkFK8SETtu2,1,0,0,0,0,0,1,0,1,0.14285714285714285,1,0.0,0,0,0,0,0,0,0,1,0,0,1,1
364,4885,sOkc0wEXSSLpxtxlqjZObJqg94IyLpuY,A3fsA9Zfv1X2fVEQhTw51lKENdNrEqT3,133,173,6,304,2,24,73,0,582,83.14285714285714,17,0.0,13,6,270,2,160,24,34,73,0,291,291,0
365,4912,gVGEUb9jfMmddRlcGqXsnz4ZV26w6q4e,SpATywNh6bZuzm8s1ceuBUnMUAeoAHHw,22,27,18,16,8,0,6,0,75,10.714285714285714,4,0.0,3,18,13,8,24,0,3,6,0,42,33,0
366,4918,QDpN8D19Mr8RZumTONWpZNlCWcHCCTbH,A3fsA9Zfv1X2fVEQhTw51lKENdNrEqT3,19,42,5,0,1,0,6,0,54,7.714285714285714,5,0.0,0,5,0,1,42,0,0,6,0,6,48,0
367,4945,ySy2zYThCkVZr5MjEXuKxq60wfOynxkJ,SpATywNh6bZuzm8s1ceuBUnMUAeoAHHw,30,72,1,33,1,58,53,3,221,31.571428571428573,14,0.0,7,1,29,1,65,58,4,53,3,38,183,0
368,4946,SVwfCRY50hd9Fz0klab9XqT7QROcyhqY,SpATywNh6bZuzm8s1ceuBUnMUAeoAHHw,46,63,38,52,19,6,11,0,189,27.0,7,0.0,17,38,43,19,46,6,9,11,0,117,72,0
369,4950,QIQydLQKNp8IAhwJcWzcTMkwBUNbfwOF,SpATywNh6bZuzm8s1ceuBUnMUAeoAHHw,35,110,3,43,2,485,35,6,684,97.71428571428571,10,0.0,39,3,41,2,71,485,2,35,6,85,599,0
370,4953,VZdYnvKDyQlSbZcXkY9T9OB3rX2Vy7uz,SpATywNh6bZuzm8s1ceuBUnMUAeoAHHw,2,0,0,0,0,0,3,0,3,0.42857142857142855,2,0.0,0,0,0,0,0,0,0,3,0,0,3,1
371,4957,W4dUmcINvn4EmYk22ZRR3EuEX8WaEqL8,bWdj2GDclj5ofokWjzoa5jAwMkxCykd6,5,5,2,0,1,1,2,0,11,1.5714285714285714,1,0.0,0,2,0,1,5,1,0,2,0,3,8,1
372,4959,DCJHya56uWCPb8fqNJdPu3ruMX2t5RgK,bWdj2GDclj5ofokWjzoa5jAwMkxCykd6,1,0,0,0,0,0,1,0,1,0.14285714285714285,1,0.0,0,0,0,0,0,0,0,1,0,0,1,1
373,4980,syrttArug8Mpzs9L0IHsvBtATawYF9J2,5X6FeZozNMgE2VRi3MJYjkkFK8SETtu2,146,218,54,355,45,19,19,3,713,101.85714285714286,8,0.0,149,54,290,45,69,19,65,19,3,538,175,0
374,4981,syrttArug8Mpzs9L0IHsvBtATawYF9J2,bWdj2GDclj5ofokWjzoa5jAwMkxCykd6,73,65,28,151,25,14,14,1,298,42.57142857142857,5,0.0,30,28,126,25,35,14,25,14,1,209,89,0
375,4991,meJV5qRzmJA836PpWZKeoFo4ZX1xiQOS,RXDvfPUBYFlVdlueBFbLW0mhhAyGEqpt,30,53,28,30,19,7,4,0,141,20.142857142857142,7,0.0,2,28,27,19,51,7,3,4,0,76,65,1
376,5020,7kNYuUNvdIVdadzDsnKIKM0Ln3KLHYo2,SpATywNh6bZuzm8s1ceuBUnMUAeoAHHw,45,132,58,35,14,25,70,5,339,48.42857142857143,14,0.0,33,58,30,14,99,25,5,70,5,135,204,1
377,5022,QCXbyb2FyuLlETPxf3u27tgIYTs9gTM4,SpATywNh6bZuzm8s1ceuBUnMUAeoAHHw,36,84,42,35,17,45,20,1,244,34.857142857142854,8,0.0,24,42,30,17,60,45,5,20,1,113,131,0
378,5031,6Qw49dxLKsjbapN7r9Da43ajoDW7rCxT,G8EPVSXsOYB5YQWZGiz1aVq5Pgr2GrQu,29,68,44,10,9,671,48,12,862,123.14285714285714,23,0.0,4,44,5,9,64,671,5,48,12,62,800,0
379,5041,m9R5p8ELPeEGL2TgmgmNZypetc0YKw9N,SpATywNh6bZuzm8s1ceuBUnMUAeoAHHw,5,2,1,0,1,0,2,0,6,0.8571428571428571,1,0.0,0,1,0,1,2,0,0,2,0,2,4,1
380,5069,pOySDxOmbrI0pDd4UMGfMc77U1VB32Te,A3fsA9Zfv1X2fVEQhTw51lKENdNrEqT3,2,0,0,0,0,0,2,0,2,0.2857142857142857,1,0.0,0,0,0,0,0,0,0,2,0,0,2,1
381,5082,rVF6sxySmleXKBlMsWpXjKDnmQNSzrnS,G8EPVSXsOYB5YQWZGiz1aVq5Pgr2GrQu,184,321,204,451,109,57,91,2,1235,176.42857142857142,16,0.0,59,204,370,109,262,57,81,91,2,742,493,0
382,5089,9uEyydZSRkLkXhWd7s5xv7f4NfRXrNUe,5X6FeZozNMgE2VRi3MJYjkkFK8SETtu2,8,5,3,0,2,0,15,1,26,3.7142857142857144,1,0.0,0,3,0,2,5,0,0,15,1,5,21,1
383,5096,rsMqzQV4BJo2NdhTX79HDXS5zRZgLPX5,SpATywNh6bZuzm8s1ceuBUnMUAeoAHHw,29,33,19,42,9,1,12,0,116,16.571428571428573,4,0.0,13,19,37,9,20,1,5,12,0,78,38,0
384,5142,B6vCUtkVL8SVuEEWctSPinCUr9rxihnh,G8EPVSXsOYB5YQWZGiz1aVq5Pgr2GrQu,81,132,61,208,26,24,25,1,477,68.14285714285714,5,0.0,53,61,157,26,79,24,51,25,1,297,180,0
385,5152,RZI7KROUR7i2T6MB71TuoKGbXE5WXiwO,bWdj2GDclj5ofokWjzoa5jAwMkxCykd6,7,8,0,0,0,0,4,0,12,1.7142857142857142,2,0.0,0,0,0,0,8,0,0,4,0,0,12,1
386,5153,JiVwV8l6zLIAeTDli3uYE3CMxT1oG8Me,SpATywNh6bZuzm8s1ceuBUnMUAeoAHHw,31,67,10,18,5,0,36,0,136,19.428571428571427,10,0.0,7,10,15,5,60,0,3,36,0,37,99,0
387,5173,d6aHeIWZcsirh8eDlHrmG2KrUzDWnJuj,A3fsA9Zfv1X2fVEQhTw51lKENdNrEqT3,14,17,12,0,10,0,8,0,47,6.714285714285714,2,0.0,0,12,0,10,17,0,0,8,0,22,25,1
388,5217,EP1XQRGS4HZOG1hdGzNZdD1HFhJcHpos,RXDvfPUBYFlVdlueBFbLW0mhhAyGEqpt,57,66,7,102,0,49,25,0,249,35.57142857142857,10,0.0,14,7,96,0,52,49,6,25,0,117,132,0
389,5224,vEkraIjbJw9RkPvqczZeJYSVVtpO2PkE,G8EPVSXsOYB5YQWZGiz1aVq5Pgr2GrQu,18,15,9,0,10,0,15,0,49,7.0,4,0.0,5,9,0,10,10,0,0,15,0,24,25,1
390,5250,UJeg7gRsnH7RZFT5Iv8Y0tTilR96sXcV,5X6FeZozNMgE2VRi3MJYjkkFK8SETtu2,5,2,1,0,1,0,2,0,6,0.8571428571428571,1,0.0,0,1,0,1,2,0,0,2,0,2,4,1
391,5259,hdKqkkWKrDzbKE9btGChBqiCfsTwp68E,bWdj2GDclj5ofokWjzoa5jAwMkxCykd6,38,89,51,120,12,202,74,3,551,78.71428571428571,17,0.0,9,51,105,12,80,202,15,74,3,177,374,0
392,5279,cs5iJZEgrhw6pymo9S5BmSlmIVmjOxuC,A3fsA9Zfv1X2fVEQhTw51lKENdNrEqT3,4,2,1,0,1,0,1,0,5,0.7142857142857143,1,0.0,0,1,0,1,2,0,0,1,0,2,3,1
393,5303,o9EVHnUUU8I3f9dlC8NAcnHlKvZOnRmy,bWdj2GDclj5ofokWjzoa5jAwMkxCykd6,49,62,15,120,10,3,16,1,227,32.42857142857143,9,0.0,13,15,111,10,49,3,9,16,1,149,78,0
394,5305,o9EVHnUUU8I3f9dlC8NAcnHlKvZOnRmy,A3fsA9Zfv1X2fVEQhTw51lKENdNrEqT3,126,77,16,288,6,23,30,1,441,63.0,13,0.0,6,16,261,6,71,23,27,30,1,289,152,0
395,5310,OMEL4ay2FeLAUvBpF5PNfopRFoBTNYW8,SpATywNh6bZuzm8s1ceuBUnMUAeoAHHw,12,29,0,11,0,0,5,0,45,6.428571428571429,4,0.0,11,0,10,0,18,0,1,5,0,21,24,0
396,5319,hDWTDNoM8bIQS3Q25EYxxHniqW2wmxDn,bWdj2GDclj5ofokWjzoa5jAwMkxCykd6,13,17,7,18,4,2,6,1,55,7.857142857142857,2,0.0,1,7,16,4,16,2,2,6,1,28,27,0
397,5332,DJ09O49b2a0ZKXkFKbGfN66X8003c5sz,SpATywNh6bZuzm8s1ceuBUnMUAeoAHHw,10,31,23,0,11,0,7,0,72,10.285714285714286,6,0.0,0,23,0,11,31,0,0,7,0,34,38,1
398,5340,oDnQYjxji4p3XVFJMOGI9NvIvASqoqC1,SpATywNh6bZuzm8s1ceuBUnMUAeoAHHw,12,5,5,0,3,0,5,0,18,2.5714285714285716,3,0.0,0,5,0,3,5,0,0,5,0,8,10,1
399,5345,Kssd3yKtVgKi0ua0svvR8GgbZwRwIJMZ,SpATywNh6bZuzm8s1ceuBUnMUAeoAHHw,40,104,27,23,7,19,16,2,198,28.285714285714285,19,0.0,23,27,22,7,81,19,1,16,2,79,119,0
400,5354,lMGiEKoNsKRALWBxyYFHfE9Y79x8NYWS,G8EPVSXsOYB5YQWZGiz1aVq5Pgr2GrQu,1,0,0,0,0,0,1,0,1,0.14285714285714285,1,0.0,0,0,0,0,0,0,0,1,0,0,1,1
401,5355,PSoMps6mf7eMkjm3aPOL6fXV3Ul1HtBb,5X6FeZozNMgE2VRi3MJYjkkFK8SETtu2,11,10,3,10,4,0,2,0,29,4.142857142857143,1,0.0,5,3,10,4,5,0,0,2,0,22,7,1
402,5363,WXWUGznWk133hcEltnw7lYbm2oVZoXLf,SpATywNh6bZuzm8s1ceuBUnMUAeoAHHw,33,128,41,21,7,20,56,24,297,42.42857142857143,12,0.0,6,41,20,7,122,20,1,56,24,74,223,1
403,5389,cd7VGHrZb4Blwr9YuFp9MqF71m5wWUVd,G8EPVSXsOYB5YQWZGiz1aVq5Pgr2GrQu,182,143,10,416,13,3,18,0,603,86.14285714285714,9,0.0,58,10,331,13,85,3,85,18,0,412,191,0
404,5390,NL3IFunZJHMkqSLqiaHHbVIge1Bdgn26,G8EPVSXsOYB5YQWZGiz1aVq5Pgr2GrQu,89,127,63,158,27,36,38,2,451,64.42857142857143,10,0.0,43,63,127,27,84,36,31,38,2,260,191,0
405,5392,Tj9gyzxktEEAGnL07HQ3qbd2V0oCt16o,SpATywNh6bZuzm8s1ceuBUnMUAeoAHHw,55,242,74,67,25,92,81,8,589,84.14285714285714,16,0.0,54,74,49,25,188,92,18,81,8,202,387,0
406,5397,I6gFU4rZZ1rIaEMk0n0tBNQZ2tGcnjLw,SpATywNh6bZuzm8s1ceuBUnMUAeoAHHw,29,47,21,40,14,0,20,0,142,20.285714285714285,7,0.0,25,21,33,14,22,0,7,20,0,93,49,0
407,5414,4qM7n65VbCTp8lq3dbzhDmImmEZcwgn8,A3fsA9Zfv1X2fVEQhTw51lKENdNrEqT3,49,113,7,166,1,177,64,3,531,75.85714285714286,13,0.0,8,7,143,1,105,177,23,64,3,159,372,0
408,5424,qNh1HmZZ5IODkL9bGcGUg3xnGvE9VrLH,5X6FeZozNMgE2VRi3MJYjkkFK8SETtu2,19,52,1,20,9,1,7,0,90,12.857142857142858,4,0.0,30,1,19,9,22,1,1,7,0,59,31,1
409,5454,3ZzNkdWgGb47Go07PRKPf0XZ6jjhVCB4,bWdj2GDclj5ofokWjzoa5jAwMkxCykd6,33,70,39,72,20,82,24,0,307,43.857142857142854,11,0.0,12,39,52,20,58,82,20,24,0,123,184,0
410,5458,YOkiW0yIzjAwppKQnKaeEhWktVPNCIFb,A3fsA9Zfv1X2fVEQhTw51lKENdNrEqT3,43,31,21,80,9,2,24,1,168,24.0,8,0.0,2,21,64,9,29,2,16,24,1,96,72,1
411,5469,fn3RgMp4JCABnOK3IDXz6cUAXpmeuiYQ,SpATywNh6bZuzm8s1ceuBUnMUAeoAHHw,20,22,16,0,10,1,7,0,56,8.0,4,0.0,0,16,0,10,22,1,0,7,0,26,30,1
412,5472,OLX98cHycOH1FdInwYYk8PZBVFPyIkIG,SpATywNh6bZuzm8s1ceuBUnMUAeoAHHw,41,62,27,28,11,0,14,0,142,20.285714285714285,8,0.0,23,27,27,11,39,0,1,14,0,88,54,0
413,5486,TMdqZjFm6eGvpWCVvOj8xDCqkoxEsWlO,RXDvfPUBYFlVdlueBFbLW0mhhAyGEqpt,15,18,11,0,5,0,2,0,36,5.142857142857143,3,0.0,0,11,0,5,18,0,0,2,0,16,20,1
414,5487,gqe5NXbZbf5uXY0rPviLeIFOMpQyekdp,SpATywNh6bZuzm8s1ceuBUnMUAeoAHHw,18,19,1,18,0,0,9,0,47,6.714285714285714,4,0.0,2,1,15,0,17,0,3,9,0,18,29,1
415,5498,F2owRK2SDPW5FCDK4TxmBVHsTtJ44Nxq,bWdj2GDclj5ofokWjzoa5jAwMkxCykd6,9,14,1,0,2,0,6,0,23,3.2857142857142856,4,0.0,0,1,0,2,14,0,0,6,0,3,20,1
416,5499,F2owRK2SDPW5FCDK4TxmBVHsTtJ44Nxq,SpATywNh6bZuzm8s1ceuBUnMUAeoAHHw,20,32,2,27,1,0,4,1,67,9.571428571428571,3,0.0,16,2,23,1,16,0,4,4,1,42,25,1
417,5511,YTuPtoiiUgMUEO0EcQhHENEgNCcauWbW,SpATywNh6bZuzm8s1ceuBUnMUAeoAHHw,5,2,1,0,1,0,5,0,9,1.2857142857142858,4,0.0,0,1,0,1,2,0,0,5,0,2,7,1
418,5526,FELnhQR0c7GZZX82ioYJEZsqujOrfyf7,5X6FeZozNMgE2VRi3MJYjkkFK8SETtu2,6,4,1,0,2,38,13,0,58,8.285714285714286,3,0.0,2,1,0,2,2,38,0,13,0,5,53,0
419,5535,0N8Aw17N0N8m1sn7piRGEu1YkeZIgvRo,SpATywNh6bZuzm8s1ceuBUnMUAeoAHHw,15,30,5,0,5,0,3,0,43,6.142857142857143,3,0.0,0,5,0,5,30,0,0,3,0,10,33,0
420,5554,C6xrhZPOmVH2gCVNP26gSSPka2CcwgB5,A3fsA9Zfv1X2fVEQhTw51lKENdNrEqT3,67,37,27,106,19,0,18,0,207,29.571428571428573,7,0.0,10,27,104,19,27,0,2,18,0,160,47,1
421,5568,w1PJeTTskG2DF1TtLUpuz9MkqxNdq5EB,bWdj2GDclj5ofokWjzoa5jAwMkxCykd6,20,44,10,81,6,0,19,3,163,23.285714285714285,2,0.0,16,10,77,6,28,0,4,19,3,109,54,1
422,5573,GdXLROZTUYTypGrrX0BjPE53M0Un36D7,SpATywNh6bZuzm8s1ceuBUnMUAeoAHHw,40,131,15,32,6,44,31,8,267,38.142857142857146,7,0.0,58,15,32,6,73,44,0,31,8,111,156,1
423,5582,kKBIfyZmN22zBj263eKBa0SA1U5xYMsR,SpATywNh6bZuzm8s1ceuBUnMUAeoAHHw,40,121,11,25,7,232,32,6,434,62.0,10,0.0,15,11,23,7,106,232,2,32,6,56,378,0
424,5601,i2rj1wVH6A7tnVQEIJcyKc1jnWx6tXOX,G8EPVSXsOYB5YQWZGiz1aVq5Pgr2GrQu,19,6,0,32,0,0,3,0,41,5.857142857142857,3,0.0,0,0,27,0,6,0,5,3,0,27,14,1
425,5605,k2w7Fl2HRg9SZoDIHFnK8RXCKuBBE2y7,bWdj2GDclj5ofokWjzoa5jAwMkxCykd6,91,164,75,172,20,250,102,4,787,112.42857142857143,22,0.0,23,75,151,20,141,250,21,102,4,269,518,0
426,5619,RHl3DsvAX7TisJ7qBptmgrrtDAQvH7mr,5X6FeZozNMgE2VRi3MJYjkkFK8SETtu2,21,38,19,12,7,9,18,0,103,14.714285714285714,6,0.0,10,19,12,7,28,9,0,18,0,48,55,0
427,5620,ZOxTwY2wRpdYn3qbKBoyT1PgdUitZ7Hl,RXDvfPUBYFlVdlueBFbLW0mhhAyGEqpt,44,65,41,10,17,16,25,0,174,24.857142857142858,5,0.0,0,41,10,17,65,16,0,25,0,68,106,1
428,5645,UCDPR1k7RkPBDIde3KiukiosB55WbRVo,A3fsA9Zfv1X2fVEQhTw51lKENdNrEqT3,10,8,4,0,3,0,4,0,19,2.7142857142857144,3,0.0,0,4,0,3,8,0,0,4,0,7,12,1
429,5669,HbDaABEakQmE8DQEoFoIphu2SH13rFRy,SpATywNh6bZuzm8s1ceuBUnMUAeoAHHw,48,77,47,25,19,6,12,0,186,26.571428571428573,8,0.0,17,47,23,19,60,6,2,12,0,106,80,0
430,5692,KtQYnyrETXqJCvCxj7ZUnFcjZBBdiT7G,SpATywNh6bZuzm8s1ceuBUnMUAeoAHHw,48,60,34,44,15,10,19,1,183,26.142857142857142,7,0.0,9,34,39,15,51,10,5,19,1,97,86,0
431,5698,YflGnFPlp9G4H12kW5BF7wIEcEPJDElk,SpATywNh6bZuzm8s1ceuBUnMUAeoAHHw,28,35,21,22,9,0,7,0,94,13.428571428571429,2,0.0,7,21,20,9,28,0,2,7,0,57,37,0
432,5713,BvO8iO7xgnKFWgDrKByClW8hgTsia70X,5X6FeZozNMgE2VRi3MJYjkkFK8SETtu2,21,50,14,19,17,9,15,1,125,17.857142857142858,2,0.0,32,14,16,17,18,9,3,15,1,79,46,1
433,5725,DLDhUvvvfnnYFJuV65Zt2yaS0jPJgvzq,bWdj2GDclj5ofokWjzoa5jAwMkxCykd6,63,106,0,206,5,70,38,2,427,61.0,7,0.0,34,0,168,5,72,70,38,38,2,207,220,0
434,5726,tzyyAYK7Q2hNPhv988H6lH5D7hdM24rK,SpATywNh6bZuzm8s1ceuBUnMUAeoAHHw,44,40,20,34,11,4,10,0,119,17.0,5,0.0,14,20,34,11,26,4,0,10,0,79,40,0
435,5738,SfZbjjvyiSDCCOAoK4WFbDb5dRmW5oVl,bWdj2GDclj5ofokWjzoa5jAwMkxCykd6,2,0,0,0,0,0,2,0,2,0.2857142857142857,1,0.0,0,0,0,0,0,0,0,2,0,0,2,1
436,5745,PpMDt0ql3KtH4YMuxusWOnbL4LfspwvV,A3fsA9Zfv1X2fVEQhTw51lKENdNrEqT3,40,43,29,68,12,28,14,0,194,27.714285714285715,9,0.0,2,29,57,12,41,28,11,14,0,100,94,1
437,5775,TO8Y79YghtROlTlvlXU7LRtpWyGNF6ec,SpATywNh6bZuzm8s1ceuBUnMUAeoAHHw,18,29,7,25,4,0,3,0,68,9.714285714285714,3,0.0,8,7,21,4,21,0,4,3,0,40,28,1
438,5776,wQWBo1X8BGkSznCww6CpwIPV7Jbmgkei,SpATywNh6bZuzm8s1ceuBUnMUAeoAHHw,9,8,4,0,2,0,1,0,15,2.142857142857143,1,0.0,0,4,0,2,8,0,0,1,0,6,9,1
439,5778,A3AW3c7i1MF6oyHBEYvrXWvBxZwqeuYh,SpATywNh6bZuzm8s1ceuBUnMUAeoAHHw,30,27,2,28,1,21,21,2,102,14.571428571428571,7,0.0,8,2,25,1,19,21,3,21,2,36,66,0
440,5782,hjUSUM6roI2mLGkMAqBjE0uxFRBSMYHJ,A3fsA9Zfv1X2fVEQhTw51lKENdNrEqT3,82,73,53,134,24,4,21,0,309,44.142857142857146,9,0.0,2,53,112,24,71,4,22,21,0,191,118,1
441,5784,hjUSUM6roI2mLGkMAqBjE0uxFRBSMYHJ,5X6FeZozNMgE2VRi3MJYjkkFK8SETtu2,4,5,1,0,4,0,1,0,11,1.5714285714285714,1,0.0,3,1,0,4,2,0,0,1,0,8,3,1
442,5787,I6LLxQVZ3Y3gFYxr9F3TFVba9rYQ1D0f,RXDvfPUBYFlVdlueBFbLW0mhhAyGEqpt,1,0,0,0,0,0,1,0,1,0.14285714285714285,1,0.0,0,0,0,0,0,0,0,1,0,0,1,1
443,5796,8tzllCaQFf5FO2XcYgqoYiMGBjUwujYx,SpATywNh6bZuzm8s1ceuBUnMUAeoAHHw,9,20,1,0,1,0,8,3,33,4.714285714285714,2,0.0,2,1,0,1,18,0,0,8,3,4,29,1
444,5835,unk5CPF7I3bAjMFdo7PROcIzOFweEiwK,SpATywNh6bZuzm8s1ceuBUnMUAeoAHHw,1,0,0,0,0,0,1,0,1,0.14285714285714285,1,0.0,0,0,0,0,0,0,0,1,0,0,1,1
445,5859,pGMnNtuqcZlCojrlW4Qh2PIHblJQmotx,SpATywNh6bZuzm8s1ceuBUnMUAeoAHHw,32,34,16,28,8,1,10,1,98,14.0,3,0.0,15,16,27,8,19,1,1,10,1,66,32,1
446,5889,Oe7zyPdqUKEu4xpqbiVxJiAwdUxxeOQv,A3fsA9Zfv1X2fVEQhTw51lKENdNrEqT3,24,35,22,0,12,0,21,0,90,12.857142857142858,5,0.0,0,22,0,12,35,0,0,21,0,34,56,1
447,5904,L4jaFu0vxNsfaC1OhafSk08ztmq6goZk,SpATywNh6bZuzm8s1ceuBUnMUAeoAHHw,43,62,30,0,19,0,20,0,131,18.714285714285715,7,0.0,2,30,0,19,60,0,0,20,0,51,80,0
448,5925,sc5S8mzwcw7LbcetViv5Dahuhyet4uF1,A3fsA9Zfv1X2fVEQhTw51lKENdNrEqT3,36,33,19,94,2,20,24,3,195,27.857142857142858,3,0.0,7,19,81,2,26,20,13,24,3,109,86,1
449,5928,QJQFN1rOmy0JEkg26kEuCjYYvoywuFFu,A3fsA9Zfv1X2fVEQhTw51lKENdNrEqT3,5,2,1,0,1,0,2,0,6,0.8571428571428571,2,0.0,0,1,0,1,2,0,0,2,0,2,4,1
450,5987,x3bTgsr7QSCiaq6OJXRLOfvMZYUxrJaI,G8EPVSXsOYB5YQWZGiz1aVq5Pgr2GrQu,4,2,0,0,0,0,2,0,4,0.5714285714285714,1,0.0,0,0,0,0,2,0,0,2,0,0,4,1
451,5992,Ov9SdOcJjrPsko4RxSRp3diSYNiMCffC,bWdj2GDclj5ofokWjzoa5jAwMkxCykd6,5,2,1,0,1,0,2,0,6,0.8571428571428571,1,0.0,0,1,0,1,2,0,0,2,0,2,4,1
452,6000,2mD1u3b1vLrSJM0DZTrsvLcZVBVwwd27,RXDvfPUBYFlVdlueBFbLW0mhhAyGEqpt,26,31,29,0,18,2,13,0,93,13.285714285714286,14,0.0,0,29,0,18,31,2,0,13,0,47,46,0
453,6010,gEPTO2jN7POX6QtJlMdktFPT74irRyFu,SpATywNh6bZuzm8s1ceuBUnMUAeoAHHw,35,57,29,40,22,18,8,0,174,24.857142857142858,14,0.0,15,29,37,22,42,18,3,8,0,103,71,0
454,6060,1gK3jCeXNxEbn9wGz2jRwqB6S5hBMDkt,bWdj2GDclj5ofokWjzoa5jAwMkxCykd6,34,73,31,126,12,47,17,2,308,44.0,3,0.0,12,31,117,12,61,47,9,17,2,172,136,1
455,6070,Hj4fYYa64lvHLVeQZBqs9EQ1OtgHTvl6,SpATywNh6bZuzm8s1ceuBUnMUAeoAHHw,38,74,28,28,5,4,23,1,163,23.285714285714285,8,0.0,14,28,26,5,60,4,2,23,1,73,90,0
456,6074,xQWsagZWr4hwuLscur4NAIFNIWIrJTay,RXDvfPUBYFlVdlueBFbLW0mhhAyGEqpt,69,73,50,157,30,56,23,1,390,55.714285714285715,5,0.0,19,50,149,30,54,56,8,23,1,248,142,0
457,6075,4pJCNd3c3ApEtuK2GDe7eGNzOhsu04W5,G8EPVSXsOYB5YQWZGiz1aVq5Pgr2GrQu,78,191,117,83,26,447,98,12,974,139.14285714285714,25,0.0,19,117,62,26,172,447,21,98,12,224,750,0
458,6077,X6F4jGrpHmts6Pi9fPAm5nX0OzNeK6MU,SpATywNh6bZuzm8s1ceuBUnMUAeoAHHw,13,14,0,8,0,0,4,0,26,3.7142857142857144,1,0.0,0,0,6,0,14,0,2,4,0,6,20,1
459,6092,egIcBO9xXh5XDAWBOR2C58eTHcHVaPTq,5X6FeZozNMgE2VRi3MJYjkkFK8SETtu2,4,2,1,0,1,0,1,0,5,0.7142857142857143,1,0.0,0,1,0,1,2,0,0,1,0,2,3,1
460,6102,DJPrQ8k1R0aSF2q32X8eWoHfRxJjw6WA,SpATywNh6bZuzm8s1ceuBUnMUAeoAHHw,47,78,39,61,16,29,35,11,269,38.42857142857143,6,0.0,25,39,52,16,53,29,9,35,11,132,137,1
461,6105,lVM3D8yPmd62Fdb29hI2YI0VPwlNvI4t,A3fsA9Zfv1X2fVEQhTw51lKENdNrEqT3,31,46,36,0,26,2,19,0,129,18.428571428571427,8,0.0,2,36,0,26,44,2,0,19,0,64,65,1
462,6106,lPxeEtjpZuY166gKAbN1CLkUMLrqY98p,SpATywNh6bZuzm8s1ceuBUnMUAeoAHHw,14,29,0,13,1,3,20,1,67,9.571428571428571,3,0.0,4,0,13,1,25,3,0,20,1,18,49,1
463,6108,WWWH5rGgnKzcRMEBKWqCKBbIYZVZp9Wi,SpATywNh6bZuzm8s1ceuBUnMUAeoAHHw,41,93,8,44,2,7,12,0,166,23.714285714285715,9,0.0,32,8,40,2,61,7,4,12,0,82,84,0
464,6114,PIxnueIZLpBbMAAHbhlsEVGPkWRYGpMI,RXDvfPUBYFlVdlueBFbLW0mhhAyGEqpt,55,85,5,47,6,23,30,11,207,29.571428571428573,7,0.0,10,5,43,6,75,23,4,30,11,64,143,0
465,6123,onsmNYIoPFEi185f5ZLsQXD70I3K25Cb,A3fsA9Zfv1X2fVEQhTw51lKENdNrEqT3,25,71,37,0,18,8,14,1,149,21.285714285714285,4,0.0,7,37,0,18,64,8,0,14,1,62,87,1
466,6134,UhLO5kko2VQ90AI2af3XOU7N46nRv9TM,SpATywNh6bZuzm8s1ceuBUnMUAeoAHHw,29,34,6,46,5,1,25,1,118,16.857142857142858,4,0.0,12,6,45,5,22,1,1,25,1,68,50,0
467,6139,GWUUH9zdw0Ds2AJrirviqep1jIbCs8WU,5X6FeZozNMgE2VRi3MJYjkkFK8SETtu2,2,0,0,0,0,0,2,0,2,0.2857142857142857,1,0.0,0,0,0,0,0,0,0,2,0,0,2,0
468,6140,IBg4xmPqhTfP3qhSQ0m2yOJeGxXoGyqu,RXDvfPUBYFlVdlueBFbLW0mhhAyGEqpt,48,50,29,123,16,313,100,12,643,91.85714285714286,16,0.0,17,29,116,16,33,313,7,100,12,178,465,0
469,6158,hdYiR72pQ6vIYKybYRC3s5GFqsrsnSH9,SpATywNh6bZuzm8s1ceuBUnMUAeoAHHw,1,0,0,0,0,0,1,0,1,0.14285714285714285,1,0.0,0,0,0,0,0,0,0,1,0,0,1,1
470,6168,H2ZjrPimYfiWwdYkdNOPsZZk83kbIBCz,bWdj2GDclj5ofokWjzoa5jAwMkxCykd6,6,5,0,0,0,0,4,0,9,1.2857142857142858,2,0.0,0,0,0,0,5,0,0,4,0,0,9,1
471,6185,rowlJHASOW6yJNtP0z67l2i9CtJCMokD,SpATywNh6bZuzm8s1ceuBUnMUAeoAHHw,33,55,2,50,1,17,18,12,155,22.142857142857142,6,0.0,10,2,43,1,45,17,7,18,12,56,99,0
472,6192,uFKxt8ud4wgPXsnEMlnj4koWPrsJIWsU,SpATywNh6bZuzm8s1ceuBUnMUAeoAHHw,35,96,23,22,8,17,42,1,209,29.857142857142858,11,0.0,13,23,21,8,83,17,1,42,1,65,144,0
473,6220,hyKcsvbAZrS0MucDsyUSihT6aOgvgztm,A3fsA9Zfv1X2fVEQhTw51lKENdNrEqT3,9,13,6,0,4,0,2,0,25,3.5714285714285716,2,0.0,0,6,0,4,13,0,0,2,0,10,15,1
474,6237,iZTKl5rJwABSJbB6n0Qia3oN1YXnM1dc,5X6FeZozNMgE2VRi3MJYjkkFK8SETtu2,4,2,0,0,0,0,2,0,4,0.5714285714285714,1,0.0,0,0,0,0,2,0,0,2,0,0,4,1
475,6240,IkJ5dxCbqNRxBRuENFqjes2Z4rIDUrXn,SpATywNh6bZuzm8s1ceuBUnMUAeoAHHw,45,74,28,56,15,13,10,0,196,28.0,4,0.0,29,28,47,15,45,13,9,10,0,119,77,0
476,6271,q2xQCstASp96wpspi8iqsuaqJ7gzfsux,A3fsA9Zfv1X2fVEQhTw51lKENdNrEqT3,153,107,62,384,0,0,11,0,564,80.57142857142857,11,0.0,14,62,326,0,93,0,58,11,0,402,162,0
477,6273,pP1hwdPGxzBA8F4ZSgJiv9MEvr2pc047,SpATywNh6bZuzm8s1ceuBUnMUAeoAHHw,17,59,4,9,1,53,47,3,176,25.142857142857142,5,0.0,15,4,9,1,44,53,0,47,3,29,147,1
478,6292,TmCsqieGLPEH7gIm9lIZtj95nwJ99JkM,A3fsA9Zfv1X2fVEQhTw51lKENdNrEqT3,7,3,2,0,2,0,3,0,10,1.4285714285714286,1,0.0,0,2,0,2,3,0,0,3,0,4,6,1
479,6303,jqoeUpESPoqODjA4STQaMBhAr7OND2EP,bWdj2GDclj5ofokWjzoa5jAwMkxCykd6,5,6,2,0,0,0,10,0,18,2.5714285714285716,2,0.0,0,2,0,0,6,0,0,10,0,2,16,1
480,6306,Q8L1mPYwfiwtGo48PB0N9B5ppVi0px10,SpATywNh6bZuzm8s1ceuBUnMUAeoAHHw,47,100,48,39,17,4,47,0,255,36.42857142857143,12,0.0,35,48,35,17,65,4,4,47,0,135,120,0
481,6317,3Bw18YJt9vJt2emNNJ6GnWW50YrVLdEa,bWdj2GDclj5ofokWjzoa5jAwMkxCykd6,65,35,9,231,4,71,23,0,373,53.285714285714285,6,0.0,11,9,206,4,24,71,25,23,0,230,143,0
482,6331,SYptj19Xjkw9HEWtBs53CLIV7bhIU7QA,SpATywNh6bZuzm8s1ceuBUnMUAeoAHHw,35,85,41,19,13,31,23,0,212,30.285714285714285,5,0.0,6,41,18,13,79,31,1,23,0,78,134,1
483,6347,TAjGGV7oJgeUhPcj5Eum0tnVYrY7qjOE,RXDvfPUBYFlVdlueBFbLW0mhhAyGEqpt,71,214,73,131,34,13,52,5,522,74.57142857142857,12,0.0,34,73,114,34,180,13,17,52,5,255,267,0
484,6357,Aay6TeSPyFLmKNsg9Z4tXGnlIddPmJBP,SpATywNh6bZuzm8s1ceuBUnMUAeoAHHw,4,6,0,0,0,0,2,0,8,1.1428571428571428,2,0.0,0,0,0,0,6,0,0,2,0,0,8,1
485,6367,62a2qrcVt98j0sATcfHDrGeU9O6dsTND,5X6FeZozNMgE2VRi3MJYjkkFK8SETtu2,8,11,1,0,3,0,5,0,20,2.857142857142857,1,0.0,7,1,0,3,4,0,0,5,0,11,9,0
486,6368,Fa7tOqP1WKllvNDMgvUWmTzPr8J8vhy8,A3fsA9Zfv1X2fVEQhTw51lKENdNrEqT3,48,48,36,64,24,0,16,0,188,26.857142857142858,11,0.0,1,36,58,24,47,0,6,16,0,119,69,1
487,6382,9a1CkPBtfy1cinURU7wYCdYhBZbPuPSf,A3fsA9Zfv1X2fVEQhTw51lKENdNrEqT3,29,9,3,56,1,2,6,1,78,11.142857142857142,3,0.0,5,3,52,1,4,2,4,6,1,61,17,1
488,6406,LA9dJIvAE6FLxCCQV1kWQN6m88ZCSRLZ,bWdj2GDclj5ofokWjzoa5jAwMkxCykd6,9,9,1,0,2,1,4,0,17,2.4285714285714284,1,0.0,3,1,0,2,6,1,0,4,0,6,11,1
489,6411,eI6xeMCc7v1nfOYfnKZdOO91PA7nex8M,bWdj2GDclj5ofokWjzoa5jAwMkxCykd6,9,3,2,0,2,0,4,1,12,1.7142857142857142,1,0.0,0,2,0,2,3,0,0,4,1,4,8,1
490,6420,oQDGeS36nDLt1VqHdqEgamkq2vJOp7Bp,SpATywNh6bZuzm8s1ceuBUnMUAeoAHHw,5,3,1,0,1,0,1,0,6,0.8571428571428571,1,0.0,0,1,0,1,3,0,0,1,0,2,4,1
491,6424,SmSrrYBj6KLZ39TqXb57CVWv6gX6sF7Q,SpATywNh6bZuzm8s1ceuBUnMUAeoAHHw,41,70,31,37,15,13,26,9,201,28.714285714285715,8,0.0,21,31,31,15,49,13,6,26,9,98,103,0
492,6426,e3L16MrCoJp6rSpz1IWKaDG3S5tGTRpK,RXDvfPUBYFlVdlueBFbLW0mhhAyGEqpt,46,29,23,26,20,0,14,0,112,16.0,7,0.0,3,23,23,20,26,0,3,14,0,69,43,0
493,6435,nFeXukK9uLZggTwgBm3mDIxskaBXISqn,SpATywNh6bZuzm8s1ceuBUnMUAeoAHHw,37,75,14,56,2,0,6,0,153,21.857142857142858,14,0.0,14,14,48,2,61,0,8,6,0,78,75,1
494,6448,yau38b5UXLNmzsSxrtZsXYfKt6l52ZSP,A3fsA9Zfv1X2fVEQhTw51lKENdNrEqT3,13,27,4,0,2,0,7,0,40,5.714285714285714,4,0.0,1,4,0,2,26,0,0,7,0,7,33,0
495,6457,wxlTuL6FVeoyKGq1xWxdRI4GRTsaG1Ha,SpATywNh6bZuzm8s1ceuBUnMUAeoAHHw,5,6,3,0,0,0,1,0,10,1.4285714285714286,1,0.0,2,3,0,0,4,0,0,1,0,5,5,1
496,6466,GUIjXzC11NU91af1UN0XPnms1Mnty0es,G8EPVSXsOYB5YQWZGiz1aVq5Pgr2GrQu,13,10,8,0,5,0,6,0,29,4.142857142857143,2,0.0,0,8,0,5,10,0,0,6,0,13,16,1
497,6472,wxlTuL6FVeoyKGq1xWxdRI4GRTsaG1Ha,A3fsA9Zfv1X2fVEQhTw51lKENdNrEqT3,5,4,3,0,0,0,1,0,8,1.1428571428571428,1,0.0,0,3,0,0,4,0,0,1,0,3,5,1
498,6488,aYhMdR5xaez3fr0lBrD6kCxYiCOyculR,RXDvfPUBYFlVdlueBFbLW0mhhAyGEqpt,100,233,148,171,15,2997,83,137,3784,540.5714285714286,28,0.0,38,148,116,15,195,2997,55,83,137,317,3467,0
499,6506,DCJPPLzeeZhBbsYhL4xGedJzVmW41Gnk,SpATywNh6bZuzm8s1ceuBUnMUAeoAHHw,37,53,35,31,15,27,15,0,176,25.142857142857142,8,0.0,11,35,28,15,42,27,3,15,0,89,87,0
500,6516,1CrVBOpFvr6rOy553Xrye0bjPdL11eu8,RXDvfPUBYFlVdlueBFbLW0mhhAyGEqpt,99,157,78,119,34,59,32,2,481,68.71428571428571,15,0.0,21,78,114,34,136,59,5,32,2,247,234,0
501,6517,7u3azzypzNqPYEFxf0DcbGOgDVhkOXos,A3fsA9Zfv1X2fVEQhTw51lKENdNrEqT3,156,69,38,330,29,1,44,1,512,73.14285714285714,12,0.0,5,38,304,29,64,1,26,44,1,376,136,0
502,6523,dna1EUjVeT7Ka4gaXCCa53DsP3COwQS1,SpATywNh6bZuzm8s1ceuBUnMUAeoAHHw,32,49,4,44,0,0,8,0,105,15.0,5,0.0,12,4,35,0,37,0,9,8,0,51,54,0
503,6528,97yjJniO9qlZAjgn3gm4HXnkbwnHzt9O,SpATywNh6bZuzm8s1ceuBUnMUAeoAHHw,17,52,5,21,3,11,11,0,103,14.714285714285714,4,0.0,13,5,15,3,39,11,6,11,0,36,67,1
504,6535,tuBxNlu8Vf06uK8sXGF2P17UeyGdHKNN,SpATywNh6bZuzm8s1ceuBUnMUAeoAHHw,26,35,26,6,11,2,9,1,90,12.857142857142858,4,0.0,0,26,5,11,35,2,1,9,1,42,48,1
505,6574,09vierxoREaD4msGgreYQSyOiGeSiZdQ,SpATywNh6bZuzm8s1ceuBUnMUAeoAHHw,30,50,33,0,20,8,6,0,117,16.714285714285715,5,0.0,0,33,0,20,50,8,0,6,0,53,64,0
506,6587,Y89GJdSZUpoYFMgx00SCe6qFoYoXIpUj,A3fsA9Zfv1X2fVEQhTw51lKENdNrEqT3,111,221,11,296,4,0,9,0,541,77.28571428571429,14,0.0,2,11,247,4,219,0,49,9,0,264,277,0
507,6620,ImttANzrjJymFPMjHDf4wrhhCWWSpYTI,A3fsA9Zfv1X2fVEQhTw51lKENdNrEqT3,25,64,19,0,0,0,10,0,93,13.285714285714286,4,0.0,2,19,0,0,62,0,0,10,0,21,72,1
508,6637,qcaVl4qf6hxavlIQkbkKC1Gm28s0psJd,SpATywNh6bZuzm8s1ceuBUnMUAeoAHHw,20,30,2,40,0,0,3,0,75,10.714285714285714,2,0.0,9,2,34,0,21,0,6,3,0,45,30,1
509,6643,lDflzmK9F6H42Kj6EtaBezWOcB4UUWiV,SpATywNh6bZuzm8s1ceuBUnMUAeoAHHw,48,64,39,23,17,4,27,1,175,25.0,14,0.0,10,39,21,17,54,4,2,27,1,87,88,0
510,6675,1K9ntuEgUSRWzXpTTqORcRDzpeO83CFG,SpATywNh6bZuzm8s1ceuBUnMUAeoAHHw,5,2,1,0,1,0,2,0,6,0.8571428571428571,1,0.0,0,1,0,1,2,0,0,2,0,2,4,1
511,6679,tY5a0NX1zue0V7W3ml5X4bo1Gus2ozCa,SpATywNh6bZuzm8s1ceuBUnMUAeoAHHw,31,51,24,22,9,0,19,0,125,17.857142857142858,6,0.0,15,24,20,9,36,0,2,19,0,68,57,0
512,6685,mfQ48K9Gnf187sLZBiTNegL6UkMDsKbJ,SpATywNh6bZuzm8s1ceuBUnMUAeoAHHw,39,79,11,48,3,0,32,1,174,24.857142857142858,13,0.0,26,11,43,3,53,0,5,32,1,83,91,0
513,6708,7FUJzRatex45Tiw3cL91Uz5fZD5gpQMy,G8EPVSXsOYB5YQWZGiz1aVq5Pgr2GrQu,2,0,0,0,0,0,2,0,2,0.2857142857142857,1,0.0,0,0,0,0,0,0,0,2,0,0,2,1
514,6760,yh14zaFitCUTgvBPqRXiaZ6cUijtktL4,A3fsA9Zfv1X2fVEQhTw51lKENdNrEqT3,74,44,28,112,16,3,15,3,221,31.571428571428573,4,0.0,6,28,98,16,38,3,14,15,3,148,73,1
515,6809,Sy675y5yY7HGgANETsmQapbB8hGWLA1f,5X6FeZozNMgE2VRi3MJYjkkFK8SETtu2,5,13,0,0,2,5,4,0,24,3.4285714285714284,1,0.0,10,0,0,2,3,5,0,4,0,12,12,1
516,6813,UvqKXPrebnykj7gkohis9MIhsKJQCjxw,G8EPVSXsOYB5YQWZGiz1aVq5Pgr2GrQu,48,109,100,100,54,0,13,0,376,53.714285714285715,6,0.0,0,100,92,54,109,0,8,13,0,246,130,0
517,6816,dSloiolTuQA1YnIVrIEZb5m23cL24cRw,A3fsA9Zfv1X2fVEQhTw51lKENdNrEqT3,29,50,6,34,3,5,17,1,116,16.571428571428573,5,0.0,5,6,29,3,45,5,5,17,1,43,73,1
518,6824,e12uQn96OlYfknMdqSXCXdImglIj4IRR,bWdj2GDclj5ofokWjzoa5jAwMkxCykd6,31,82,49,0,21,110,61,7,330,47.142857142857146,9,0.0,7,49,0,21,75,110,0,61,7,77,253,0
519,6835,05hxkbgK0IX5639oITtQjU5YEEUBb8L1,SpATywNh6bZuzm8s1ceuBUnMUAeoAHHw,26,115,6,36,5,4,17,2,185,26.428571428571427,5,0.0,40,6,31,5,75,4,5,17,2,82,103,0
520,6838,AyhJARh0xhxObM9zhvUdDxlTCtu309eW,SpATywNh6bZuzm8s1ceuBUnMUAeoAHHw,28,42,25,20,13,88,10,0,198,28.285714285714285,6,0.0,7,25,20,13,35,88,0,10,0,65,133,1
521,6873,NAuTAy6LFtpkSTeaDzpzRRxCaq6qJCQ5,A3fsA9Zfv1X2fVEQhTw51lKENdNrEqT3,56,73,54,73,30,3,42,0,275,39.285714285714285,8,0.0,5,54,65,30,68,3,8,42,0,154,121,0
522,6881,jzWvwaTexkgbyBrPkQbXDb98Viqx6cSS,G8EPVSXsOYB5YQWZGiz1aVq5Pgr2GrQu,20,20,6,30,4,11,11,1,83,11.857142857142858,5,0.0,11,6,23,4,9,11,7,11,1,44,39,1
523,6889,M2RAm5z8WwQ5y9jyAQgRWh88PDVhS1V9,RXDvfPUBYFlVdlueBFbLW0mhhAyGEqpt,1,0,0,0,0,0,1,0,1,0.14285714285714285,1,0.0,0,0,0,0,0,0,0,1,0,0,1,1
524,6898,UxSaaQ6GZyl7nlDC1x0TA1qshXRkMyH8,RXDvfPUBYFlVdlueBFbLW0mhhAyGEqpt,103,238,80,147,53,28,19,0,565,80.71428571428571,5,0.0,69,80,142,53,169,28,5,19,0,344,221,0
525,6914,5XorWInOikFQGiy06qBvCZ6iOgBDDoJu,SpATywNh6bZuzm8s1ceuBUnMUAeoAHHw,38,95,47,17,27,43,24,3,256,36.57142857142857,6,0.0,35,47,16,27,60,43,1,24,3,125,131,0
526,6916,x6r7USCSuVFGzUeOMsU9rcLC4WDuI3GF,A3fsA9Zfv1X2fVEQhTw51lKENdNrEqT3,13,25,15,0,0,1,20,1,62,8.857142857142858,5,0.0,0,15,0,0,25,1,0,20,1,15,47,0
527,6917,ZolI9SZEN13j7gv74MFUKg6bUxZlsWPc,G8EPVSXsOYB5YQWZGiz1aVq5Pgr2GrQu,7,5,2,0,2,0,2,0,11,1.5714285714285714,1,0.0,0,2,0,2,5,0,0,2,0,4,7,1
528,6925,h9168zUD8zDtaVgTWmp8akLV044AqETE,G8EPVSXsOYB5YQWZGiz1aVq5Pgr2GrQu,66,78,27,246,0,20,6,0,377,53.857142857142854,4,0.0,47,27,201,0,31,20,45,6,0,275,102,0
529,6931,s6iPd6MFpHWkQ354d5Z6XCZ6dbx7CutD,SpATywNh6bZuzm8s1ceuBUnMUAeoAHHw,13,9,7,4,3,0,4,0,27,3.857142857142857,3,0.0,0,7,3,3,9,0,1,4,0,13,14,0
530,6938,a6f3gPi6axX0cfBnUGVliBDQrPx92l1r,A3fsA9Zfv1X2fVEQhTw51lKENdNrEqT3,78,136,89,246,62,1,21,0,555,79.28571428571429,11,0.0,15,89,206,62,121,1,40,21,0,372,183,1
531,6948,4r712Cp6HawShlWfCnD4BeT5bNCQMkQ4,SpATywNh6bZuzm8s1ceuBUnMUAeoAHHw,44,59,6,40,2,7,11,1,126,18.0,6,0.0,15,6,32,2,44,7,8,11,1,55,71,0
532,6956,ykaUPJW4Nc9r2mv4b25QxgdHgIcQ63RQ,SpATywNh6bZuzm8s1ceuBUnMUAeoAHHw,40,48,17,39,9,50,9,1,173,24.714285714285715,15,0.0,18,17,37,9,30,50,2,9,1,81,92,0
533,6969,YfVqOdQV9ZXJgq8aC5ARPHksMFUwqOvU,SpATywNh6bZuzm8s1ceuBUnMUAeoAHHw,13,11,7,0,4,4,16,0,42,6.0,2,0.0,0,7,0,4,11,4,0,16,0,11,31,1
534,6981,Pp5JJMKWhHjqXDQq6vl852N5LskPEcDA,bWdj2GDclj5ofokWjzoa5jAwMkxCykd6,16,29,7,54,8,0,5,0,103,14.714285714285714,3,0.0,18,7,49,8,11,0,5,5,0,82,21,1
535,6983,7fC3V6ivG07wUIMOmiYFzSlyjWvbYnYf,A3fsA9Zfv1X2fVEQhTw51lKENdNrEqT3,163,104,2,670,2,2,30,0,810,115.71428571428571,14,0.0,9,2,562,2,95,2,108,30,0,575,235,0
536,6985,Pp5JJMKWhHjqXDQq6vl852N5LskPEcDA,A3fsA9Zfv1X2fVEQhTw51lKENdNrEqT3,5,4,1,0,1,0,4,0,10,1.4285714285714286,2,0.0,0,1,0,1,4,0,0,4,0,2,8,1
537,6989,QXMWMAYLhXvptULktpThtcXNRQ6JansN,SpATywNh6bZuzm8s1ceuBUnMUAeoAHHw,47,154,71,23,20,15,105,0,388,55.42857142857143,26,0.0,24,71,23,20,130,15,0,105,0,138,250,0
538,7004,4L8FEL9uQ33lr2hJ5CSJNyGu6GEq5daD,A3fsA9Zfv1X2fVEQhTw51lKENdNrEqT3,2,0,0,0,0,0,2,0,2,0.2857142857142857,1,0.0,0,0,0,0,0,0,0,2,0,0,2,1
539,7020,43QhXZfKBBZHpTmjLSVuTzbc6djzr40d,SpATywNh6bZuzm8s1ceuBUnMUAeoAHHw,35,87,1,35,3,11,30,0,167,23.857142857142858,7,0.0,20,1,32,3,67,11,3,30,0,56,111,0
540,7032,ogcVEHXlejDZ3EsIUfi0CHUmNlnDccd3,A3fsA9Zfv1X2fVEQhTw51lKENdNrEqT3,4,0,0,0,0,0,4,0,4,0.5714285714285714,1,0.0,0,0,0,0,0,0,0,4,0,0,4,1
541,7036,ogcVEHXlejDZ3EsIUfi0CHUmNlnDccd3,5X6FeZozNMgE2VRi3MJYjkkFK8SETtu2,8,7,2,0,0,3,10,3,25,3.5714285714285716,3,0.0,1,2,0,0,6,3,0,10,3,3,22,1
542,7051,86WaolA0zlcsNwK3PQQKKGFDOSiqigXx,SpATywNh6bZuzm8s1ceuBUnMUAeoAHHw,41,39,19,43,13,0,5,0,119,17.0,2,0.0,6,19,37,13,33,0,6,5,0,75,44,1
543,7070,NHNfeNYNs1K8l9QFLPxdhmQxgpP2pCve,SpATywNh6bZuzm8s1ceuBUnMUAeoAHHw,13,7,5,0,4,1,5,1,23,3.2857142857142856,1,0.0,1,5,0,4,6,1,0,5,1,10,13,1
544,7085,UrENN1zIfJIc4hCxDDWe8c7coKokiTdF,A3fsA9Zfv1X2fVEQhTw51lKENdNrEqT3,56,37,26,76,18,3,7,1,168,24.0,4,0.0,4,26,62,18,33,3,14,7,1,110,58,1
545,7107,oBmksukoqTKiKpWhco7hv7dHpVNhiTm0,SpATywNh6bZuzm8s1ceuBUnMUAeoAHHw,15,17,0,7,0,0,6,0,30,4.285714285714286,2,0.0,3,0,7,0,14,0,0,6,0,10,20,1
546,7119,03YAuQnjuYjTWwgHqE1110CZpZwknRbj,RXDvfPUBYFlVdlueBFbLW0mhhAyGEqpt,101,79,44,229,25,1,17,1,396,56.57142857142857,6,0.0,21,44,219,25,58,1,10,17,1,309,87,0
547,7138,tJ7FzaUMbzSP2K4BtZobNqzCoEbllcH1,RXDvfPUBYFlVdlueBFbLW0mhhAyGEqpt,93,310,85,227,8,1231,284,1041,3186,455.14285714285717,30,0.0,49,85,210,8,261,1231,17,284,1041,352,2834,0
548,7143,ahFkMpqRNclNalhsRFgKmc75UZfOTdgQ,SpATywNh6bZuzm8s1ceuBUnMUAeoAHHw,48,151,64,67,18,5,22,2,329,47.0,16,0.0,54,64,51,18,97,5,16,22,2,187,142,1
549,7151,2QwHrFxGcIFGuR6TyUnlExhchaRL2Ipx,SpATywNh6bZuzm8s1ceuBUnMUAeoAHHw,43,172,33,52,5,14,51,1,328,46.857142857142854,22,0.0,41,33,44,5,131,14,8,51,1,123,205,0
550,7182,HlYiU2TA92it9HWOPDlsBmlpdZ7J7QTJ,SpATywNh6bZuzm8s1ceuBUnMUAeoAHHw,37,56,25,21,11,0,16,0,129,18.428571428571427,8,0.0,11,25,21,11,45,0,0,16,0,68,61,1
551,7211,KcnsNeA0wAhOuQ7U5h8zRsePAeKM7tfj,SpATywNh6bZuzm8s1ceuBUnMUAeoAHHw,6,3,0,0,1,0,2,0,6,0.8571428571428571,1,0.0,0,0,0,1,3,0,0,2,0,1,5,1
552,7225,WixZusYrasZzR9owXlaQpXrbIZeJOheR,SpATywNh6bZuzm8s1ceuBUnMUAeoAHHw,12,20,9,0,3,3,9,1,45,6.428571428571429,5,0.0,6,9,0,3,14,3,0,9,1,18,27,0
553,7233,Kv9yM6Ye606xOusGmqGDWX6SW9fdHP2Q,bWdj2GDclj5ofokWjzoa5jAwMkxCykd6,9,7,2,0,1,25,7,1,43,6.142857142857143,2,0.0,0,2,0,1,7,25,0,7,1,3,40,1
554,7246,WixZusYrasZzR9owXlaQpXrbIZeJOheR,RXDvfPUBYFlVdlueBFbLW0mhhAyGEqpt,1,0,0,0,0,0,2,0,2,0.2857142857142857,2,0.0,0,0,0,0,0,0,0,2,0,0,2,1
555,7258,sT9hGAnww95aeGvqwQpJlS3ORhWDT49F,A3fsA9Zfv1X2fVEQhTw51lKENdNrEqT3,11,19,11,0,3,0,5,0,38,5.428571428571429,4,0.0,1,11,0,3,18,0,0,5,0,15,23,1
556,7282,gMP76SzwbIEJUCyidRWCdRJzafVqamrK,bWdj2GDclj5ofokWjzoa5jAwMkxCykd6,10,17,4,0,2,1,17,1,42,6.0,3,0.0,3,4,0,2,14,1,0,17,1,9,33,1
557,7283,K5Sy6doI03r5uctdEcvObhW1bpzNGROt,G8EPVSXsOYB5YQWZGiz1aVq5Pgr2GrQu,82,207,107,138,56,14,43,2,567,81.0,14,0.0,49,107,92,56,158,14,46,43,2,304,263,0
558,7304,VSEOcWZYpZiKC2PUmidzj4VqbBnc3GAo,A3fsA9Zfv1X2fVEQhTw51lKENdNrEqT3,101,29,14,339,0,13,92,0,487,69.57142857142857,18,0.0,12,14,299,0,17,13,40,92,0,325,162,0
559,7310,Yby0It9Tj4ASosIcvg72qeavqJKBNZLT,5X6FeZozNMgE2VRi3MJYjkkFK8SETtu2,2,0,0,0,0,0,2,0,2,0.2857142857142857,1,0.0,0,0,0,0,0,0,0,2,0,0,2,1
560,7317,EwpbggvNdZkeSTjdG48aEltlJYavm02s,5X6FeZozNMgE2VRi3MJYjkkFK8SETtu2,53,469,13,0,61,0,12,0,555,79.28571428571429,7,0.0,291,13,0,61,178,0,0,12,0,365,190,0
561,7332,5kqorcxIJejDFcc1de7q3uie94xFSgMJ,SpATywNh6bZuzm8s1ceuBUnMUAeoAHHw,43,170,100,19,29,3,28,0,349,49.857142857142854,12,0.0,30,100,18,29,140,3,1,28,0,177,172,0
562,7336,XaZ9suMr2OUkXLhyKSMfk6SMeajIT5ha,A3fsA9Zfv1X2fVEQhTw51lKENdNrEqT3,7,6,1,0,1,0,5,0,13,1.8571428571428572,1,0.0,0,1,0,1,6,0,0,5,0,2,11,1
563,7337,J5FkxM9o8L4y51xbaKwQjZuay8KpJMzH,SpATywNh6bZuzm8s1ceuBUnMUAeoAHHw,44,81,11,50,5,31,21,1,200,28.571428571428573,10,0.0,30,11,41,5,51,31,9,21,1,87,113,1
564,7338,XpquNqg2EIDRwNL88GzK6drchpRZMQN1,A3fsA9Zfv1X2fVEQhTw51lKENdNrEqT3,28,28,23,0,17,1,8,0,77,11.0,7,0.0,0,23,0,17,28,1,0,8,0,40,37,0
565,7345,B9KqNNxXBxHFUsJnQKQysblL3f8zF7sg,bWdj2GDclj5ofokWjzoa5jAwMkxCykd6,26,68,10,0,3,0,21,0,102,14.571428571428571,15,0.0,11,10,0,3,57,0,0,21,0,24,78,0
566,7348,5a7fehAo0Ol3kwHzhNqAYRGEzPLIE5FD,SpATywNh6bZuzm8s1ceuBUnMUAeoAHHw,24,36,25,11,15,2,14,0,103,14.714285714285714,6,0.0,2,25,10,15,34,2,1,14,0,52,51,1
567,7364,84Vq27rxsidbGJFxLO0cd5e2CSiXRChu,A3fsA9Zfv1X2fVEQhTw51lKENdNrEqT3,111,111,77,120,34,10,37,2,391,55.857142857142854,15,0.0,6,77,109,34,105,10,11,37,2,226,165,1
568,7377,84Vq27rxsidbGJFxLO0cd5e2CSiXRChu,SpATywNh6bZuzm8s1ceuBUnMUAeoAHHw,37,39,26,6,15,2,14,1,103,14.714285714285714,7,0.0,3,26,6,15,36,2,0,14,1,50,53,1
569,7380,y4ROZxtUW2SffaQ3DMgCK81r0GDNLnMO,SpATywNh6bZuzm8s1ceuBUnMUAeoAHHw,29,32,12,23,7,2,11,1,88,12.571428571428571,7,0.0,10,12,20,7,22,2,3,11,1,49,39,0
570,7387,u82lBhpDxJIwlZISEntCxj1zgVFdW0vT,SpATywNh6bZuzm8s1ceuBUnMUAeoAHHw,61,381,187,72,70,233,136,10,1089,155.57142857142858,26,0.0,123,187,50,70,258,233,22,136,10,430,659,0
571,7402,XESEnxXOxYn0sEg8u7X5S27rymbaMzNA,SpATywNh6bZuzm8s1ceuBUnMUAeoAHHw,62,113,64,72,28,11,40,0,328,46.857142857142854,7,0.0,26,64,61,28,87,11,11,40,0,179,149,0
572,7405,thbVK5OkB13GLXnOCtBegvQeqDmjraYm,SpATywNh6bZuzm8s1ceuBUnMUAeoAHHw,47,80,42,40,23,21,21,0,227,32.42857142857143,9,0.0,27,42,39,23,53,21,1,21,0,131,96,0
573,7410,MRybyq1cnqatDusvwSwOpxgKfQSDJUE3,bWdj2GDclj5ofokWjzoa5jAwMkxCykd6,17,13,8,24,4,0,7,1,57,8.142857142857142,2,0.0,2,8,23,4,11,0,1,7,1,37,20,1
574,7425,AV3xIWfwsQ5uGH8Qf1BwlVsUBUI5kjl1,SpATywNh6bZuzm8s1ceuBUnMUAeoAHHw,10,26,7,0,3,0,10,0,46,6.571428571428571,4,0.0,0,7,0,3,26,0,0,10,0,10,36,1
575,7445,mawBMWVaMDuwBgxqJlSNvSnxuZmWfWRW,SpATywNh6bZuzm8s1ceuBUnMUAeoAHHw,38,94,24,56,7,4,32,0,217,31.0,11,0.0,14,24,52,7,80,4,4,32,0,97,120,0
576,7456,1CrVBOpFvr6rOy553Xrye0bjPdL11eu8,A3fsA9Zfv1X2fVEQhTw51lKENdNrEqT3,182,177,98,234,41,97,60,1,708,101.14285714285714,18,0.0,25,98,219,41,152,97,15,60,1,383,325,0
577,7459,RvbHqbSC41GB9aoXWEA7k8GnWBXN8w9e,SpATywNh6bZuzm8s1ceuBUnMUAeoAHHw,5,3,0,0,0,0,2,0,5,0.7142857142857143,1,0.0,0,0,0,0,3,0,0,2,0,0,5,1
578,7460,oTbhbArArMYa19mRFQxnzp4vm2INrkSU,SpATywNh6bZuzm8s1ceuBUnMUAeoAHHw,13,15,2,0,1,2,7,1,28,4.0,1,0.0,3,2,0,1,12,2,0,7,1,6,22,1
579,7470,zwtc7XYkGr4Bhsl8UEIZlPO0o9lpzfSZ,A3fsA9Zfv1X2fVEQhTw51lKENdNrEqT3,161,143,52,414,33,1,31,3,677,96.71428571428571,9,0.0,5,52,374,33,138,1,40,31,3,464,213,0
580,7477,5DIcniD9kRbDupVPBNugV5by0SZHtD2e,SpATywNh6bZuzm8s1ceuBUnMUAeoAHHw,42,89,14,47,4,2,26,2,184,26.285714285714285,11,0.0,18,14,41,4,71,2,6,26,2,77,107,0
581,7484,ZghgmsFKGlL396BKFJoJeIy2X7crdnN0,SpATywNh6bZuzm8s1ceuBUnMUAeoAHHw,52,94,38,68,17,42,29,4,292,41.714285714285715,7,0.0,43,38,59,17,51,42,9,29,4,157,135,0
582,7489,uUSTKM8g1hIskJbYHh1UiIQ6epHTSTNR,bWdj2GDclj5ofokWjzoa5jAwMkxCykd6,20,49,27,30,7,3,20,0,136,19.428571428571427,10,0.0,3,27,28,7,46,3,2,20,0,65,71,1
583,7490,uUSTKM8g1hIskJbYHh1UiIQ6epHTSTNR,G8EPVSXsOYB5YQWZGiz1aVq5Pgr2GrQu,95,123,51,184,22,3,22,1,406,58.0,8,0.0,58,51,129,22,65,3,55,22,1,260,146,0
584,7494,CSp8QkNZa6B12LzJipxPFgC5w6lKLtbn,RXDvfPUBYFlVdlueBFbLW0mhhAyGEqpt,29,67,7,45,9,10,17,1,156,22.285714285714285,3,0.0,14,7,43,9,53,10,2,17,1,73,83,0
585,7497,guprsx2yFQ5jOFQRa2OmDTvoe1Qtus0L,SpATywNh6bZuzm8s1ceuBUnMUAeoAHHw,10,18,9,0,5,0,4,0,36,5.142857142857143,2,0.0,0,9,0,5,18,0,0,4,0,14,22,1
586,7500,BQwuBUR4WYRdCAVoQUNUZK3Ln34YX0iv,SpATywNh6bZuzm8s1ceuBUnMUAeoAHHw,20,44,23,13,13,15,31,6,145,20.714285714285715,6,0.0,10,23,11,13,34,15,2,31,6,57,88,1
587,7505,1sFJ1Szdx1WU21TgC1PRv3tkQ09H4qed,SpATywNh6bZuzm8s1ceuBUnMUAeoAHHw,17,17,9,10,4,8,14,1,63,9.0,3,0.0,4,9,9,4,13,8,1,14,1,26,37,1
588,7524,UNtI3N6D9AZsFIjfiItWfMe73uBfp0VS,SpATywNh6bZuzm8s1ceuBUnMUAeoAHHw,40,38,22,31,15,0,21,0,127,18.142857142857142,6,0.0,13,22,30,15,25,0,1,21,0,80,47,0
589,7541,CGIwACA114zcxKI2ZiGPCkXleQcVHz2y,SpATywNh6bZuzm8s1ceuBUnMUAeoAHHw,36,65,11,41,5,21,28,2,173,24.714285714285715,11,0.0,21,11,37,5,44,21,4,28,2,74,99,0
590,7543,fGIeAB7IRJCHxzCo8u4GLaPKxQfHeCdi,SpATywNh6bZuzm8s1ceuBUnMUAeoAHHw,56,184,64,47,32,8,57,0,392,56.0,12,0.0,37,64,44,32,147,8,3,57,0,177,215,0
591,7551,dnay2jAX3cgskuo0IcUq4nB4ZOtSKU5x,SpATywNh6bZuzm8s1ceuBUnMUAeoAHHw,31,68,25,28,10,1,19,0,151,21.571428571428573,9,0.0,9,25,26,10,59,1,2,19,0,70,81,0
592,7554,eO5CgKdvPHZfZ8krv7wlSTYp2EdmZAmV,RXDvfPUBYFlVdlueBFbLW0mhhAyGEqpt,43,147,4,82,10,17,22,6,288,41.142857142857146,6,0.0,38,4,74,10,109,17,8,22,6,126,162,1
593,7586,40eiF3ZEuOYP1RP6XBUcW4OUQFmNxf9i,SpATywNh6bZuzm8s1ceuBUnMUAeoAHHw,40,47,26,27,12,9,20,3,144,20.571428571428573,4,0.0,8,26,24,12,39,9,3,20,3,70,74,0
594,7587,wEaTyOJwwvOCk7eUttQISK5WPXL7ANNV,SpATywNh6bZuzm8s1ceuBUnMUAeoAHHw,32,58,24,34,8,15,26,6,171,24.428571428571427,5,0.0,12,24,28,8,46,15,6,26,6,72,99,0
595,7616,PcrKUgtxZcGXBYkLOmECh99m3fhAOabf,SpATywNh6bZuzm8s1ceuBUnMUAeoAHHw,28,93,27,37,5,8,18,0,188,26.857142857142858,6,0.0,15,27,31,5,78,8,6,18,0,78,110,0
596,7623,uRIMG7KJWhHO81Kf9MvAfUFzZC6juL3s,bWdj2GDclj5ofokWjzoa5jAwMkxCykd6,20,30,13,72,7,9,7,0,138,19.714285714285715,7,0.0,6,13,67,7,24,9,5,7,0,93,45,0
597,7649,cauH4YekuRKFsHZgdw9jChinljVOhzCP,SpATywNh6bZuzm8s1ceuBUnMUAeoAHHw,21,18,10,19,8,0,3,0,58,8.285714285714286,3,0.0,4,10,16,8,14,0,3,3,0,38,20,1
598,7651,HL6JESJ9UfnK7mtp7EsklcgEKja4gTaC,RXDvfPUBYFlVdlueBFbLW0mhhAyGEqpt,87,131,9,122,16,16,16,0,310,44.285714285714285,8,0.0,48,9,120,16,83,16,2,16,0,193,117,1
599,7656,v9Jp2iBPSFTVxP8FrUe1odwfz8Hd1wS3,SpATywNh6bZuzm8s1ceuBUnMUAeoAHHw,57,70,37,29,18,35,20,0,209,29.857142857142858,7,0.0,23,37,28,18,47,35,1,20,0,106,103,0
600,7659,1KSlK2xXHUc3PjC1CsQEQaomGBagqDXf,A3fsA9Zfv1X2fVEQhTw51lKENdNrEqT3,17,10,8,0,7,0,2,0,27,3.857142857142857,4,0.0,0,8,0,7,10,0,0,2,0,15,12,1
601,7660,ae4nSawB3M11Wmq3zKGmekxyJPcADmL9,bWdj2GDclj5ofokWjzoa5jAwMkxCykd6,1,0,0,0,0,0,1,0,1,0.14285714285714285,1,0.0,0,0,0,0,0,0,0,1,0,0,1,1
602,7667,ImCVHOP1jti1S73II8BRabWE6aqK4I6u,SpATywNh6bZuzm8s1ceuBUnMUAeoAHHw,2,0,0,0,0,0,3,0,3,0.42857142857142855,2,0.0,0,0,0,0,0,0,0,3,0,0,3,1
603,7670,NKzNFHK6LaJqjMec69ZX5HfBigF4yyJV,SpATywNh6bZuzm8s1ceuBUnMUAeoAHHw,59,81,46,29,22,51,35,4,268,38.285714285714285,6,0.0,24,46,28,22,57,51,1,35,4,120,148,0
604,7677,HPp2Yy992FcBIXDjeQl0bEftbV1QFRDS,SpATywNh6bZuzm8s1ceuBUnMUAeoAHHw,47,104,42,58,14,19,22,3,262,37.42857142857143,8,0.0,30,42,47,14,74,19,11,22,3,133,129,0
605,7681,3RcsrMTbPrb8ZHYXLlgwoRK7zrqTGSuq,bWdj2GDclj5ofokWjzoa5jAwMkxCykd6,6,3,2,0,2,0,1,0,8,1.1428571428571428,1,0.0,0,2,0,2,3,0,0,1,0,4,4,1
606,7683,uydIb4MWCn95KWcEhKwj3VRfjvxXo8Nj,A3fsA9Zfv1X2fVEQhTw51lKENdNrEqT3,88,283,158,236,5,1337,241,6,2266,323.7142857142857,30,0.0,31,158,172,5,252,1337,64,241,6,366,1900,0
607,7694,a6f3gPi6axX0cfBnUGVliBDQrPx92l1r,SpATywNh6bZuzm8s1ceuBUnMUAeoAHHw,42,100,61,53,29,0,24,0,267,38.142857142857146,16,0.0,11,61,42,29,89,0,11,24,0,143,124,0
608,7701,f81JJCqMlkJdA9lV7uQBviuGlLm2CDkR,SpATywNh6bZuzm8s1ceuBUnMUAeoAHHw,37,135,11,53,6,13,44,0,262,37.42857142857143,12,0.0,41,11,42,6,94,13,11,44,0,100,162,0
609,7720,LyBG9vpZvAGsIKFzeD4gB6XRCVzk12fF,A3fsA9Zfv1X2fVEQhTw51lKENdNrEqT3,13,7,6,10,4,0,6,0,33,4.714285714285714,2,0.0,0,6,9,4,7,0,1,6,0,19,14,1
610,7729,xkt3K6JWpnfeixDBdwkLXaHgXuuGt35v,A3fsA9Zfv1X2fVEQhTw51lKENdNrEqT3,82,51,31,230,9,2,23,0,346,49.42857142857143,8,0.0,6,31,204,9,45,2,26,23,0,250,96,1
611,7731,ZD844NRFhgHqwskHd8pIBuIwDiTAY4NC,SpATywNh6bZuzm8s1ceuBUnMUAeoAHHw,26,48,31,31,17,6,11,0,144,20.571428571428573,6,0.0,7,31,26,17,41,6,5,11,0,81,63,0
612,7766,3kfsZtV93tVXeg8YtF9PTasYswVdOeLx,SpATywNh6bZuzm8s1ceuBUnMUAeoAHHw,46,138,21,58,8,2,45,0,272,38.857142857142854,21,0.0,23,21,49,8,115,2,9,45,0,101,171,0
613,7767,GcInGCXKYnNWAnYbqUyxJe7hi4ZjhElg,RXDvfPUBYFlVdlueBFbLW0mhhAyGEqpt,27,27,15,8,14,0,5,0,69,9.857142857142858,3,0.0,5,15,8,14,22,0,0,5,0,42,27,1
614,7771,Rdvgrardg53H2oeCgmOt8vFxIUu5nogb,SpATywNh6bZuzm8s1ceuBUnMUAeoAHHw,41,80,33,41,13,1,17,0,185,26.428571428571427,8,0.0,17,33,32,13,63,1,9,17,0,95,90,0
615,7774,EQU3KQKmF0NpNwQmPmUw90ptahwADmIz,SpATywNh6bZuzm8s1ceuBUnMUAeoAHHw,22,62,9,0,2,13,30,2,118,16.857142857142858,7,0.0,17,9,0,2,45,13,0,30,2,28,90,1
616,7778,moK1GdnqoYxhSRCf5a95lgXdVNdzYrjs,A3fsA9Zfv1X2fVEQhTw51lKENdNrEqT3,145,132,20,230,10,16,113,0,521,74.42857142857143,21,0.0,5,20,216,10,127,16,14,113,0,251,270,0
617,7781,h1PVCD4diCwozuU4ZjcMLdFycUmYpSIc,G8EPVSXsOYB5YQWZGiz1aVq5Pgr2GrQu,88,104,45,184,27,2,25,2,389,55.57142857142857,8,0.0,46,45,129,27,58,2,55,25,2,247,142,0
618,7786,7aA6BrVZipLHOrozlrYBMEmfMq4MXahq,RXDvfPUBYFlVdlueBFbLW0mhhAyGEqpt,72,225,63,130,40,25,58,3,544,77.71428571428571,16,0.0,32,63,112,40,193,25,18,58,3,247,297,0
619,7789,pdotXwlXOl4cuEJn7TjzheQq2EZaH9qB,SpATywNh6bZuzm8s1ceuBUnMUAeoAHHw,6,6,0,0,0,0,2,0,8,1.1428571428571428,3,0.0,0,0,0,0,6,0,0,2,0,0,8,1
620,7793,z2zhro5MCTuNkAWXNKBS5L7zEtJc0Vs9,SpATywNh6bZuzm8s1ceuBUnMUAeoAHHw,44,119,52,36,25,184,69,14,499,71.28571428571429,7,0.0,32,52,32,25,87,184,4,69,14,141,358,0
621,7820,tcrOs8a5NYKg0fcf0qJ4buK5RKIEFS5o,RXDvfPUBYFlVdlueBFbLW0mhhAyGEqpt,64,68,26,148,14,6,10,0,272,38.857142857142854,6,0.0,16,26,140,14,52,6,8,10,0,196,76,0
622,7831,SozLQk8695JG7fvj1Enp26s5ACJQjjq5,SpATywNh6bZuzm8s1ceuBUnMUAeoAHHw,55,65,43,34,19,31,37,5,234,33.42857142857143,7,0.0,8,43,32,19,57,31,2,37,5,102,132,0
623,7844,cSB2xmj1Zot5hgCLSHhxDNISJzHyYsXf,SpATywNh6bZuzm8s1ceuBUnMUAeoAHHw,19,26,4,0,2,0,18,0,50,7.142857142857143,7,0.0,0,4,0,2,26,0,0,18,0,6,44,1
624,7869,34oDxV5jJfVaGWSsgPNGJP2ott7rJu7I,SpATywNh6bZuzm8s1ceuBUnMUAeoAHHw,43,178,87,57,70,3,21,0,416,59.42857142857143,9,0.0,47,87,49,70,131,3,8,21,0,253,163,0
625,7872,ZosutOeXAHBSIvZIuIxhmKGfV7JZESP5,SpATywNh6bZuzm8s1ceuBUnMUAeoAHHw,34,61,34,1,23,1,94,1,215,30.714285714285715,7,0.0,5,34,1,23,56,1,0,94,1,63,152,0
626,7885,S58o7T8J2JcEBTi3bdMATXeMdhJbXqYq,SpATywNh6bZuzm8s1ceuBUnMUAeoAHHw,53,50,32,44,21,16,19,3,185,26.428571428571427,4,0.0,9,32,38,21,41,16,6,19,3,100,85,0
627,7900,pVR5qyfYJN582jaXWwJ4YRpKGyADx6Eu,RXDvfPUBYFlVdlueBFbLW0mhhAyGEqpt,29,18,15,0,11,0,4,0,48,6.857142857142857,1,0.0,2,15,0,11,16,0,0,4,0,28,20,1
628,7916,TIvBCmMDquWj2iwTixxUP6A3HzcrQyq3,SpATywNh6bZuzm8s1ceuBUnMUAeoAHHw,58,165,56,51,22,60,104,5,463,66.14285714285714,17,0.0,36,56,38,22,129,60,13,104,5,152,311,0
629,7932,Dm0fTQ5hQ4vZLMdCz8HpFheMP2yCMt3n,SpATywNh6bZuzm8s1ceuBUnMUAeoAHHw,6,6,4,0,3,0,5,1,19,2.7142857142857144,3,0.0,0,4,0,3,6,0,0,5,1,7,12,0
630,7953,KIPXc8MOqmnlmMqnIzIeaBqliIw9pS44,RXDvfPUBYFlVdlueBFbLW0mhhAyGEqpt,18,39,21,14,10,2,14,0,100,14.285714285714286,3,0.0,4,21,13,10,35,2,1,14,0,48,52,1
631,7971,Y7KMNxUWz3B2grUtFCf2FgfpqFMvSy0l,G8EPVSXsOYB5YQWZGiz1aVq5Pgr2GrQu,117,115,74,336,36,14,62,5,642,91.71428571428571,14,0.0,7,74,271,36,108,14,65,62,5,388,254,0
632,7982,9MK6uRaOnLFmxpxcsZHlBDf4ITU7Vvr6,SpATywNh6bZuzm8s1ceuBUnMUAeoAHHw,7,3,0,0,0,0,4,0,7,1.0,1,0.0,0,0,0,0,3,0,0,4,0,0,7,1
633,8012,jagu0OJDhWTGFhfCMk0ghqluLpW3kzdC,SpATywNh6bZuzm8s1ceuBUnMUAeoAHHw,58,48,29,49,17,6,33,4,186,26.571428571428573,8,0.0,11,29,39,17,37,6,10,33,4,96,90,0
634,8033,e2lOOqKSlF9Fw65H87m0cJslmAtz6Yej,SpATywNh6bZuzm8s1ceuBUnMUAeoAHHw,5,2,1,0,1,0,2,0,6,0.8571428571428571,1,0.0,0,1,0,1,2,0,0,2,0,2,4,1
635,8035,Q7WmsII1N0h11nYfhimDkafAIQtH8FBe,A3fsA9Zfv1X2fVEQhTw51lKENdNrEqT3,27,16,11,0,9,3,12,2,53,7.571428571428571,1,0.0,3,11,0,9,13,3,0,12,2,23,30,1
636,8040,IjI8O6qhXWrzvoHGjD0jKSLTrkjwywnZ,SpATywNh6bZuzm8s1ceuBUnMUAeoAHHw,36,72,2,58,1,45,21,1,200,28.571428571428573,5,0.0,28,2,48,1,44,45,10,21,1,79,121,0
637,8042,XDPvGyFLLEYwbNEQik2MM4yiADs5rrYJ,SpATywNh6bZuzm8s1ceuBUnMUAeoAHHw,14,18,9,0,3,15,6,0,51,7.285714285714286,4,0.0,4,9,0,3,14,15,0,6,0,16,35,1
638,8048,lPfsYctvOlk2KshSTR0YzF9fsG0sDcXm,SpATywNh6bZuzm8s1ceuBUnMUAeoAHHw,18,47,21,27,6,7,17,3,128,18.285714285714285,6,0.0,16,21,21,6,31,7,6,17,3,64,64,0
639,8054,3nOS3JEH08BgwunQqioyEFfja4qIND4p,SpATywNh6bZuzm8s1ceuBUnMUAeoAHHw,8,6,4,0,1,0,3,0,14,2.0,2,0.0,0,4,0,1,6,0,0,3,0,5,9,1
640,8060,aJPDWxjvWh7cfVWUTg8ZVK8q5wjeFEdQ,SpATywNh6bZuzm8s1ceuBUnMUAeoAHHw,22,56,17,14,6,3,25,6,127,18.142857142857142,5,0.0,2,17,12,6,54,3,2,25,6,37,90,1
641,8084,Rl9j2cgwioq6OBXKad44x4Um0fdVh2gk,SpATywNh6bZuzm8s1ceuBUnMUAeoAHHw,6,2,1,0,1,0,3,0,7,1.0,1,0.0,0,1,0,1,2,0,0,3,0,2,5,1
642,8090,cXITZ8Hjmr6myIyBLbDLY8s8nux0OPPJ,SpATywNh6bZuzm8s1ceuBUnMUAeoAHHw,6,9,2,0,0,0,7,0,18,2.5714285714285716,2,0.0,0,2,0,0,9,0,0,7,0,2,16,1
643,8091,Nt122dpzJdE1gwkHUV6Ncnzj3MDda3Gr,G8EPVSXsOYB5YQWZGiz1aVq5Pgr2GrQu,5,9,1,2,1,0,3,0,16,2.2857142857142856,1,0.0,3,1,1,1,6,0,1,3,0,6,10,1
644,8094,cZCWNPGtcdIiIlOnNkFDWI8KTo9TOlAC,SpATywNh6bZuzm8s1ceuBUnMUAeoAHHw,6,1,1,0,1,0,4,0,7,1.0,1,0.0,0,1,0,1,1,0,0,4,0,2,5,1
645,8108,D8ad6YCP4S8e1UHCQjU17HMPa0udSxjF,A3fsA9Zfv1X2fVEQhTw51lKENdNrEqT3,37,10,8,64,5,12,17,2,118,16.857142857142858,2,0.0,1,8,60,5,9,12,4,17,2,74,44,1
646,8112,X4PGvTm4F0x49zE1LPpj4etdmQj6eS9S,SpATywNh6bZuzm8s1ceuBUnMUAeoAHHw,40,50,33,0,23,0,12,0,118,16.857142857142858,4,0.0,3,33,0,23,47,0,0,12,0,59,59,0
647,8123,q6JeU48PcDOdiZ368tb3IoCh3BVgnxVp,bWdj2GDclj5ofokWjzoa5jAwMkxCykd6,35,109,57,58,38,83,21,0,366,52.285714285714285,10,0.0,11,57,43,38,98,83,15,21,0,149,217,1
648,8145,ZDVmuYiPoGm0gu1bR2BaE1soF6dU5v1W,A3fsA9Zfv1X2fVEQhTw51lKENdNrEqT3,39,96,45,46,26,3,5,0,221,31.571428571428573,3,0.0,0,45,42,26,96,3,4,5,0,113,108,1
649,8148,nx1z63DgmeEAxW8gQgEbpcNs34kbRne4,A3fsA9Zfv1X2fVEQhTw51lKENdNrEqT3,4,1,1,0,0,0,3,0,5,0.7142857142857143,1,0.0,0,1,0,0,1,0,0,3,0,1,4,1
650,8166,eOxm8XEI11Xs6eiBi1Nu5QzIagZXwEm9,SpATywNh6bZuzm8s1ceuBUnMUAeoAHHw,22,34,22,19,5,106,16,0,202,28.857142857142858,8,0.0,3,22,17,5,31,106,2,16,0,47,155,0
651,8168,jtxvuHBV8ZOgNnNCL1A1WerzR2TVfFNy,A3fsA9Zfv1X2fVEQhTw51lKENdNrEqT3,42,24,17,62,12,0,4,0,119,17.0,3,0.0,3,17,52,12,21,0,10,4,0,84,35,1
652,8185,WgYQBUzSJJLcj6PwA0d8MdNri6k7nN4s,RXDvfPUBYFlVdlueBFbLW0mhhAyGEqpt,5,2,1,0,1,0,4,0,8,1.1428571428571428,2,0.0,0,1,0,1,2,0,0,4,0,2,6,1
653,8188,XpMzbdWNf7VknZxctjGvDzxNpyCLWCaP,SpATywNh6bZuzm8s1ceuBUnMUAeoAHHw,22,35,14,16,8,1,14,2,90,12.857142857142858,4,0.0,13,14,15,8,22,1,1,14,2,50,40,1
654,8210,YxqHC7YRxEYSyD66BTdrU6f4qZw3IxAu,SpATywNh6bZuzm8s1ceuBUnMUAeoAHHw,7,1,1,0,1,0,4,0,7,1.0,1,0.0,0,1,0,1,1,0,0,4,0,2,5,1
655,8243,VAe2acDlYib7o05H0M3tg4gQoc5gLI96,SpATywNh6bZuzm8s1ceuBUnMUAeoAHHw,29,39,21,17,7,0,9,1,94,13.428571428571429,5,0.0,10,21,17,7,29,0,0,9,1,55,39,1
656,8254,rD3x5Ovuza1MLiqkvaHksaL42hepSLSa,bWdj2GDclj5ofokWjzoa5jAwMkxCykd6,12,29,13,8,4,1,15,0,70,10.0,6,0.0,1,13,8,4,28,1,0,15,0,26,44,1
657,8257,ANOp8mWNHTZUswLhYddMTdBChUriYZaX,RXDvfPUBYFlVdlueBFbLW0mhhAyGEqpt,95,557,26,324,28,211,106,4,1256,179.42857142857142,20,0.0,128,26,295,28,429,211,29,106,4,477,779,0
658,8284,X9u2Hncxz9A6DpGBhCZ5wulJhsMdyVac,RXDvfPUBYFlVdlueBFbLW0mhhAyGEqpt,13,11,9,0,4,0,6,0,30,4.285714285714286,3,0.0,0,9,0,4,11,0,0,6,0,13,17,1
659,8291,ljmWZCzWPqv1RXsn1q2wpsQtrnA1zct2,bWdj2GDclj5ofokWjzoa5jAwMkxCykd6,16,31,1,194,2,46,21,1,296,42.285714285714285,4,0.0,9,1,186,2,22,46,8,21,1,198,98,1
660,8301,KdYI01F9Xc7qTt82weazWGHtHsUvxDB7,SpATywNh6bZuzm8s1ceuBUnMUAeoAHHw,35,62,9,22,8,19,16,1,137,19.571428571428573,9,0.0,17,9,19,8,45,19,3,16,1,53,84,1
661,8305,kpS5tMAHQr9yJyfVB9Mkc4TlfmouYjNE,SpATywNh6bZuzm8s1ceuBUnMUAeoAHHw,36,169,43,0,18,3,31,4,268,38.285714285714285,16,0.0,0,43,0,18,169,3,0,31,4,61,207,0
662,8312,cYibpCaMUGq0WjgUWfTv0iIvJ7QbFj5E,SpATywNh6bZuzm8s1ceuBUnMUAeoAHHw,43,43,21,45,14,37,54,0,214,30.571428571428573,12,0.0,17,21,39,14,26,37,6,54,0,91,123,0
663,8345,qDcPjYl3DZy0WT2lmJT9GmZYgAdLwjE1,SpATywNh6bZuzm8s1ceuBUnMUAeoAHHw,5,6,1,0,0,0,2,0,9,1.2857142857142858,1,0.0,3,1,0,0,3,0,0,2,0,4,5,1
664,8348,f6fUoSUJslaShApLLQ3C3hAE39t0Ewco,SpATywNh6bZuzm8s1ceuBUnMUAeoAHHw,28,52,15,18,7,31,11,2,136,19.428571428571427,2,0.0,23,15,17,7,29,31,1,11,2,62,74,1
665,8375,U7C8tpNUwsrK1uIrWw0ieIQJYwOo61Uc,SpATywNh6bZuzm8s1ceuBUnMUAeoAHHw,20,25,16,8,7,0,3,0,59,8.428571428571429,3,0.0,2,16,6,7,23,0,2,3,0,31,28,1
666,8378,ZipuPEeCqze6LFrYfkIZBU7ronXF3JAb,SpATywNh6bZuzm8s1ceuBUnMUAeoAHHw,55,56,35,39,21,0,10,1,162,23.142857142857142,4,0.0,15,35,35,21,41,0,4,10,1,106,56,0
667,8381,XDUz0oVcNwke0CqAlFlmwOWSA32SgeFl,SpATywNh6bZuzm8s1ceuBUnMUAeoAHHw,24,62,3,4,1,0,21,0,91,13.0,15,0.0,3,3,4,1,59,0,0,21,0,11,80,0
668,8397,a9P7gN6Av72Gjg1AVS7Rv4BiyiW2xpDS,bWdj2GDclj5ofokWjzoa5jAwMkxCykd6,3,0,0,0,0,1,3,0,4,0.5714285714285714,1,0.0,0,0,0,0,0,1,0,3,0,0,4,1
669,8408,NYt3HW4iIDKFfkoDHUmE2GfhEi6C8Rqu,bWdj2GDclj5ofokWjzoa5jAwMkxCykd6,8,11,6,0,0,6,18,1,42,6.0,5,0.0,0,6,0,0,11,6,0,18,1,6,36,1
670,8410,kWUbu8oK1dFJKpHhiF15MwcSzNzv8GaS,A3fsA9Zfv1X2fVEQhTw51lKENdNrEqT3,6,12,7,0,3,0,6,0,28,4.0,4,0.0,0,7,0,3,12,0,0,6,0,10,18,1
671,8424,ukCIrv5h45nbdIEPPmMlvipT87B8fFE7,RXDvfPUBYFlVdlueBFbLW0mhhAyGEqpt,67,141,107,2,48,34,20,5,357,51.0,19,0.0,0,107,2,48,141,34,0,20,5,157,200,0
672,8427,sOkc0wEXSSLpxtxlqjZObJqg94IyLpuY,SpATywNh6bZuzm8s1ceuBUnMUAeoAHHw,45,129,2,37,0,34,46,0,248,35.42857142857143,13,0.0,33,2,31,0,96,34,6,46,0,66,182,0
673,8443,ITkxDxE80MnM3R1P6Tny4qeXU1QIqBHa,A3fsA9Zfv1X2fVEQhTw51lKENdNrEqT3,73,53,34,192,14,42,23,1,359,51.285714285714285,5,0.0,4,34,163,14,49,42,29,23,1,215,144,1
674,8449,TTJoWZMu9qE69gK338lM1DPPuzOJjTS2,SpATywNh6bZuzm8s1ceuBUnMUAeoAHHw,18,31,2,20,2,5,8,1,69,9.857142857142858,3,0.0,5,2,17,2,26,5,3,8,1,26,43,1
675,8457,jcXoYFaI9QPcliotiwIgOLeObkrSUvNn,SpATywNh6bZuzm8s1ceuBUnMUAeoAHHw,24,32,2,14,1,3,5,0,57,8.142857142857142,5,0.0,5,2,13,1,27,3,1,5,0,21,36,0
676,8471,qLCBP0aNIaDp6cyqIvUit2p06Y7zVnQy,G8EPVSXsOYB5YQWZGiz1aVq5Pgr2GrQu,7,6,1,0,1,0,2,0,10,1.4285714285714286,1,0.0,1,1,0,1,5,0,0,2,0,3,7,1
677,8478,UY6XF5Ob1mgKcqmlUI5FgYfIUUIUAwxR,SpATywNh6bZuzm8s1ceuBUnMUAeoAHHw,60,132,45,56,23,5,37,3,301,43.0,10,0.0,37,45,45,23,95,5,11,37,3,150,151,0
678,8504,2cKDRLsZWRQVPO7xdF2dpJ6vw1EsD7pk,bWdj2GDclj5ofokWjzoa5jAwMkxCykd6,14,35,8,102,3,0,4,0,152,21.714285714285715,5,0.0,3,8,96,3,32,0,6,4,0,110,42,1
679,8505,DpXkrIHIAIPNESKyvFah0WhpVT5PHFeL,SpATywNh6bZuzm8s1ceuBUnMUAeoAHHw,28,49,27,19,0,20,18,2,135,19.285714285714285,9,0.0,8,27,17,0,41,20,2,18,2,52,83,0
680,8510,2cKDRLsZWRQVPO7xdF2dpJ6vw1EsD7pk,A3fsA9Zfv1X2fVEQhTw51lKENdNrEqT3,66,76,28,218,13,0,4,0,339,48.42857142857143,4,0.0,10,28,182,13,66,0,36,4,0,233,106,1
681,8516,WFBeS5f6wWn1eFBxyujnTFuvM6fqEpDk,A3fsA9Zfv1X2fVEQhTw51lKENdNrEqT3,13,7,2,6,2,0,4,0,21,3.0,2,0.0,1,2,6,2,6,0,0,4,0,11,10,1
682,8517,4tj4DQ4XnBvn4uM9Mw2kTJbN1KPDkno4,SpATywNh6bZuzm8s1ceuBUnMUAeoAHHw,33,94,43,34,12,24,32,8,247,35.285714285714285,10,0.0,26,43,33,12,68,24,1,32,8,114,133,0
683,8522,aLRP3ahB5SIcOn5vpM1VPEh9ib2QIioX,bWdj2GDclj5ofokWjzoa5jAwMkxCykd6,5,12,1,0,0,19,6,0,38,5.428571428571429,4,0.0,0,1,0,0,12,19,0,6,0,1,37,1
684,8523,0Vj24SN7QK68fxZGEj9b6pGHh8nTXfGG,A3fsA9Zfv1X2fVEQhTw51lKENdNrEqT3,52,43,28,150,2,0,15,0,238,34.0,9,0.0,3,28,139,2,40,0,11,15,0,172,66,0
685,8526,HBfe50okXo4yGURKfz5xhaX3ToIkoF7Q,bWdj2GDclj5ofokWjzoa5jAwMkxCykd6,38,95,44,88,13,58,23,1,322,46.0,8,0.0,9,44,81,13,86,58,7,23,1,147,175,1
686,8529,lnzFfoDYtlWPJMTPbihufULiQk1Jv9SB,SpATywNh6bZuzm8s1ceuBUnMUAeoAHHw,6,2,1,0,1,0,3,0,7,1.0,1,0.0,0,1,0,1,2,0,0,3,0,2,5,1
687,8540,83bogZlv4TVHMx4MUYOU3yEQWNYHnGAe,G8EPVSXsOYB5YQWZGiz1aVq5Pgr2GrQu,3,17,4,0,0,0,2,0,23,3.2857142857142856,6,0.0,1,4,0,0,16,0,0,2,0,5,18,1
688,8553,aGkT5uzDJUsKsLNIW3C8wBL1bUhJSBfn,SpATywNh6bZuzm8s1ceuBUnMUAeoAHHw,22,43,3,36,2,0,3,0,87,12.428571428571429,8,0.0,10,3,30,2,33,0,6,3,0,45,42,0
689,8570,ApFdQQBcLqTLoA4wIvtlnnwFs4FrlVS1,RXDvfPUBYFlVdlueBFbLW0mhhAyGEqpt,106,187,116,156,52,43,90,3,647,92.42857142857143,16,0.0,48,116,144,52,139,43,12,90,3,360,287,0
690,8574,7jkKKf5Pb7FrtJ3WnuF11G7ePioUPJm3,A3fsA9Zfv1X2fVEQhTw51lKENdNrEqT3,52,37,29,76,17,6,11,0,176,25.142857142857142,4,0.0,1,29,66,17,36,6,10,11,0,113,63,1
691,8582,x0VzAeYdlywtGLqE1HF68qQMYZTLfsw9,SpATywNh6bZuzm8s1ceuBUnMUAeoAHHw,58,107,54,34,27,1,28,1,252,36.0,13,0.0,33,54,31,27,74,1,3,28,1,145,107,0
692,8585,28jQkMYgDOh7TIBKdGn62G1sm2slN0BP,A3fsA9Zfv1X2fVEQhTw51lKENdNrEqT3,142,95,63,339,37,0,21,0,555,79.28571428571429,14,0.0,3,63,287,37,92,0,52,21,0,390,165,0
693,8586,Xci1viGBABzXjikcwwlwGEGBfmePUlzw,SpATywNh6bZuzm8s1ceuBUnMUAeoAHHw,32,177,73,20,5,67,51,6,399,57.0,10,0.0,76,73,20,5,101,67,0,51,6,174,225,1
694,8616,GexMn1szbSD50sX3ghgNlwAzziO50D2R,SpATywNh6bZuzm8s1ceuBUnMUAeoAHHw,43,148,29,36,13,69,59,2,356,50.857142857142854,11,0.0,40,29,33,13,108,69,3,59,2,115,241,0
695,8619,7yfm92CNSrFqBw5yp2Efl7B2jNSXGlux,SpATywNh6bZuzm8s1ceuBUnMUAeoAHHw,1,0,0,0,0,0,1,0,1,0.14285714285714285,1,0.0,0,0,0,0,0,0,0,1,0,0,1,1
696,8620,x0VzAeYdlywtGLqE1HF68qQMYZTLfsw9,bWdj2GDclj5ofokWjzoa5jAwMkxCykd6,8,7,5,0,3,0,2,0,17,2.4285714285714284,1,0.0,0,5,0,3,7,0,0,2,0,8,9,1
697,8628,nQgK4glIoTighvWZSrb5cpZqSgT49IUz,SpATywNh6bZuzm8s1ceuBUnMUAeoAHHw,60,82,45,39,19,2,26,0,213,30.428571428571427,11,0.0,23,45,36,19,59,2,3,26,0,123,90,0
698,8636,2tNnsKlcvz4IV4xQh5sF75J9zNq5DtzC,SpATywNh6bZuzm8s1ceuBUnMUAeoAHHw,36,67,11,48,3,27,6,0,162,23.142857142857142,5,0.0,30,11,44,3,37,27,4,6,0,88,74,1
699,8640,g2XbJogybHS3UQDYBcO0HoCO8HfG7ABm,A3fsA9Zfv1X2fVEQhTw51lKENdNrEqT3,42,58,2,38,0,5,20,3,126,18.0,5,0.0,3,2,38,0,55,5,0,20,3,43,83,1
700,8641,3dlrFJzmVyUebS1oyKqPiquAJj3CweSU,SpATywNh6bZuzm8s1ceuBUnMUAeoAHHw,29,60,15,29,5,2,20,2,133,19.0,4,0.0,16,15,23,5,44,2,6,20,2,59,74,1
701,8649,uQjl8NGtIQkRfoe9edBiMgtYYmdkzVXR,bWdj2GDclj5ofokWjzoa5jAwMkxCykd6,42,156,79,113,26,38,51,3,466,66.57142857142857,19,0.0,18,79,95,26,138,38,18,51,3,218,248,0
702,8652,15n53eqSRMLQKZaiigI2Vgclm7aKceka,A3fsA9Zfv1X2fVEQhTw51lKENdNrEqT3,20,30,5,0,3,1,19,2,60,8.571428571428571,7,0.0,0,5,0,3,30,1,0,19,2,8,52,0
703,8660,CxUPOQRaQMGLmbOcfniIQOhh24PXLDR6,A3fsA9Zfv1X2fVEQhTw51lKENdNrEqT3,53,101,52,79,16,22,34,4,308,44.0,18,0.0,6,52,63,16,95,22,16,34,4,137,171,0
704,8677,k6Ev3pOofJatsjXYv6yHRgeWPlAQcaXL,SpATywNh6bZuzm8s1ceuBUnMUAeoAHHw,31,32,20,20,8,1,12,1,94,13.428571428571429,4,0.0,4,20,19,8,28,1,1,12,1,51,43,1
705,8683,xlLP2MUG9CBaax1U0Ai47Er5upBZhMpV,SpATywNh6bZuzm8s1ceuBUnMUAeoAHHw,17,45,21,11,8,1,9,0,95,13.571428571428571,5,0.0,15,21,10,8,30,1,1,9,0,54,41,1
706,8690,NuBf7vtWvcfQjgrelnmNuJu6a5WC9FFT,SpATywNh6bZuzm8s1ceuBUnMUAeoAHHw,32,103,28,66,11,33,58,5,304,43.42857142857143,9,0.0,20,28,59,11,83,33,7,58,5,118,186,0
707,8734,fxq584v5hQmVOHgm4uohGT9XrYo1FGMS,SpATywNh6bZuzm8s1ceuBUnMUAeoAHHw,60,195,64,84,24,5,30,1,403,57.57142857142857,8,0.0,23,64,69,24,172,5,15,30,1,180,223,0
708,8741,XWElpBT4PKnC5pi96PLjtYP5u9l1rrKm,SpATywNh6bZuzm8s1ceuBUnMUAeoAHHw,43,156,49,25,17,10,61,3,321,45.857142857142854,14,0.0,29,49,23,17,127,10,2,61,3,118,203,0
709,8748,IZ5pWpBLzW50MjCCGxCjTz4w6DVz2MU3,A3fsA9Zfv1X2fVEQhTw51lKENdNrEqT3,64,66,37,156,22,0,11,0,292,41.714285714285715,6,0.0,7,37,124,22,59,0,32,11,0,190,102,0
710,8752,tsTDNHtkzUQqr6Le5CiKzEb1J3ub8XpE,G8EPVSXsOYB5YQWZGiz1aVq5Pgr2GrQu,114,102,18,219,19,0,8,0,366,52.285714285714285,17,0.0,26,18,194,19,76,0,25,8,0,257,109,0
711,8756,cPzUMr5q8dc3UpQvyyBObvWhUfY89oua,SpATywNh6bZuzm8s1ceuBUnMUAeoAHHw,39,30,22,30,15,1,9,1,108,15.428571428571429,2,0.0,5,22,25,15,25,1,5,9,1,67,41,1
712,8766,V8icfAYA9I8myBnRTjbheMwStuoZOBk5,SpATywNh6bZuzm8s1ceuBUnMUAeoAHHw,32,106,36,35,11,20,42,6,256,36.57142857142857,8,0.0,29,36,30,11,77,20,5,42,6,106,150,1
713,8768,Za0SfT4qDZpXUZtWaYX1DLLmm9w6G9yO,RXDvfPUBYFlVdlueBFbLW0mhhAyGEqpt,28,32,18,0,10,14,7,1,82,11.714285714285714,2,0.0,0,18,0,10,32,14,0,7,1,28,54,1
714,8772,NLUFE7ndaVQ8A2tkIa8xBpPqWZbahAYT,SpATywNh6bZuzm8s1ceuBUnMUAeoAHHw,62,78,40,82,21,12,38,3,274,39.142857142857146,8,0.0,20,40,65,21,58,12,17,38,3,146,128,0
715,8778,hkmT0j8GDy3ymXnKaIcUDPdFkebvKRou,SpATywNh6bZuzm8s1ceuBUnMUAeoAHHw,30,68,32,45,15,17,29,3,209,29.857142857142858,7,0.0,20,32,37,15,48,17,8,29,3,104,105,0
716,8783,V9A9B2T9pRTU3AqvpqzuKs4MfRcAEte2,RXDvfPUBYFlVdlueBFbLW0mhhAyGEqpt,35,43,27,12,11,0,23,1,117,16.714285714285715,6,0.0,4,27,10,11,39,0,2,23,1,52,65,1
717,8790,hShFZH2IARrzxZjv2Hbws9rmf9bt3f58,SpATywNh6bZuzm8s1ceuBUnMUAeoAHHw,32,87,21,36,8,0,16,1,169,24.142857142857142,9,0.0,33,21,31,8,54,0,5,16,1,93,76,0
718,8820,sqKEuRhvHf94SnQ2C0IdhOfhaSrrM6tg,SpATywNh6bZuzm8s1ceuBUnMUAeoAHHw,43,158,8,57,10,19,47,3,302,43.142857142857146,13,0.0,47,8,49,10,111,19,8,47,3,114,188,0
719,8830,LfzKT52vEtoxbNqX2vKaJI7cIpPCsgUd,SpATywNh6bZuzm8s1ceuBUnMUAeoAHHw,7,3,2,0,2,0,4,0,11,1.5714285714285714,1,0.0,0,2,0,2,3,0,0,4,0,4,7,1
720,8831,SoFzOO60yRk0ggHCvfEgIFgyAhcbDPEU,SpATywNh6bZuzm8s1ceuBUnMUAeoAHHw,5,2,1,0,1,0,2,0,6,0.8571428571428571,1,0.0,0,1,0,1,2,0,0,2,0,2,4,1
721,8833,BX9KMh9DUbDRkGw8SYAs3wHv0hHJ990Z,SpATywNh6bZuzm8s1ceuBUnMUAeoAHHw,56,85,51,48,25,0,21,0,230,32.857142857142854,13,0.0,10,51,43,25,75,0,5,21,0,129,101,0
722,8862,5QXD7nGlfa5LD2DcNq8Av61TrcRi85rU,G8EPVSXsOYB5YQWZGiz1aVq5Pgr2GrQu,15,15,1,39,3,0,2,0,60,8.571428571428571,1,0.0,8,1,32,3,7,0,7,2,0,44,16,0
723,8863,4vEHDSGKXu9Cie3on99cieDjI4lud9xW,SpATywNh6bZuzm8s1ceuBUnMUAeoAHHw,12,26,1,14,0,0,2,0,43,6.142857142857143,1,0.0,13,1,13,0,13,0,1,2,0,27,16,1
724,8874,XrkmN79zYVHhoXA87bb44oUhAS8HKFji,SpATywNh6bZuzm8s1ceuBUnMUAeoAHHw,16,35,20,0,3,6,12,1,77,11.0,1,0.0,2,20,0,3,33,6,0,12,1,25,52,1
725,8880,mVMuUEeLKa3SdL5JnStqlN0fzPnKsCAA,SpATywNh6bZuzm8s1ceuBUnMUAeoAHHw,1,0,0,0,0,0,1,0,1,0.14285714285714285,1,0.0,0,0,0,0,0,0,0,1,0,0,1,1
726,8882,NAmyRYUXoAoJaF1WmEUzfZdW5j2jsFh1,SpATywNh6bZuzm8s1ceuBUnMUAeoAHHw,47,67,45,44,24,61,31,1,273,39.0,8,0.0,13,45,38,24,54,61,6,31,1,120,153,0
727,8894,8IuzZOXaXVUql9pLZtNuJIyLoDJ8ZL4V,bWdj2GDclj5ofokWjzoa5jAwMkxCykd6,8,13,5,0,0,0,13,0,31,4.428571428571429,5,0.0,0,5,0,0,13,0,0,13,0,5,26,1
728,8903,cvlNPzqQj2LOz3Z7WcczCYX7AEEZY5z2,RXDvfPUBYFlVdlueBFbLW0mhhAyGEqpt,7,5,2,0,1,2,6,0,16,2.2857142857142856,1,0.0,0,2,0,1,5,2,0,6,0,3,13,1
729,8908,9lksmcPg7FQE2FGQIA9VvWum1Z9DYrHM,SpATywNh6bZuzm8s1ceuBUnMUAeoAHHw,13,25,14,0,4,3,12,0,58,8.285714285714286,3,0.0,5,14,0,4,20,3,0,12,0,23,35,1
730,8915,RlIzEuK7g6sugNWIIhijiyryQft8qZof,SpATywNh6bZuzm8s1ceuBUnMUAeoAHHw,20,21,13,10,6,4,7,0,61,8.714285714285714,3,0.0,4,13,9,6,17,4,1,7,0,32,29,1
731,8939,awz7o49PrUBSNrYng5ZPMFSJBn6RXWK1,G8EPVSXsOYB5YQWZGiz1aVq5Pgr2GrQu,166,281,173,169,106,2,71,0,802,114.57142857142857,22,0.0,19,173,147,106,262,2,22,71,0,445,357,0
732,8943,dQggCBdg5KVSltApPCgVZB7TTUQzzzoI,RXDvfPUBYFlVdlueBFbLW0mhhAyGEqpt,51,49,28,101,11,22,8,0,219,31.285714285714285,5,0.0,10,28,86,11,39,22,15,8,0,135,84,1
733,8954,N7x6rez9AavUVus2y33zQwbgvW9e4FwN,bWdj2GDclj5ofokWjzoa5jAwMkxCykd6,4,2,1,0,1,0,1,0,5,0.7142857142857143,1,0.0,0,1,0,1,2,0,0,1,0,2,3,1
734,8972,3NITGQuylcrTi63aoWqnzXuF5Rtf7QVq,SpATywNh6bZuzm8s1ceuBUnMUAeoAHHw,25,45,19,15,17,19,23,0,138,19.714285714285715,4,0.0,7,19,14,17,38,19,1,23,0,57,81,1
735,8976,7uaenfsWfnarv8At387iUkznBBW20T7a,SpATywNh6bZuzm8s1ceuBUnMUAeoAHHw,35,70,28,25,10,9,22,1,165,23.571428571428573,10,0.0,18,28,19,10,52,9,6,22,1,75,90,0
736,8978,WCRryRCEKP6zK3AUHtR5dzBwncEtNUH8,G8EPVSXsOYB5YQWZGiz1aVq5Pgr2GrQu,180,369,55,448,36,7,374,3,1292,184.57142857142858,26,0.0,116,55,343,36,253,7,105,374,3,550,742,0
737,8986,Ucr48Rnt4CA9YgbeIcM1jITCIMHtgMC0,A3fsA9Zfv1X2fVEQhTw51lKENdNrEqT3,3,0,0,0,0,0,6,0,6,0.8571428571428571,2,0.0,0,0,0,0,0,0,0,6,0,0,6,1
738,9001,lvwGRCEVK5ut59266fZHM9ppN9a4Qw6i,SpATywNh6bZuzm8s1ceuBUnMUAeoAHHw,6,5,3,0,2,0,3,0,13,1.8571428571428572,2,0.0,0,3,0,2,5,0,0,3,0,5,8,1
739,9007,WDMP5c2Ubx8vVSFegA0mXeU23cYb0qCY,RXDvfPUBYFlVdlueBFbLW0mhhAyGEqpt,89,162,10,141,4,74,26,2,419,59.857142857142854,23,0.0,23,10,128,4,139,74,13,26,2,165,254,0
740,9035,ANOp8mWNHTZUswLhYddMTdBChUriYZaX,SpATywNh6bZuzm8s1ceuBUnMUAeoAHHw,45,136,0,82,0,31,39,2,290,41.42857142857143,8,0.0,38,0,70,0,98,31,12,39,2,108,182,0
741,9039,AoGNGJBevj5UJJAo0rhBglhkcP4W6WBy,G8EPVSXsOYB5YQWZGiz1aVq5Pgr2GrQu,1,0,0,0,0,0,1,0,1,0.14285714285714285,1,0.0,0,0,0,0,0,0,0,1,0,0,1,1
742,9043,aiXR63FJxLzLjxOw200I9QHjcVwt5TEN,SpATywNh6bZuzm8s1ceuBUnMUAeoAHHw,18,33,1,25,1,34,15,1,110,15.714285714285714,2,0.0,14,1,21,1,19,34,4,15,1,37,73,1
743,9136,UqGW2x76mENodjXkUPPKnojGcrLxXcJN,SpATywNh6bZuzm8s1ceuBUnMUAeoAHHw,43,98,49,57,24,2,19,0,249,35.57142857142857,12,0.0,30,49,50,24,68,2,7,19,0,153,96,0
744,9146,ZZYUdx90J4oaTxXr1v9ckDyAAO4fdRrW,bWdj2GDclj5ofokWjzoa5jAwMkxCykd6,7,4,2,0,2,0,4,0,12,1.7142857142857142,2,0.0,0,2,0,2,4,0,0,4,0,4,8,1
745,9149,8SekjqaLbfUPHiuX7ZCPwYfF03sn6XJi,RXDvfPUBYFlVdlueBFbLW0mhhAyGEqpt,46,73,30,101,15,3,10,0,232,33.142857142857146,7,0.0,16,30,99,15,57,3,2,10,0,160,72,1
746,9159,9DysAmMC3i4TW1eruWnww7wyDSDGRjXp,A3fsA9Zfv1X2fVEQhTw51lKENdNrEqT3,2,0,0,0,0,0,2,0,2,0.2857142857142857,1,0.0,0,0,0,0,0,0,0,2,0,0,2,1
747,9190,aP7onqFgeKEyIpEWyf9FmzL3YmPhzgtY,SpATywNh6bZuzm8s1ceuBUnMUAeoAHHw,5,4,2,0,0,0,2,0,8,1.1428571428571428,1,0.0,0,2,0,0,4,0,0,2,0,2,6,1
748,9197,1F8H7rmfvGmKxlm2143vBRoEH3vbZnuH,SpATywNh6bZuzm8s1ceuBUnMUAeoAHHw,7,5,2,0,2,0,4,0,13,1.8571428571428572,1,0.0,0,2,0,2,5,0,0,4,0,4,9,1
749,9206,Gdklwa0GJ75FwxPq1eHDC2rS99nIOtyi,bWdj2GDclj5ofokWjzoa5jAwMkxCykd6,38,53,31,116,12,12,14,2,240,34.285714285714285,4,0.0,12,31,102,12,41,12,14,14,2,157,83,1
750,9211,wSA7fJey1UFj4xGAji5nvUhhmZ43Jtbi,SpATywNh6bZuzm8s1ceuBUnMUAeoAHHw,7,7,2,0,1,0,8,0,18,2.5714285714285716,1,0.0,0,2,0,1,7,0,0,8,0,3,15,1
751,9220,lnpRXkDrSwjGYP4CoWLvjg5xZj4SSBHh,SpATywNh6bZuzm8s1ceuBUnMUAeoAHHw,62,123,58,41,21,91,31,2,367,52.42857142857143,10,0.0,22,58,36,21,101,91,5,31,2,137,230,0
752,9229,pSPqM0wxHLvU8pOPPVGkhJ6iIpXOwE0D,SpATywNh6bZuzm8s1ceuBUnMUAeoAHHw,5,2,1,0,1,3,3,0,10,1.4285714285714286,1,0.0,0,1,0,1,2,3,0,3,0,2,8,1
753,9232,b3doS3mx4rZAsWrCVosVej8UMBCaG0ZM,SpATywNh6bZuzm8s1ceuBUnMUAeoAHHw,32,41,20,18,11,0,6,0,96,13.714285714285714,3,0.0,16,20,17,11,25,0,1,6,0,64,32,1
754,9246,oolYEp2BotSva2yfmUYiIDYQiMjym92z,SpATywNh6bZuzm8s1ceuBUnMUAeoAHHw,9,11,6,0,4,0,5,0,26,3.7142857142857144,4,0.0,0,6,0,4,11,0,0,5,0,10,16,0
755,9257,XQsLTRxBgT09jhwR2kw4g3k34p5O8kHV,A3fsA9Zfv1X2fVEQhTw51lKENdNrEqT3,25,48,28,0,13,12,18,3,122,17.428571428571427,8,0.0,5,28,0,13,43,12,0,18,3,46,76,1
756,9260,OXDIjQPBiuWpB7PdzfniEtiITaq40Kxq,SpATywNh6bZuzm8s1ceuBUnMUAeoAHHw,35,53,24,35,9,2,18,1,142,20.285714285714285,9,0.0,14,24,31,9,39,2,4,18,1,78,64,1
757,9272,8lhedVUrxjbKOOXrDoKpLvh9BgBDrVND,SpATywNh6bZuzm8s1ceuBUnMUAeoAHHw,45,100,29,36,16,7,26,5,219,31.285714285714285,6,0.0,14,29,30,16,86,7,6,26,5,89,130,0
758,9273,Mu4L96Qo7KWrVAKYK2IsPfV4EjP9aNL4,G8EPVSXsOYB5YQWZGiz1aVq5Pgr2GrQu,14,9,5,2,4,13,16,1,50,7.142857142857143,5,0.0,4,5,1,4,5,13,1,16,1,14,36,1
759,9275,Mu4L96Qo7KWrVAKYK2IsPfV4EjP9aNL4,SpATywNh6bZuzm8s1ceuBUnMUAeoAHHw,30,38,22,47,9,34,20,0,170,24.285714285714285,6,0.0,7,22,39,9,31,34,8,20,0,77,93,1
760,9291,0rBpfipIkPUXXv4992tUqetb5IpoweSC,SpATywNh6bZuzm8s1ceuBUnMUAeoAHHw,12,13,1,12,0,0,6,1,33,4.714285714285714,2,0.0,4,1,12,0,9,0,0,6,1,17,16,1
761,9295,Xj0ZJ92JN6F4CNXTzd0Bvhi4bYi9S3VP,SpATywNh6bZuzm8s1ceuBUnMUAeoAHHw,20,26,15,11,12,6,27,2,99,14.142857142857142,8,0.0,4,15,11,12,22,6,0,27,2,42,57,0
762,9315,MjPA7JgM9XbkzRn3BICo8xJPG5qfeCcD,bWdj2GDclj5ofokWjzoa5jAwMkxCykd6,8,30,23,0,21,0,8,0,82,11.714285714285714,8,0.0,0,23,0,21,30,0,0,8,0,44,38,1
763,9327,tJN8ZYcrD7OwnBb01xCqUSDOnzwFRPdf,SpATywNh6bZuzm8s1ceuBUnMUAeoAHHw,35,94,14,40,5,11,38,0,202,28.857142857142858,12,0.0,17,14,34,5,77,11,6,38,0,70,132,0
764,9328,3SP9iNDvUt8m67ZMqC5DpQRe6ekkTpsP,SpATywNh6bZuzm8s1ceuBUnMUAeoAHHw,1,0,0,0,0,0,33,0,33,4.714285714285714,12,0.0,0,0,0,0,0,0,0,33,0,0,33,1
765,9329,sh6bGbGsbHzTVrRuQUATUDypFgGrJyhP,bWdj2GDclj5ofokWjzoa5jAwMkxCykd6,1,0,0,0,0,0,1,0,1,0.14285714285714285,1,0.0,0,0,0,0,0,0,0,1,0,0,1,1
766,9335,hsFDq5MhfyyJ0opvBTTLO0xNuy1mKh4f,SpATywNh6bZuzm8s1ceuBUnMUAeoAHHw,25,28,14,8,7,0,8,0,65,9.285714285714286,4,0.0,6,14,8,7,22,0,0,8,0,35,30,1
767,9339,4GxaPPzHsA8XSeyZ6ySVKPYJkeTDhbmO,A3fsA9Zfv1X2fVEQhTw51lKENdNrEqT3,11,2,2,0,2,5,15,3,29,4.142857142857143,1,0.0,0,2,0,2,2,5,0,15,3,4,25,1
768,9347,dQweEcdBCmNmUPOeO7X4TTmH8zuMq2aJ,bWdj2GDclj5ofokWjzoa5jAwMkxCykd6,36,93,41,174,1,30,27,0,366,52.285714285714285,5,0.0,20,41,124,1,73,30,50,27,0,186,180,1
769,9357,aSYSmBNLMzBrel3rF1bQSMOfc7OKhL4q,SpATywNh6bZuzm8s1ceuBUnMUAeoAHHw,18,36,11,20,7,0,12,0,86,12.285714285714286,5,0.0,3,11,16,7,33,0,4,12,0,37,49,1
770,9358,I2ghGumCKIaVsnJOGZA0xyJzTnEm5KtW,RXDvfPUBYFlVdlueBFbLW0mhhAyGEqpt,28,32,19,0,8,16,5,0,80,11.428571428571429,4,0.0,6,19,0,8,26,16,0,5,0,33,47,1
771,9362,EoYFOaJU19EU8QGJeHpIRqrgzpIVI4Qd,bWdj2GDclj5ofokWjzoa5jAwMkxCykd6,9,15,6,28,3,0,10,0,62,8.857142857142858,5,0.0,4,6,27,3,11,0,1,10,0,40,22,1
772,9389,UGnGGFIGvpoYWCshdaVb9HHg3HECfvUa,A3fsA9Zfv1X2fVEQhTw51lKENdNrEqT3,9,4,3,0,3,0,4,0,14,2.0,1,0.0,0,3,0,3,4,0,0,4,0,6,8,1
773,9391,ZVsvi9Hs3gwMngikgiUNz4ONY4BYnfbY,SpATywNh6bZuzm8s1ceuBUnMUAeoAHHw,1,0,0,0,0,0,1,0,1,0.14285714285714285,1,0.0,0,0,0,0,0,0,0,1,0,0,1,1
774,9419,JZCy2v8CZ2nSCAUiBMrG3NWUkCCn6jiz,G8EPVSXsOYB5YQWZGiz1aVq5Pgr2GrQu,32,73,8,6,3,1,11,1,103,14.714285714285714,5,0.0,14,8,5,3,59,1,1,11,1,30,73,1
775,9422,KqXKhfoS0ErJVO04c2y8uGBxUt61ck8m,SpATywNh6bZuzm8s1ceuBUnMUAeoAHHw,16,21,2,20,1,0,7,0,51,7.285714285714286,3,0.0,9,2,19,1,12,0,1,7,0,31,20,1
776,9460,zOr0niRplBKfkwpPHNykN96u1FhzegfK,G8EPVSXsOYB5YQWZGiz1aVq5Pgr2GrQu,90,440,207,22,46,202,82,1,1000,142.85714285714286,21,0.0,59,207,16,46,381,202,6,82,1,328,672,0
777,9466,XDPvGyFLLEYwbNEQik2MM4yiADs5rrYJ,G8EPVSXsOYB5YQWZGiz1aVq5Pgr2GrQu,2,0,0,0,0,0,2,0,2,0.2857142857142857,1,0.0,0,0,0,0,0,0,0,2,0,0,2,1
778,9468,JnhPqAOFLEpgEufKhwt0tmkUNhkNteVd,SpATywNh6bZuzm8s1ceuBUnMUAeoAHHw,22,44,9,36,2,0,16,0,107,15.285714285714286,7,0.0,11,9,34,2,33,0,2,16,0,56,51,1
779,9469,V4PEne3FGwC3uaaGa4t7iLZtyEIE0fzF,SpATywNh6bZuzm8s1ceuBUnMUAeoAHHw,30,54,12,29,5,15,29,3,147,21.0,7,0.0,13,12,24,5,41,15,5,29,3,54,93,1
780,9470,XDPvGyFLLEYwbNEQik2MM4yiADs5rrYJ,RXDvfPUBYFlVdlueBFbLW0mhhAyGEqpt,2,0,0,0,0,0,3,0,3,0.42857142857142855,2,0.0,0,0,0,0,0,0,0,3,0,0,3,1
781,9480,xNIFyatWugs5Maa0edr0HyKzFRsz7FQp,G8EPVSXsOYB5YQWZGiz1aVq5Pgr2GrQu,2,0,0,0,0,0,2,0,2,0.2857142857142857,1,0.0,0,0,0,0,0,0,0,2,0,0,2,1
782,9482,2YohZ5UKGzy1qUgVAShosLdhgm3pfvsR,SpATywNh6bZuzm8s1ceuBUnMUAeoAHHw,6,3,1,0,1,0,2,0,7,1.0,1,0.0,0,1,0,1,3,0,0,2,0,2,5,1
783,9510,20lTdK7j1fcbNyoe9mD2q7qXvA5Z8HOD,SpATywNh6bZuzm8s1ceuBUnMUAeoAHHw,39,127,76,11,50,3,22,1,290,41.42857142857143,6,0.0,16,76,10,50,111,3,1,22,1,152,138,0
784,9517,fN4I0M2Yv3uPvseFkDyQdSg5ZokzJaMj,RXDvfPUBYFlVdlueBFbLW0mhhAyGEqpt,90,99,55,224,23,119,14,10,544,77.71428571428571,11,0.0,22,55,207,23,77,119,17,14,10,307,237,1
785,9533,xdUSsALCLmQFNaGX8BEyTR2RhmvhWdsB,SpATywNh6bZuzm8s1ceuBUnMUAeoAHHw,28,39,11,32,5,4,39,0,130,18.571428571428573,9,0.0,8,11,28,5,31,4,4,39,0,52,78,0
786,9549,RV3mgnFEm5em6PXoEJeQNSKFCpjzfVyy,bWdj2GDclj5ofokWjzoa5jAwMkxCykd6,14,18,5,6,1,246,52,0,328,46.857142857142854,14,0.0,1,5,4,1,17,246,2,52,0,11,317,0
787,9550,7J9JIWVCQG1g6yXh3uTVbrSu3pa18Ezn,SpATywNh6bZuzm8s1ceuBUnMUAeoAHHw,47,60,38,29,14,15,17,2,175,25.0,6,0.0,11,38,27,14,49,15,2,17,2,90,85,0
788,9581,c9jAWas5mvRKYRBHiOkTzLeYoPWRHLa3,G8EPVSXsOYB5YQWZGiz1aVq5Pgr2GrQu,1,0,0,0,0,0,2,0,2,0.2857142857142857,1,0.0,0,0,0,0,0,0,0,2,0,0,2,1
789,9624,GD8FRA1y66qb4KlW9w61HoAU1TWGpDoa,G8EPVSXsOYB5YQWZGiz1aVq5Pgr2GrQu,58,138,63,80,11,1496,195,125,2108,301.14285714285717,30,0.0,17,63,62,11,121,1496,18,195,125,153,1955,0
790,9636,zcw6JFT1cBTyKAWUWt6eG4jvVYxHMSLq,SpATywNh6bZuzm8s1ceuBUnMUAeoAHHw,38,47,29,30,11,8,10,0,135,19.285714285714285,6,0.0,10,29,27,11,37,8,3,10,0,77,58,0
791,9643,UzwJVyLJF6Ih9iHYPyYWMullgIr89o5m,SpATywNh6bZuzm8s1ceuBUnMUAeoAHHw,29,58,28,22,3,2,20,0,133,19.0,12,0.0,12,28,22,3,46,2,0,20,0,65,68,0
792,9655,66U3TkcZA1aSl7HKRun9CzahgGH85zQD,SpATywNh6bZuzm8s1ceuBUnMUAeoAHHw,41,113,24,29,9,39,33,0,247,35.285714285714285,13,0.0,37,24,29,9,76,39,0,33,0,99,148,0
793,9663,C4q4gNQYEpjKh7pq1qjN8i3L7uSpUX9d,bWdj2GDclj5ofokWjzoa5jAwMkxCykd6,52,94,58,198,32,4,23,2,411,58.714285714285715,7,0.0,14,58,176,32,80,4,22,23,2,280,131,0
794,9672,Bi4hHmeTLwTbUCScu9tC6ZZN7frLUhVP,A3fsA9Zfv1X2fVEQhTw51lKENdNrEqT3,115,58,45,118,30,15,26,0,292,41.714285714285715,6,0.0,4,45,117,30,54,15,1,26,0,196,96,0
795,9720,0dBn4alo7QBTd62VD5XO0yNMbQ5QN2OQ,bWdj2GDclj5ofokWjzoa5jAwMkxCykd6,10,32,12,0,5,0,5,0,54,7.714285714285714,4,0.0,0,12,0,5,32,0,0,5,0,17,37,1
796,9724,YwojqO58bCgaotjJoOTtpKH2oiEFOZyB,bWdj2GDclj5ofokWjzoa5jAwMkxCykd6,15,25,16,10,16,1,7,0,75,10.714285714285714,6,0.0,6,16,8,16,19,1,2,7,0,46,29,1
797,9746,ZPXEPNmHJO62FgTOVc5NtKcudTAnHNKW,SpATywNh6bZuzm8s1ceuBUnMUAeoAHHw,5,2,1,0,1,0,2,0,6,0.8571428571428571,2,0.0,0,1,0,1,2,0,0,2,0,2,4,1
798,9760,HNHEsc9fD0OwHisMoqyCkexAkrQ9Muqq,bWdj2GDclj5ofokWjzoa5jAwMkxCykd6,6,4,2,0,1,0,5,0,12,1.7142857142857142,1,0.0,0,2,0,1,4,0,0,5,0,3,9,0
799,9767,Bv9FSXvHlE6wLC4E4yrAKqe3BQhrrtfx,A3fsA9Zfv1X2fVEQhTw51lKENdNrEqT3,9,18,2,0,0,0,5,0,25,3.5714285714285716,3,0.0,0,2,0,0,18,0,0,5,0,2,23,1
800,9783,CZfXDHVnNPClikyXrFzPhkQoFiILzXmF,SpATywNh6bZuzm8s1ceuBUnMUAeoAHHw,33,78,4,47,1,0,11,0,141,20.142857142857142,7,0.0,19,4,39,1,59,0,8,11,0,63,78,0
801,9784,WnYAypmYi03odcBC7NgJFsh1FzqrpNw6,SpATywNh6bZuzm8s1ceuBUnMUAeoAHHw,24,30,17,12,9,1,7,0,76,10.857142857142858,6,0.0,3,17,9,9,27,1,3,7,0,38,38,0
802,9790,yUvG5Vqh097epwWCIkZetr2ZlwvQRcLL,SpATywNh6bZuzm8s1ceuBUnMUAeoAHHw,39,63,7,28,3,0,19,0,120,17.142857142857142,10,0.0,23,7,27,3,40,0,1,19,0,60,60,0
803,9793,B2ahwtOo16YsNrAQ9LRd2yjP18Ni9l2c,SpATywNh6bZuzm8s1ceuBUnMUAeoAHHw,27,119,18,17,10,0,25,0,189,27.0,14,0.0,5,18,15,10,114,0,2,25,0,48,141,0
804,9797,Dnyzk8ev480byt0tTEIN8mPtG79PwCH1,RXDvfPUBYFlVdlueBFbLW0mhhAyGEqpt,38,44,37,2,22,20,5,0,130,18.571428571428573,8,0.0,1,37,2,22,43,20,0,5,0,62,68,1
805,9812,fARr9B8lZ63xDV7GkxAczvRhzY3xBLi6,RXDvfPUBYFlVdlueBFbLW0mhhAyGEqpt,36,43,6,1,5,29,7,0,91,13.0,6,0.0,1,6,1,5,42,29,0,7,0,13,78,1
806,9823,hEw8FL1KT7bCC88Jn3Nko4dT9ob6cai1,A3fsA9Zfv1X2fVEQhTw51lKENdNrEqT3,10,9,1,0,1,0,1,0,12,1.7142857142857142,1,0.0,0,1,0,1,9,0,0,1,0,2,10,0
807,9839,bunHowa0BgtekXN64zdm8G1L1XdN8gBZ,bWdj2GDclj5ofokWjzoa5jAwMkxCykd6,7,7,1,4,1,0,6,0,19,2.7142857142857144,2,0.0,4,1,4,1,3,0,0,6,0,10,9,1
808,9852,1wIqcRX58Bpw6RXvGnbxsc6WbPwWGwXd,SpATywNh6bZuzm8s1ceuBUnMUAeoAHHw,16,44,7,17,0,3,14,0,85,12.142857142857142,6,0.0,15,7,16,0,29,3,1,14,0,38,47,0
809,9869,0RNr6P08D2zaPSoifoE3KvUeNCFcBSvA,SpATywNh6bZuzm8s1ceuBUnMUAeoAHHw,28,54,12,19,4,17,11,1,118,16.857142857142858,7,0.0,15,12,16,4,39,17,3,11,1,47,71,0
810,9873,u4s0SPiIkynucY7ReF58TL89R2q4zw1x,SpATywNh6bZuzm8s1ceuBUnMUAeoAHHw,16,46,26,6,12,0,8,0,98,14.0,7,0.0,2,26,6,12,44,0,0,8,0,46,52,1
811,9876,vn6QiPL2hNfbQVlbP4Lnj04J2ZQusfUk,A3fsA9Zfv1X2fVEQhTw51lKENdNrEqT3,7,10,7,0,0,0,4,0,21,3.0,2,0.0,1,7,0,0,9,0,0,4,0,8,13,1
812,9904,OfMabADNCpK7MfQ7IaqBsUw8RvPeHL0S,RXDvfPUBYFlVdlueBFbLW0mhhAyGEqpt,106,134,76,199,34,16,36,0,495,70.71428571428571,13,0.0,30,76,194,34,104,16,5,36,0,334,161,0
813,9923,CRrOxkmi8hXpA4NrCBnJ87Z2odaZzKo5,SpATywNh6bZuzm8s1ceuBUnMUAeoAHHw,31,49,22,37,11,19,16,2,156,22.285714285714285,3,0.0,23,22,33,11,26,19,4,16,2,89,67,1
814,9928,ylxIxsQV8oDzYk1f9bdd1UWiUi1ODLbL,SpATywNh6bZuzm8s1ceuBUnMUAeoAHHw,36,122,3,46,2,33,54,4,264,37.714285714285715,14,0.0,35,3,38,2,87,33,8,54,4,78,186,0
815,9929,oaL3pbpAfEH9L4o42G6X4xjme1kXt2tm,SpATywNh6bZuzm8s1ceuBUnMUAeoAHHw,42,84,47,31,28,0,15,0,205,29.285714285714285,11,0.0,12,47,29,28,72,0,2,15,0,116,89,0
816,9943,KXKbDyPytrUZAnNaQjyZgMFkA2w3Wpvj,SpATywNh6bZuzm8s1ceuBUnMUAeoAHHw,47,134,83,62,37,135,57,4,512,73.14285714285714,12,0.0,22,83,51,37,112,135,11,57,4,193,319,1
817,9946,Jd5OP6GIsguRdsq9k3eSYNENmzhPbdGe,G8EPVSXsOYB5YQWZGiz1aVq5Pgr2GrQu,113,161,78,176,53,6,22,0,496,70.85714285714286,9,0.0,63,78,116,53,98,6,60,22,0,310,186,0
818,9949,IUn6MADAjAYkGlJisA1WiDvCeNlJd5Xd,SpATywNh6bZuzm8s1ceuBUnMUAeoAHHw,54,83,46,27,25,17,27,0,225,32.142857142857146,9,0.0,11,46,24,25,72,17,3,27,0,106,119,0
819,9953,KeGByI8uvXcUVBvZaFAzVTfOuPfjSv5Y,SpATywNh6bZuzm8s1ceuBUnMUAeoAHHw,11,24,6,0,0,36,27,6,99,14.142857142857142,5,0.0,5,6,0,0,19,36,0,27,6,11,88,1
820,9963,YleydB3G0OM4jGw8hrXeA6aAbHfKvakN,SpATywNh6bZuzm8s1ceuBUnMUAeoAHHw,42,54,32,26,15,0,12,0,139,19.857142857142858,10,0.0,11,32,25,15,43,0,1,12,0,83,56,1
821,9970,Eok9XbYPb68kijAV2YozwwDkJT3HyKxy,RXDvfPUBYFlVdlueBFbLW0mhhAyGEqpt,6,4,3,0,1,0,1,0,9,1.2857142857142858,1,0.0,0,3,0,1,4,0,0,1,0,4,5,1
822,9976,lGkFqL5UAvY3j67ej7JQek066TD04jDH,bWdj2GDclj5ofokWjzoa5jAwMkxCykd6,1,0,0,0,0,0,1,0,1,0.14285714285714285,1,0.0,0,0,0,0,0,0,0,1,0,0,1,1
823,9988,GVRJN4wkoooaXJUVmwnX983A87KsrZPK,SpATywNh6bZuzm8s1ceuBUnMUAeoAHHw,32,49,28,25,10,195,16,1,324,46.285714285714285,11,0.0,10,28,23,10,39,195,2,16,1,71,253,0
824,10015,gFtSwrFBdsFWgLyqjSCzwaUhlQmEHgOq,SpATywNh6bZuzm8s1ceuBUnMUAeoAHHw,47,72,43,38,22,1,20,0,196,28.0,15,0.0,6,43,36,22,66,1,2,20,0,107,89,0
825,10016,5z0TnHJcRYhCDHjnNu4kmaWirO8lucwr,SpATywNh6bZuzm8s1ceuBUnMUAeoAHHw,21,155,8,9,5,3,18,0,198,28.285714285714285,8,0.0,27,8,8,5,128,3,1,18,0,48,150,1
826,10018,yzEVvmdwGMRoO2gS2DXIrqQbxP7DOJod,SpATywNh6bZuzm8s1ceuBUnMUAeoAHHw,7,3,2,0,2,0,2,0,9,1.2857142857142858,1,0.0,0,2,0,2,3,0,0,2,0,4,5,1
827,10024,FELnhQR0c7GZZX82ioYJEZsqujOrfyf7,bWdj2GDclj5ofokWjzoa5jAwMkxCykd6,10,8,5,0,2,10,10,0,35,5.0,3,0.0,0,5,0,2,8,10,0,10,0,7,28,1
828,10025,SozAkRr5kfRi3urQaoczmRXQoW70onBa,A3fsA9Zfv1X2fVEQhTw51lKENdNrEqT3,21,30,1,0,1,0,9,1,42,6.0,2,0.0,0,1,0,1,30,0,0,9,1,2,40,1
829,10035,FELnhQR0c7GZZX82ioYJEZsqujOrfyf7,A3fsA9Zfv1X2fVEQhTw51lKENdNrEqT3,10,6,3,0,1,25,15,1,51,7.285714285714286,5,0.0,0,3,0,1,6,25,0,15,1,4,47,1
830,10050,syrttArug8Mpzs9L0IHsvBtATawYF9J2,RXDvfPUBYFlVdlueBFbLW0mhhAyGEqpt,7,5,3,0,2,0,4,0,14,2.0,2,0.0,0,3,0,2,5,0,0,4,0,5,9,1
831,10059,UOOsauq1lFlLECbNF7MRjSfLxlpKxsoG,SpATywNh6bZuzm8s1ceuBUnMUAeoAHHw,33,31,18,27,10,2,27,2,117,16.714285714285715,9,0.0,9,18,26,10,22,2,1,27,2,63,54,0
832,10062,e0buQlxlHVWdQd03EOAehldJOI8AeFTm,SpATywNh6bZuzm8s1ceuBUnMUAeoAHHw,39,97,27,32,14,3,33,0,206,29.428571428571427,11,0.0,23,27,31,14,74,3,1,33,0,95,111,1
833,10077,Hm4CsH22c8YOwrQia0hrSt9jO8gMpoFd,SpATywNh6bZuzm8s1ceuBUnMUAeoAHHw,9,7,2,0,2,0,4,0,15,2.142857142857143,1,0.0,0,2,0,2,7,0,0,4,0,4,11,1
834,10101,30Velr3UVYghs85WZNOKXFcrgzOgBsfI,SpATywNh6bZuzm8s1ceuBUnMUAeoAHHw,31,29,16,26,8,77,17,0,173,24.714285714285715,7,0.0,6,16,25,8,23,77,1,17,0,55,118,0
835,10103,yS4oyG8z71VcMw1yy9w2LWRiDWgGhtKA,SpATywNh6bZuzm8s1ceuBUnMUAeoAHHw,16,31,16,18,7,1,7,0,80,11.428571428571429,4,0.0,5,16,15,7,26,1,3,7,0,43,37,0
836,10113,D1iAkJgGLDV90w339eOp4Bqd5z6wvBY6,G8EPVSXsOYB5YQWZGiz1aVq5Pgr2GrQu,26,25,13,41,7,0,6,1,93,13.285714285714286,1,0.0,8,13,34,7,17,0,7,6,1,62,31,1
837,10123,pAxOMca5gwJLembsUpWhZwow68Ox9dFB,SpATywNh6bZuzm8s1ceuBUnMUAeoAHHw,31,68,24,44,11,21,17,0,185,26.428571428571427,6,0.0,26,24,34,11,42,21,10,17,0,95,90,0
838,10132,ILMhPMpEir8VP8Uy0NQI7guQFniKAiGh,SpATywNh6bZuzm8s1ceuBUnMUAeoAHHw,48,96,24,19,12,6,30,2,189,27.0,13,0.0,22,24,19,12,74,6,0,30,2,77,112,0
839,10149,KG1VMsurgFKqkMv9nVqkO9ppjva59kYw,SpATywNh6bZuzm8s1ceuBUnMUAeoAHHw,11,35,17,0,5,4,14,1,76,10.857142857142858,4,0.0,5,17,0,5,30,4,0,14,1,27,49,0
840,10157,CUHsvexAAfaCEMKsM3644JTxXL5DgSss,SpATywNh6bZuzm8s1ceuBUnMUAeoAHHw,11,13,8,0,5,0,3,0,29,4.142857142857143,3,0.0,1,8,0,5,12,0,0,3,0,14,15,1
841,10173,ewZzdypyl0fDIzKshXnlZXjyO7oizoCq,SpATywNh6bZuzm8s1ceuBUnMUAeoAHHw,21,22,5,18,3,1,6,0,55,7.857142857142857,4,0.0,5,5,15,3,17,1,3,6,0,28,27,1
842,10183,rf43ZHojMqXQ775bmX3nnHgQ62d9XvGK,SpATywNh6bZuzm8s1ceuBUnMUAeoAHHw,53,85,42,38,17,3,16,0,201,28.714285714285715,12,0.0,14,42,34,17,71,3,4,16,0,107,94,1
843,10188,2rS9ufrltSIJVkQHjlKCjTvqcoR7anzz,A3fsA9Zfv1X2fVEQhTw51lKENdNrEqT3,49,87,17,68,4,0,23,0,199,28.428571428571427,9,0.0,7,17,56,4,80,0,12,23,0,84,115,1
844,10189,sY8CcZG79KJSl2UAc47IiYJD1k5ghqCN,SpATywNh6bZuzm8s1ceuBUnMUAeoAHHw,22,60,28,16,11,11,22,2,150,21.428571428571427,11,0.0,13,28,14,11,47,11,2,22,2,66,84,1
845,10197,tqvOTiQbipkIXQL7CIR5dckxV83rng9S,SpATywNh6bZuzm8s1ceuBUnMUAeoAHHw,44,88,46,41,25,36,34,1,271,38.714285714285715,13,0.0,20,46,38,25,68,36,3,34,1,129,142,0
846,10201,MB156dsmOWVhw7SmCPNYcmBUK9V54bIt,SpATywNh6bZuzm8s1ceuBUnMUAeoAHHw,27,110,9,15,7,10,35,4,190,27.142857142857142,8,0.0,12,9,15,7,98,10,0,35,4,43,147,1
847,10217,VWRhwnsbyy7kINpd5Pldlp01a86tVlAt,SpATywNh6bZuzm8s1ceuBUnMUAeoAHHw,44,190,73,39,28,9,43,6,388,55.42857142857143,9,0.0,56,73,31,28,134,9,8,43,6,188,200,0
848,10220,L4Uo99RvQ1cxFdSSaMag731dHicuHxV2,SpATywNh6bZuzm8s1ceuBUnMUAeoAHHw,45,96,4,85,0,11,38,7,241,34.42857142857143,12,0.0,21,4,66,0,75,11,19,38,7,91,150,0
849,10226,DHenWrxVzReZszxo1qw3Im0Zj99tiAII,bWdj2GDclj5ofokWjzoa5jAwMkxCykd6,17,31,19,0,14,22,22,5,113,16.142857142857142,6,0.0,2,19,0,14,29,22,0,22,5,35,78,1
850,10229,NF3XhJyO8NABn8EYOnk4mda6QMNEzq1R,SpATywNh6bZuzm8s1ceuBUnMUAeoAHHw,5,4,1,0,1,0,1,0,7,1.0,1,0.0,0,1,0,1,4,0,0,1,0,2,5,1
851,10239,tFhufiT6u4TsvucRy3FgIz40XsxZ2qh7,SpATywNh6bZuzm8s1ceuBUnMUAeoAHHw,7,4,3,0,3,0,4,0,14,2.0,1,0.0,0,3,0,3,4,0,0,4,0,6,8,1
852,10241,7kTdvih7UMOiFKC9aXRp88JppGP4qSKH,G8EPVSXsOYB5YQWZGiz1aVq5Pgr2GrQu,18,17,8,8,5,0,4,0,42,6.0,3,0.0,4,8,4,5,13,0,4,4,0,21,21,1
853,10243,YdCaKimqYb8kuFiHEtjPDsCbtIch1tfO,SpATywNh6bZuzm8s1ceuBUnMUAeoAHHw,27,55,22,38,3,6,14,7,145,20.714285714285715,8,0.0,22,22,30,3,33,6,8,14,7,77,68,0
854,10266,8Q42Hi4bJP7SqbH4XystURHk2B8tBI5i,G8EPVSXsOYB5YQWZGiz1aVq5Pgr2GrQu,102,66,43,237,30,0,11,0,387,55.285714285714285,9,0.0,3,43,201,30,63,0,36,11,0,277,110,0
855,10285,GIsRCDxWVYGm4So2chhYPzgj7oVxCsSB,SpATywNh6bZuzm8s1ceuBUnMUAeoAHHw,13,10,2,0,2,0,7,0,21,3.0,3,0.0,0,2,0,2,10,0,0,7,0,4,17,1
856,10321,njb10SfHXKB30cApzPJzWBcqA8VQx0HA,A3fsA9Zfv1X2fVEQhTw51lKENdNrEqT3,7,2,1,0,1,0,6,0,10,1.4285714285714286,2,0.0,0,1,0,1,2,0,0,6,0,2,8,1
857,10332,86utfBtmFqtE8TLsj2h1BusfBdMTH1O8,G8EPVSXsOYB5YQWZGiz1aVq5Pgr2GrQu,1,0,0,0,0,0,1,0,1,0.14285714285714285,1,0.0,0,0,0,0,0,0,0,1,0,0,1,1
858,10338,j2MboDReb1SoSFb2jmGT6OHiYADxn3PT,A3fsA9Zfv1X2fVEQhTw51lKENdNrEqT3,4,3,0,0,0,0,2,0,5,0.7142857142857143,1,0.0,0,0,0,0,3,0,0,2,0,0,5,1
859,10345,cRvonGDWMKfxHYP6TdkGqL61F16M4yAA,SpATywNh6bZuzm8s1ceuBUnMUAeoAHHw,25,50,13,23,9,7,10,1,113,16.142857142857142,5,0.0,16,13,18,9,34,7,5,10,1,56,57,1
860,10350,VPNixAQG356EF5jDEqbiZrQi2WBUwBq3,bWdj2GDclj5ofokWjzoa5jAwMkxCykd6,1,0,0,0,0,0,1,0,1,0.14285714285714285,1,0.0,0,0,0,0,0,0,0,1,0,0,1,1
861,10366,c4eku5xKmsJEaRwRx0NUj58EVKBhTUlh,bWdj2GDclj5ofokWjzoa5jAwMkxCykd6,1,0,0,0,0,0,1,0,1,0.14285714285714285,1,0.0,0,0,0,0,0,0,0,1,0,0,1,1
862,10385,4SjsVB9NX97jh5FCSnOdHgEUANJ1svZm,SpATywNh6bZuzm8s1ceuBUnMUAeoAHHw,40,40,26,21,15,0,19,2,123,17.571428571428573,5,0.0,8,26,19,15,32,0,2,19,2,68,55,0
863,10387,MicTROP14z0YujgzSBBjIifCsW8T6Yg4,RXDvfPUBYFlVdlueBFbLW0mhhAyGEqpt,6,0,0,0,0,1,6,1,8,1.1428571428571428,1,0.0,0,0,0,0,0,1,0,6,1,0,8,1
864,10394,EF3EfvSrA0c1KnpZ3bhY87a1rscondwY,SpATywNh6bZuzm8s1ceuBUnMUAeoAHHw,40,70,40,43,21,0,19,0,193,27.571428571428573,6,0.0,17,40,36,21,53,0,7,19,0,114,79,0
865,10399,D2M0lUAbb3NbvYyEfkDkoqJ8mQHTb4db,G8EPVSXsOYB5YQWZGiz1aVq5Pgr2GrQu,58,67,27,102,16,14,9,1,236,33.714285714285715,3,0.0,34,27,77,16,33,14,25,9,1,154,82,0
866,10402,CQOn4KWCA0duDCOSP1DQzvXZ3yAfq1zW,RXDvfPUBYFlVdlueBFbLW0mhhAyGEqpt,74,109,71,223,32,143,38,17,633,90.42857142857143,10,0.0,17,71,201,32,92,143,22,38,17,321,312,0
867,10420,Eu9HoDt3WhECHgcXaERosbI6lMj7Hipb,bWdj2GDclj5ofokWjzoa5jAwMkxCykd6,23,79,39,44,25,20,22,1,230,32.857142857142854,5,0.0,22,39,36,25,57,20,8,22,1,122,108,0
868,10437,N0P6Yrg1zRuUPyVufFpM0ZExnJnGTKKG,SpATywNh6bZuzm8s1ceuBUnMUAeoAHHw,31,42,7,45,3,1,16,1,115,16.428571428571427,6,0.0,10,7,37,3,32,1,8,16,1,57,58,0
869,10445,wXYPFlL861BbeAt6BcFbVApC7BUFADjk,A3fsA9Zfv1X2fVEQhTw51lKENdNrEqT3,22,58,5,32,3,0,8,0,106,15.142857142857142,5,0.0,3,5,25,3,55,0,7,8,0,36,70,1
870,10451,JLVzu9EMywyHTSJk37J5rGpw1UsulAZc,SpATywNh6bZuzm8s1ceuBUnMUAeoAHHw,15,68,24,0,10,1,22,3,128,18.285714285714285,2,0.0,10,24,0,10,58,1,0,22,3,44,84,1
871,10454,6tpE26inQQeNPyhZ0HoRMm7l4NlMiWJC,SpATywNh6bZuzm8s1ceuBUnMUAeoAHHw,21,46,3,37,1,13,33,5,138,19.714285714285715,6,0.0,16,3,34,1,30,13,3,33,5,54,84,0
872,10463,uhU9XFMHqXe19d0SBpTzsSNqTtdSMXBT,SpATywNh6bZuzm8s1ceuBUnMUAeoAHHw,24,54,27,16,8,33,20,1,159,22.714285714285715,6,0.0,21,27,15,8,33,33,1,20,1,71,88,1
873,10471,l7T8dOWG1cEtOxAxVcD5zNV6vn1g4oYM,G8EPVSXsOYB5YQWZGiz1aVq5Pgr2GrQu,27,54,4,66,2,7,23,0,156,22.285714285714285,13,0.0,14,4,59,2,40,7,7,23,0,79,77,1
874,10475,haRKCROopZUqu2HvR7rfja2IzweZ0l2Z,G8EPVSXsOYB5YQWZGiz1aVq5Pgr2GrQu,1,0,0,0,0,0,1,0,1,0.14285714285714285,1,0.0,0,0,0,0,0,0,0,1,0,0,1,1
875,10483,TroWrp5S8FhNJSgSuQ7Yk9WR8zsmBapA,SpATywNh6bZuzm8s1ceuBUnMUAeoAHHw,6,3,2,0,1,0,2,0,8,1.1428571428571428,1,0.0,0,2,0,1,3,0,0,2,0,3,5,1
876,10491,egnijdxL4Cz1CfzoCQSNIgWry6KIzA7P,SpATywNh6bZuzm8s1ceuBUnMUAeoAHHw,15,25,7,16,3,0,6,0,57,8.142857142857142,6,0.0,2,7,13,3,23,0,3,6,0,25,32,0
877,10505,L5cqiD5dkEVfnPDeQYK5cFR9ssDpnyPm,SpATywNh6bZuzm8s1ceuBUnMUAeoAHHw,2,0,0,0,0,0,2,0,2,0.2857142857142857,1,0.0,0,0,0,0,0,0,0,2,0,0,2,1
878,10507,rf43ZHojMqXQ775bmX3nnHgQ62d9XvGK,bWdj2GDclj5ofokWjzoa5jAwMkxCykd6,14,35,17,4,2,2,17,0,77,11.0,8,0.0,2,17,4,2,33,2,0,17,0,25,52,0
879,10519,lnzFfoDYtlWPJMTPbihufULiQk1Jv9SB,bWdj2GDclj5ofokWjzoa5jAwMkxCykd6,7,7,1,0,1,0,3,0,12,1.7142857142857142,1,0.0,0,1,0,1,7,0,0,3,0,2,10,1
880,10525,w8NGfLpAxSvlcPdxr1N6ClRtnCD7UkJu,A3fsA9Zfv1X2fVEQhTw51lKENdNrEqT3,78,21,5,257,2,4,26,2,317,45.285714285714285,7,0.0,3,5,225,2,18,4,32,26,2,235,82,0
881,10537,4zppanuK6US9rtvd04IL60AQkgDx5lm5,RXDvfPUBYFlVdlueBFbLW0mhhAyGEqpt,22,47,1,0,0,3,7,0,58,8.285714285714286,2,0.0,0,1,0,0,47,3,0,7,0,1,57,1
882,10538,xhM6sGbifURQLX65jKTsRiTJp9ePqM2R,RXDvfPUBYFlVdlueBFbLW0mhhAyGEqpt,1,0,0,0,0,0,1,0,1,0.14285714285714285,1,0.0,0,0,0,0,0,0,0,1,0,0,1,1
883,10560,m4jrmeR3FtkOUCbFelK4w5ennRkxlxWD,A3fsA9Zfv1X2fVEQhTw51lKENdNrEqT3,26,37,23,24,16,0,7,0,107,15.285714285714286,4,0.0,1,23,19,16,36,0,5,7,0,59,48,0
884,10563,IQCtPVNPylpjpNjZtQrr88vV5qPansN0,SpATywNh6bZuzm8s1ceuBUnMUAeoAHHw,55,55,37,27,19,3,7,0,148,21.142857142857142,4,0.0,7,37,25,19,48,3,2,7,0,88,60,0
885,10569,54BZa2PEVowNqI6EO6NzeCnkR49ry3oS,SpATywNh6bZuzm8s1ceuBUnMUAeoAHHw,35,76,1,45,1,37,23,1,184,26.285714285714285,11,0.0,11,1,34,1,65,37,11,23,1,47,137,0
886,10574,NFgPnsok64XIrx8pioLRAIHoliaoDIvn,SpATywNh6bZuzm8s1ceuBUnMUAeoAHHw,30,75,16,48,1,8,27,0,175,25.0,9,0.0,28,16,41,1,47,8,7,27,0,86,89,0
887,10579,QoRl6lUIBIR1pRLScf6eg36kOBc6a9q5,SpATywNh6bZuzm8s1ceuBUnMUAeoAHHw,2,0,0,0,0,0,7,0,7,1.0,2,0.0,0,0,0,0,0,0,0,7,0,0,7,1
888,10607,ySOA4rbQpe1GOPfJP5VkUnJIGjlF7GXO,SpATywNh6bZuzm8s1ceuBUnMUAeoAHHw,23,41,0,30,0,4,15,4,94,13.428571428571429,4,0.0,18,0,26,0,23,4,4,15,4,44,50,1
889,10612,BTSZE2PXdA7MkOyBKPCnqqHRa0lxJtHO,SpATywNh6bZuzm8s1ceuBUnMUAeoAHHw,40,116,4,63,3,4,21,0,211,30.142857142857142,13,0.0,31,4,53,3,85,4,10,21,0,91,120,0
890,10627,80aCDppJ7kPmOrquzLdsI5OBB47H5IdW,G8EPVSXsOYB5YQWZGiz1aVq5Pgr2GrQu,2,0,0,0,0,0,2,0,2,0.2857142857142857,1,0.0,0,0,0,0,0,0,0,2,0,0,2,1
891,10629,okYlHVritwXcHhkiNLd9pfhBZv2uubiO,SpATywNh6bZuzm8s1ceuBUnMUAeoAHHw,43,47,27,47,20,1,10,0,152,21.714285714285715,5,0.0,12,27,41,20,35,1,6,10,0,100,52,1
892,10641,Q5TmTVdy8nnH2vTL73s67ZseaCMO3k91,SpATywNh6bZuzm8s1ceuBUnMUAeoAHHw,28,21,16,24,9,0,16,0,86,12.285714285714286,7,0.0,4,16,23,9,17,0,1,16,0,52,34,0
893,10652,teqJGecOr4a6oVYU1O9bgvPkX5ZSKA8N,SpATywNh6bZuzm8s1ceuBUnMUAeoAHHw,41,61,18,27,10,0,10,0,126,18.0,8,0.0,8,18,23,10,53,0,4,10,0,59,67,0
894,10653,7xJbwgQFzeH69YJLbZncWAGT3dRrKubC,bWdj2GDclj5ofokWjzoa5jAwMkxCykd6,73,147,76,311,41,44,56,5,680,97.14285714285714,7,0.0,43,76,274,41,104,44,37,56,5,434,246,0
895,10659,DLCsXj6afYeXedkEor8cSwWpPMWMukEN,A3fsA9Zfv1X2fVEQhTw51lKENdNrEqT3,2,0,0,0,0,0,2,0,2,0.2857142857142857,1,0.0,0,0,0,0,0,0,0,2,0,0,2,1
896,10687,CXT3urKvwCIfBmuQmODRcZXAAAJs07Dk,RXDvfPUBYFlVdlueBFbLW0mhhAyGEqpt,1,0,0,0,0,0,1,0,1,0.14285714285714285,1,0.0,0,0,0,0,0,0,0,1,0,0,1,1
897,10705,CeupRRMHE9iQJGvyrBKaDsPPM9lhEl5t,SpATywNh6bZuzm8s1ceuBUnMUAeoAHHw,40,59,15,35,6,13,20,0,148,21.142857142857142,9,0.0,10,15,28,6,49,13,7,20,0,59,89,0
898,10721,trG5MFuNMIgyTGz1X8WvOUa7Zgqkp3Oe,SpATywNh6bZuzm8s1ceuBUnMUAeoAHHw,17,18,7,18,3,3,7,2,58,8.285714285714286,1,0.0,9,7,15,3,9,3,3,7,2,34,24,1
899,10738,uyomj5PLSD8MuBnIm3UXNOM2zJB1f3kv,bWdj2GDclj5ofokWjzoa5jAwMkxCykd6,21,61,12,52,6,23,16,0,170,24.285714285714285,4,0.0,17,12,43,6,44,23,9,16,0,78,92,1
900,10766,puC0Dx9PufKMVxVv15STTWR0hwd8EG3K,A3fsA9Zfv1X2fVEQhTw51lKENdNrEqT3,6,3,2,0,1,0,2,0,8,1.1428571428571428,1,0.0,0,2,0,1,3,0,0,2,0,3,5,1
901,10804,kGzsRVbG5WMbWj0lYrhayqrDZ1knQphM,SpATywNh6bZuzm8s1ceuBUnMUAeoAHHw,1,0,0,0,0,0,1,0,1,0.14285714285714285,1,0.0,0,0,0,0,0,0,0,1,0,0,1,1
902,10808,8dXlYKMlojZ10oWsfo0feSv9eUr2FQcM,G8EPVSXsOYB5YQWZGiz1aVq5Pgr2GrQu,33,66,38,0,30,0,19,1,154,22.0,7,0.0,12,38,0,30,54,0,0,19,1,80,74,1
903,10809,gzv7fk7jLAAb6tXwbmA5ceisqqnvcETz,SpATywNh6bZuzm8s1ceuBUnMUAeoAHHw,13,15,10,0,3,3,12,1,44,6.285714285714286,4,0.0,0,10,0,3,15,3,0,12,1,13,31,0
904,10819,v21GnAmoo56SIXGBSOh9jDiYo8T7Od29,SpATywNh6bZuzm8s1ceuBUnMUAeoAHHw,23,48,7,10,3,0,8,0,76,10.857142857142858,6,0.0,18,7,10,3,30,0,0,8,0,38,38,0
905,10822,xYLJB56SVkFUOdT5vN3Qq6OYNlnP0Fjc,RXDvfPUBYFlVdlueBFbLW0mhhAyGEqpt,34,106,45,26,22,8,33,7,247,35.285714285714285,8,0.0,0,45,22,22,106,8,4,33,7,89,158,0
906,10823,aGY42WVQQtCQKQRks3knIxGWrLxCy60h,G8EPVSXsOYB5YQWZGiz1aVq5Pgr2GrQu,10,4,0,0,0,7,9,1,21,3.0,2,0.0,0,0,0,0,4,7,0,9,1,0,21,1
907,10835,kGzsRVbG5WMbWj0lYrhayqrDZ1knQphM,bWdj2GDclj5ofokWjzoa5jAwMkxCykd6,1,0,0,0,0,0,1,0,1,0.14285714285714285,1,0.0,0,0,0,0,0,0,0,1,0,0,1,1
908,10853,2uZ2ZHQBnnVrb5vAtTu1AloVYtZL1MXg,G8EPVSXsOYB5YQWZGiz1aVq5Pgr2GrQu,206,631,187,392,66,44,114,15,1449,207.0,23,0.0,95,187,304,66,536,44,88,114,15,652,797,0
909,10869,fuprfcX49r5QcUYvMQnvvzEf76cx4sRp,bWdj2GDclj5ofokWjzoa5jAwMkxCykd6,9,12,1,6,1,1,6,4,31,4.428571428571429,2,0.0,5,1,5,1,7,1,1,6,4,12,19,1
910,10876,4vKI2gaXrHATS50fqVyDxXcmRy0MrgJS,A3fsA9Zfv1X2fVEQhTw51lKENdNrEqT3,34,62,42,2,29,8,21,3,167,23.857142857142858,5,0.0,12,42,2,29,50,8,0,21,3,85,82,1
911,10891,L5fA3BAe6FOUhd5mq4cXOYYHxtSuGgKM,SpATywNh6bZuzm8s1ceuBUnMUAeoAHHw,44,100,49,25,22,19,32,2,249,35.57142857142857,10,0.0,36,49,23,22,64,19,2,32,2,130,119,0
912,10917,Bf9it9d08iLIslwAMDaZjQzh1Kdl2qhf,SpATywNh6bZuzm8s1ceuBUnMUAeoAHHw,9,11,0,14,0,0,5,0,30,4.285714285714286,4,0.0,4,0,11,0,7,0,3,5,0,15,15,0
913,10922,Bf9it9d08iLIslwAMDaZjQzh1Kdl2qhf,A3fsA9Zfv1X2fVEQhTw51lKENdNrEqT3,8,10,0,0,0,0,6,0,16,2.2857142857142856,3,0.0,0,0,0,0,10,0,0,6,0,0,16,0
914,10952,nKH0niV76APk64AIPNglQ4nJBpaxE108,SpATywNh6bZuzm8s1ceuBUnMUAeoAHHw,19,40,2,19,1,12,15,1,90,12.857142857142858,2,0.0,9,2,16,1,31,12,3,15,1,28,62,0
915,10955,rieeUlMbLxJ13UbEQlJjvhM4prlyBS6B,SpATywNh6bZuzm8s1ceuBUnMUAeoAHHw,47,73,29,47,14,115,34,5,317,45.285714285714285,13,0.0,17,29,42,14,56,115,5,34,5,102,215,0
916,10990,xxd1UUpRh1yQGgGLMyjshPknKZCNEYlg,A3fsA9Zfv1X2fVEQhTw51lKENdNrEqT3,130,153,76,244,38,8,37,1,557,79.57142857142857,18,0.0,10,76,196,38,143,8,48,37,1,320,237,0
917,10998,h5xiKkT5i4jRXd69Uq7dCU9wazCqxrHf,bWdj2GDclj5ofokWjzoa5jAwMkxCykd6,2,0,0,0,0,0,2,0,2,0.2857142857142857,1,0.0,0,0,0,0,0,0,0,2,0,0,2,1
918,11001,4vKI2gaXrHATS50fqVyDxXcmRy0MrgJS,bWdj2GDclj5ofokWjzoa5jAwMkxCykd6,21,86,49,26,19,46,45,3,274,39.142857142857146,11,0.0,8,49,24,19,78,46,2,45,3,100,174,0
919,11008,nKH0niV76APk64AIPNglQ4nJBpaxE108,A3fsA9Zfv1X2fVEQhTw51lKENdNrEqT3,1,0,0,0,0,0,1,0,1,0.14285714285714285,1,0.0,0,0,0,0,0,0,0,1,0,0,1,1
920,11023,T1BAt2dEt9EzWcybuzXyLq6mHbiEQWZt,G8EPVSXsOYB5YQWZGiz1aVq5Pgr2GrQu,6,3,2,0,2,0,1,0,8,1.1428571428571428,1,0.0,0,2,0,2,3,0,0,1,0,4,4,1
921,11029,1PM9jc7cZ3C091LId9Ek5VaVwRreQ0TH,A3fsA9Zfv1X2fVEQhTw51lKENdNrEqT3,5,3,1,0,1,0,3,0,8,1.1428571428571428,2,0.0,0,1,0,1,3,0,0,3,0,2,6,1
922,11036,0kTYCEXFiuNuYfSpCOb8HIL3aF9nkrGc,SpATywNh6bZuzm8s1ceuBUnMUAeoAHHw,46,59,31,32,12,13,23,1,171,24.428571428571427,10,0.0,19,31,28,12,40,13,4,23,1,90,81,0
923,11052,T1BAt2dEt9EzWcybuzXyLq6mHbiEQWZt,SpATywNh6bZuzm8s1ceuBUnMUAeoAHHw,4,2,1,0,1,0,2,0,6,0.8571428571428571,1,0.0,0,1,0,1,2,0,0,2,0,2,4,1
924,11068,E6SywimuBT6ZGpGjcedDyV1LTcQRc9ds,A3fsA9Zfv1X2fVEQhTw51lKENdNrEqT3,47,31,24,90,15,24,21,2,207,29.571428571428573,4,0.0,2,24,75,15,29,24,15,21,2,116,91,1
925,11087,vrHzQ6JF32OpLCmbxoOSorIkJkRXwSrS,SpATywNh6bZuzm8s1ceuBUnMUAeoAHHw,5,7,2,0,1,0,3,0,13,1.8571428571428572,2,0.0,0,2,0,1,7,0,0,3,0,3,10,1
926,11092,WFURYJe5F7dgP6i0YwgNFeyKSFpNu7xS,A3fsA9Zfv1X2fVEQhTw51lKENdNrEqT3,27,24,15,0,12,0,5,0,56,8.0,3,0.0,0,15,0,12,24,0,0,5,0,27,29,1
927,11103,hGRsAtrDXcgCObVXPjFeCVGCoNSaOPeW,SpATywNh6bZuzm8s1ceuBUnMUAeoAHHw,6,5,3,0,1,0,3,0,12,1.7142857142857142,2,0.0,0,3,0,1,5,0,0,3,0,4,8,1
928,11104,hGRsAtrDXcgCObVXPjFeCVGCoNSaOPeW,G8EPVSXsOYB5YQWZGiz1aVq5Pgr2GrQu,5,4,2,0,1,0,2,0,9,1.2857142857142858,2,0.0,0,2,0,1,4,0,0,2,0,3,6,1
929,11113,tDwPtwMZBHQrqhm9RKWd7GW4j1pmFbeZ,A3fsA9Zfv1X2fVEQhTw51lKENdNrEqT3,2,0,0,0,0,0,6,0,6,0.8571428571428571,2,0.0,0,0,0,0,0,0,0,6,0,0,6,1
930,11136,iVrbldNmEASAlMSnUTWFx7qcEdScVNde,SpATywNh6bZuzm8s1ceuBUnMUAeoAHHw,15,33,20,0,13,0,8,0,74,10.571428571428571,5,0.0,0,20,0,13,33,0,0,8,0,33,41,1
931,11143,P9MGcZfmosEjD4PEwCVp6vB9MzPbeKLI,G8EPVSXsOYB5YQWZGiz1aVq5Pgr2GrQu,1,0,0,0,0,0,1,0,1,0.14285714285714285,1,0.0,0,0,0,0,0,0,0,1,0,0,1,1
932,11146,e2vebmlDc23PpKpfRYyd1By1iCXcv3UO,RXDvfPUBYFlVdlueBFbLW0mhhAyGEqpt,42,32,0,58,0,0,3,0,93,13.285714285714286,3,0.0,9,0,56,0,23,0,2,3,0,65,28,1
933,11163,arCKlRkqmCQRumxhAEQROrAdYVJBCNWo,SpATywNh6bZuzm8s1ceuBUnMUAeoAHHw,11,13,8,0,3,0,5,0,29,4.142857142857143,3,0.0,0,8,0,3,13,0,0,5,0,11,18,0
934,11165,xebgVIBazn8SEoqG6RUzBHRE4EbzaN4t,A3fsA9Zfv1X2fVEQhTw51lKENdNrEqT3,8,2,1,0,1,1,9,1,15,2.142857142857143,2,0.0,0,1,0,1,2,1,0,9,1,2,13,1
935,11179,gryVUwWLvrsNv4F8O3kiEBAQILnJg7OT,SpATywNh6bZuzm8s1ceuBUnMUAeoAHHw,23,45,0,27,0,38,27,4,141,20.142857142857142,8,0.0,18,0,26,0,27,38,1,27,4,44,97,0
936,11198,HbdIEiZ1jslj2pBp8czn7lhBbxLYjtpj,SpATywNh6bZuzm8s1ceuBUnMUAeoAHHw,7,19,9,0,3,0,5,0,36,5.142857142857143,5,0.0,2,9,0,3,17,0,0,5,0,14,22,1
937,11225,Vmvdv9k8S1ONPkUHSdXPEenyx7UNVISW,SpATywNh6bZuzm8s1ceuBUnMUAeoAHHw,35,75,1,46,0,34,19,5,180,25.714285714285715,4,0.0,33,1,41,0,42,34,5,19,5,75,105,1
938,11290,JZZnn79hJZh6uernNE50Bi5HDewJf78E,RXDvfPUBYFlVdlueBFbLW0mhhAyGEqpt,15,14,5,0,2,8,3,0,32,4.571428571428571,1,0.0,0,5,0,2,14,8,0,3,0,7,25,1
939,11303,gnjZOoI8BeitDTrO8bhWhoFLWjid4LeA,bWdj2GDclj5ofokWjzoa5jAwMkxCykd6,7,9,4,0,0,0,5,0,18,2.5714285714285716,1,0.0,2,4,0,0,7,0,0,5,0,6,12,1
940,11306,5ZQSBzYZG0AalCCLt1PNSHaXvEDYOMak,SpATywNh6bZuzm8s1ceuBUnMUAeoAHHw,1,0,0,0,0,0,2,0,2,0.2857142857142857,1,0.0,0,0,0,0,0,0,0,2,0,0,2,1
941,11314,o7HGnjuXHyEfteJtxVQ5dpBJz7Yzz0T1,SpATywNh6bZuzm8s1ceuBUnMUAeoAHHw,7,3,0,0,0,2,4,0,9,1.2857142857142858,1,0.0,0,0,0,0,3,2,0,4,0,0,9,1
942,11326,IFQQStJmvfA3NyTN88jNEn631VKsGQET,SpATywNh6bZuzm8s1ceuBUnMUAeoAHHw,7,2,1,0,1,1,4,0,9,1.2857142857142858,1,0.0,0,1,0,1,2,1,0,4,0,2,7,1
943,11331,eqaDSMjkkLr4V8zwKAYzNF193Wm3l9Pg,A3fsA9Zfv1X2fVEQhTw51lKENdNrEqT3,1,0,0,0,0,0,1,0,1,0.14285714285714285,1,0.0,0,0,0,0,0,0,0,1,0,0,1,1
944,11344,SHXTFVyrdbzmF1pJEIvr2zpR8jK358bb,SpATywNh6bZuzm8s1ceuBUnMUAeoAHHw,22,46,3,28,1,25,9,1,113,16.142857142857142,5,0.0,11,3,24,1,35,25,4,9,1,39,74,1
945,11355,Z5t6AGEyADeSVHWZTgBW4lR5XMnM5VWU,SpATywNh6bZuzm8s1ceuBUnMUAeoAHHw,41,61,23,29,16,0,8,0,137,19.571428571428573,5,0.0,21,23,26,16,40,0,3,8,0,86,51,0
946,11356,KXkOWXgIJuvmtvaUVHrKWAaqrFaY5cx8,SpATywNh6bZuzm8s1ceuBUnMUAeoAHHw,11,18,0,22,0,3,7,3,53,7.571428571428571,3,0.0,13,0,18,0,5,3,4,7,3,31,22,1
947,11357,WJKEaeH3ob9wscd3i5dXEY7kRPHMEwVj,bWdj2GDclj5ofokWjzoa5jAwMkxCykd6,5,3,1,0,1,0,2,0,7,1.0,2,0.0,0,1,0,1,3,0,0,2,0,2,5,1
948,11362,13fzVwLJSsgGzTLwjEHCuvf0Ks8dgxYZ,SpATywNh6bZuzm8s1ceuBUnMUAeoAHHw,28,49,13,24,5,12,42,7,152,21.714285714285715,8,0.0,12,13,20,5,37,12,4,42,7,50,102,1
949,11389,PqLnOjm8gCkS4EhgcnGtGCfdwzyBuNjz,A3fsA9Zfv1X2fVEQhTw51lKENdNrEqT3,10,3,2,0,2,0,8,2,17,2.4285714285714284,1,0.0,0,2,0,2,3,0,0,8,2,4,13,1
950,11403,HYCkyEJhW9QtzilmanJKsxRLSBi9UGoV,A3fsA9Zfv1X2fVEQhTw51lKENdNrEqT3,1,0,0,0,0,0,1,0,1,0.14285714285714285,1,0.0,0,0,0,0,0,0,0,1,0,0,1,1
951,11410,YEYkPWHcftKd8bKe1Q9b21lzhv1SChRM,SpATywNh6bZuzm8s1ceuBUnMUAeoAHHw,38,41,24,21,11,6,18,2,123,17.571428571428573,6,0.0,7,24,21,11,34,6,0,18,2,63,60,1
952,11414,HYCkyEJhW9QtzilmanJKsxRLSBi9UGoV,bWdj2GDclj5ofokWjzoa5jAwMkxCykd6,2,0,0,0,0,0,2,0,2,0.2857142857142857,1,0.0,0,0,0,0,0,0,0,2,0,0,2,1
953,11425,82UlWF6Fm1gkNum7nNbVw0yOV1BUdNoS,bWdj2GDclj5ofokWjzoa5jAwMkxCykd6,28,38,23,46,5,49,21,1,183,26.142857142857142,10,0.0,2,23,39,5,36,49,7,21,1,69,114,0
954,11428,82UlWF6Fm1gkNum7nNbVw0yOV1BUdNoS,A3fsA9Zfv1X2fVEQhTw51lKENdNrEqT3,106,123,85,134,45,69,48,6,510,72.85714285714286,18,0.0,11,85,103,45,112,69,31,48,6,244,266,0
955,11463,uFcd6yCTniScAvbMiWJYRQ8Du52ubELm,RXDvfPUBYFlVdlueBFbLW0mhhAyGEqpt,31,45,8,18,5,6,9,0,91,13.0,7,0.0,0,8,17,5,45,6,1,9,0,30,61,0
956,11475,UJiJ4PvH4qodyDnURbFXyi5LWwaSKUwb,RXDvfPUBYFlVdlueBFbLW0mhhAyGEqpt,111,149,82,260,39,100,77,6,713,101.85714285714286,17,0.0,29,82,244,39,120,100,16,77,6,394,319,0
957,11478,RGf4k3THi4AV4qsAjc1UEOWiIeDYcchf,A3fsA9Zfv1X2fVEQhTw51lKENdNrEqT3,82,127,71,172,27,28,32,0,457,65.28571428571429,17,0.0,13,71,142,27,114,28,30,32,0,253,204,0
958,11492,zKdMAgWBKjA8jF1t74QW0q0ZxGMcvW9t,RXDvfPUBYFlVdlueBFbLW0mhhAyGEqpt,42,25,15,56,11,2,9,0,118,16.857142857142858,2,0.0,6,15,55,11,19,2,1,9,0,87,31,1
959,11509,sQVxVjeT9NfPAT9IdDUsY0RSB3XrvO2y,SpATywNh6bZuzm8s1ceuBUnMUAeoAHHw,25,66,32,45,0,29,24,1,197,28.142857142857142,6,0.0,25,32,36,0,41,29,9,24,1,93,104,0
960,11515,iIwpETh60BkJfJQJqvWucH2tzh64j0U3,SpATywNh6bZuzm8s1ceuBUnMUAeoAHHw,50,105,46,38,16,4,31,3,243,34.714285714285715,11,0.0,18,46,35,16,87,4,3,31,3,115,128,0
961,11522,MOJ1BiwMK7lBUiFS9DTwwPvbUWIkdFFP,A3fsA9Zfv1X2fVEQhTw51lKENdNrEqT3,35,87,52,22,29,0,20,0,210,30.0,19,0.0,2,52,21,29,85,0,1,20,0,104,106,1
962,11547,NKnL5oTIIxOmPf0Ep5iKaKIecNheR2t7,SpATywNh6bZuzm8s1ceuBUnMUAeoAHHw,40,85,49,26,24,0,14,0,198,28.285714285714285,6,0.0,22,49,23,24,63,0,3,14,0,118,80,0
963,11555,7OkCZWJW1Ow4wpTBUq53amL13pV2vy2v,G8EPVSXsOYB5YQWZGiz1aVq5Pgr2GrQu,32,96,28,48,20,13,42,0,247,35.285714285714285,11,0.0,8,28,40,20,88,13,8,42,0,96,151,0
964,11618,FftGEmgyFF5pWtfM0EZJwp0rzcGMH1JL,SpATywNh6bZuzm8s1ceuBUnMUAeoAHHw,35,79,47,28,20,4,47,10,235,33.57142857142857,7,0.0,11,47,25,20,68,4,3,47,10,103,132,1
965,11636,Y3uwxWCm13Ol5xozrT2GPjOPhBlC2kOq,RXDvfPUBYFlVdlueBFbLW0mhhAyGEqpt,54,67,4,158,0,0,5,0,234,33.42857142857143,6,0.0,11,4,146,0,56,0,12,5,0,161,73,1
966,11646,MR4k3wv95Ttq1fQaT9W4WgxrPezl0N4j,G8EPVSXsOYB5YQWZGiz1aVq5Pgr2GrQu,11,15,5,16,2,0,3,0,41,5.857142857142857,1,0.0,2,5,12,2,13,0,4,3,0,21,20,1
967,11647,KAHcIFqF1cp4MJN69oD7XlQBuGCiexCt,bWdj2GDclj5ofokWjzoa5jAwMkxCykd6,2,0,0,0,0,0,2,0,2,0.2857142857142857,1,0.0,0,0,0,0,0,0,0,2,0,0,2,1
968,11677,FduexGuoL0tC7LqIuSFtIm03lXvHHbSw,SpATywNh6bZuzm8s1ceuBUnMUAeoAHHw,11,44,2,0,1,4,36,4,91,13.0,6,0.0,0,2,0,1,44,4,0,36,4,3,88,1
969,11690,37daqGAbA6x2VvXkiqdWX1nBv2Tqqgte,G8EPVSXsOYB5YQWZGiz1aVq5Pgr2GrQu,133,458,235,290,79,82,93,3,1240,177.14285714285714,17,0.0,51,235,241,79,407,82,49,93,3,606,634,0
970,11741,n3cFXGx3rjoPJPOmeF5tlnmkFmFFJI7p,A3fsA9Zfv1X2fVEQhTw51lKENdNrEqT3,50,49,28,72,10,24,32,2,217,31.0,8,0.0,4,28,54,10,45,24,18,32,2,96,121,1
971,11758,7UZLQknm2A0Xcs9lZDmhCq5ocQIOEmmj,SpATywNh6bZuzm8s1ceuBUnMUAeoAHHw,26,25,11,16,6,0,11,1,70,10.0,2,0.0,10,11,14,6,15,0,2,11,1,41,29,1
972,11811,YRnTGuoAQA7UM3uV59YNXUYN4n1CR9jv,SpATywNh6bZuzm8s1ceuBUnMUAeoAHHw,41,36,21,21,12,1,10,0,101,14.428571428571429,8,0.0,9,21,19,12,27,1,2,10,0,61,40,0
973,11827,McYATdhZDDMDpni6a4GbjI06ustMpvdV,G8EPVSXsOYB5YQWZGiz1aVq5Pgr2GrQu,7,3,2,0,2,4,3,0,14,2.0,2,0.0,0,2,0,2,3,4,0,3,0,4,10,1
974,11836,zm7kTPWc2Ij7nyP9Co8cVtDEuAGTQRmn,A3fsA9Zfv1X2fVEQhTw51lKENdNrEqT3,5,3,1,0,1,0,2,0,7,1.0,1,0.0,0,1,0,1,3,0,0,2,0,2,5,1
975,11839,McYATdhZDDMDpni6a4GbjI06ustMpvdV,A3fsA9Zfv1X2fVEQhTw51lKENdNrEqT3,10,8,6,0,5,6,2,0,27,3.857142857142857,2,0.0,0,6,0,5,8,6,0,2,0,11,16,1
976,11841,4GMbKnTV7f2uA3paM09GNAdyVnypDTbs,A3fsA9Zfv1X2fVEQhTw51lKENdNrEqT3,84,50,7,160,4,0,20,0,241,34.42857142857143,9,0.0,7,7,153,4,43,0,7,20,0,171,70,0
977,11842,MFEX8ieEZqjvGSzLHf4hJjdY1BCifo1Q,G8EPVSXsOYB5YQWZGiz1aVq5Pgr2GrQu,9,5,2,4,2,0,3,0,16,2.2857142857142856,1,0.0,1,2,3,2,4,0,1,3,0,8,8,1
978,11862,n42jeLyeDpoJPwT1pkhXRyhzHjUnC2KC,SpATywNh6bZuzm8s1ceuBUnMUAeoAHHw,26,51,16,12,4,2,21,5,111,15.857142857142858,8,0.0,12,16,9,4,39,2,3,21,5,41,70,1
979,11867,2axjl9Byq908rUlMrYGzo2sfhA3p18fU,SpATywNh6bZuzm8s1ceuBUnMUAeoAHHw,11,6,4,1,3,0,2,0,16,2.2857142857142856,1,0.0,1,4,1,3,5,0,0,2,0,9,7,1
980,11892,QkpDyGn4qqqwpxvXRrFsAsKSrEtfkQJQ,SpATywNh6bZuzm8s1ceuBUnMUAeoAHHw,29,32,18,24,8,4,7,0,93,13.285714285714286,5,0.0,8,18,23,8,24,4,1,7,0,57,36,0
981,11895,Er0phLmicWoU9yr3sUBC2BCne0YIK1vQ,A3fsA9Zfv1X2fVEQhTw51lKENdNrEqT3,71,59,41,34,33,0,27,0,194,27.714285714285715,8,0.0,0,41,29,33,59,0,5,27,0,103,91,1
982,11896,UzuB1gScsXJ6b46FForXq5x2wnZw4QoH,SpATywNh6bZuzm8s1ceuBUnMUAeoAHHw,31,61,30,26,17,6,21,2,163,23.285714285714285,4,0.0,14,30,24,17,47,6,2,21,2,85,78,0
983,11900,8xT75XL9dKm7CwLmOxtys3bmWBh3OJmY,RXDvfPUBYFlVdlueBFbLW0mhhAyGEqpt,119,179,53,248,17,16,18,1,532,76.0,8,0.0,48,53,236,17,131,16,12,18,1,354,178,0
984,11914,5YO2NGkR6BZ1s4HfeOrLezgFkpBKmNPV,SpATywNh6bZuzm8s1ceuBUnMUAeoAHHw,30,32,25,13,13,0,9,0,92,13.142857142857142,4,0.0,1,25,11,13,31,0,2,9,0,50,42,0
985,11917,uuxrUSHn3GpYFneZnY8GpLgr5XiyDABs,A3fsA9Zfv1X2fVEQhTw51lKENdNrEqT3,19,22,18,0,12,0,9,1,62,8.857142857142858,2,0.0,0,18,0,12,22,0,0,9,1,30,32,0
986,11920,uarVJhEs6XLW7Dw1D7iBgEK6zPe65WwX,A3fsA9Zfv1X2fVEQhTw51lKENdNrEqT3,15,16,13,0,2,0,6,0,37,5.285714285714286,3,0.0,1,13,0,2,15,0,0,6,0,16,21,1
987,11921,JERgMmFADxaPxEUdcYHhaMN4ZwNAyErv,A3fsA9Zfv1X2fVEQhTw51lKENdNrEqT3,101,66,36,248,20,24,24,1,419,59.857142857142854,6,0.0,7,36,210,20,59,24,38,24,1,273,146,0
988,11922,gKme5KJOgqJrjNwDUsRPKwK3QFyN7vPD,RXDvfPUBYFlVdlueBFbLW0mhhAyGEqpt,110,166,96,243,44,6,29,1,585,83.57142857142857,15,0.0,39,96,233,44,127,6,10,29,1,412,173,0
989,11951,Nsiwn7635mGlMs5nxmspwUbmVQaPZWQ6,G8EPVSXsOYB5YQWZGiz1aVq5Pgr2GrQu,21,18,10,26,7,1,11,1,74,10.571428571428571,3,0.0,2,10,21,7,16,1,5,11,1,40,34,1
990,11956,oyFfPK6y9oPPwQR5mbsXW98FJaEnU88b,bWdj2GDclj5ofokWjzoa5jAwMkxCykd6,4,2,1,0,1,0,2,0,6,0.8571428571428571,1,0.0,0,1,0,1,2,0,0,2,0,2,4,1
991,11977,JtbtRyqX4dZ0edFKFJwGNY9JG3aidrlj,SpATywNh6bZuzm8s1ceuBUnMUAeoAHHw,36,54,28,26,18,4,30,1,161,23.0,7,0.0,16,28,20,18,38,4,6,30,1,82,79,0
992,11983,058hmyJK1lejTwX8sX29U5yFETfrvQ95,G8EPVSXsOYB5YQWZGiz1aVq5Pgr2GrQu,1,0,0,0,0,0,1,0,1,0.14285714285714285,1,0.0,0,0,0,0,0,0,0,1,0,0,1,1
993,11986,058hmyJK1lejTwX8sX29U5yFETfrvQ95,A3fsA9Zfv1X2fVEQhTw51lKENdNrEqT3,1,0,0,0,0,0,1,0,1,0.14285714285714285,1,0.0,0,0,0,0,0,0,0,1,0,0,1,1
994,12007,Uwggq8NcihxhBLnReA5tboVbRLkIS371,SpATywNh6bZuzm8s1ceuBUnMUAeoAHHw,1,0,0,0,0,0,1,0,1,0.14285714285714285,1,0.0,0,0,0,0,0,0,0,1,0,0,1,1
995,12011,q36eiA77bwwsXGg05ifhgnTFDpR9Ar4V,bWdj2GDclj5ofokWjzoa5jAwMkxCykd6,81,139,70,312,24,50,27,2,624,89.14285714285714,14,0.0,37,70,280,24,102,50,32,27,2,411,213,0
996,12020,LHFojLmJ5Ll3LGp6GnqLClTkRFP5a32j,bWdj2GDclj5ofokWjzoa5jAwMkxCykd6,1,0,0,0,0,0,1,0,1,0.14285714285714285,1,0.0,0,0,0,0,0,0,0,1,0,0,1,1
997,12030,gSxiLtAU3HWIGwL9IJcAr6lB3iS2AC6Z,A3fsA9Zfv1X2fVEQhTw51lKENdNrEqT3,2,0,0,0,0,0,2,0,2,0.2857142857142857,1,0.0,0,0,0,0,0,0,0,2,0,0,2,1
998,12053,7m381KBoEq7nybFxitllQlgHOa7YYR1i,SpATywNh6bZuzm8s1ceuBUnMUAeoAHHw,40,140,28,43,11,7,23,0,252,36.0,14,0.0,12,28,39,11,128,7,4,23,0,90,162,0
999,12090,M7Vbw5q1oL32IfEMSI9AM5uHCUMDFHmm,A3fsA9Zfv1X2fVEQhTw51lKENdNrEqT3,19,17,11,2,5,1,17,3,56,8.0,2,0.0,0,11,2,5,17,1,0,17,3,18,38,1
1000,12099,tCXa4pMsMXRuliZWNM9so3Odte6UmpYj,bWdj2GDclj5ofokWjzoa5jAwMkxCykd6,1,0,0,0,0,0,1,0,1,0.14285714285714285,1,0.0,0,0,0,0,0,0,0,1,0,0,1,1
1001,12113,l6nLhBWETqCazxhjGSPbpZQRNqpsMPRD,bWdj2GDclj5ofokWjzoa5jAwMkxCykd6,2,0,0,0,0,0,4,0,4,0.5714285714285714,1,0.0,0,0,0,0,0,0,0,4,0,0,4,1
1002,12141,4n0eavxCNp4F6LlqtEg5gsmyBVEbRBeE,G8EPVSXsOYB5YQWZGiz1aVq5Pgr2GrQu,71,152,59,114,47,0,15,0,387,55.285714285714285,7,0.0,77,59,83,47,75,0,31,15,0,266,121,1
1003,12147,VJw4zFdkpwcu4sXr2e3LyD2CU2ajLhIu,SpATywNh6bZuzm8s1ceuBUnMUAeoAHHw,37,57,28,20,11,22,23,0,161,23.0,5,0.0,9,28,18,11,48,22,2,23,0,66,95,0
1004,12178,V2ut0n3Er1p82GdKRcLWOrmZXj3No2ts,bWdj2GDclj5ofokWjzoa5jAwMkxCykd6,1,0,0,0,0,0,1,0,1,0.14285714285714285,1,0.0,0,0,0,0,0,0,0,1,0,0,1,1
1005,12203,TSpDTvH7tx13LMObu1OWRVwKh8isSitO,SpATywNh6bZuzm8s1ceuBUnMUAeoAHHw,15,21,6,3,4,0,8,1,43,6.142857142857143,2,0.0,4,6,3,4,17,0,0,8,1,17,26,1
1006,12208,dOjwcbpJoBEbemc7xmUKlO5o5THYYuWb,RXDvfPUBYFlVdlueBFbLW0mhhAyGEqpt,98,98,33,123,19,25,22,2,322,46.0,6,0.0,30,33,121,19,68,25,2,22,2,203,119,0
1007,12223,ysTOTg8n91NBng8BrzlEom4lR6CnDwPC,SpATywNh6bZuzm8s1ceuBUnMUAeoAHHw,26,57,22,17,7,12,29,10,154,22.0,4,0.0,13,22,16,7,44,12,1,29,10,58,96,1
1008,12241,YqzonIu9nUz3X2nkdJiReRrylaOckiCC,SpATywNh6bZuzm8s1ceuBUnMUAeoAHHw,21,31,2,24,1,4,14,1,77,11.0,2,0.0,17,2,21,1,14,4,3,14,1,41,36,0
1009,12246,I0uHaMvDeJM1w1AenEVj8xWzg3OizAzv,G8EPVSXsOYB5YQWZGiz1aVq5Pgr2GrQu,35,45,1,60,0,2,19,2,129,18.428571428571427,3,0.0,10,1,48,0,35,2,12,19,2,59,70,1
1010,12253,Kxifrwa9ntGWJyRtJS6owg0ZQfSyRPcW,A3fsA9Zfv1X2fVEQhTw51lKENdNrEqT3,4,2,0,0,0,0,4,0,6,0.8571428571428571,2,0.0,0,0,0,0,2,0,0,4,0,0,6,0
1011,12262,GAfZCFoItZF6u2g6TmFIAYqk177Q5kZH,SpATywNh6bZuzm8s1ceuBUnMUAeoAHHw,30,25,13,25,7,1,8,0,79,11.285714285714286,1,0.0,8,13,21,7,17,1,4,8,0,49,30,1
1012,12287,zZK4lWrYYn5bTLcjHRRO0XA8xNwpu7OT,RXDvfPUBYFlVdlueBFbLW0mhhAyGEqpt,74,53,26,135,21,1,19,7,262,37.42857142857143,6,0.0,20,26,126,21,33,1,9,19,7,193,69,0
1013,12293,UxPdjVFzcqqJoB99RNTW4pwswAcQ32eZ,RXDvfPUBYFlVdlueBFbLW0mhhAyGEqpt,47,33,30,0,26,0,40,0,129,18.428571428571427,7,0.0,2,30,0,26,31,0,0,40,0,58,71,0
1014,12302,OeLBIzS0gNQ56euxy5b66gAZMzQCGE7n,A3fsA9Zfv1X2fVEQhTw51lKENdNrEqT3,71,31,21,140,14,2,30,2,240,34.285714285714285,3,0.0,2,21,116,14,29,2,24,30,2,153,87,1
1015,12316,8SG0IoRU1kfooCNm4CWXEAnDe54VjVcy,A3fsA9Zfv1X2fVEQhTw51lKENdNrEqT3,22,16,11,0,8,2,10,2,49,7.0,2,0.0,2,11,0,8,14,2,0,10,2,21,28,1
1016,12330,9iGaqBGS5kkoXjLd87hUL2eIJMVUVKfU,A3fsA9Zfv1X2fVEQhTw51lKENdNrEqT3,73,74,36,266,4,0,26,1,407,58.142857142857146,6,0.0,11,36,228,4,63,0,38,26,1,279,128,0
1017,12350,7m381KBoEq7nybFxitllQlgHOa7YYR1i,G8EPVSXsOYB5YQWZGiz1aVq5Pgr2GrQu,102,206,57,206,31,18,23,0,541,77.28571428571429,10,0.0,6,57,191,31,200,18,15,23,0,285,256,1
1018,12356,GW78UVODV1oPxxynjXG1U7em3gdA8wQF,SpATywNh6bZuzm8s1ceuBUnMUAeoAHHw,26,30,16,8,9,1,9,1,74,10.571428571428571,4,0.0,0,16,8,9,30,1,0,9,1,33,41,0
1019,12358,nlf7AlI08jbhXKXagULClsgDoakDOx2G,SpATywNh6bZuzm8s1ceuBUnMUAeoAHHw,12,8,6,0,5,2,6,1,28,4.0,1,0.0,0,6,0,5,8,2,0,6,1,11,17,1
1020,12363,5wKAjfQ5T37M2WWxYAwMeUeLhDScm1Z0,bWdj2GDclj5ofokWjzoa5jAwMkxCykd6,4,2,0,0,0,56,27,0,85,12.142857142857142,7,0.0,0,0,0,0,2,56,0,27,0,0,85,0
1021,12372,Dx1ZzKpwFtwNhE9gdaLaohssqGyqrqjD,A3fsA9Zfv1X2fVEQhTw51lKENdNrEqT3,45,42,23,60,10,17,11,0,163,23.285714285714285,3,0.0,6,23,50,10,36,17,10,11,0,89,74,1
1022,12374,dkmoSmrpP5gK9Xi6ySwrroCNfUlumbtO,G8EPVSXsOYB5YQWZGiz1aVq5Pgr2GrQu,12,7,0,10,0,0,2,0,19,2.7142857142857144,1,0.0,0,0,8,0,7,0,2,2,0,8,11,1
1023,12381,zZsHSLX7Hk1sqhZYCfBgGlYJnqetGIKf,SpATywNh6bZuzm8s1ceuBUnMUAeoAHHw,9,12,2,0,0,4,7,1,26,3.7142857142857144,3,0.0,0,2,0,0,12,4,0,7,1,2,24,1
1024,12383,7OkCZWJW1Ow4wpTBUq53amL13pV2vy2v,SpATywNh6bZuzm8s1ceuBUnMUAeoAHHw,32,85,15,34,12,106,46,8,306,43.714285714285715,8,0.0,30,15,29,12,55,106,5,46,8,86,220,0
1025,12394,HXDAyPRsApqduwAe8pSs8BlStcKWeCOs,bWdj2GDclj5ofokWjzoa5jAwMkxCykd6,5,6,3,0,1,0,3,0,13,1.8571428571428572,2,0.0,0,3,0,1,6,0,0,3,0,4,9,1
1026,12410,wXFfHtwd9smrvhh9NQW7SmEEo1001LDW,A3fsA9Zfv1X2fVEQhTw51lKENdNrEqT3,27,42,26,10,9,10,33,4,134,19.142857142857142,8,0.0,2,26,8,9,40,10,2,33,4,45,89,1
1027,12412,s24Qk0ZpAXR97ldBDtgP8DE6rT8or69U,SpATywNh6bZuzm8s1ceuBUnMUAeoAHHw,27,73,6,64,0,0,14,0,157,22.428571428571427,11,0.0,17,6,58,0,56,0,6,14,0,81,76,0
1028,12442,HbmZzALzRW0CJmaD07o1oMpvJwGgfjK4,SpATywNh6bZuzm8s1ceuBUnMUAeoAHHw,8,12,2,0,2,2,4,1,23,3.2857142857142856,3,0.0,1,2,0,2,11,2,0,4,1,5,18,1
1029,12445,CqxK3XGagGgLgWXJIkp8qfeo0SWv94XW,RXDvfPUBYFlVdlueBFbLW0mhhAyGEqpt,83,198,119,115,34,131,52,25,674,96.28571428571429,16,0.0,45,119,98,34,153,131,17,52,25,296,378,0
1030,12464,NSrMJ69WS92LaJ6a09xOpViELCrjji8S,SpATywNh6bZuzm8s1ceuBUnMUAeoAHHw,33,66,13,36,3,56,26,0,200,28.571428571428573,14,0.0,9,13,31,3,57,56,5,26,0,56,144,0
1031,12480,q54oCvxsY1LE19jtoD23qGpHSrkdhUlF,A3fsA9Zfv1X2fVEQhTw51lKENdNrEqT3,36,26,1,66,1,1,16,0,111,15.857142857142858,2,0.0,2,1,62,1,24,1,4,16,0,66,45,1
1032,12482,35upFtDrqCqWhj8RVNLHqe6Xg75dIX7z,G8EPVSXsOYB5YQWZGiz1aVq5Pgr2GrQu,4,3,1,2,0,0,2,0,8,1.1428571428571428,2,0.0,1,1,2,0,2,0,0,2,0,4,4,1
1033,12515,UKrQdzHwNJRJK7ZoTzKsoWlrkEbsQk7X,RXDvfPUBYFlVdlueBFbLW0mhhAyGEqpt,1,0,0,0,0,0,1,0,1,0.14285714285714285,1,0.0,0,0,0,0,0,0,0,1,0,0,1,1
1034,12522,MRCD9XxqQVpIexf9EdSwdaoHW691k7OH,SpATywNh6bZuzm8s1ceuBUnMUAeoAHHw,21,33,17,16,0,0,5,0,71,10.142857142857142,2,0.0,9,17,14,0,24,0,2,5,0,40,31,1
1035,12569,4Z7n4wdauhlOTY95FN6j39vUUWT0ZgYl,SpATywNh6bZuzm8s1ceuBUnMUAeoAHHw,24,75,35,24,14,0,17,0,165,23.571428571428573,10,0.0,16,35,18,14,59,0,6,17,0,83,82,1
1036,12580,kB76SiSV4uYN77hHUOgf3IbLpFWkgJbj,SpATywNh6bZuzm8s1ceuBUnMUAeoAHHw,54,71,39,50,22,1,25,2,210,30.0,9,0.0,8,39,43,22,63,1,7,25,2,112,98,0
1037,12583,JRuzCriX6hvuTQ943ttXKlmrFVyfxMHr,SpATywNh6bZuzm8s1ceuBUnMUAeoAHHw,43,65,33,39,12,2,10,1,162,23.142857142857142,7,0.0,16,33,32,12,49,2,7,10,1,93,69,0
1038,12586,jfC6fPTH59GZUrxarremx8AmMC8XNgfG,SpATywNh6bZuzm8s1ceuBUnMUAeoAHHw,26,36,22,13,9,2,3,0,85,12.142857142857142,4,0.0,7,22,13,9,29,2,0,3,0,51,34,1
1039,12588,XQTN1LOe7iul8RvZ4acTOpEntRORT1SG,SpATywNh6bZuzm8s1ceuBUnMUAeoAHHw,6,6,0,0,0,0,4,0,10,1.4285714285714286,3,0.0,2,0,0,0,4,0,0,4,0,2,8,1
1040,12597,R8tAdEYq32rVkLXscE5SipLgbsEEPIk8,bWdj2GDclj5ofokWjzoa5jAwMkxCykd6,1,0,0,0,0,0,2,0,2,0.2857142857142857,1,0.0,0,0,0,0,0,0,0,2,0,0,2,1
1041,12600,NO22WSq5lVGwq6WPEcqalEaMjYIZxX3u,bWdj2GDclj5ofokWjzoa5jAwMkxCykd6,10,27,0,9,1,0,10,0,47,6.714285714285714,3,0.0,13,0,8,1,14,0,1,10,0,22,25,1
1042,12616,gLKRPeA7yYfxDrcYMLyblT6wVEjgwKPH,SpATywNh6bZuzm8s1ceuBUnMUAeoAHHw,48,115,34,32,19,5,22,1,228,32.57142857142857,10,0.0,33,34,27,19,82,5,5,22,1,113,115,0
1043,12620,LxV8BE7SALs1WsK81jAFnmtwnc7yS8ck,G8EPVSXsOYB5YQWZGiz1aVq5Pgr2GrQu,14,29,17,2,7,0,8,0,63,9.0,4,0.0,5,17,2,7,24,0,0,8,0,31,32,1
1044,12626,NSkQyRZ5kDInEI8yx5AGmbuyJ28eG48A,SpATywNh6bZuzm8s1ceuBUnMUAeoAHHw,31,38,21,24,10,5,10,0,108,15.428571428571429,3,0.0,5,21,19,10,33,5,5,10,0,55,53,0
1045,12633,8DlfU1bgriTJuUO8vI8x268Lnn7yRdfp,A3fsA9Zfv1X2fVEQhTw51lKENdNrEqT3,5,2,1,0,1,4,6,0,14,2.0,2,0.0,0,1,0,1,2,4,0,6,0,2,12,1
1046,12649,TexDHGk8F5I6X0NlqVQwzJ9MMWpLdMbB,SpATywNh6bZuzm8s1ceuBUnMUAeoAHHw,46,59,30,51,14,6,13,1,174,24.857142857142858,9,0.0,16,30,40,14,43,6,11,13,1,100,74,0
1047,12667,h1g6Jk0YES6cZKnPtmszwjPCneFTGd3j,bWdj2GDclj5ofokWjzoa5jAwMkxCykd6,13,14,9,0,6,18,15,2,64,9.142857142857142,3,0.0,0,9,0,6,14,18,0,15,2,15,49,1
1048,12682,I19aG6zmdTntoy0T8VxEogbN4WVEZZNa,SpATywNh6bZuzm8s1ceuBUnMUAeoAHHw,22,37,3,28,0,0,6,0,74,10.571428571428571,3,0.0,14,3,26,0,23,0,2,6,0,43,31,1
1049,12689,1Ld3jQU8M0eiaLBshs8gjcgQEfdlgHyZ,RXDvfPUBYFlVdlueBFbLW0mhhAyGEqpt,30,21,15,0,12,0,4,0,52,7.428571428571429,3,0.0,2,15,0,12,19,0,0,4,0,29,23,1
1050,12707,Hr9mm3bIoeLv4wyDeAcwJNdd3K6mgRy4,SpATywNh6bZuzm8s1ceuBUnMUAeoAHHw,60,65,38,57,18,3,12,0,193,27.571428571428573,5,0.0,16,38,53,18,49,3,4,12,0,125,68,0
1051,12711,rDEv38jBkahw1DC082iTP7UbA4sE1KaP,SpATywNh6bZuzm8s1ceuBUnMUAeoAHHw,13,9,1,17,1,0,3,0,31,4.428571428571429,1,0.0,2,1,15,1,7,0,2,3,0,19,12,0
1052,12726,bQve3ajdEL4IqADUWqNBP99IoqvejzJV,A3fsA9Zfv1X2fVEQhTw51lKENdNrEqT3,6,3,0,0,0,4,8,1,16,2.2857142857142856,2,0.0,0,0,0,0,3,4,0,8,1,0,16,1
1053,12735,KBt3gvTJLTIjt4EkmG3y3LICooEML1xW,G8EPVSXsOYB5YQWZGiz1aVq5Pgr2GrQu,32,43,25,26,14,0,18,2,128,18.285714285714285,5,0.0,11,25,19,14,32,0,7,18,2,69,59,1
1054,12742,arTGhRrKZksM4iY72XDJ8i8oBmMABS0m,SpATywNh6bZuzm8s1ceuBUnMUAeoAHHw,44,110,12,12,2,78,33,1,248,35.42857142857143,15,0.0,22,12,12,2,88,78,0,33,1,48,200,0
1055,12745,rRt0QHymEdl6Kph5VPgdVUvepB7ZBNXt,SpATywNh6bZuzm8s1ceuBUnMUAeoAHHw,54,154,44,49,19,2,24,0,292,41.714285714285715,9,0.0,29,44,44,19,125,2,5,24,0,136,156,0
1056,12750,i67qzouvUD7nINgK6d1xrH4pvufZqbFd,SpATywNh6bZuzm8s1ceuBUnMUAeoAHHw,41,68,1,55,0,10,15,0,149,21.285714285714285,9,0.0,16,1,47,0,52,10,8,15,0,64,85,0
1057,12753,79Po0Awyh8Z7ruF9y6agajWClv9uUoPL,SpATywNh6bZuzm8s1ceuBUnMUAeoAHHw,29,93,2,15,3,6,19,1,139,19.857142857142858,7,0.0,8,2,15,3,85,6,0,19,1,28,111,1
1058,12761,rtYqtRTnqUXb6diSp0MKjdA0eLt2BJ3X,SpATywNh6bZuzm8s1ceuBUnMUAeoAHHw,48,57,33,32,15,28,16,0,181,25.857142857142858,6,0.0,13,33,29,15,44,28,3,16,0,90,91,0
1059,12768,ghgdA2SJuIXQM23Hgf4BrlUd29ois5mW,SpATywNh6bZuzm8s1ceuBUnMUAeoAHHw,14,19,1,12,1,6,5,0,44,6.285714285714286,2,0.0,6,1,11,1,13,6,1,5,0,19,25,1
1060,12784,rZSLmwiYX8trzeLsBLeg8r0IN1GBbqOC,bWdj2GDclj5ofokWjzoa5jAwMkxCykd6,1,0,0,0,0,0,1,0,1,0.14285714285714285,1,0.0,0,0,0,0,0,0,0,1,0,0,1,1
1061,12796,P5jfghvfecmYY6IMTqwwXqe4o108QRc4,SpATywNh6bZuzm8s1ceuBUnMUAeoAHHw,18,11,9,0,8,0,4,0,32,4.571428571428571,3,0.0,0,9,0,8,11,0,0,4,0,17,15,1
1062,12805,P0uW8e7uWJsgVO5MWg1krlEvXljM181Y,G8EPVSXsOYB5YQWZGiz1aVq5Pgr2GrQu,1,0,0,0,0,0,4,0,4,0.5714285714285714,3,0.0,0,0,0,0,0,0,0,4,0,0,4,1
1063,12808,idxWUfEs3kYL0r7IC35umYY3ZJQ22Zab,SpATywNh6bZuzm8s1ceuBUnMUAeoAHHw,6,9,4,0,2,0,3,0,18,2.5714285714285716,2,0.0,0,4,0,2,9,0,0,3,0,6,12,1
1064,12813,L3khlyhxkzKPVeEgnV2Dt5jl6Pe5Thm4,RXDvfPUBYFlVdlueBFbLW0mhhAyGEqpt,23,39,22,25,12,1,9,0,108,15.428571428571429,5,0.0,14,22,22,12,25,1,3,9,0,70,38,1
1065,12834,ZYxocA1Ix9ILa1C9VKK1bM1W4sEOXUVw,SpATywNh6bZuzm8s1ceuBUnMUAeoAHHw,19,29,0,29,0,0,8,0,66,9.428571428571429,4,0.0,12,0,28,0,17,0,1,8,0,40,26,0
1066,12845,syrttArug8Mpzs9L0IHsvBtATawYF9J2,SpATywNh6bZuzm8s1ceuBUnMUAeoAHHw,8,8,5,0,2,0,4,0,19,2.7142857142857144,4,0.0,0,5,0,2,8,0,0,4,0,7,12,1
1067,12853,55dttExESw0iXI74tkLBOaeITFkRCx90,A3fsA9Zfv1X2fVEQhTw51lKENdNrEqT3,42,39,21,58,8,2,15,1,144,20.571428571428573,3,0.0,1,21,48,8,38,2,10,15,1,78,66,1
1068,12854,cVHCYdG6eoXKQe55dLZbvLgwBGbWam7p,A3fsA9Zfv1X2fVEQhTw51lKENdNrEqT3,11,11,2,0,1,0,6,0,20,2.857142857142857,3,0.0,0,2,0,1,11,0,0,6,0,3,17,1
1069,12856,0wSRq6mRtt7ajwm8CWZxYMig1mbMrg7d,bWdj2GDclj5ofokWjzoa5jAwMkxCykd6,1,0,0,0,0,0,1,0,1,0.14285714285714285,1,0.0,0,0,0,0,0,0,0,1,0,0,1,1
1070,12883,KKz5C2CIERGp4d0g7P8ZO1hnR4NT39t2,SpATywNh6bZuzm8s1ceuBUnMUAeoAHHw,46,46,28,29,17,10,11,3,144,20.571428571428573,4,0.0,11,28,24,17,35,10,5,11,3,80,64,0
1071,12888,lMy0A59BRo4770ALzvOjsBS5HJkCRV78,A3fsA9Zfv1X2fVEQhTw51lKENdNrEqT3,43,66,11,50,3,27,48,2,207,29.571428571428573,9,0.0,4,11,48,3,62,27,2,48,2,66,141,1
1072,12892,P0uW8e7uWJsgVO5MWg1krlEvXljM181Y,bWdj2GDclj5ofokWjzoa5jAwMkxCykd6,11,13,4,8,2,0,11,0,38,5.428571428571429,4,0.0,1,4,7,2,12,0,1,11,0,14,24,1
1073,12948,f7pgA2Hp0s8DkqzKuvE0Kw8QRuoBh3Zv,A3fsA9Zfv1X2fVEQhTw51lKENdNrEqT3,60,27,14,143,1,17,11,0,213,30.428571428571427,5,0.0,4,14,126,1,23,17,17,11,0,145,68,0
1074,12956,lEIFkqeT396JMSPUyiaHNMN8g7bQ1x9p,SpATywNh6bZuzm8s1ceuBUnMUAeoAHHw,45,99,43,27,27,5,32,1,234,33.42857142857143,10,0.0,50,43,25,27,49,5,2,32,1,145,89,0
1075,12976,KpbHdGVlZIWVraCiFee7Cav2rNnqqrsJ,SpATywNh6bZuzm8s1ceuBUnMUAeoAHHw,42,52,31,25,21,7,10,0,146,20.857142857142858,4,0.0,6,31,25,21,46,7,0,10,0,83,63,1
1076,12993,8r4M2l7ATXMXEQUCAknekZVeyUGIpRyK,SpATywNh6bZuzm8s1ceuBUnMUAeoAHHw,20,94,8,15,5,2,48,0,172,24.571428571428573,12,0.0,8,8,12,5,86,2,3,48,0,33,139,1
1077,13011,3Eee8QbVtHhcwedqstQME1x67jOdVLkK,SpATywNh6bZuzm8s1ceuBUnMUAeoAHHw,5,3,0,0,0,1,4,3,11,1.5714285714285714,1,0.0,0,0,0,0,3,1,0,4,3,0,11,1
1078,13023,MAktGJIumyskhJp25e79u9tVhauVJ2c6,SpATywNh6bZuzm8s1ceuBUnMUAeoAHHw,41,55,18,48,11,57,32,1,222,31.714285714285715,7,0.0,12,18,41,11,43,57,7,32,1,82,140,0
1079,13088,AbunVo6pGQTlDxnSJmOS7flQ0Vb2S3xP,bWdj2GDclj5ofokWjzoa5jAwMkxCykd6,13,13,5,18,3,6,12,1,58,8.285714285714286,2,0.0,4,5,18,3,9,6,0,12,1,30,28,1
1080,13109,YW2vWUP3xrebFWQq20TaENvqpb9ZdJV6,SpATywNh6bZuzm8s1ceuBUnMUAeoAHHw,28,27,13,26,7,5,17,1,96,13.714285714285714,4,0.0,4,13,22,7,23,5,4,17,1,46,50,0
1081,13129,AbunVo6pGQTlDxnSJmOS7flQ0Vb2S3xP,A3fsA9Zfv1X2fVEQhTw51lKENdNrEqT3,1,0,0,0,0,0,3,0,3,0.42857142857142855,2,0.0,0,0,0,0,0,0,0,3,0,0,3,1
1082,13135,nF3fyodzvP9Kt8uvHxBDafFDSHuZ38jd,SpATywNh6bZuzm8s1ceuBUnMUAeoAHHw,38,111,16,38,13,50,28,4,260,37.142857142857146,9,0.0,8,16,31,13,103,50,7,28,4,68,192,1
1083,13143,igeK6rUQT7Ehyj7yY5oAEj8DvOITiuBO,SpATywNh6bZuzm8s1ceuBUnMUAeoAHHw,31,91,34,35,11,5,25,0,201,28.714285714285715,12,0.0,18,34,30,11,73,5,5,25,0,93,108,0
1084,13147,p9Pgf9XUtcr2kL39MqLlMakadbFqlUtX,RXDvfPUBYFlVdlueBFbLW0mhhAyGEqpt,19,57,37,22,17,9,17,2,161,23.0,6,0.0,7,37,17,17,50,9,5,17,2,78,83,1
1085,13159,gMZKWOenFyVb6m3mcpDQmzDRcu1zvYbF,G8EPVSXsOYB5YQWZGiz1aVq5Pgr2GrQu,12,21,8,50,5,0,9,0,93,13.285714285714286,3,0.0,6,8,47,5,15,0,3,9,0,66,27,1
1086,13179,pOKZyBql9SdI7DoREUHq99ghEycAS0cI,bWdj2GDclj5ofokWjzoa5jAwMkxCykd6,6,6,0,0,1,0,2,0,9,1.2857142857142858,2,0.0,0,0,0,1,6,0,0,2,0,1,8,1
1087,13187,i67qzouvUD7nINgK6d1xrH4pvufZqbFd,bWdj2GDclj5ofokWjzoa5jAwMkxCykd6,3,2,0,0,0,0,3,0,5,0.7142857142857143,1,0.0,0,0,0,0,2,0,0,3,0,0,5,1
1088,13206,GSkYUOcl4XzYMWSWhE6gXRGQ9kqPeXsi,RXDvfPUBYFlVdlueBFbLW0mhhAyGEqpt,50,35,20,84,11,0,7,0,157,22.428571428571427,5,0.0,8,20,82,11,27,0,2,7,0,121,36,1
1089,13207,PMDa1SUjeddLyhfDscbnAxL67GyZb6sD,SpATywNh6bZuzm8s1ceuBUnMUAeoAHHw,28,101,50,24,1,13,31,0,220,31.428571428571427,11,0.0,6,50,24,1,95,13,0,31,0,81,139,0
1090,13212,pR0rEzd43YPn1ujQN1oHxqL0z3U4G8ju,SpATywNh6bZuzm8s1ceuBUnMUAeoAHHw,7,6,1,0,1,0,3,0,11,1.5714285714285714,2,0.0,2,1,0,1,4,0,0,3,0,4,7,1
1091,13214,XFmrH2WQYMYLXRE1Jm7VValFt236PUJr,SpATywNh6bZuzm8s1ceuBUnMUAeoAHHw,22,24,1,24,1,0,3,0,53,7.571428571428571,2,0.0,8,1,20,1,16,0,4,3,0,30,23,1
1092,13227,0wJhtCWK60WPCeRF62m8T80DtNpWhRrg,RXDvfPUBYFlVdlueBFbLW0mhhAyGEqpt,85,120,55,194,28,12,13,0,422,60.285714285714285,9,0.0,21,55,181,28,99,12,13,13,0,285,137,0
1093,13233,UM3F51S6vWhAORUn5XfgddMSa2NpuDR3,bWdj2GDclj5ofokWjzoa5jAwMkxCykd6,5,4,1,0,1,0,3,0,9,1.2857142857142858,2,0.0,0,1,0,1,4,0,0,3,0,2,7,1
1094,13240,m52orXncJIuZMWO7LnwS1hFqDU5X5m24,SpATywNh6bZuzm8s1ceuBUnMUAeoAHHw,44,57,21,59,16,38,34,2,227,32.42857142857143,9,0.0,18,21,50,16,39,38,9,34,2,105,122,0
1095,13259,KovPBJesZmgqVCWR3DXdtvcd4XyHL9BT,SpATywNh6bZuzm8s1ceuBUnMUAeoAHHw,27,48,4,35,3,36,27,7,160,22.857142857142858,6,0.0,13,4,29,3,35,36,6,27,7,49,111,0
1096,13263,CZ6gFOo6OnSPq5AGDZTDmf17XM8Rum8M,SpATywNh6bZuzm8s1ceuBUnMUAeoAHHw,10,8,0,11,0,0,3,0,22,3.142857142857143,1,0.0,3,0,10,0,5,0,1,3,0,13,9,1
1097,13273,bKbwS8bsj3eNxoCQcsrg5SKpHAoJ8uGu,A3fsA9Zfv1X2fVEQhTw51lKENdNrEqT3,49,44,2,148,0,8,12,0,214,30.571428571428573,6,0.0,11,2,120,0,33,8,28,12,0,133,81,1
1098,13290,bDOMCQV7nFdKo0pDqOPr3ECLpgkdBCSt,A3fsA9Zfv1X2fVEQhTw51lKENdNrEqT3,34,67,4,38,2,1,10,0,122,17.428571428571427,3,0.0,2,4,35,2,65,1,3,10,0,43,79,1
1099,13316,7P8eMWaZZgnw2duzHVId8BVYAnTZapE1,SpATywNh6bZuzm8s1ceuBUnMUAeoAHHw,8,4,2,0,2,0,8,0,16,2.2857142857142856,1,0.0,0,2,0,2,4,0,0,8,0,4,12,1
1100,13319,sqZsZQq9LcjzbfCPmehLyMMrK3ClcYAT,SpATywNh6bZuzm8s1ceuBUnMUAeoAHHw,3,2,0,0,0,0,1,0,3,0.42857142857142855,1,0.0,0,0,0,0,2,0,0,1,0,0,3,1
1101,13338,UidTeyEs50r1zTQVJtstLvLcMUKrNN3b,SpATywNh6bZuzm8s1ceuBUnMUAeoAHHw,25,62,3,12,1,2,21,1,102,14.571428571428571,10,0.0,11,3,12,1,51,2,0,21,1,27,75,0
1102,13358,Aw7PeIkLW9CDHbPpPSjrFUdtBaUuHUXm,bWdj2GDclj5ofokWjzoa5jAwMkxCykd6,66,111,45,179,17,95,107,5,559,79.85714285714286,17,0.0,42,45,155,17,69,95,24,107,5,259,300,0
1103,13379,TGngiWN6RHpSD048KJCksxngjFh0emXm,A3fsA9Zfv1X2fVEQhTw51lKENdNrEqT3,7,6,1,0,1,0,3,0,11,1.5714285714285714,1,0.0,0,1,0,1,6,0,0,3,0,2,9,1
1104,13386,5KSMnQXKnbRqNWod4v539vcEvMedku3c,bWdj2GDclj5ofokWjzoa5jAwMkxCykd6,2,0,0,0,0,0,2,0,2,0.2857142857142857,1,0.0,0,0,0,0,0,0,0,2,0,0,2,1
1105,13398,bqWpav7ocOhCfb3xc4QgAvBDK5g8BmiZ,SpATywNh6bZuzm8s1ceuBUnMUAeoAHHw,18,46,25,12,4,55,20,1,163,23.285714285714285,8,0.0,10,25,9,4,36,55,3,20,1,48,115,0
1106,13402,mGb99e4ZiyyEapZp3B98Pssar5eWGHEz,G8EPVSXsOYB5YQWZGiz1aVq5Pgr2GrQu,24,29,3,48,3,0,6,0,89,12.714285714285714,4,0.0,4,3,40,3,25,0,8,6,0,50,39,1
1107,13424,PfZH4Yubwsve9DvShzAvHjayDN16nhpN,G8EPVSXsOYB5YQWZGiz1aVq5Pgr2GrQu,1,0,0,0,0,0,1,0,1,0.14285714285714285,1,0.0,0,0,0,0,0,0,0,1,0,0,1,1
1108,13430,j0gxXks7DZitzyeEGG2agLKFp30HqXVu,bWdj2GDclj5ofokWjzoa5jAwMkxCykd6,27,122,47,0,6,16,27,2,220,31.428571428571427,8,0.0,26,47,0,6,96,16,0,27,2,79,141,0
1109,13460,mG2HKIW4KvK5MNtCekVvEvxXHT51PCPq,A3fsA9Zfv1X2fVEQhTw51lKENdNrEqT3,1,0,0,0,0,0,1,0,1,0.14285714285714285,1,0.0,0,0,0,0,0,0,0,1,0,0,1,1
1110,13469,OLmaTq1VRWq8uhF6WwamKt59rXmIqMgh,SpATywNh6bZuzm8s1ceuBUnMUAeoAHHw,11,17,9,0,5,4,12,0,47,6.714285714285714,4,0.0,0,9,0,5,17,4,0,12,0,14,33,1
1111,13477,9pzI899XVNJmMa8xv35JoCa2P4C0Faa4,bWdj2GDclj5ofokWjzoa5jAwMkxCykd6,14,31,3,0,2,39,13,1,89,12.714285714285714,2,0.0,0,3,0,2,31,39,0,13,1,5,84,1
1112,13479,sfuANiSFq72qS7aoKnyvPaRtXw7bLFiY,SpATywNh6bZuzm8s1ceuBUnMUAeoAHHw,17,27,12,10,5,0,7,0,61,8.714285714285714,6,0.0,4,12,10,5,23,0,0,7,0,31,30,1
1113,13490,RtDHl5nE4LpZJE4fPWaXYE5l5ziJJw3q,SpATywNh6bZuzm8s1ceuBUnMUAeoAHHw,6,7,3,0,3,0,1,0,14,2.0,1,0.0,0,3,0,3,7,0,0,1,0,6,8,1
1114,13491,KKBYOCb35hszQy5vSfsxbAFYFgilEECF,SpATywNh6bZuzm8s1ceuBUnMUAeoAHHw,27,23,16,18,9,0,19,0,85,12.142857142857142,8,0.0,6,16,18,9,17,0,0,19,0,49,36,1
1115,13518,OcFLLEI56U80V98vNeJ7LrlE5FWxkkpp,SpATywNh6bZuzm8s1ceuBUnMUAeoAHHw,60,91,44,54,23,73,34,6,325,46.42857142857143,9,0.0,23,44,50,23,68,73,4,34,6,140,185,0
1116,13525,J1f9rNzR7t1WQhWY7vU0QrkaWuS9xCeR,bWdj2GDclj5ofokWjzoa5jAwMkxCykd6,23,17,10,48,8,27,31,1,142,20.285714285714285,4,0.0,5,10,44,8,12,27,4,31,1,67,75,1
1117,13530,7dPYuxC1NExRQjXFHnhWbTviIyBFUDmL,SpATywNh6bZuzm8s1ceuBUnMUAeoAHHw,5,20,14,0,1,0,2,0,37,5.285714285714286,15,0.0,0,14,0,1,20,0,0,2,0,15,22,1
1118,13537,LDoffeIzXBaEA3EoYd9Gp4Kl36LUuUJD,SpATywNh6bZuzm8s1ceuBUnMUAeoAHHw,10,12,6,0,1,17,10,4,50,7.142857142857143,3,0.0,0,6,0,1,12,17,0,10,4,7,43,1
1119,13552,IGnubmoC2Z3kyMhnm5cfb5h7HnKkMEVq,G8EPVSXsOYB5YQWZGiz1aVq5Pgr2GrQu,6,6,2,0,1,3,7,0,19,2.7142857142857144,2,0.0,0,2,0,1,6,3,0,7,0,3,16,1
1120,13578,7XgWWxsOrwxcFjioh5NncRGrx77dSS5r,SpATywNh6bZuzm8s1ceuBUnMUAeoAHHw,28,75,6,21,7,1,18,0,128,18.285714285714285,10,0.0,9,6,19,7,66,1,2,18,0,41,87,0
1121,13583,UmlMF2TsgsipXk92JRV0A7TQAmCZuKWV,SpATywNh6bZuzm8s1ceuBUnMUAeoAHHw,6,4,1,0,0,0,2,0,7,1.0,1,0.0,0,1,0,0,4,0,0,2,0,1,6,1
1122,13587,zFEKyzORyNtVsN87mi1ReZjFEUKvm21T,SpATywNh6bZuzm8s1ceuBUnMUAeoAHHw,25,32,19,12,9,9,6,2,89,12.714285714285714,3,0.0,3,19,10,9,29,9,2,6,2,41,48,1
1123,13594,sZYvW7O1yC1PAj5iYABgZ056jCM2PsNq,SpATywNh6bZuzm8s1ceuBUnMUAeoAHHw,13,37,20,4,6,0,11,0,78,11.142857142857142,6,0.0,9,20,4,6,28,0,0,11,0,39,39,0
1124,13605,g2crr0D1YRZspeg3aG0QVrkBBPBltTjz,SpATywNh6bZuzm8s1ceuBUnMUAeoAHHw,23,32,7,31,1,5,4,0,80,11.428571428571429,7,0.0,11,7,27,1,21,5,4,4,0,46,34,0
1125,13610,r10mjNLAOjkXo9ipKqWrD4Hts48L6lcD,G8EPVSXsOYB5YQWZGiz1aVq5Pgr2GrQu,57,34,25,134,20,0,4,0,217,31.0,4,0.0,0,25,113,20,34,0,21,4,0,158,59,0
1126,13672,kP6GmMO1OBG46GzGpGgNEkhdNz0eN2Yt,SpATywNh6bZuzm8s1ceuBUnMUAeoAHHw,1,0,0,0,0,0,1,0,1,0.14285714285714285,1,0.0,0,0,0,0,0,0,0,1,0,0,1,1
1127,13684,XkKS323fFxBVezQ5JyIgzxHDxEKEwwEf,A3fsA9Zfv1X2fVEQhTw51lKENdNrEqT3,92,33,20,152,7,3,7,0,222,31.714285714285715,3,0.0,7,20,152,7,26,3,0,7,0,186,36,0
1128,13696,r0yAsNzYkqEPYi6zNhQfzuueDjmcyFRr,bWdj2GDclj5ofokWjzoa5jAwMkxCykd6,2,0,0,0,0,0,3,0,3,0.42857142857142855,1,0.0,0,0,0,0,0,0,0,3,0,0,3,1
1129,13703,FaZLW3HiYLflnTCxi4BN21oHHvNYhtue,SpATywNh6bZuzm8s1ceuBUnMUAeoAHHw,20,46,22,18,6,1,13,0,106,15.142857142857142,10,0.0,9,22,15,6,37,1,3,13,0,52,54,1
1130,13711,H2Rgqo3kRDsNdbNVEDl0788s9SSdLM8P,bWdj2GDclj5ofokWjzoa5jAwMkxCykd6,6,5,2,0,2,0,4,0,13,1.8571428571428572,3,0.0,0,2,0,2,5,0,0,4,0,4,9,1
1131,13714,e4xoItGqdt7VvYzxou1Pv23rnKAXXXsC,SpATywNh6bZuzm8s1ceuBUnMUAeoAHHw,19,34,5,9,3,6,15,2,74,10.571428571428571,4,0.0,7,5,8,3,27,6,1,15,2,23,51,1
1132,13720,9JsNhrsWtCheE46kbgKiC6TCsPPGBSze,SpATywNh6bZuzm8s1ceuBUnMUAeoAHHw,19,34,19,9,6,4,7,0,79,11.285714285714286,3,0.0,7,19,9,6,27,4,0,7,0,41,38,1
1133,13750,6UfeuZvS7L15CgcbiecsOUDWQezuLDJz,SpATywNh6bZuzm8s1ceuBUnMUAeoAHHw,1,0,0,0,0,0,1,0,1,0.14285714285714285,1,0.0,0,0,0,0,0,0,0,1,0,0,1,1
1134,13751,wfHTtk8oy0CiP4p3waBMhlIvxeVIbZqk,SpATywNh6bZuzm8s1ceuBUnMUAeoAHHw,46,69,30,24,16,13,35,0,187,26.714285714285715,11,0.0,10,30,23,16,59,13,1,35,0,79,108,0
1135,13758,Pt4CHQaH2Lj9ri6xbjrkQ0IBNpZPKhdM,SpATywNh6bZuzm8s1ceuBUnMUAeoAHHw,2,0,0,0,0,0,2,0,2,0.2857142857142857,1,0.0,0,0,0,0,0,0,0,2,0,0,2,1
1136,13764,fdJXQSSucuzaRljy096jXgInnW2TakHQ,SpATywNh6bZuzm8s1ceuBUnMUAeoAHHw,30,94,53,33,11,39,28,2,260,37.142857142857146,10,0.0,18,53,27,11,76,39,6,28,2,109,151,0
1137,13780,EikisME12XnhqTfgnKK3O8hmfAWTmSd3,G8EPVSXsOYB5YQWZGiz1aVq5Pgr2GrQu,58,60,23,126,14,4,19,1,247,35.285714285714285,7,0.0,10,23,107,14,50,4,19,19,1,154,93,0
1138,13788,xYZJv26kEF7oZiNSoEZMnXHo33iYNlMJ,A3fsA9Zfv1X2fVEQhTw51lKENdNrEqT3,30,18,9,62,2,2,9,1,103,14.714285714285714,4,0.0,2,9,55,2,16,2,7,9,1,68,35,1
1139,14620,7FtUWtWtOf3nOZgatsCqg5hskFNeytpp,5X6FeZozNMgE2VRi3MJYjkkFK8SETtu2,8,8,2,0,1,0,7,1,19,2.7142857142857144,2,0.0,0,2,0,1,8,0,0,7,1,3,16,1
1140,14657,MuqCMckJZvG1cCcSC2ZsOM3AWWpLrBZR,5X6FeZozNMgE2VRi3MJYjkkFK8SETtu2,12,15,5,11,6,0,7,1,45,6.428571428571429,3,0.0,6,5,9,6,9,0,2,7,1,26,19,0
1141,14666,XF97rGqdAZjCQ3lABhhTnQ0vkqCZZ88w,5X6FeZozNMgE2VRi3MJYjkkFK8SETtu2,3,2,0,0,0,0,1,0,3,0.42857142857142855,1,0.0,0,0,0,0,2,0,0,1,0,0,3,1
1142,14683,EK8cH2rqaeWCMjTFz8xL65N7r32HerY9,7GRhBDsirIGkRZBtSMEzNTyDr2JQm4xx,111,244,93,162,56,194,42,4,795,113.57142857142857,15,0.0,107,93,133,56,137,194,29,42,4,389,406,0
1143,14690,ZbWUV0qkotaaSLhz8iJBNOk5nD7qDeuY,7GRhBDsirIGkRZBtSMEzNTyDr2JQm4xx,44,70,37,6,42,0,12,0,167,23.857142857142858,5,0.0,24,37,6,42,46,0,0,12,0,109,58,0
1144,14695,bR8Yt9wBqkSt4bNAyLqdLvjmoEdtlwOY,5X6FeZozNMgE2VRi3MJYjkkFK8SETtu2,55,115,14,54,25,0,3,0,211,30.142857142857142,6,0.0,41,14,51,25,74,0,3,3,0,131,80,1
1145,14749,ay8UWPLvleTCjZbhX0m45MeC9HVyUsC1,5X6FeZozNMgE2VRi3MJYjkkFK8SETtu2,22,27,2,21,8,1,13,3,75,10.714285714285714,3,0.0,16,2,19,8,11,1,2,13,3,45,30,1
1146,14815,IQhh6lXlVmCrcAcXbMrK8pYs2wjQgUqq,7GRhBDsirIGkRZBtSMEzNTyDr2JQm4xx,4,1,1,0,0,184,6,0,192,27.428571428571427,4,0.0,0,1,0,0,1,184,0,6,0,1,191,0
1147,14818,UgETwjVUoQXyxwFA12B4jwRDb3R4sQSN,7GRhBDsirIGkRZBtSMEzNTyDr2JQm4xx,60,125,54,131,40,1,22,0,373,53.285714285714285,10,0.0,57,54,117,40,68,1,14,22,0,268,105,1
1148,14829,QZIRHdwFgibI2SBehTrmLAZxED1F4JL7,7GRhBDsirIGkRZBtSMEzNTyDr2JQm4xx,26,47,16,12,18,0,4,0,97,13.857142857142858,3,0.0,8,16,10,18,39,0,2,4,0,52,45,1
1149,14836,lEIFkqeT396JMSPUyiaHNMN8g7bQ1x9p,7GRhBDsirIGkRZBtSMEzNTyDr2JQm4xx,6,1,1,0,1,0,3,0,6,0.8571428571428571,1,0.0,0,1,0,1,1,0,0,3,0,2,4,1
1150,14837,CEMMuEEc653PcYnJ6cnr3jxrYZv9f8D1,7GRhBDsirIGkRZBtSMEzNTyDr2JQm4xx,1,0,0,0,0,0,1,0,1,0.14285714285714285,1,0.0,0,0,0,0,0,0,0,1,0,0,1,1
1151,14846,5Xet5BwM6xDYh8pbaupnwmiq9T6jy7TC,7GRhBDsirIGkRZBtSMEzNTyDr2JQm4xx,47,64,20,73,23,23,19,0,222,31.714285714285715,5,0.0,44,20,62,23,20,23,11,19,0,149,73,1
1152,14851,SDvatKCgfdtv12UzJLxR0GYxgD4pUkgT,7GRhBDsirIGkRZBtSMEzNTyDr2JQm4xx,24,37,14,36,4,5,9,0,105,15.0,4,0.0,16,14,31,4,21,5,5,9,0,65,40,1
1153,14873,vJOKvfBreLyHqbEVMHx8ymKhM8KWKMc3,7GRhBDsirIGkRZBtSMEzNTyDr2JQm4xx,1,0,0,0,0,0,1,0,1,0.14285714285714285,1,0.0,0,0,0,0,0,0,0,1,0,0,1,1
1154,14944,g4UocDcFYSnUbOlhUZMBUfqXzzGSRrqN,7GRhBDsirIGkRZBtSMEzNTyDr2JQm4xx,1,0,0,0,0,0,1,0,1,0.14285714285714285,1,0.0,0,0,0,0,0,0,0,1,0,0,1,1
1155,14990,5VgPwWusKQIJc1LutXp6JyAv3fzKgfIX,7GRhBDsirIGkRZBtSMEzNTyDr2JQm4xx,43,82,34,45,30,1,11,0,203,29.0,8,0.0,38,34,42,30,44,1,3,11,0,144,59,1
1156,15016,yZ9FndAKqVsKwZtO1B2JJJblefdbhZ02,7GRhBDsirIGkRZBtSMEzNTyDr2JQm4xx,43,50,13,64,14,36,30,0,207,29.571428571428573,7,0.0,30,13,62,14,20,36,2,30,0,119,88,1
1157,15017,Qp9WPjKz2PASr9CWx9cGEYZGKd1Nemqr,7GRhBDsirIGkRZBtSMEzNTyDr2JQm4xx,20,34,11,27,5,62,23,0,162,23.142857142857142,2,0.0,18,11,24,5,16,62,3,23,0,58,104,1
1158,15029,R4o6u8M88d4gp68vTiRfI0Gudy4UPyor,5X6FeZozNMgE2VRi3MJYjkkFK8SETtu2,52,111,6,158,23,6,13,1,318,45.42857142857143,3,0.0,46,6,132,23,65,6,26,13,1,207,111,0
1159,15107,HFGNqnAY2MWiYF3III5EKx6o7tu1uiwJ,7GRhBDsirIGkRZBtSMEzNTyDr2JQm4xx,85,219,93,173,49,72,33,1,640,91.42857142857143,12,0.0,79,93,146,49,140,72,27,33,1,367,273,1
1160,15110,5zX31TZPkBQ4nxGKP7lPYFABTGNW6PHa,7GRhBDsirIGkRZBtSMEzNTyDr2JQm4xx,8,5,3,0,3,2,2,0,15,2.142857142857143,2,0.0,1,3,0,3,4,2,0,2,0,7,8,1
1161,15132,uOfATV0WsL0BPHDdVyS70rl0sYjdudpd,7GRhBDsirIGkRZBtSMEzNTyDr2JQm4xx,19,20,9,0,7,0,3,0,39,5.571428571428571,2,0.0,9,9,0,7,11,0,0,3,0,25,14,1
1162,15158,6nI0LAabOD8mpYbsk0fkK8B83pTINX0v,5X6FeZozNMgE2VRi3MJYjkkFK8SETtu2,8,24,9,2,8,0,5,0,48,6.857142857142857,4,0.0,8,9,2,8,16,0,0,5,0,27,21,0
1163,15164,ziRAzdRuzlLfb854mAvEaRYGuXqnCERH,7GRhBDsirIGkRZBtSMEzNTyDr2JQm4xx,109,270,90,200,61,47,40,0,708,101.14285714285714,9,0.0,148,90,168,61,122,47,32,40,0,467,241,0
1164,15178,28PHU9suTM8EqUKsQwsvQ03DzFXi0yDl,7GRhBDsirIGkRZBtSMEzNTyDr2JQm4xx,88,139,48,160,48,15,14,0,424,60.57142857142857,9,0.0,79,48,125,48,60,15,35,14,0,300,124,0
1165,15282,FRiuKxH98VzIG6N65WQEkvVSqVJx6TSd,7GRhBDsirIGkRZBtSMEzNTyDr2JQm4xx,40,90,22,70,27,0,6,0,215,30.714285714285715,3,0.0,62,22,69,27,28,0,1,6,0,180,35,1
1166,15318,5ApoT0ZoLbVQmiV8xOjwVDUBfTF6QDuq,7GRhBDsirIGkRZBtSMEzNTyDr2JQm4xx,25,47,19,35,15,21,23,2,162,23.142857142857142,3,0.0,23,19,29,15,24,21,6,23,2,86,76,1
1167,15353,zv1MTlqEl4Nw73cGpyMcdRKThLliUAlA,5X6FeZozNMgE2VRi3MJYjkkFK8SETtu2,6,5,2,0,1,0,4,0,12,1.7142857142857142,2,0.0,0,2,0,1,5,0,0,4,0,3,9,1
1168,15397,iWIAGeS3ATYiVCcaQcig63Lt0fYY4o8o,7GRhBDsirIGkRZBtSMEzNTyDr2JQm4xx,55,80,30,150,26,13,10,0,309,44.142857142857146,4,0.0,43,30,135,26,37,13,15,10,0,234,75,0
1169,15445,hrmgRr5TKkTKcJMaNH4IpBZoiQT9X6aI,7GRhBDsirIGkRZBtSMEzNTyDr2JQm4xx,28,90,5,21,23,2,19,0,160,22.857142857142858,8,0.0,58,5,17,23,32,2,4,19,0,103,57,0
1170,15463,IkoiWVr2ygCLdZNh2Bkmtx3mmgIErIzY,5X6FeZozNMgE2VRi3MJYjkkFK8SETtu2,1,0,0,0,0,0,1,0,1,0.14285714285714285,1,0.0,0,0,0,0,0,0,0,1,0,0,1,1
1171,15469,udnRYxurswpE4GUZcnc80kafg0hn3fpz,7GRhBDsirIGkRZBtSMEzNTyDr2JQm4xx,6,7,2,4,1,0,1,0,15,2.142857142857143,1,0.0,1,2,3,1,6,0,1,1,0,7,8,1
1172,15478,pHniYPYuaHgPmhy34oeWjiQMJE6eXmrA,7GRhBDsirIGkRZBtSMEzNTyDr2JQm4xx,1,0,0,0,0,0,1,0,1,0.14285714285714285,1,0.0,0,0,0,0,0,0,0,1,0,0,1,1
1173,15484,2OBbYlHxjDvtkcifhxwhxMZlYPhEHOro,7GRhBDsirIGkRZBtSMEzNTyDr2JQm4xx,64,107,10,205,4,0,21,0,347,49.57142857142857,13,0.0,45,10,179,4,62,0,26,21,0,238,109,0
1174,15540,UuDjs68Ty88iPLGMXsqZ9bEqUXmWG3bB,5X6FeZozNMgE2VRi3MJYjkkFK8SETtu2,1,0,0,0,0,0,1,0,1,0.14285714285714285,1,0.0,0,0,0,0,0,0,0,1,0,0,1,1
1175,15541,ILkUjE8LhIAQFlZwnOqsyA4K0QvAbnzA,7GRhBDsirIGkRZBtSMEzNTyDr2JQm4xx,106,555,137,167,80,231,83,7,1260,180.0,21,0.0,320,137,136,80,235,231,31,83,7,673,587,0
1176,15577,WeG9Rj8lv2ekdTamRkXPOfgW6N9lzyds,7GRhBDsirIGkRZBtSMEzNTyDr2JQm4xx,47,71,27,73,19,10,14,0,214,30.571428571428573,8,0.0,32,27,65,19,39,10,8,14,0,143,71,1
1177,15587,J5Igg8VrXDnaGFbVX70IduvQll75W8pB,5X6FeZozNMgE2VRi3MJYjkkFK8SETtu2,1,0,0,0,0,0,1,0,1,0.14285714285714285,1,0.0,0,0,0,0,0,0,0,1,0,0,1,1
1178,15593,917a11esEUG2kjEBnxsgADWhvlUYEWb2,7GRhBDsirIGkRZBtSMEzNTyDr2JQm4xx,5,1,1,0,0,0,9,0,11,1.5714285714285714,2,0.0,0,1,0,0,1,0,0,9,0,1,10,1
1179,15596,Jag1EXQWfAuTRiCgcVLyhRRkdOL9RtSD,7GRhBDsirIGkRZBtSMEzNTyDr2JQm4xx,37,43,21,38,9,28,29,1,169,24.142857142857142,8,0.0,12,21,37,9,31,28,1,29,1,79,90,1
1180,15604,MUERAHHFAKMlIE27Ma0uSdeN9dFIyDRi,7GRhBDsirIGkRZBtSMEzNTyDr2JQm4xx,6,3,1,0,1,0,3,0,8,1.1428571428571428,2,0.0,0,1,0,1,3,0,0,3,0,2,6,1
1181,15634,oco4sYAQqzdnYEwLykTSM4qmOTgkFoAN,7GRhBDsirIGkRZBtSMEzNTyDr2JQm4xx,72,219,84,140,29,21,70,3,566,80.85714285714286,12,0.0,101,84,116,29,118,21,24,70,3,330,236,0
1182,15637,syrttArug8Mpzs9L0IHsvBtATawYF9J2,7GRhBDsirIGkRZBtSMEzNTyDr2JQm4xx,69,130,49,115,21,4,13,0,332,47.42857142857143,9,0.0,63,49,102,21,67,4,13,13,0,235,97,1
1183,15644,V1ISBfZRhnmGbKQmxoCcA5AkClMXp9Rj,5X6FeZozNMgE2VRi3MJYjkkFK8SETtu2,10,21,1,2,4,3,9,3,43,6.142857142857143,3,0.0,11,1,2,4,10,3,0,9,3,18,25,1
1184,15676,fT8l2Rgir0TYnZP4X9UADbvRi0H8tycH,7GRhBDsirIGkRZBtSMEzNTyDr2JQm4xx,1,0,0,0,0,0,1,0,1,0.14285714285714285,1,0.0,0,0,0,0,0,0,0,1,0,0,1,1
1185,15783,Jm4nQ05ndX10jbofbWx6S0r9VXrqia6S,7GRhBDsirIGkRZBtSMEzNTyDr2JQm4xx,75,124,48,203,19,0,18,0,412,58.857142857142854,10,0.0,53,48,175,19,71,0,28,18,0,295,117,0
1186,15812,zTVBZ1zOMswSgDWxrOfzKUr5J9HO6HOE,7GRhBDsirIGkRZBtSMEzNTyDr2JQm4xx,96,251,76,180,53,8,35,0,603,86.14285714285714,11,0.0,103,76,156,53,148,8,24,35,0,388,215,1
1187,15829,tD36vn1aCu8pvS184dpJPyASEvtRWzdE,7GRhBDsirIGkRZBtSMEzNTyDr2JQm4xx,45,64,23,72,21,14,7,0,201,28.714285714285715,7,0.0,29,23,59,21,35,14,13,7,0,132,69,0
1188,15836,Ms0MC4W5moiGJLWP7iE3FImeH9CHN4KT,7GRhBDsirIGkRZBtSMEzNTyDr2JQm4xx,35,96,8,51,7,0,17,0,179,25.571428571428573,10,0.0,46,8,44,7,50,0,7,17,0,105,74,0
1189,15867,itOUYtUQXKtiNJoDhHvixGSCtswgEapf,7GRhBDsirIGkRZBtSMEzNTyDr2JQm4xx,85,118,57,49,64,8,14,0,310,44.285714285714285,14,0.0,52,57,43,64,66,8,6,14,0,216,94,1
1190,15911,INA4NXYWhyg0zaZtVRPkeCFe7zg5P8Ny,5X6FeZozNMgE2VRi3MJYjkkFK8SETtu2,24,42,15,28,7,0,8,0,100,14.285714285714286,5,0.0,14,15,28,7,28,0,0,8,0,64,36,0
1191,16009,Slk5JcZSYHmDLQZXaNVmcMDmjJ16kBhI,7GRhBDsirIGkRZBtSMEzNTyDr2JQm4xx,88,254,31,141,22,0,23,0,471,67.28571428571429,16,0.0,111,31,117,22,143,0,24,23,0,281,190,0
1192,16016,SSM7wEvdZo8FZW0zxJcXGwdA1S6Vbn5Q,7GRhBDsirIGkRZBtSMEzNTyDr2JQm4xx,5,3,1,0,0,0,2,0,6,0.8571428571428571,1,0.0,0,1,0,0,3,0,0,2,0,1,5,1
1193,16095,2WHRUx9c3z0u3SMwexxVlR2sgx8QCphl,7GRhBDsirIGkRZBtSMEzNTyDr2JQm4xx,2,0,0,0,0,0,4,0,4,0.5714285714285714,3,0.0,0,0,0,0,0,0,0,4,0,0,4,1
1194,16109,cmnVKDF5NlWXx0AsUNgswSBrQUc0cjpO,7GRhBDsirIGkRZBtSMEzNTyDr2JQm4xx,6,3,2,0,1,0,2,0,8,1.1428571428571428,1,0.0,0,2,0,1,3,0,0,2,0,3,5,1
1195,16126,6YaJxva3ruoxqQBNg2zA6CX5WSixFgrI,7GRhBDsirIGkRZBtSMEzNTyDr2JQm4xx,59,153,46,47,33,13,14,0,306,43.714285714285715,5,0.0,80,46,47,33,73,13,0,14,0,206,100,1
1196,16137,qG2WjxxVTjr5YeDGnwFvACGaHzeUu9HC,7GRhBDsirIGkRZBtSMEzNTyDr2JQm4xx,62,69,28,32,33,3,24,2,191,27.285714285714285,6,0.0,34,28,30,33,35,3,2,24,2,125,66,1
1197,16171,HieJch2LMldZteUgpMFf3KIoNYB4ohUW,5X6FeZozNMgE2VRi3MJYjkkFK8SETtu2,1,0,0,0,0,0,1,0,1,0.14285714285714285,1,0.0,0,0,0,0,0,0,0,1,0,0,1,1
1198,16217,ESzAGDiQvgaXvzXTziuj7JqXtnuQhUld,7GRhBDsirIGkRZBtSMEzNTyDr2JQm4xx,20,23,12,12,7,0,8,0,62,8.857142857142858,3,0.0,2,12,10,7,21,0,2,8,0,31,31,1
1199,16222,u6EnJOtoYTYGkLQOUZyVf756OPCxjorW,7GRhBDsirIGkRZBtSMEzNTyDr2JQm4xx,2,0,0,0,0,0,2,0,2,0.2857142857142857,1,0.0,0,0,0,0,0,0,0,2,0,0,2,1
1200,16235,fV5QpAWiywuCcKLCcDbuJBbZ43MyivgG,7GRhBDsirIGkRZBtSMEzNTyDr2JQm4xx,43,74,17,66,17,10,15,1,200,28.571428571428573,4,0.0,29,17,55,17,45,10,11,15,1,118,82,1
1201,16242,CtBdHmlYqpaYTMEPBvno3lS1o4khTfTp,7GRhBDsirIGkRZBtSMEzNTyDr2JQm4xx,110,159,58,146,70,28,19,4,484,69.14285714285714,11,0.0,79,58,131,70,80,28,15,19,4,338,146,1
1202,16326,vEWkXCfBtnzPc8huJqQsoGlEGR1bS2AS,7GRhBDsirIGkRZBtSMEzNTyDr2JQm4xx,29,79,33,52,20,9,7,0,200,28.571428571428573,4,0.0,38,33,41,20,41,9,11,7,0,132,68,1
1203,16350,jPtottuCTEl2a1fB4pqDjwAHNeUWQz5o,7GRhBDsirIGkRZBtSMEzNTyDr2JQm4xx,70,155,60,108,36,12,36,4,411,58.714285714285715,5,0.0,83,60,93,36,72,12,15,36,4,272,139,0
1204,16353,bONRCO0uATZ9orvOXASjWia0swY9AaMZ,7GRhBDsirIGkRZBtSMEzNTyDr2JQm4xx,62,93,23,125,20,5,6,0,272,38.857142857142854,1,0.0,37,23,102,20,56,5,23,6,0,182,90,1
1205,16384,DmRnf6emOOeLa4MI9vNggFDmgXu8cRIO,7GRhBDsirIGkRZBtSMEzNTyDr2JQm4xx,102,277,121,227,51,54,73,5,808,115.42857142857143,11,0.0,119,121,191,51,158,54,36,73,5,482,326,0
1206,16398,BoLe02lvDeCShGmwKeobGR6lB0bWy1t5,5X6FeZozNMgE2VRi3MJYjkkFK8SETtu2,1,0,0,0,0,0,1,0,1,0.14285714285714285,1,0.0,0,0,0,0,0,0,0,1,0,0,1,1
1207,16467,pz4WzmrapGULqEk99lfOZVzJbwiC2Cl1,7GRhBDsirIGkRZBtSMEzNTyDr2JQm4xx,80,261,2,166,16,84,30,6,565,80.71428571428571,9,0.0,111,2,147,16,150,84,19,30,6,276,289,1
1208,16473,aPM6Pkx8yXzDO1Wq6YMG1wXnFkTU2WLX,7GRhBDsirIGkRZBtSMEzNTyDr2JQm4xx,70,171,24,155,31,2,6,0,389,55.57142857142857,6,0.0,75,24,140,31,96,2,15,6,0,270,119,1
1209,16475,Od5SJB9QYomULqL762ang9IzHhai9Ph9,5X6FeZozNMgE2VRi3MJYjkkFK8SETtu2,7,3,2,0,2,0,2,0,9,1.2857142857142858,1,0.0,0,2,0,2,3,0,0,2,0,4,5,1
1210,16513,DWFLMejD5u3rghjtGauMHAJIC3QSphK7,5X6FeZozNMgE2VRi3MJYjkkFK8SETtu2,3,2,0,0,0,0,4,0,6,0.8571428571428571,1,0.0,0,0,0,0,2,0,0,4,0,0,6,1
1211,16523,koNIIdoqi1yUhLIZAXp5I3Fl17qrPzNm,5X6FeZozNMgE2VRi3MJYjkkFK8SETtu2,62,165,46,3,99,0,14,0,327,46.714285714285715,8,0.0,95,46,3,99,70,0,0,14,0,243,84,1
1212,16572,ckaBfYMRcWDmM0gkDIb3PY6kSLd0nbzq,7GRhBDsirIGkRZBtSMEzNTyDr2JQm4xx,20,42,8,0,6,0,7,0,63,9.0,2,0.0,2,8,0,6,40,0,0,7,0,16,47,0
1213,16578,fGIeAB7IRJCHxzCo8u4GLaPKxQfHeCdi,5X6FeZozNMgE2VRi3MJYjkkFK8SETtu2,5,2,1,0,1,0,2,0,6,0.8571428571428571,1,0.0,0,1,0,1,2,0,0,2,0,2,4,1
1214,16587,3l2AMuYrLjfvMGOYSOdPeQAMIHP0QDGn,7GRhBDsirIGkRZBtSMEzNTyDr2JQm4xx,13,20,9,10,4,9,5,0,57,8.142857142857142,3,0.0,9,9,8,4,11,9,2,5,0,30,27,0
1215,16638,QJSnryS3zb1gL3fTkTse6gK6PnzljUD1,7GRhBDsirIGkRZBtSMEzNTyDr2JQm4xx,14,17,1,36,1,1,1,0,57,8.142857142857142,1,0.0,9,1,33,1,8,1,3,1,0,44,13,1
1216,16641,nq7nltznx1EwtcnQOuGwGVLzMwD63I5W,7GRhBDsirIGkRZBtSMEzNTyDr2JQm4xx,4,6,3,0,0,0,2,0,11,1.5714285714285714,1,0.0,1,3,0,0,5,0,0,2,0,4,7,1
1217,16669,D222lqyFrC2b1DAJCNvtq2cDPE2yWdSh,7GRhBDsirIGkRZBtSMEzNTyDr2JQm4xx,67,157,61,74,48,10,26,5,381,54.42857142857143,8,0.0,61,61,68,48,96,10,6,26,5,238,143,1
1218,16689,EHb1g6rHAZsPWF8Gnr1xievV0vdAYt5Q,5X6FeZozNMgE2VRi3MJYjkkFK8SETtu2,24,81,19,0,23,1,24,1,149,21.285714285714285,5,0.0,21,19,0,23,60,1,0,24,1,63,86,1
1219,16706,slYeCkbTPIrLKmlwHnXlLGAsLG9LsAsp,5X6FeZozNMgE2VRi3MJYjkkFK8SETtu2,13,15,2,16,5,0,3,0,41,5.857142857142857,2,0.0,12,2,13,5,3,0,3,3,0,32,9,1
1220,16750,3FnNr9vIYZumFxJHz1azU06JI7Pm6hh3,5X6FeZozNMgE2VRi3MJYjkkFK8SETtu2,21,46,15,4,16,0,12,0,93,13.285714285714286,7,0.0,14,15,4,16,32,0,0,12,0,49,44,0
1221,16792,fbDgsipajp0xhHFfXN21wQyuQBNdN7hy,7GRhBDsirIGkRZBtSMEzNTyDr2JQm4xx,114,141,54,206,60,12,13,2,488,69.71428571428571,5,0.0,70,54,177,60,71,12,29,13,2,361,127,0
1222,16816,clv7wTDLUGVcdBnHuGK5igxvVYbUFhfO,7GRhBDsirIGkRZBtSMEzNTyDr2JQm4xx,1,0,0,0,0,0,1,0,1,0.14285714285714285,1,0.0,0,0,0,0,0,0,0,1,0,0,1,1
1223,16838,krqPTjwq96uxScwTNs38D4Dn2uZHC91r,7GRhBDsirIGkRZBtSMEzNTyDr2JQm4xx,5,3,1,0,1,0,2,0,7,1.0,1,0.0,0,1,0,1,3,0,0,2,0,2,5,1
1224,16880,JxLtKAnMek98G5fWpyeTaKlh0zheuNnU,7GRhBDsirIGkRZBtSMEzNTyDr2JQm4xx,5,2,1,0,1,0,3,0,7,1.0,2,0.0,0,1,0,1,2,0,0,3,0,2,5,1
1225,16900,WGK8mQ0dncy2teM4KtkdUCsILwqbrJWd,5X6FeZozNMgE2VRi3MJYjkkFK8SETtu2,17,28,1,0,0,0,6,0,35,5.0,4,0.0,0,1,0,0,28,0,0,6,0,1,34,0
1226,16905,Wp1xeVcESYWtuQa7LcTjyNCN1tWrWadY,5X6FeZozNMgE2VRi3MJYjkkFK8SETtu2,6,6,0,0,0,0,2,0,8,1.1428571428571428,1,0.0,0,0,0,0,6,0,0,2,0,0,8,1
1227,16987,Ar7wri6od2sIMOfx95hPmMwDttR4wtOC,7GRhBDsirIGkRZBtSMEzNTyDr2JQm4xx,97,180,64,181,50,6,20,1,502,71.71428571428571,11,0.0,94,64,159,50,86,6,22,20,1,367,135,0
1228,17035,M76ofI2UJItYXeusDRswE1mzVX9YlrVW,7GRhBDsirIGkRZBtSMEzNTyDr2JQm4xx,114,256,71,380,22,2,18,0,749,107.0,8,0.0,159,71,332,22,97,2,48,18,0,584,165,1
1229,17060,WX5bge9EFbPypYuObEiSD1Gyvh8Z866G,7GRhBDsirIGkRZBtSMEzNTyDr2JQm4xx,57,61,28,0,37,2,11,0,139,19.857142857142858,3,0.0,26,28,0,37,35,2,0,11,0,91,48,1
1230,17088,V08OBGRnuhGVZi2iGPXN66GxN6wKZmV9,7GRhBDsirIGkRZBtSMEzNTyDr2JQm4xx,2,0,0,0,0,0,2,0,2,0.2857142857142857,1,0.0,0,0,0,0,0,0,0,2,0,0,2,1
1231,17102,queJQcMYiH8jxjXTFMi1fslIxDDACkNw,7GRhBDsirIGkRZBtSMEzNTyDr2JQm4xx,26,30,13,20,9,1,12,0,85,12.142857142857142,3,0.0,12,13,17,9,18,1,3,12,0,51,34,1
1232,17124,xOB7vl3l1Tpb0i0cSWni40BfJ5FBclms,7GRhBDsirIGkRZBtSMEzNTyDr2JQm4xx,47,143,24,96,16,2,52,2,335,47.857142857142854,8,0.0,46,24,81,16,97,2,15,52,2,167,168,0
1233,17188,t6owJ66zI1aqKUvaXhE60g958CkKM6DK,5X6FeZozNMgE2VRi3MJYjkkFK8SETtu2,5,4,1,0,2,0,2,0,9,1.2857142857142858,1,0.0,2,1,0,2,2,0,0,2,0,5,4,0
1234,17240,g2VgGARpgGy9rA8aDCffqfXvItMu95Qi,7GRhBDsirIGkRZBtSMEzNTyDr2JQm4xx,40,78,42,60,23,17,30,1,251,35.857142857142854,5,0.0,10,42,53,23,68,17,7,30,1,128,123,0
1235,17242,OcmM4lAJy1xB9HSsEUxVtaUQ7oE5dcTp,7GRhBDsirIGkRZBtSMEzNTyDr2JQm4xx,41,105,36,46,31,3,11,0,232,33.142857142857146,12,0.0,27,36,33,31,78,3,13,11,0,127,105,0
1236,17257,E4fUiWo3de6EW3llrqGI6KBrgWgpa0OH,7GRhBDsirIGkRZBtSMEzNTyDr2JQm4xx,31,40,5,52,8,11,13,0,129,18.428571428571427,2,0.0,19,5,48,8,21,11,4,13,0,80,49,1
1237,17338,RLvXqOMggPmNW2f1XGbARyW4Nurlrkjt,7GRhBDsirIGkRZBtSMEzNTyDr2JQm4xx,4,2,0,0,0,0,3,0,5,0.7142857142857143,1,0.0,0,0,0,0,2,0,0,3,0,0,5,1
1238,17408,yV812AacRwieF2jdqr0WB58v7NmmEdx5,7GRhBDsirIGkRZBtSMEzNTyDr2JQm4xx,1,0,0,0,0,0,2,0,2,0.2857142857142857,1,0.0,0,0,0,0,0,0,0,2,0,0,2,1
1239,17427,LXb7JMOXN1ofXaAKjur9VNJzkhXbqCgp,5X6FeZozNMgE2VRi3MJYjkkFK8SETtu2,1,0,0,0,0,0,1,0,1,0.14285714285714285,1,0.0,0,0,0,0,0,0,0,1,0,0,1,0
1240,17449,yUIi2GUBxhysS9d9StVXyKUpISr6ANil,5X6FeZozNMgE2VRi3MJYjkkFK8SETtu2,33,69,14,19,31,8,37,1,179,25.571428571428573,5,0.0,47,14,18,31,22,8,1,37,1,110,69,0
1241,17485,7fC3V6ivG07wUIMOmiYFzSlyjWvbYnYf,7GRhBDsirIGkRZBtSMEzNTyDr2JQm4xx,83,134,1,291,17,11,24,0,478,68.28571428571429,9,0.0,69,1,246,17,65,11,45,24,0,333,145,0
1242,17505,X0efozcVijJghBnDtnJGbXo656NrPVoZ,7GRhBDsirIGkRZBtSMEzNTyDr2JQm4xx,2,0,0,0,0,0,2,0,2,0.2857142857142857,1,0.0,0,0,0,0,0,0,0,2,0,0,2,1
1243,17545,DGDF7EtBLvOTcfUxrOsvdCg2Ar6LlSc6,7GRhBDsirIGkRZBtSMEzNTyDr2JQm4xx,21,87,34,0,1,0,14,0,136,19.428571428571427,9,0.0,9,34,0,1,78,0,0,14,0,44,92,0
1244,17589,jJsFOxENnNTTNJOQ1tE8IoKNy1vSDO3t,5X6FeZozNMgE2VRi3MJYjkkFK8SETtu2,6,4,3,0,3,0,1,0,11,1.5714285714285714,1,0.0,0,3,0,3,4,0,0,1,0,6,5,1
1245,17634,UA8vU3s92g3lXc62U363PEO0xor6Mpeg,7GRhBDsirIGkRZBtSMEzNTyDr2JQm4xx,75,75,34,0,50,5,8,0,172,24.571428571428573,9,0.0,30,34,0,50,45,5,0,8,0,114,58,0
1246,17673,JSViK46d91E9ikMcvKp1rzZlHAqQuH4h,7GRhBDsirIGkRZBtSMEzNTyDr2JQm4xx,11,23,15,0,4,0,4,0,46,6.571428571428571,7,0.0,0,15,0,4,23,0,0,4,0,19,27,1
1247,17686,u0SrW65Zdf0RG2PPgt52qf6MWWYZDmbZ,5X6FeZozNMgE2VRi3MJYjkkFK8SETtu2,4,17,2,0,2,0,3,0,24,3.4285714285714284,4,0.0,2,2,0,2,15,0,0,3,0,6,18,1
1248,17732,uSYPJScTBnHLomhQS9YX0a2fQSS0kAh7,3VkHkmOtom3jM2wCu94xgzzu1d6Dn7or,65,136,62,41,60,10,31,5,345,49.285714285714285,11,0.0,52,62,40,60,84,10,1,31,5,214,131,1
1249,17748,Dha6i4inJ8jK0OySEa9I85ooFkmSQR0f,3VkHkmOtom3jM2wCu94xgzzu1d6Dn7or,79,285,136,46,44,82,57,97,747,106.71428571428571,20,0.0,97,136,44,44,188,82,2,57,97,321,426,0
1250,17762,8GF3xih10SN0lTJQvD5ffZk94qz9veVn,3VkHkmOtom3jM2wCu94xgzzu1d6Dn7or,66,198,9,71,18,13,22,4,335,47.857142857142854,14,0.0,111,9,64,18,87,13,7,22,4,202,133,1
1251,17772,Ix0I3r1fnKOg1dmzRjt5yYIGOrTQ5F1h,3VkHkmOtom3jM2wCu94xgzzu1d6Dn7or,62,394,20,103,12,49,38,1,617,88.14285714285714,13,0.0,139,20,99,12,255,49,4,38,1,270,347,1
1252,17797,Grmueh4kYgLYo2kInw23ZHrSQJbjli7D,3VkHkmOtom3jM2wCu94xgzzu1d6Dn7or,1,0,0,0,0,0,1,0,1,0.14285714285714285,1,0.0,0,0,0,0,0,0,0,1,0,0,1,1
1253,17817,X1EUj7wk6F33hO4P0XJp5wPekH9jNbQl,3VkHkmOtom3jM2wCu94xgzzu1d6Dn7or,24,17,15,0,14,0,18,0,64,9.142857142857142,2,0.0,0,15,0,14,17,0,0,18,0,29,35,1
1254,17881,brJtU2ctZ98mR2x67cNWnN516bdfRqUH,3VkHkmOtom3jM2wCu94xgzzu1d6Dn7or,53,149,78,73,0,171,20,7,498,71.14285714285714,14,0.0,57,78,71,0,92,171,2,20,7,206,292,0
1255,17882,6Nedk2yiWtM4avzjFO0iKSrk1Ko6yIUK,3VkHkmOtom3jM2wCu94xgzzu1d6Dn7or,21,42,20,17,10,7,13,1,110,15.714285714285714,7,0.0,5,20,13,10,37,7,4,13,1,48,62,1
1256,17907,pE2pfmXY2JZ1ppA5N0APNqSGmVpRUVPY,3VkHkmOtom3jM2wCu94xgzzu1d6Dn7or,73,224,62,98,39,0,75,1,499,71.28571428571429,14,0.0,85,62,96,39,139,0,2,75,1,282,217,0
1257,17945,r3zOb44kbET1pjptzIuq8WZVUENTEA3D,3VkHkmOtom3jM2wCu94xgzzu1d6Dn7or,97,296,155,59,141,67,33,2,753,107.57142857142857,15,0.0,119,155,55,141,177,67,4,33,2,470,283,0
1258,18023,XYBLB5vnJS2TawgpFm2PqudALg5wF8Kg,3VkHkmOtom3jM2wCu94xgzzu1d6Dn7or,7,3,1,0,1,0,6,0,11,1.5714285714285714,2,0.0,1,1,0,1,2,0,0,6,0,3,8,1
1259,18078,rmxHCOJX4wSBlcTrJuAWqR1bup4swsK6,3VkHkmOtom3jM2wCu94xgzzu1d6Dn7or,1,0,0,0,0,0,1,0,1,0.14285714285714285,1,0.0,0,0,0,0,0,0,0,1,0,0,1,1
1260,18086,TnMuPtEYCG1UP1JnaDUM0auIBTc6VjvH,3VkHkmOtom3jM2wCu94xgzzu1d6Dn7or,83,260,122,65,64,140,70,6,727,103.85714285714286,9,0.0,70,122,55,64,190,140,10,70,6,311,416,0
1261,18088,IYg5NbiXDzXRMWONARzl3jmz5ST0akR1,3VkHkmOtom3jM2wCu94xgzzu1d6Dn7or,52,67,44,0,36,0,11,0,158,22.571428571428573,8,0.0,0,44,0,36,67,0,0,11,0,80,78,0
1262,18092,001Wosm650x4ktE3NPV76K6QhVwlKDP6,3VkHkmOtom3jM2wCu94xgzzu1d6Dn7or,1,0,0,0,0,0,1,0,1,0.14285714285714285,1,0.0,0,0,0,0,0,0,0,1,0,0,1,1
1263,18097,RhrhT0DsU5k5o3MtqPuXQswIRC7VTIjC,3VkHkmOtom3jM2wCu94xgzzu1d6Dn7or,1,0,0,0,0,0,3,0,3,0.42857142857142855,1,0.0,0,0,0,0,0,0,0,3,0,0,3,1
1264,18101,ag9syR84Cy6sEDoCNkuFTpCWCEtqdqJc,3VkHkmOtom3jM2wCu94xgzzu1d6Dn7or,30,104,35,42,30,86,29,2,328,46.857142857142854,16,0.0,49,35,33,30,55,86,9,29,2,147,181,0
1265,18144,pk69em2bhNfGTrrqysMHCMfzjd22WDJE,3VkHkmOtom3jM2wCu94xgzzu1d6Dn7or,31,127,45,33,21,19,25,0,270,38.57142857142857,10,0.0,25,45,33,21,102,19,0,25,0,124,146,0
1266,18159,BRclHGtISz8OrVQUxPrUgTFUDM8fjMcZ,3VkHkmOtom3jM2wCu94xgzzu1d6Dn7or,3,0,0,0,0,0,4,0,4,0.5714285714285714,1,0.0,0,0,0,0,0,0,0,4,0,0,4,1
1267,18188,PPOy6eFALFchmbWLetIASc4gvjCBJT44,3VkHkmOtom3jM2wCu94xgzzu1d6Dn7or,65,161,67,59,47,36,57,31,458,65.42857142857143,13,0.0,64,67,52,47,97,36,7,57,31,230,228,0
1268,18196,Ywb8KfjZdIQ3abMJEb6RTRF3JJxAFjU7,3VkHkmOtom3jM2wCu94xgzzu1d6Dn7or,69,204,49,66,65,44,21,4,453,64.71428571428571,16,0.0,103,49,58,65,101,44,8,21,4,275,178,0
1269,18221,MRzfDn8Dt6xZQHTAuGEWQiuznoHxxpTX,3VkHkmOtom3jM2wCu94xgzzu1d6Dn7or,32,71,19,26,29,0,40,0,185,26.428571428571427,11,0.0,44,19,26,29,27,0,0,40,0,118,67,0
1270,18243,EGKN6vyN5Q43uHhLGJeQNxMWUFnutUxK,3VkHkmOtom3jM2wCu94xgzzu1d6Dn7or,34,126,33,27,35,37,35,2,295,42.142857142857146,8,0.0,68,33,23,35,58,37,4,35,2,159,136,1
1271,18265,KIQtwyG9uOFU6xTKYvwqivjGIZ1GfiMa,3VkHkmOtom3jM2wCu94xgzzu1d6Dn7or,69,229,97,70,82,67,32,4,581,83.0,14,0.0,99,97,70,82,130,67,0,32,4,348,233,0
1272,18364,gMeKwVdV7xHR9zrsQTTuP5xOz4aKMsCh,3VkHkmOtom3jM2wCu94xgzzu1d6Dn7or,28,39,19,24,15,2,19,0,118,16.857142857142858,4,0.0,13,19,21,15,26,2,3,19,0,68,50,1
1273,18373,dx9pQrhQ84HPZEwcXhND3i57oR5xlZcF,3VkHkmOtom3jM2wCu94xgzzu1d6Dn7or,78,213,55,126,77,7,45,6,529,75.57142857142857,15,0.0,137,55,119,77,76,7,7,45,6,388,141,0
1274,18381,9TAoWA17iJi4aGxReuxcPCWmtwK9xK5D,3VkHkmOtom3jM2wCu94xgzzu1d6Dn7or,57,133,35,87,28,1,24,3,311,44.42857142857143,8,0.0,39,35,80,28,94,1,7,24,3,182,129,0
1275,18403,I9yi1jZjIznCPzP5fpMJEhPDMiUaetUu,3VkHkmOtom3jM2wCu94xgzzu1d6Dn7or,69,174,73,89,40,19,26,4,425,60.714285714285715,18,0.0,30,73,78,40,144,19,11,26,4,221,204,1
1276,18428,kxruAMKyHOcayI2NB5Y6rjVEEl5poFsO,3VkHkmOtom3jM2wCu94xgzzu1d6Dn7or,22,14,11,0,8,10,25,0,68,9.714285714285714,3,0.0,0,11,0,8,14,10,0,25,0,19,49,1
1277,18450,lFuxKGBpNGivMMktjiNncr25c8ERjZWC,3VkHkmOtom3jM2wCu94xgzzu1d6Dn7or,25,127,50,23,26,78,39,3,346,49.42857142857143,7,0.0,37,50,19,26,90,78,4,39,3,132,214,0
1278,18466,s24Qk0ZpAXR97ldBDtgP8DE6rT8or69U,3VkHkmOtom3jM2wCu94xgzzu1d6Dn7or,80,245,90,90,67,37,32,2,563,80.42857142857143,21,0.0,98,90,73,67,147,37,17,32,2,328,235,0
1279,18523,lXSTwshe07PL988rWzAoelFryi3Pn7tG,3VkHkmOtom3jM2wCu94xgzzu1d6Dn7or,7,12,7,0,2,0,8,0,29,4.142857142857143,3,0.0,0,7,0,2,12,0,0,8,0,9,20,1
1280,18539,Ci9FGx4bWbxBIrvlwmLcaPnUTvif70a3,3VkHkmOtom3jM2wCu94xgzzu1d6Dn7or,51,111,35,48,17,12,14,10,247,35.285714285714285,10,0.0,30,35,46,17,81,12,2,14,10,128,119,0
1281,18542,ECEUT4nRUDaFV5qHTqBhsS2pJikODqSu,3VkHkmOtom3jM2wCu94xgzzu1d6Dn7or,8,11,5,0,4,0,3,0,23,3.2857142857142856,1,0.0,2,5,0,4,9,0,0,3,0,11,12,1
1282,18550,Foug4Pz6AbcC9cKxJW2E85auy3I2Ujw9,3VkHkmOtom3jM2wCu94xgzzu1d6Dn7or,9,3,2,0,2,0,7,0,14,2.0,1,0.0,0,2,0,2,3,0,0,7,0,4,10,1
1283,18630,LJBTrS8sHkFyN47h6ik2jPfi1u81PolZ,3VkHkmOtom3jM2wCu94xgzzu1d6Dn7or,67,240,63,111,45,56,41,1,557,79.57142857142857,20,0.0,89,63,110,45,151,56,1,41,1,307,250,0
1284,18641,wbm7aXhz4d0PkVw0PLDLLW0uINj17nxg,3VkHkmOtom3jM2wCu94xgzzu1d6Dn7or,13,39,13,6,9,6,8,0,81,11.571428571428571,5,0.0,14,13,5,9,25,6,1,8,0,41,40,1
1285,18658,6BQ1MfaAfWSP4zUxzPbaafKGCseltjDR,3VkHkmOtom3jM2wCu94xgzzu1d6Dn7or,10,18,7,0,6,0,4,0,35,5.0,3,0.0,5,7,0,6,13,0,0,4,0,18,17,1
1286,18663,VSxmvcFHrZIVtNnTaFw0qdfh1Zdl1LMy,3VkHkmOtom3jM2wCu94xgzzu1d6Dn7or,9,21,9,3,3,15,4,0,55,7.857142857142857,3,0.0,6,9,3,3,15,15,0,4,0,21,34,1
1287,18689,2xZrQQP23hxOtlLcdItvAyKPIWRJ1v3T,3VkHkmOtom3jM2wCu94xgzzu1d6Dn7or,59,43,33,0,27,0,8,0,111,15.857142857142858,5,0.0,0,33,0,27,43,0,0,8,0,60,51,0
1288,18698,pvhPBXiUlAyJeaMIOU2U6eYfza72w7rZ,3VkHkmOtom3jM2wCu94xgzzu1d6Dn7or,8,3,2,0,2,0,5,0,12,1.7142857142857142,3,0.0,0,2,0,2,3,0,0,5,0,4,8,1
1289,18702,Qiu00ngPMaYSLIBJ0lGXVVmnZ9RcWVyJ,3VkHkmOtom3jM2wCu94xgzzu1d6Dn7or,18,20,8,10,12,7,2,0,59,8.428571428571429,1,0.0,11,8,10,12,9,7,0,2,0,41,18,1
1290,18711,VySPxqxLrvQXsa4ANpNsQKDb6glXzoI5,3VkHkmOtom3jM2wCu94xgzzu1d6Dn7or,54,152,77,26,45,32,44,4,380,54.285714285714285,12,0.0,20,77,26,45,132,32,0,44,4,168,212,0
1291,18740,EiNWohr3Zb4jjWZbmhSd0fizIZ5iJUD6,3VkHkmOtom3jM2wCu94xgzzu1d6Dn7or,12,27,12,7,13,11,4,0,74,10.571428571428571,4,0.0,11,12,7,13,16,11,0,4,0,43,31,1
1292,18750,HIbKGQJ8yDbPhmqDqsEHxHEydttgfsQA,3VkHkmOtom3jM2wCu94xgzzu1d6Dn7or,63,195,90,41,59,55,35,3,478,68.28571428571429,7,0.0,60,90,37,59,135,55,4,35,3,246,232,0
1293,18769,Q8LjqyQUAhel7eahT3smYZreGv7r7aK4,3VkHkmOtom3jM2wCu94xgzzu1d6Dn7or,85,205,73,63,64,59,68,3,535,76.42857142857143,19,0.0,84,73,56,64,121,59,7,68,3,277,258,0
1294,18774,y2sW95cqHxDSSyqwCmaoCGpxWGUy5xSo,3VkHkmOtom3jM2wCu94xgzzu1d6Dn7or,79,247,47,88,96,34,13,1,526,75.14285714285714,11,0.0,180,47,82,96,67,34,6,13,1,405,121,0
1295,18785,MfMma0Ta6pPfrEXtJ0AJ2URgwzF8BIcO,3VkHkmOtom3jM2wCu94xgzzu1d6Dn7or,2,0,0,0,0,0,3,0,3,0.42857142857142855,1,0.0,0,0,0,0,0,0,0,3,0,0,3,1
1296,18900,twL3gg1NxV7siasyIyesAxTIzR4pdVii,3VkHkmOtom3jM2wCu94xgzzu1d6Dn7or,66,189,68,45,42,97,18,0,459,65.57142857142857,9,0.0,69,68,43,42,120,97,2,18,0,222,237,0
1297,18903,5PQ2zPZwyHgVOd3muSSBQz7FsKF2poQh,3VkHkmOtom3jM2wCu94xgzzu1d6Dn7or,64,206,57,90,53,25,53,7,491,70.14285714285714,6,0.0,99,57,82,53,107,25,8,53,7,291,200,0
1298,18916,KoV68VcO7F3E8wg0KpRNwvTyiwvSxGqA,3VkHkmOtom3jM2wCu94xgzzu1d6Dn7or,9,5,4,0,4,1,3,0,17,2.4285714285714284,1,0.0,0,4,0,4,5,1,0,3,0,8,9,1
1299,18930,2UI6dX5TZfoXI1GNCTxQwRjZdy9DYB86,3VkHkmOtom3jM2wCu94xgzzu1d6Dn7or,61,143,42,52,22,7,15,1,282,40.285714285714285,8,0.0,38,42,51,22,105,7,1,15,1,153,129,0
1300,18973,bRmWg6mFQ7xPrAw8okLLDyjGujSO4E8W,3VkHkmOtom3jM2wCu94xgzzu1d6Dn7or,77,148,51,46,50,48,98,4,445,63.57142857142857,12,0.0,69,51,42,50,79,48,4,98,4,212,233,0
1301,18981,TxPdRo4YM0nG7krToBXcizu0WlDyTWIy,3VkHkmOtom3jM2wCu94xgzzu1d6Dn7or,9,13,5,8,2,2,3,0,33,4.714285714285714,2,0.0,6,5,7,2,7,2,1,3,0,20,13,1
1302,19102,6V735G3zF0lLcv0aFmtQmFRoGL9yLYzI,3VkHkmOtom3jM2wCu94xgzzu1d6Dn7or,1,0,0,0,0,0,1,0,1,0.14285714285714285,1,0.0,0,0,0,0,0,0,0,1,0,0,1,1
1303,19110,3ny9mc45r6qJQOOxmh4xg5QHGygeiHbu,3VkHkmOtom3jM2wCu94xgzzu1d6Dn7or,57,191,69,41,46,6,35,0,388,55.42857142857143,8,0.0,73,69,38,46,118,6,3,35,0,226,162,0
1304,19124,1kjyC7ahZCsVlNSBwjZNyonjDeeXb2jh,3VkHkmOtom3jM2wCu94xgzzu1d6Dn7or,76,267,122,35,89,68,49,9,639,91.28571428571429,18,0.0,40,122,29,89,227,68,6,49,9,280,359,0
1305,19159,5yR5O4DRPJvdwUa00RWlgmmSt86eHiWt,3VkHkmOtom3jM2wCu94xgzzu1d6Dn7or,7,5,3,0,1,0,5,1,15,2.142857142857143,1,0.0,0,3,0,1,5,0,0,5,1,4,11,1
1306,19224,V3R0gIx6Yd8uB6bFWcwIynkF0zfEHsVH,3VkHkmOtom3jM2wCu94xgzzu1d6Dn7or,71,230,67,54,96,37,40,14,538,76.85714285714286,16,0.0,138,67,48,96,92,37,6,40,14,349,189,0
1307,19289,zyMs55MEXcYV6llnecBHL4KGyjGwZwbR,3VkHkmOtom3jM2wCu94xgzzu1d6Dn7or,70,195,54,65,71,27,19,0,431,61.57142857142857,17,0.0,107,54,64,71,88,27,1,19,0,296,135,0
1308,19323,PlUF2VKLVgW5qlXUwlw7IbYoWraUDopo,3VkHkmOtom3jM2wCu94xgzzu1d6Dn7or,16,30,9,19,6,10,4,0,78,11.142857142857142,2,0.0,9,9,17,6,21,10,2,4,0,41,37,1
1309,19339,lqEGjqZQzcaIOdC4SfhGwonY0sNEdv9v,3VkHkmOtom3jM2wCu94xgzzu1d6Dn7or,10,42,4,0,3,5,6,0,60,8.571428571428571,4,0.0,15,4,0,3,27,5,0,6,0,22,38,1
1310,19356,CWyQorKTdtJysACpC8OcqJBGDDmfcHTs,3VkHkmOtom3jM2wCu94xgzzu1d6Dn7or,3,0,0,0,0,0,3,0,3,0.42857142857142855,1,0.0,0,0,0,0,0,0,0,3,0,0,3,1
1311,19359,n1ESpvyobZkFsfrWJhKOuY4URaa1sUc5,3VkHkmOtom3jM2wCu94xgzzu1d6Dn7or,65,505,103,78,15,33,59,3,796,113.71428571428571,14,0.0,161,103,76,15,344,33,2,59,3,355,441,0
1312,19378,t2pLyQogXlU1FYBSbBXVU6WIkp2EphwW,3VkHkmOtom3jM2wCu94xgzzu1d6Dn7or,10,23,6,0,1,13,16,2,61,8.714285714285714,2,0.0,2,6,0,1,21,13,0,16,2,9,52,1
1313,19390,bIGq7A9r0Y0NLU65d3TOWeEFWRfABEv0,3VkHkmOtom3jM2wCu94xgzzu1d6Dn7or,1,0,0,0,0,0,1,0,1,0.14285714285714285,1,0.0,0,0,0,0,0,0,0,1,0,0,1,1
1314,19405,YEOUoDIDe7yUhdKE02prv9UscLPObTDD,3VkHkmOtom3jM2wCu94xgzzu1d6Dn7or,1,0,0,0,0,0,2,0,2,0.2857142857142857,1,0.0,0,0,0,0,0,0,0,2,0,0,2,1
1315,19406,2bkNmlQB9BrmgVluXIKiykQrlDIy5pxv,3VkHkmOtom3jM2wCu94xgzzu1d6Dn7or,5,2,1,0,1,0,3,0,7,1.0,2,0.0,0,1,0,1,2,0,0,3,0,2,5,1
1316,19583,EWAoo7AAzLTKxICthBrlzvoQ4jKqTV5Z,fbPkOYLVPtPgIt0MxizjfFJov3JbHyAi,3,2,0,0,0,2,1,0,5,0.7142857142857143,1,0.0,0,0,0,0,2,2,0,1,0,0,5,1
1317,19585,eUVqEtQR3HLmXjNHTc0FXKT2InqoH24Q,fbPkOYLVPtPgIt0MxizjfFJov3JbHyAi,4,7,2,0,2,0,2,0,13,1.8571428571428572,3,0.0,0,2,0,2,7,0,0,2,0,4,9,1
1318,19590,iES59bXqTODmGXmysyfu1geM8lUv5mwl,fbPkOYLVPtPgIt0MxizjfFJov3JbHyAi,7,7,2,0,2,0,8,0,19,2.7142857142857144,1,0.0,2,2,0,2,5,0,0,8,0,6,13,1
1319,19594,4x6w2QLFfXQ2dHDa4fBCOvJ1UYg7yE69,fbPkOYLVPtPgIt0MxizjfFJov3JbHyAi,21,23,12,13,7,12,15,2,84,12.0,5,0.0,4,12,9,7,19,12,4,15,2,32,52,1
1320,19596,lhkiaYX6n9dxQvsKk8vp6UZQBNlsuGnH,fbPkOYLVPtPgIt0MxizjfFJov3JbHyAi,81,194,90,97,53,188,75,2,699,99.85714285714286,9,0.0,83,90,73,53,111,188,24,75,2,299,400,0
1321,19605,BPDxtvSmkKR4nTdKjes8gGxzoOprTkK2,fbPkOYLVPtPgIt0MxizjfFJov3JbHyAi,6,2,1,0,1,2,4,1,11,1.5714285714285714,1,0.0,0,1,0,1,2,2,0,4,1,2,9,1
1322,19608,CJhqdTUUI9IhUemITUcGqZ2FNfX5tFcn,fbPkOYLVPtPgIt0MxizjfFJov3JbHyAi,3,1,0,0,0,0,2,0,3,0.42857142857142855,1,0.0,0,0,0,0,1,0,0,2,0,0,3,1
1323,19613,hPhvZr1dLTLTcIKq5t7vAfQqTozZXlRI,fbPkOYLVPtPgIt0MxizjfFJov3JbHyAi,38,32,25,0,19,0,4,0,80,11.428571428571429,4,0.0,0,25,0,19,32,0,0,4,0,44,36,1
1324,19614,3tr9vOqNQBlqx7G8lEAeoRN3dN5LTQt8,fbPkOYLVPtPgIt0MxizjfFJov3JbHyAi,6,5,3,0,2,0,3,1,14,2.0,1,0.0,0,3,0,2,5,0,0,3,1,5,9,1
1325,19618,oJ9j9ejTgKixczg3tSE8Sg8DPI7YQpJq,fbPkOYLVPtPgIt0MxizjfFJov3JbHyAi,10,17,8,0,4,14,3,0,46,6.571428571428571,2,0.0,4,8,0,4,13,14,0,3,0,16,30,0
1326,19619,BcKYeHv4ZKY4DeUPw2M71hKVyOhypokT,fbPkOYLVPtPgIt0MxizjfFJov3JbHyAi,22,30,16,0,11,25,16,2,100,14.285714285714286,3,0.0,0,16,0,11,30,25,0,16,2,27,73,1
1327,19625,TvUBYMbHTCcIGUIFw5l8y3Oo0Axsdspt,fbPkOYLVPtPgIt0MxizjfFJov3JbHyAi,19,31,24,0,15,4,7,0,81,11.571428571428571,3,0.0,0,24,0,15,31,4,0,7,0,39,42,1
1328,19628,eqpnrsO3UPO24LQNWGKYtfRd0DQ0MPDl,fbPkOYLVPtPgIt0MxizjfFJov3JbHyAi,13,18,1,9,3,18,15,1,65,9.285714285714286,2,0.0,9,1,7,3,9,18,2,15,1,20,45,1
1329,19632,QOCecwQRgvCytTVCFa2MB091bctR2VxO,fbPkOYLVPtPgIt0MxizjfFJov3JbHyAi,6,3,2,0,2,10,1,0,18,2.5714285714285716,1,0.0,0,2,0,2,3,10,0,1,0,4,14,1
1330,19635,fz559cnktTQw4xrHI1wICm1ao7bugAZA,fbPkOYLVPtPgIt0MxizjfFJov3JbHyAi,6,8,4,0,2,0,3,0,17,2.4285714285714284,2,0.0,0,4,0,2,8,0,0,3,0,6,11,1
1331,19637,8MQx62NrM26CEa5RRkhFUh36AiGGNx6S,fbPkOYLVPtPgIt0MxizjfFJov3JbHyAi,22,57,5,0,6,0,13,1,82,11.714285714285714,5,0.0,2,5,0,6,55,0,0,13,1,13,69,0
1332,19645,bazJXiq7ucQvx12BgvEogiLDadc2i22I,fbPkOYLVPtPgIt0MxizjfFJov3JbHyAi,6,6,2,0,2,0,3,0,13,1.8571428571428572,2,0.0,2,2,0,2,4,0,0,3,0,6,7,1
1333,19647,95Gw2yhEY17itkROcjsEWWGhFV0TNXNK,fbPkOYLVPtPgIt0MxizjfFJov3JbHyAi,26,36,19,14,9,11,10,0,99,14.142857142857142,2,0.0,11,19,14,9,25,11,0,10,0,53,46,1
1334,19651,czkVdqv8QRpY6SHliMvW81P6eofNIUuP,fbPkOYLVPtPgIt0MxizjfFJov3JbHyAi,6,2,1,0,1,0,3,0,7,1.0,1,0.0,0,1,0,1,2,0,0,3,0,2,5,1
1335,19652,UJay3MfkIPCa65Or9jDxIJTFTpNpxKv0,fbPkOYLVPtPgIt0MxizjfFJov3JbHyAi,5,10,3,0,0,0,4,0,17,2.4285714285714284,1,0.0,2,3,0,0,8,0,0,4,0,5,12,1
1336,19653,RZO451egqNvgwYLVc2DT5RZC5jtK41Wn,fbPkOYLVPtPgIt0MxizjfFJov3JbHyAi,25,26,11,18,10,0,8,1,74,10.571428571428571,3,0.0,12,11,18,10,14,0,0,8,1,51,23,0
1337,19662,tvh0r7BXEnkkRFvEGDSaxc2cnDAVPflf,fbPkOYLVPtPgIt0MxizjfFJov3JbHyAi,32,70,27,21,11,62,39,3,233,33.285714285714285,12,0.0,12,27,18,11,58,62,3,39,3,68,165,1
1338,19663,dqE1PGrWExsbP4JkEoKdSn4p50FzqbEb,fbPkOYLVPtPgIt0MxizjfFJov3JbHyAi,7,8,5,0,4,0,3,0,20,2.857142857142857,3,0.0,0,5,0,4,8,0,0,3,0,9,11,1
1339,19664,IAvuP4GGmvnNj3Zisz3jDfo3mSmXiJSb,fbPkOYLVPtPgIt0MxizjfFJov3JbHyAi,25,77,33,34,32,1,8,1,186,26.571428571428573,4,0.0,37,33,28,32,40,1,6,8,1,130,56,1
1340,19666,3mpQrDEY6qYqlUT3nGLIM1V0MOlZAk6h,fbPkOYLVPtPgIt0MxizjfFJov3JbHyAi,8,11,7,0,5,0,3,0,26,3.7142857142857144,2,0.0,1,7,0,5,10,0,0,3,0,13,13,1
1341,19669,5CV53T145kru57HDn4DelXde0UjT6xqn,fbPkOYLVPtPgIt0MxizjfFJov3JbHyAi,5,6,1,0,1,0,5,0,13,1.8571428571428572,1,0.0,3,1,0,1,3,0,0,5,0,5,8,1
1342,19670,CiNjO5C17d45NfmPbNPGATJqInGPv9eX,fbPkOYLVPtPgIt0MxizjfFJov3JbHyAi,2,0,0,0,0,0,8,0,8,1.1428571428571428,2,0.0,0,0,0,0,0,0,0,8,0,0,8,1
1343,19672,Thuw3SvsWAczQHNEJLdc52dNwXNFxJ27,fbPkOYLVPtPgIt0MxizjfFJov3JbHyAi,1,0,0,0,0,0,1,0,1,0.14285714285714285,1,0.0,0,0,0,0,0,0,0,1,0,0,1,1
1344,19673,5IM8g7YMOYo5qH7Yu3x31T3JkVOH9iqe,fbPkOYLVPtPgIt0MxizjfFJov3JbHyAi,10,18,6,0,3,5,4,0,36,5.142857142857143,2,0.0,0,6,0,3,18,5,0,4,0,9,27,1
1345,19676,gWLNrui4xJ6xOW9BQTEyWRBtLNqndryz,fbPkOYLVPtPgIt0MxizjfFJov3JbHyAi,5,3,1,0,1,3,4,0,12,1.7142857142857142,1,0.0,0,1,0,1,3,3,0,4,0,2,10,1
1346,19677,rl1ijjmPoVXrn0BLw0LMwhU2iQWvim3X,fbPkOYLVPtPgIt0MxizjfFJov3JbHyAi,82,164,98,62,43,143,20,1,531,75.85714285714286,14,0.0,49,98,58,43,115,143,4,20,1,248,283,0
1347,19680,PLKfIj5PWmJ1pq6F2TAT2ZidBGAMa6pt,fbPkOYLVPtPgIt0MxizjfFJov3JbHyAi,29,96,37,16,20,43,30,7,249,35.57142857142857,5,0.0,38,37,13,20,58,43,3,30,7,108,141,1
1348,19681,XY4zkM1XF8dydjqcvDmQyLNW1UDj6PeN,fbPkOYLVPtPgIt0MxizjfFJov3JbHyAi,18,29,15,17,10,4,7,0,82,11.714285714285714,3,0.0,8,15,15,10,21,4,2,7,0,48,34,1
1349,19682,jq3G4vNjVUo5sqAQquCFzqcPQiyiVAd4,fbPkOYLVPtPgIt0MxizjfFJov3JbHyAi,10,18,9,6,4,2,5,0,44,6.285714285714286,3,0.0,1,9,5,4,17,2,1,5,0,19,25,1
1350,19683,EqwF2QzEhw4NgIj4YX1bMoLFO7jCzOVt,fbPkOYLVPtPgIt0MxizjfFJov3JbHyAi,11,5,3,13,4,0,5,0,30,4.285714285714286,1,0.0,2,3,8,4,3,0,5,5,0,17,13,1
1351,19684,mya8TfxNbiDk3y9Od8avdqRP3ecWgTII,fbPkOYLVPtPgIt0MxizjfFJov3JbHyAi,10,10,5,4,5,19,3,0,46,6.571428571428571,3,0.0,3,5,3,5,7,19,1,3,0,16,30,1
1352,19686,CnbF8r7iTFBimMMahtVgMZeVp9U8TCPU,fbPkOYLVPtPgIt0MxizjfFJov3JbHyAi,8,14,3,0,2,5,4,1,29,4.142857142857143,1,0.0,2,3,0,2,12,5,0,4,1,7,22,1
1353,19688,RxXRKZYpbfKbF79XwFGwONhlZ3CWNuKc,fbPkOYLVPtPgIt0MxizjfFJov3JbHyAi,5,2,1,0,1,0,3,0,7,1.0,3,0.0,0,1,0,1,2,0,0,3,0,2,5,1
1354,19691,j4HDn7pHd4SauRXrARz1vjrq9gR7efiY,fbPkOYLVPtPgIt0MxizjfFJov3JbHyAi,10,22,9,0,7,0,9,0,47,6.714285714285714,1,0.0,2,9,0,7,20,0,0,9,0,18,29,1
1355,19697,94kd1qvIZ0nokZPS6BCV8qxXnL5MM2jB,fbPkOYLVPtPgIt0MxizjfFJov3JbHyAi,82,606,276,83,156,109,93,3,1326,189.42857142857142,17,0.0,83,276,75,156,523,109,8,93,3,590,736,0
1356,19700,WfC8bzRtjtkKnUrmorui57fDTiw7ripx,fbPkOYLVPtPgIt0MxizjfFJov3JbHyAi,1,0,0,0,0,0,1,0,1,0.14285714285714285,1,0.0,0,0,0,0,0,0,0,1,0,0,1,1
1357,19703,PNFwnD5V878zriXX4URfko4zocKM6AxT,fbPkOYLVPtPgIt0MxizjfFJov3JbHyAi,7,5,3,0,2,1,1,0,12,1.7142857142857142,1,0.0,0,3,0,2,5,1,0,1,0,5,7,1
1358,19704,5WAIxgqU8QRTpOrU8O3vmj4h4ZKof8jn,fbPkOYLVPtPgIt0MxizjfFJov3JbHyAi,6,6,2,0,2,3,1,0,14,2.0,1,0.0,3,2,0,2,3,3,0,1,0,7,7,1
1359,19706,ZgQ15hhI1Ucp5464waJfnBAlAZitQ6GS,fbPkOYLVPtPgIt0MxizjfFJov3JbHyAi,30,37,20,19,16,0,13,0,105,15.0,4,0.0,12,20,16,16,25,0,3,13,0,64,41,1
1360,19707,mFpiELMd2y5tbkdxs4m8pKS7gXHb7bIO,fbPkOYLVPtPgIt0MxizjfFJov3JbHyAi,6,3,2,0,2,0,1,0,8,1.1428571428571428,1,0.0,0,2,0,2,3,0,0,1,0,4,4,1
1361,19710,2mdoNlBiXpgUVSmoihAheHl3NISmi738,fbPkOYLVPtPgIt0MxizjfFJov3JbHyAi,91,143,86,41,52,1,29,1,353,50.42857142857143,7,0.0,35,86,38,52,108,1,3,29,1,211,142,1
1362,19711,qqdJa21dgyzvCuC2gEGuhgU9JUiH4Miw,fbPkOYLVPtPgIt0MxizjfFJov3JbHyAi,9,12,5,6,5,5,4,0,37,5.285714285714286,1,0.0,5,5,4,5,7,5,2,4,0,19,18,1
1363,19712,YviwWEN6zon2XUnzizUs5e4hMfvZTKyo,fbPkOYLVPtPgIt0MxizjfFJov3JbHyAi,10,19,10,0,6,4,9,0,48,6.857142857142857,4,0.0,0,10,0,6,19,4,0,9,0,16,32,1
1364,19716,VDczqRqblkMPJmrAoZEhPuTYAP3s4BVi,fbPkOYLVPtPgIt0MxizjfFJov3JbHyAi,8,6,4,0,3,0,5,0,18,2.5714285714285716,2,0.0,0,4,0,3,6,0,0,5,0,7,11,1
1365,19717,vs0vqlNXzuHsqVxOsB15kGfpvGf2pUt3,fbPkOYLVPtPgIt0MxizjfFJov3JbHyAi,1,0,0,0,0,0,1,0,1,0.14285714285714285,1,0.0,0,0,0,0,0,0,0,1,0,0,1,1
1366,19718,E4lbnSGpFm0DLoI5I2cB98rKNvfek7Pe,fbPkOYLVPtPgIt0MxizjfFJov3JbHyAi,9,3,2,0,2,0,6,1,14,2.0,1,0.0,0,2,0,2,3,0,0,6,1,4,10,1
1367,19724,iaR2pnkwyNY3r5zTqD1W39STthtx49ji,fbPkOYLVPtPgIt0MxizjfFJov3JbHyAi,26,56,18,17,16,0,11,0,118,16.857142857142858,4,0.0,23,18,15,16,33,0,2,11,0,72,46,1
1368,19725,47CO43LdBnUCItnxzVzNK8EGYhZB4UEL,fbPkOYLVPtPgIt0MxizjfFJov3JbHyAi,5,2,1,0,1,0,2,0,6,0.8571428571428571,1,0.0,0,1,0,1,2,0,0,2,0,2,4,0
1369,19727,bL3u5qIjoppYFsMUfGswfFLujxnAggge,fbPkOYLVPtPgIt0MxizjfFJov3JbHyAi,51,126,68,36,60,81,34,5,410,58.57142857142857,10,0.0,37,68,35,60,89,81,1,34,5,200,210,0
1370,19728,klABCgiMhTPJ0XO3mm3Xvqo3F5v3JzEw,fbPkOYLVPtPgIt0MxizjfFJov3JbHyAi,2,0,0,0,0,0,2,0,2,0.2857142857142857,1,0.0,0,0,0,0,0,0,0,2,0,0,2,1
1371,19729,GP9uxCl0w0ORUxGcBwBhHCA6EDx2EOSR,fbPkOYLVPtPgIt0MxizjfFJov3JbHyAi,10,13,9,0,6,6,16,1,51,7.285714285714286,2,0.0,0,9,0,6,13,6,0,16,1,15,36,1
1372,19734,PwwEqEv3o1wfWN5Eu8NuK3q82yRAO9LK,fbPkOYLVPtPgIt0MxizjfFJov3JbHyAi,9,4,3,0,3,0,3,0,13,1.8571428571428572,2,0.0,0,3,0,3,4,0,0,3,0,6,7,1
1373,19736,RTFyJMIqIq6xWTPdoUugdDSXlWY0NS3w,fbPkOYLVPtPgIt0MxizjfFJov3JbHyAi,3,0,0,0,0,2,3,0,5,0.7142857142857143,1,0.0,0,0,0,0,0,2,0,3,0,0,5,1
1374,19737,r5nHhhPp8wNqkUKwaWfUvmNqly1MZrKz,fbPkOYLVPtPgIt0MxizjfFJov3JbHyAi,8,12,2,0,2,1,2,0,19,2.7142857142857144,3,0.0,1,2,0,2,11,1,0,2,0,5,14,0
1375,19739,XyD01HhzMuHzP5ArHNJFexoSZMamD6Wh,fbPkOYLVPtPgIt0MxizjfFJov3JbHyAi,6,7,4,0,1,0,3,0,15,2.142857142857143,2,0.0,1,4,0,1,6,0,0,3,0,6,9,1
1376,19740,J0agIiDPDsO7EgNBs76RsZQyZ6XLl2nX,fbPkOYLVPtPgIt0MxizjfFJov3JbHyAi,9,5,5,0,4,0,6,0,20,2.857142857142857,2,0.0,0,5,0,4,5,0,0,6,0,9,11,1
1377,19741,IMwEerHys6R3vOnp3J0coaa20HaLBM5L,fbPkOYLVPtPgIt0MxizjfFJov3JbHyAi,8,8,4,0,2,0,6,0,20,2.857142857142857,2,0.0,1,4,0,2,7,0,0,6,0,7,13,1
1378,19747,5QI6OaFhCHlCtRcFfvDdZQ38fgw6K7ZS,fbPkOYLVPtPgIt0MxizjfFJov3JbHyAi,2,0,0,0,0,0,3,0,3,0.42857142857142855,1,0.0,0,0,0,0,0,0,0,3,0,0,3,1
1379,19749,0artPLh8IkCTAf124kxiUrz2J9bSLV97,fbPkOYLVPtPgIt0MxizjfFJov3JbHyAi,13,23,13,0,4,2,10,1,53,7.571428571428571,5,0.0,3,13,0,4,20,2,0,10,1,20,33,1
1380,19750,g80H6iY57adZtyt3qdJsUFLOZl0two6T,fbPkOYLVPtPgIt0MxizjfFJov3JbHyAi,6,3,1,0,1,0,4,0,9,1.2857142857142858,1,0.0,0,1,0,1,3,0,0,4,0,2,7,1
1381,19751,21WmZ1MYMXM5lnwi17lhbA5W7URRxFf7,fbPkOYLVPtPgIt0MxizjfFJov3JbHyAi,2,0,0,0,0,0,2,0,2,0.2857142857142857,1,0.0,0,0,0,0,0,0,0,2,0,0,2,1
1382,19755,jMt06vkBXL8VPGQpBPqacOfIuLzrVTe6,fbPkOYLVPtPgIt0MxizjfFJov3JbHyAi,14,18,11,5,8,37,7,0,86,12.285714285714286,2,0.0,3,11,4,8,15,37,1,7,0,26,60,1
1383,19756,rYmGXfabWDSzV9Y1YJe1P9bXx90UHqZS,fbPkOYLVPtPgIt0MxizjfFJov3JbHyAi,7,9,2,0,3,0,6,0,20,2.857142857142857,1,0.0,5,2,0,3,4,0,0,6,0,10,10,1
1384,19760,fKydOJi1gInT4LhNbAI1K5Nn83QpbQ9b,fbPkOYLVPtPgIt0MxizjfFJov3JbHyAi,10,6,4,0,3,0,15,1,29,4.142857142857143,3,0.0,0,4,0,3,6,0,0,15,1,7,22,1
1385,19761,2ZVrSpja22JYuBdqG7iHOipKnnGEm2ou,fbPkOYLVPtPgIt0MxizjfFJov3JbHyAi,62,96,48,45,29,41,36,2,297,42.42857142857143,7,0.0,31,48,37,29,65,41,8,36,2,145,152,0
1386,19764,IHJGcg8XuB6HPRBrjHVn1eWwbgo7JSEZ,fbPkOYLVPtPgIt0MxizjfFJov3JbHyAi,26,23,12,18,9,0,5,0,67,9.571428571428571,3,0.0,6,12,18,9,17,0,0,5,0,45,22,1
1387,19765,oZrYS5rqR18A77jULvm9aJ8bGsP88f4h,fbPkOYLVPtPgIt0MxizjfFJov3JbHyAi,57,125,64,39,33,8,35,2,306,43.714285714285715,14,0.0,25,64,33,33,100,8,6,35,2,155,151,0
1388,19770,HneXab7aMQtYruvuxuZ9dNY5QxwlGitq,fbPkOYLVPtPgIt0MxizjfFJov3JbHyAi,17,19,11,12,8,2,11,1,64,9.142857142857142,2,0.0,4,11,9,8,15,2,3,11,1,32,32,1
1389,19772,fKgU6PKVjgAnp4uvGa6MHJe7D2ZYaBc1,fbPkOYLVPtPgIt0MxizjfFJov3JbHyAi,22,61,30,17,26,16,9,3,162,23.142857142857142,5,0.0,21,30,13,26,40,16,4,9,3,90,72,1
1390,19773,VryhTUuSCWlg2ThKmkz8AynIgw8SfZgv,fbPkOYLVPtPgIt0MxizjfFJov3JbHyAi,10,5,3,0,3,0,3,0,14,2.0,1,0.0,0,3,0,3,5,0,0,3,0,6,8,1
1391,19774,R0JUZ056kzFL6PD0dHwCASPDjJEFALuj,fbPkOYLVPtPgIt0MxizjfFJov3JbHyAi,91,237,137,95,99,33,31,3,635,90.71428571428571,13,0.0,65,137,91,99,172,33,4,31,3,392,243,1
1392,19775,tA1lc3vnumj95Nh6FWr8EK0wWDHGYnC2,fbPkOYLVPtPgIt0MxizjfFJov3JbHyAi,23,23,14,10,15,4,18,3,87,12.428571428571429,3,0.0,8,14,7,15,15,4,3,18,3,44,43,1
1393,19778,8b7ZppycC3YQh10hFhgFNseCAwtseLj5,fbPkOYLVPtPgIt0MxizjfFJov3JbHyAi,10,6,4,0,3,0,4,0,17,2.4285714285714284,2,0.0,0,4,0,3,6,0,0,4,0,7,10,0
1394,19784,KqVrk2SHI9QdxCC7nQf6EBD4bfm6dNDK,fbPkOYLVPtPgIt0MxizjfFJov3JbHyAi,39,43,21,25,12,52,27,4,184,26.285714285714285,4,0.0,11,21,21,12,32,52,4,27,4,65,119,1
1395,19786,pVW1QDTezd5CM1iZ8cdugaLwJl6C95dO,fbPkOYLVPtPgIt0MxizjfFJov3JbHyAi,1,0,0,0,0,0,1,0,1,0.14285714285714285,1,0.0,0,0,0,0,0,0,0,1,0,0,1,1
1396,19787,Uud6ejfxjo2wR9C9pIlBSyKMyMrHfe52,fbPkOYLVPtPgIt0MxizjfFJov3JbHyAi,24,30,26,0,21,29,4,0,110,15.714285714285714,8,0.0,0,26,0,21,30,29,0,4,0,47,63,1
1397,19792,gmI36QrP5V0XjdeY5fw2LtMzPgNNn1eX,fbPkOYLVPtPgIt0MxizjfFJov3JbHyAi,12,10,5,5,6,0,2,0,28,4.0,1,0.0,2,5,4,6,8,0,1,2,0,17,11,1
1398,19796,szY7iRYrnZrzBCwm4obBzatvtWaWEKSz,fbPkOYLVPtPgIt0MxizjfFJov3JbHyAi,13,16,10,13,9,0,1,0,49,7.0,1,0.0,5,10,9,9,11,0,4,1,0,33,16,1
1399,19797,kV0etVT4eF07a55Y2wFFrCm2NuKlfy3O,fbPkOYLVPtPgIt0MxizjfFJov3JbHyAi,11,14,7,0,4,0,4,1,30,4.285714285714286,2,0.0,0,7,0,4,14,0,0,4,1,11,19,1
1400,19801,eRM1cqDGfrej4Riud5wVHQPpEv2yAjcd,fbPkOYLVPtPgIt0MxizjfFJov3JbHyAi,12,11,8,0,7,1,3,0,30,4.285714285714286,3,0.0,0,8,0,7,11,1,0,3,0,15,15,1
1401,19802,JOTZzIfdhlRRSJT88VvraViqFb0FOnua,fbPkOYLVPtPgIt0MxizjfFJov3JbHyAi,9,8,5,0,1,0,7,0,21,3.0,2,0.0,0,5,0,1,8,0,0,7,0,6,15,1
1402,19805,mulCI7iOK8lLmqauH7xJJcesnUywr862,fbPkOYLVPtPgIt0MxizjfFJov3JbHyAi,1,0,0,0,0,0,1,0,1,0.14285714285714285,1,0.0,0,0,0,0,0,0,0,1,0,0,1,1
1403,19808,iv92crQZIzkBMlffqmkcGn935WuSz4il,fbPkOYLVPtPgIt0MxizjfFJov3JbHyAi,12,14,7,0,4,1,9,1,36,5.142857142857143,1,0.0,0,7,0,4,14,1,0,9,1,11,25,1
1404,19811,i3UVHHN0j4qIwZlYLBYHJICyHTcdcLCq,fbPkOYLVPtPgIt0MxizjfFJov3JbHyAi,5,2,1,0,1,0,2,0,6,0.8571428571428571,1,0.0,0,1,0,1,2,0,0,2,0,2,4,1
1405,19812,mnOHLhQDMWuHBooceLF0rczqDD9bUim8,fbPkOYLVPtPgIt0MxizjfFJov3JbHyAi,7,8,5,0,3,0,3,0,19,2.7142857142857144,2,0.0,1,5,0,3,7,0,0,3,0,9,10,1
1406,19813,QBgKSCSCtuy3kameVOAw6Wwz0K2iKBbH,fbPkOYLVPtPgIt0MxizjfFJov3JbHyAi,7,1,1,0,1,0,7,0,10,1.4285714285714286,1,0.0,0,1,0,1,1,0,0,7,0,2,8,1
1407,19816,08IVc3h7dXZMEursFSIPoikCC2aZN7Rx,fbPkOYLVPtPgIt0MxizjfFJov3JbHyAi,6,2,1,0,1,0,5,1,10,1.4285714285714286,1,0.0,0,1,0,1,2,0,0,5,1,2,8,1
1408,19817,8FipiYFD5ufymfN3QkHjea5yaJKq4FqA,fbPkOYLVPtPgIt0MxizjfFJov3JbHyAi,14,13,7,0,5,0,14,1,40,5.714285714285714,2,0.0,3,7,0,5,10,0,0,14,1,15,25,1
1409,19826,HuDb7M7dL9QrDMvQSMZiZjXQu7KASVlk,fbPkOYLVPtPgIt0MxizjfFJov3JbHyAi,1,0,0,0,0,0,1,0,1,0.14285714285714285,1,0.0,0,0,0,0,0,0,0,1,0,0,1,1
1410,19830,J19fRobYymSKSws9Yoy23YPes8L6wyrW,fbPkOYLVPtPgIt0MxizjfFJov3JbHyAi,22,22,16,0,10,6,21,3,78,11.142857142857142,4,0.0,0,16,0,10,22,6,0,21,3,26,52,1
1411,19831,TuwawmYF5vKqxlkjFW9KLE2z6pGSYesW,fbPkOYLVPtPgIt0MxizjfFJov3JbHyAi,7,3,2,0,2,0,2,0,9,1.2857142857142858,1,0.0,0,2,0,2,3,0,0,2,0,4,5,1
1412,19832,5SmzJtCsl9zVvD6aNu6O5oGjHDZpcVHV,fbPkOYLVPtPgIt0MxizjfFJov3JbHyAi,5,3,2,0,0,1,3,1,10,1.4285714285714286,1,0.0,0,2,0,0,3,1,0,3,1,2,8,1
1413,19835,ERdNSLuXe4QWBWuCUcfh6NqIoQCrGXv1,fbPkOYLVPtPgIt0MxizjfFJov3JbHyAi,23,21,10,19,10,0,2,0,62,8.857142857142858,3,0.0,7,10,15,10,14,0,4,2,0,42,20,1
1414,19837,iPJRBluqQatkmbuqumnMGE3SRxlXa7A1,fbPkOYLVPtPgIt0MxizjfFJov3JbHyAi,1,0,0,0,0,0,1,0,1,0.14285714285714285,1,0.0,0,0,0,0,0,0,0,1,0,0,1,1
1415,19839,dsDDZP1tTIurmngds776Mxkx99B7QaoD,fbPkOYLVPtPgIt0MxizjfFJov3JbHyAi,8,7,5,0,4,0,3,0,19,2.7142857142857144,2,0.0,0,5,0,4,7,0,0,3,0,9,10,1
1416,19845,FOhKzePMHLals6J3nHBPn1VH8EqTuIWc,fbPkOYLVPtPgIt0MxizjfFJov3JbHyAi,7,3,2,0,2,0,6,0,13,1.8571428571428572,2,0.0,0,2,0,2,3,0,0,6,0,4,9,1
1417,19846,3mL78JhEm154Hwp0XQW8ZVuzbvUw5uCk,fbPkOYLVPtPgIt0MxizjfFJov3JbHyAi,4,2,1,0,0,0,3,0,6,0.8571428571428571,1,0.0,0,1,0,0,2,0,0,3,0,1,5,1
1418,19848,VZNenETJcretQ75QoBMXgygqhUZNWX9e,fbPkOYLVPtPgIt0MxizjfFJov3JbHyAi,7,6,2,0,1,0,2,0,11,1.5714285714285714,1,0.0,0,2,0,1,6,0,0,2,0,3,8,1
1419,19856,cNw6DSimidnnJTy63mT8fC6ow4HuQb5s,fbPkOYLVPtPgIt0MxizjfFJov3JbHyAi,46,91,59,27,32,38,21,2,270,38.57142857142857,4,0.0,24,59,24,32,67,38,3,21,2,139,131,0
1420,19858,j0qtw4MyzPS0BrZiuGQy55Y9HiEw9Wyz,fbPkOYLVPtPgIt0MxizjfFJov3JbHyAi,7,7,2,0,2,0,7,0,18,2.5714285714285716,2,0.0,0,2,0,2,7,0,0,7,0,4,14,1
1421,19862,jWsLxS98Uf5iPgurn9PRvQM3beT2rSkF,fbPkOYLVPtPgIt0MxizjfFJov3JbHyAi,2,0,0,0,0,0,3,0,3,0.42857142857142855,1,0.0,0,0,0,0,0,0,0,3,0,0,3,1
1422,19863,cL4725Y58Cl01IjeOv5CCdtpjNF0EqJp,fbPkOYLVPtPgIt0MxizjfFJov3JbHyAi,1,0,0,0,0,0,1,0,1,0.14285714285714285,1,0.0,0,0,0,0,0,0,0,1,0,0,1,1
1423,19864,xpAxjSreQEJGjM28FJsQcyiEt1VA8RXl,fbPkOYLVPtPgIt0MxizjfFJov3JbHyAi,87,194,80,82,29,23,34,0,442,63.142857142857146,17,0.0,30,80,80,29,164,23,2,34,0,219,223,0
1424,19865,bVTv3LNbSDemleiUP48OewgXg39Jt9HM,fbPkOYLVPtPgIt0MxizjfFJov3JbHyAi,2,0,0,0,0,0,3,0,3,0.42857142857142855,1,0.0,0,0,0,0,0,0,0,3,0,0,3,1
1425,19878,iuOmDEhpvOE7SqnGlPzkF3AFhAsHx7fO,fbPkOYLVPtPgIt0MxizjfFJov3JbHyAi,20,34,10,22,6,0,12,0,84,12.0,5,0.0,9,10,18,6,25,0,4,12,0,43,41,1
1426,19880,7cdSr9CqRrEGZIWG84xbV4x3Kafz72lh,fbPkOYLVPtPgIt0MxizjfFJov3JbHyAi,16,17,7,10,9,1,5,1,50,7.142857142857143,3,0.0,9,7,8,9,8,1,2,5,1,33,17,1
1427,19881,PW9Md9XLqRR5MZXK4hL3T3H1o4IZAcWS,fbPkOYLVPtPgIt0MxizjfFJov3JbHyAi,5,3,1,0,1,0,2,0,7,1.0,1,0.0,0,1,0,1,3,0,0,2,0,2,5,1
1428,19882,bISN9xXdPBM2gxjOPU4uIyceAQnHyeaO,fbPkOYLVPtPgIt0MxizjfFJov3JbHyAi,9,11,3,0,1,0,5,0,20,2.857142857142857,1,0.0,0,3,0,1,11,0,0,5,0,4,16,1
1429,19883,oBB4V7EIN8ossAzWm6ldlqIytEJdobH7,fbPkOYLVPtPgIt0MxizjfFJov3JbHyAi,13,27,16,0,10,53,19,4,129,18.428571428571427,5,0.0,4,16,0,10,23,53,0,19,4,30,99,1
1430,19890,IVtvtdZLBtL9DhFAioWkcCx38OrFXpXg,fbPkOYLVPtPgIt0MxizjfFJov3JbHyAi,48,170,78,55,0,61,57,2,423,60.42857142857143,17,0.0,57,78,52,0,113,61,3,57,2,187,236,0
1431,19891,wgvtQPGwXLcgDRyRFzsNLvjTzjo4pZey,fbPkOYLVPtPgIt0MxizjfFJov3JbHyAi,11,7,4,0,2,1,11,1,26,3.7142857142857144,1,0.0,0,4,0,2,7,1,0,11,1,6,20,1
1432,19892,W2otfyc3X4TPBPK1UZBOKMi0pFwInYnb,fbPkOYLVPtPgIt0MxizjfFJov3JbHyAi,8,2,1,0,1,1,5,1,11,1.5714285714285714,1,0.0,0,1,0,1,2,1,0,5,1,2,9,0
1433,19899,g1LjBGhO06u71QjhH8AiBdRCV0auffeV,fbPkOYLVPtPgIt0MxizjfFJov3JbHyAi,5,2,1,0,1,0,2,0,6,0.8571428571428571,1,0.0,0,1,0,1,2,0,0,2,0,2,4,1
1434,19900,b7PuwalmdIR7gI2f0kgWK9mhLJEyGy0c,fbPkOYLVPtPgIt0MxizjfFJov3JbHyAi,1,0,0,0,0,0,1,0,1,0.14285714285714285,1,0.0,0,0,0,0,0,0,0,1,0,0,1,1
1435,19901,d45S9FtiK3JaUn5gt0gBKZnLs0OGVQHt,fbPkOYLVPtPgIt0MxizjfFJov3JbHyAi,18,13,10,0,10,1,7,1,42,6.0,2,0.0,2,10,0,10,11,1,0,7,1,22,20,1
1436,19902,WaEPHAZo5pH7Npa5iwnKZ2EJATuLkfKt,fbPkOYLVPtPgIt0MxizjfFJov3JbHyAi,17,27,3,0,3,0,8,0,41,5.857142857142857,3,0.0,2,3,0,3,25,0,0,8,0,8,33,1
1437,19904,C7C4g4nHC5w1aNh5moBHlv2F8Oo4TbRT,fbPkOYLVPtPgIt0MxizjfFJov3JbHyAi,11,8,5,0,4,0,2,0,19,2.7142857142857144,1,0.0,0,5,0,4,8,0,0,2,0,9,10,1
1438,19909,eGMQ402zeENVOKkP29KRxs0f1wZX1TvA,fbPkOYLVPtPgIt0MxizjfFJov3JbHyAi,5,4,0,0,0,0,2,0,6,0.8571428571428571,1,0.0,0,0,0,0,4,0,0,2,0,0,6,1
1439,19910,1Epnr53yLJpI4d6wSWAUymSv0Yujn22A,fbPkOYLVPtPgIt0MxizjfFJov3JbHyAi,50,89,44,49,27,1,26,0,236,33.714285714285715,6,0.0,28,44,44,27,61,1,5,26,0,143,93,0
1440,19911,JZFzammsPtqI96gZi5jjWsT1PaVAEh64,fbPkOYLVPtPgIt0MxizjfFJov3JbHyAi,4,2,1,0,1,0,3,0,7,1.0,1,0.0,0,1,0,1,2,0,0,3,0,2,5,1
1441,19913,XbORnKU4LaOdLNHafCieVF22rPhRdsHM,fbPkOYLVPtPgIt0MxizjfFJov3JbHyAi,8,9,5,0,4,0,2,0,20,2.857142857142857,2,0.0,0,5,0,4,9,0,0,2,0,9,11,1
1442,19914,iUELwsAOi144Gv3ZwF4pg4MHhyg4VTy9,fbPkOYLVPtPgIt0MxizjfFJov3JbHyAi,10,6,4,0,3,0,3,0,16,2.2857142857142856,2,0.0,0,4,0,3,6,0,0,3,0,7,9,1
1443,19915,qFnFxVZ0kWnoJ6Z9EGCtfX2XIxJ2ju5D,fbPkOYLVPtPgIt0MxizjfFJov3JbHyAi,9,5,3,0,2,0,8,0,18,2.5714285714285716,2,0.0,0,3,0,2,5,0,0,8,0,5,13,0
1444,19919,RIeL3dVlafJn0CvzFRWYuhAjPOY5jm6q,fbPkOYLVPtPgIt0MxizjfFJov3JbHyAi,8,9,3,0,2,0,4,0,18,2.5714285714285716,1,0.0,0,3,0,2,9,0,0,4,0,5,13,1
1445,19921,3CdjWVi2KulUMxBQEG35wDbgAd5vv1rf,fbPkOYLVPtPgIt0MxizjfFJov3JbHyAi,1,0,0,0,0,0,1,0,1,0.14285714285714285,1,0.0,0,0,0,0,0,0,0,1,0,0,1,1
1446,19922,1qrewX2JRhRs3lyeTFWMYnwQw6V9CpLd,fbPkOYLVPtPgIt0MxizjfFJov3JbHyAi,12,9,5,0,4,0,4,0,22,3.142857142857143,2,0.0,0,5,0,4,9,0,0,4,0,9,13,1
1447,19923,a0YvhqmPpF6B62CVp5XUUUyQ2cFSSLDq,fbPkOYLVPtPgIt0MxizjfFJov3JbHyAi,7,8,6,0,5,4,3,0,26,3.7142857142857144,2,0.0,0,6,0,5,8,4,0,3,0,11,15,1
1448,19924,OT5T42YlAbCtocwISa5ev3ROMYVra29q,fbPkOYLVPtPgIt0MxizjfFJov3JbHyAi,9,8,6,0,5,3,9,0,31,4.428571428571429,3,0.0,0,6,0,5,8,3,0,9,0,11,20,1
1449,19925,u82lBhpDxJIwlZISEntCxj1zgVFdW0vT,fbPkOYLVPtPgIt0MxizjfFJov3JbHyAi,1,0,0,0,0,0,5,0,5,0.7142857142857143,2,0.0,0,0,0,0,0,0,0,5,0,0,5,1
1450,19927,tfmBOfTcprRGNfQ7gzFBd9blOJuDxGOv,fbPkOYLVPtPgIt0MxizjfFJov3JbHyAi,1,0,0,0,0,0,1,0,1,0.14285714285714285,1,0.0,0,0,0,0,0,0,0,1,0,0,1,1
1451,19929,rVO8IsFZOLqwyY7i49TyObO4q8Yse38O,fbPkOYLVPtPgIt0MxizjfFJov3JbHyAi,23,30,1,19,1,8,10,1,70,10.0,4,0.0,8,1,16,1,22,8,3,10,1,26,44,1
1452,19930,5YTEHfbdjCMCzr5G677ZGUzXcQxELgAb,fbPkOYLVPtPgIt0MxizjfFJov3JbHyAi,5,3,2,0,2,0,3,0,10,1.4285714285714286,2,0.0,0,2,0,2,3,0,0,3,0,4,6,1
1453,19931,Mae23dMejP7a3ejG0UsFTeoQgkbLs5l7,fbPkOYLVPtPgIt0MxizjfFJov3JbHyAi,2,0,0,0,0,0,4,0,4,0.5714285714285714,1,0.0,0,0,0,0,0,0,0,4,0,0,4,1
1454,19944,tShEWwQUmNvdJJLgb6IWQwSvspfEXM5K,fbPkOYLVPtPgIt0MxizjfFJov3JbHyAi,8,6,4,0,2,0,3,0,15,2.142857142857143,2,0.0,0,4,0,2,6,0,0,3,0,6,9,1
1455,19945,k6ezCrD5h8una2gKZ9FLMwuP5gpk8HYa,fbPkOYLVPtPgIt0MxizjfFJov3JbHyAi,8,3,2,0,2,0,5,0,12,1.7142857142857142,1,0.0,0,2,0,2,3,0,0,5,0,4,8,1
1456,19946,l9HZDhlAzMA7SQE77dy0GfpgPqHQZI8y,fbPkOYLVPtPgIt0MxizjfFJov3JbHyAi,34,90,31,37,28,14,30,1,231,33.0,7,0.0,39,31,31,28,51,14,6,30,1,129,102,0
1457,19950,ok15ssTMon44FKUffK29mVEN6xTGU7F9,fbPkOYLVPtPgIt0MxizjfFJov3JbHyAi,4,2,0,0,0,0,2,0,4,0.5714285714285714,1,0.0,0,0,0,0,2,0,0,2,0,0,4,1
1458,19952,qzE4xRGg4xgP1uXuFdpBCVtFm7DMRWEv,fbPkOYLVPtPgIt0MxizjfFJov3JbHyAi,21,80,0,50,18,22,20,6,196,28.0,2,0.0,49,0,34,18,31,22,16,20,6,101,95,1
1459,19954,eL4FSQJCTtWaJ5Qlsbb1oH9XvIKsOuUy,fbPkOYLVPtPgIt0MxizjfFJov3JbHyAi,9,3,2,0,2,5,6,0,18,2.5714285714285716,1,0.0,0,2,0,2,3,5,0,6,0,4,14,1
1460,19957,1dkRu3NI0VUWfhY3RmHWMkMxYXCnS1Uj,fbPkOYLVPtPgIt0MxizjfFJov3JbHyAi,11,14,10,0,9,1,10,3,47,6.714285714285714,1,0.0,2,10,0,9,12,1,0,10,3,21,26,1
1461,20043,qIocZKknaEHoCEEqTwKDXMoKLprrYhO4,5Gyp41oLVo7Gg7vF4vpmggWP5MU70QO6,6,6,2,0,2,0,1,0,11,1.5714285714285714,1,0.0,0,2,0,2,6,0,0,1,0,4,7,1
1462,20048,CIjZVb8iJSeRVF4KWC0hvOeGnb2qkTW6,5Gyp41oLVo7Gg7vF4vpmggWP5MU70QO6,15,32,17,11,7,0,7,0,74,10.571428571428571,5,0.0,2,17,7,7,30,0,4,7,0,33,41,1
1463,20059,VkAVvn7k93vjjseI32me2kHBgfQ0kdc6,5Gyp41oLVo7Gg7vF4vpmggWP5MU70QO6,15,34,12,8,6,14,7,0,81,11.571428571428571,4,0.0,14,12,5,6,20,14,3,7,0,37,44,1
1464,20061,qunpqUxobLJx6Y8utSfs2dqDzCVpWpAQ,5Gyp41oLVo7Gg7vF4vpmggWP5MU70QO6,13,21,9,0,9,28,10,1,78,11.142857142857142,4,0.0,6,9,0,9,15,28,0,10,1,24,54,1
1465,20063,NzJuOfalEsOT54AavPrqSe3rsSE0cQkZ,5Gyp41oLVo7Gg7vF4vpmggWP5MU70QO6,4,2,1,0,1,0,1,0,5,0.7142857142857143,1,0.0,0,1,0,1,2,0,0,1,0,2,3,1
1466,20065,WDjKwLQgCw0UQT2CtXETzK9vLgBdL9uW,5Gyp41oLVo7Gg7vF4vpmggWP5MU70QO6,10,7,4,0,2,0,5,0,18,2.5714285714285716,2,0.0,0,4,0,2,7,0,0,5,0,6,12,1
1467,20067,hdKqkkWKrDzbKE9btGChBqiCfsTwp68E,5Gyp41oLVo7Gg7vF4vpmggWP5MU70QO6,47,199,85,13,68,42,63,6,476,68.0,12,0.0,96,85,11,68,103,42,2,63,6,260,216,1
1468,20071,CD5qGdJcyhdSPxUBqUX1ekd9HG7T3yUd,5Gyp41oLVo7Gg7vF4vpmggWP5MU70QO6,15,17,10,5,6,0,6,0,44,6.285714285714286,4,0.0,3,10,4,6,14,0,1,6,0,23,21,1
1469,20088,d9iF5wamCJyapOBe9zIdFXXofKiHZBFF,5Gyp41oLVo7Gg7vF4vpmggWP5MU70QO6,33,163,67,24,22,69,46,5,396,56.57142857142857,6,0.0,32,67,15,22,131,69,9,46,5,136,260,1
1470,20097,eyE0pR8OFcQU5RgHSRKYOtNQv60KOjOW,5Gyp41oLVo7Gg7vF4vpmggWP5MU70QO6,18,34,24,4,16,8,13,1,100,14.285714285714286,2,0.0,4,24,3,16,30,8,1,13,1,47,53,1
1471,20099,yy3mnhQdz8UKZ45nbn0h9FPjCmDR9px9,5Gyp41oLVo7Gg7vF4vpmggWP5MU70QO6,21,29,17,0,8,15,14,1,84,12.0,6,0.0,1,17,0,8,28,15,0,14,1,26,58,1
1472,20104,25eG0radMtgfbDURkwAcWJxELIokxKPp,5Gyp41oLVo7Gg7vF4vpmggWP5MU70QO6,4,5,2,0,0,0,1,0,8,1.1428571428571428,1,0.0,0,2,0,0,5,0,0,1,0,2,6,1
1473,20115,ITvb0EWV8ZZ88RI4SBwUoVbHLyVcwZRP,5Gyp41oLVo7Gg7vF4vpmggWP5MU70QO6,20,39,15,3,10,6,4,0,77,11.0,4,0.0,16,15,3,10,23,6,0,4,0,44,33,1
1474,20130,VeC3hCWeY1E7Ue4F0xd5fbrxtVODX7yh,5Gyp41oLVo7Gg7vF4vpmggWP5MU70QO6,7,6,4,0,3,0,2,0,15,2.142857142857143,2,0.0,0,4,0,3,6,0,0,2,0,7,8,1
1475,20142,OyfGRbQeIfHudT9dftM6VmMNaqaBni2W,5Gyp41oLVo7Gg7vF4vpmggWP5MU70QO6,1,0,0,0,0,0,1,0,1,0.14285714285714285,1,0.0,0,0,0,0,0,0,0,1,0,0,1,1
1476,20154,c2xJclWCPBe6qCkY4ZnIBuTmDp4MnYP6,5Gyp41oLVo7Gg7vF4vpmggWP5MU70QO6,8,9,3,2,2,0,1,0,17,2.4285714285714284,1,0.0,5,3,1,2,4,0,1,1,0,11,6,1
1477,20155,tCH7WvGXMpRKTElgtTaIs3TIobop03rV,5Gyp41oLVo7Gg7vF4vpmggWP5MU70QO6,5,4,1,0,1,0,1,0,7,1.0,1,0.0,0,1,0,1,4,0,0,1,0,2,5,1
1478,20156,leoy5SuUwpFaiyPkcOUrWqQIBdmhP9sW,5Gyp41oLVo7Gg7vF4vpmggWP5MU70QO6,12,23,18,0,7,0,8,0,56,8.0,2,0.0,0,18,0,7,23,0,0,8,0,25,31,1
1479,20165,WKPeAIiAXdvhirmkXGacjyUoBPaY5Fsx,5Gyp41oLVo7Gg7vF4vpmggWP5MU70QO6,12,14,9,3,4,13,5,1,49,7.0,2,0.0,2,9,2,4,12,13,1,5,1,17,32,1
1480,20166,teqaLfbDNSTWdzUpiU4jG8tePhAuvNN3,5Gyp41oLVo7Gg7vF4vpmggWP5MU70QO6,8,3,1,0,1,2,7,1,15,2.142857142857143,1,0.0,0,1,0,1,3,2,0,7,1,2,13,1
1481,20171,KG6oNmBFEPQJXhvAD0RPIYEBC1kCcYzu,5Gyp41oLVo7Gg7vF4vpmggWP5MU70QO6,15,22,9,2,4,5,6,1,49,7.0,2,0.0,5,9,2,4,17,5,0,6,1,20,29,1
1482,20173,M3gs30iLAcs0soWjrTQtiCP05lYedJ7C,5Gyp41oLVo7Gg7vF4vpmggWP5MU70QO6,3,0,0,0,0,1,2,0,3,0.42857142857142855,1,0.0,0,0,0,0,0,1,0,2,0,0,3,1
1483,20177,RJzT6SARrbUV1CbkLbry2DisVfGIAlEE,5Gyp41oLVo7Gg7vF4vpmggWP5MU70QO6,14,13,1,2,6,2,6,1,31,4.428571428571429,1,0.0,7,1,2,6,6,2,0,6,1,16,15,1
1484,20416,eOKSQ8jJCz78XIkddlLHd1RyyYmWVNK3,3VkHkmOtom3jM2wCu94xgzzu1d6Dn7or,16,14,8,0,5,0,11,0,38,5.428571428571429,3,0.0,0,8,0,5,14,0,0,11,0,13,25,1
1485,20422,adDGX99l1n1iBt8AmYVD4kO1enVdrmvn,3VkHkmOtom3jM2wCu94xgzzu1d6Dn7or,97,189,66,83,63,71,45,4,521,74.42857142857143,11,0.0,99,66,72,63,90,71,11,45,4,300,221,0
1486,20426,1La5rp9ZSz9cfpqCRJiC01Rwvuq5VVrf,3VkHkmOtom3jM2wCu94xgzzu1d6Dn7or,94,284,88,179,84,12,70,1,718,102.57142857142857,7,0.0,139,88,171,84,145,12,8,70,1,482,236,0
1487,20443,UuzHHE4BsvJ3uANRLbVyAeeeheL79bl6,3VkHkmOtom3jM2wCu94xgzzu1d6Dn7or,1,0,0,0,0,0,1,0,1,0.14285714285714285,1,0.0,0,0,0,0,0,0,0,1,0,0,1,1
1488,20494,5PZBmKEXGmnHhrok7M9vaGB06CAzFVOO,5Gyp41oLVo7Gg7vF4vpmggWP5MU70QO6,35,106,31,0,21,0,22,0,180,25.714285714285715,9,0.0,22,31,0,21,84,0,0,22,0,74,106,0
1489,20528,zIUWFUBiruRlI0YsqK1cB5MqV7D5JbaQ,5Gyp41oLVo7Gg7vF4vpmggWP5MU70QO6,8,6,4,0,3,0,4,0,17,2.4285714285714284,1,0.0,0,4,0,3,6,0,0,4,0,7,10,0
1490,20584,EytS791DMHkWPyEwKtiaQ332ujzLnBwF,5Gyp41oLVo7Gg7vF4vpmggWP5MU70QO6,61,642,228,55,100,142,130,9,1306,186.57142857142858,20,0.0,132,228,49,100,510,142,6,130,9,509,797,0
1491,20603,Sl5PevsrNgep5w1PJpEG06fmMj1RG52q,5Gyp41oLVo7Gg7vF4vpmggWP5MU70QO6,5,2,1,0,1,3,4,0,11,1.5714285714285714,1,0.0,0,1,0,1,2,3,0,4,0,2,9,1
1492,20626,HpQ6m991ijEworYjOxjwjrx2uQeTX9GV,5Gyp41oLVo7Gg7vF4vpmggWP5MU70QO6,5,2,1,0,1,0,3,0,7,1.0,1,0.0,0,1,0,1,2,0,0,3,0,2,5,1
1493,20627,03dVzxLI1AumV0kSjoDxUD9fYstLoIRm,5Gyp41oLVo7Gg7vF4vpmggWP5MU70QO6,27,104,32,25,7,14,34,1,217,31.0,11,0.0,12,32,22,7,92,14,3,34,1,73,144,0
1494,20671,S2q1gEPtloNcMfcAwTCrDjaeEJ3ox2aC,5Gyp41oLVo7Gg7vF4vpmggWP5MU70QO6,91,446,226,124,76,285,132,4,1293,184.71428571428572,22,0.0,120,226,107,76,326,285,17,132,4,529,764,0
1495,20694,x0VzAeYdlywtGLqE1HF68qQMYZTLfsw9,5Gyp41oLVo7Gg7vF4vpmggWP5MU70QO6,59,146,71,11,41,4,38,3,314,44.857142857142854,15,0.0,39,71,9,41,107,4,2,38,3,160,154,0
1496,20715,O4X95fQpNzvt0UCyuWEl2S7R4akLhSmP,5Gyp41oLVo7Gg7vF4vpmggWP5MU70QO6,7,6,3,0,1,0,7,0,17,2.4285714285714284,3,0.0,0,3,0,1,6,0,0,7,0,4,13,1
1497,20720,be2BGciqfmGYmo9sjhfujJEyJqmHKX4L,5Gyp41oLVo7Gg7vF4vpmggWP5MU70QO6,13,14,1,0,0,0,2,0,17,2.4285714285714284,1,0.0,1,1,0,0,13,0,0,2,0,2,15,1
1498,20735,SY8PjWAcViY3TAxvifjZF4drAUdDweaG,5Gyp41oLVo7Gg7vF4vpmggWP5MU70QO6,43,93,42,98,18,10,17,2,280,40.0,4,0.0,32,42,77,18,61,10,21,17,2,169,111,1
1499,20752,HDx7XT9cwQtHtGFe0Ylk6QLaCz2f0GRa,5Gyp41oLVo7Gg7vF4vpmggWP5MU70QO6,29,126,74,57,39,149,24,3,472,67.42857142857143,12,0.0,31,74,37,39,95,149,20,24,3,181,291,0
1500,20759,0W851bk6FoM6Xqxl9tkBScwPhSY3L9ta,5Gyp41oLVo7Gg7vF4vpmggWP5MU70QO6,10,6,4,0,0,0,7,2,19,2.7142857142857144,2,0.0,0,4,0,0,6,0,0,7,2,4,15,1
1501,20917,O2rUq90V5lR36PY1lXYAoUFT98vBmg1w,5Gyp41oLVo7Gg7vF4vpmggWP5MU70QO6,10,19,6,0,4,0,4,0,33,4.714285714285714,3,0.0,1,6,0,4,18,0,0,4,0,11,22,0
1502,20948,PuyGNo8qc6xk0x7N225chheH1U0jpEmh,5Gyp41oLVo7Gg7vF4vpmggWP5MU70QO6,12,13,4,7,4,0,8,0,36,5.142857142857143,4,0.0,2,4,5,4,11,0,2,8,0,15,21,1
1503,20957,C41dmWc6HeeNkDNSm8CZALCNogkmWJ1z,5Gyp41oLVo7Gg7vF4vpmggWP5MU70QO6,9,25,0,0,0,0,7,1,33,4.714285714285714,3,0.0,1,0,0,0,24,0,0,7,1,1,32,0
1504,21001,uKSoXEJNhPBaLwogtj5AI2INbh67Hhkx,5Gyp41oLVo7Gg7vF4vpmggWP5MU70QO6,7,3,2,0,2,0,2,0,9,1.2857142857142858,1,0.0,0,2,0,2,3,0,0,2,0,4,5,1
1505,21017,tLP5rkZGy3HXF1Jaor7VJqja6xXsYWE2,5Gyp41oLVo7Gg7vF4vpmggWP5MU70QO6,14,21,8,10,7,0,1,0,47,6.714285714285714,1,0.0,4,8,5,7,17,0,5,1,0,24,23,0
1506,21057,opH3DZ3uCmoJwuaHmCeQ8GdADxdJdHXo,5Gyp41oLVo7Gg7vF4vpmggWP5MU70QO6,6,3,2,0,2,0,1,0,8,1.1428571428571428,1,0.0,0,2,0,2,3,0,0,1,0,4,4,1
1507,21064,fK0ybxlrUhmgrAr6gFQPIfSHLrJ4RdyL,5Gyp41oLVo7Gg7vF4vpmggWP5MU70QO6,20,95,38,18,20,9,25,1,206,29.428571428571427,13,0.0,37,38,12,20,58,9,6,25,1,107,99,0
1508,21095,YehuiIJSKXIiDi9yLjlODMN0AsaxnPwr,5Gyp41oLVo7Gg7vF4vpmggWP5MU70QO6,13,11,4,2,4,0,3,0,24,3.4285714285714284,2,0.0,3,4,1,4,8,0,1,3,0,12,12,0
1509,21097,oaoj9be4jW2Hot8wYgYrzLRvB0RU4KYy,5Gyp41oLVo7Gg7vF4vpmggWP5MU70QO6,22,48,18,14,8,0,20,0,108,15.428571428571429,14,0.0,16,18,9,8,32,0,5,20,0,51,57,0
1510,21146,e12uQn96OlYfknMdqSXCXdImglIj4IRR,5Gyp41oLVo7Gg7vF4vpmggWP5MU70QO6,76,631,368,57,111,769,426,8,2370,338.57142857142856,29,0.0,113,368,42,111,518,769,15,426,8,634,1736,0
1511,21152,gOLd0TJ7VBK1ACPs2m2Ll9XNi0z0ZlSW,5Gyp41oLVo7Gg7vF4vpmggWP5MU70QO6,9,4,3,0,3,0,3,0,13,1.8571428571428572,1,0.0,0,3,0,3,4,0,0,3,0,6,7,0
1512,21168,7ZMduaVYihdhUAhjPf5gtCPmPeHkcI6t,5Gyp41oLVo7Gg7vF4vpmggWP5MU70QO6,25,34,15,24,6,30,9,5,123,17.571428571428573,4,0.0,10,15,13,6,24,30,11,9,5,44,79,0
1513,21185,ztoDdWXOMNddavwJ1YAGprIc7Ewm1FkP,5Gyp41oLVo7Gg7vF4vpmggWP5MU70QO6,19,56,23,19,6,1,16,4,125,17.857142857142858,9,0.0,19,23,15,6,37,1,4,16,4,63,62,0
1514,21187,eZgbWFMeI0otfUV1lMfDbtMKCRIv32Fs,5Gyp41oLVo7Gg7vF4vpmggWP5MU70QO6,1,0,0,0,0,0,1,0,1,0.14285714285714285,1,0.0,0,0,0,0,0,0,0,1,0,0,1,1
1515,21241,QbQngQMAL3BNHIXjcg1taH4YCWBJJPbj,5Gyp41oLVo7Gg7vF4vpmggWP5MU70QO6,76,130,62,66,33,7,44,0,342,48.857142857142854,11,0.0,42,62,58,33,88,7,8,44,0,195,147,0
1516,21249,ZjjzblWLBhpCB41WVkrtllAfmPXPK6bc,5Gyp41oLVo7Gg7vF4vpmggWP5MU70QO6,1,0,0,0,0,0,1,0,1,0.14285714285714285,1,0.0,0,0,0,0,0,0,0,1,0,0,1,1
1517,21343,mZH0122lLzXNagyBw31ZHMe1GS3GUi9h,5Gyp41oLVo7Gg7vF4vpmggWP5MU70QO6,7,2,1,0,1,0,6,0,10,1.4285714285714286,1,0.0,0,1,0,1,2,0,0,6,0,2,8,0
1518,21469,5oy5I8Xh5KkzBBzgBTkYXJ5uADqnzeVC,7GRhBDsirIGkRZBtSMEzNTyDr2JQm4xx,110,290,93,169,76,31,24,0,683,97.57142857142857,12,0.0,112,93,136,76,178,31,33,24,0,417,266,0
1519,21478,43nq30xhRsgmZVAWkH8Zjb7IyZDGRDeY,7GRhBDsirIGkRZBtSMEzNTyDr2JQm4xx,119,308,95,162,85,94,38,0,782,111.71428571428571,12,0.0,166,95,143,85,142,94,19,38,0,489,293,0
1520,21480,gVgKclRs9U0S4Q8p4FYoky4COwDqIiNN,7GRhBDsirIGkRZBtSMEzNTyDr2JQm4xx,38,81,24,28,14,16,13,2,178,25.428571428571427,3,0.0,34,24,15,14,47,16,13,13,2,87,91,0
1521,21498,pqUcxq00SFcjmnxHDdHJfvpMD3HzyhM8,7GRhBDsirIGkRZBtSMEzNTyDr2JQm4xx,65,133,58,75,43,25,15,3,352,50.285714285714285,6,0.0,45,58,54,43,88,25,21,15,3,200,152,1
1522,21499,L74tKRZpBi1qsh0NM3EwE5D87acCLK8s,7GRhBDsirIGkRZBtSMEzNTyDr2JQm4xx,112,186,72,206,26,0,46,0,536,76.57142857142857,10,0.0,86,72,180,26,100,0,26,46,0,364,172,0
1523,21500,SkSNdONKSsRL2ZUQhM3bWRg6jfQsm6hV,7GRhBDsirIGkRZBtSMEzNTyDr2JQm4xx,31,30,15,0,15,1,9,0,70,10.0,4,0.0,9,15,0,15,21,1,0,9,0,39,31,1
1524,21503,PUFh3BsQaDVIJMDvwsFTqkrgAzvjO9ME,7GRhBDsirIGkRZBtSMEzNTyDr2JQm4xx,17,21,11,0,5,9,15,0,61,8.714285714285714,7,0.0,2,11,0,5,19,9,0,15,0,18,43,1
1525,21509,xQUfEioM1SWfzt7GPks06vCol3vnHwj2,7GRhBDsirIGkRZBtSMEzNTyDr2JQm4xx,26,27,3,6,2,1,10,0,49,7.0,1,0.0,2,3,3,2,25,1,3,10,0,10,39,1
1526,21525,jx3xuttzjsapcmXloFswnvznadokOMWC,7GRhBDsirIGkRZBtSMEzNTyDr2JQm4xx,2,0,0,0,0,0,2,0,2,0.2857142857142857,1,0.0,0,0,0,0,0,0,0,2,0,0,2,1
1527,21528,S5RuYbQmA5K156juNY12D97yGDmISJaQ,7GRhBDsirIGkRZBtSMEzNTyDr2JQm4xx,50,154,3,65,1,1,14,1,239,34.142857142857146,7,0.0,66,3,47,1,88,1,18,14,1,117,122,0
1528,21533,zqwrod4FlqaduP76a40P1VYHXufy1EKD,7GRhBDsirIGkRZBtSMEzNTyDr2JQm4xx,8,5,3,0,1,5,7,1,22,3.142857142857143,2,0.0,1,3,0,1,4,5,0,7,1,5,17,0
1529,21542,1vc4mzvvPXHXb8S531cIWrSOSh2pxuKf,7GRhBDsirIGkRZBtSMEzNTyDr2JQm4xx,1,0,0,0,0,0,1,0,1,0.14285714285714285,1,0.0,0,0,0,0,0,0,0,1,0,0,1,1
1530,21544,9yOmrZmCy5JntLIiSDxWkgYcXOxXcJja,7GRhBDsirIGkRZBtSMEzNTyDr2JQm4xx,1,0,0,0,0,0,1,0,1,0.14285714285714285,1,0.0,0,0,0,0,0,0,0,1,0,0,1,1
1531,21566,r0xLQZJ7XErj8hBxXhgtLAa0ZIpucchx,7GRhBDsirIGkRZBtSMEzNTyDr2JQm4xx,28,31,18,12,13,0,3,0,77,11.0,4,0.0,9,18,6,13,22,0,6,3,0,46,31,0
1532,21731,duCgCLehWZAcuj5LEq7x7sJx1orDCK54,7GRhBDsirIGkRZBtSMEzNTyDr2JQm4xx,14,11,1,0,1,0,2,0,15,2.142857142857143,2,0.0,0,1,0,1,11,0,0,2,0,2,13,1
1533,21832,W5CVKONt5qsYlbCwSDDjPmuQMWPx8PFD,7GRhBDsirIGkRZBtSMEzNTyDr2JQm4xx,31,56,20,14,18,0,14,0,122,17.428571428571427,3,0.0,11,20,7,18,45,0,7,14,0,56,66,0
1534,21895,kQcHT9XjbeNVxuKuAz9nk02Q91AkSUCM,7GRhBDsirIGkRZBtSMEzNTyDr2JQm4xx,12,16,5,7,3,1,2,0,34,4.857142857142857,1,0.0,10,5,6,3,6,1,1,2,0,24,10,1
1535,21968,xYZJv26kEF7oZiNSoEZMnXHo33iYNlMJ,7GRhBDsirIGkRZBtSMEzNTyDr2JQm4xx,10,22,12,6,2,0,3,0,45,6.428571428571429,1,0.0,6,12,4,2,16,0,2,3,0,24,21,1
1536,21998,7MDrIAC0QY6MecoCDUshePjpChHSFKAj,7GRhBDsirIGkRZBtSMEzNTyDr2JQm4xx,32,45,3,26,8,1,4,0,87,12.428571428571429,4,0.0,20,3,13,8,25,1,13,4,0,44,43,1
1537,22007,eovSKdG09ZHYTXNtS1zUIy1RfsRsCibs,7GRhBDsirIGkRZBtSMEzNTyDr2JQm4xx,163,932,339,359,206,2494,304,9,4643,663.2857142857143,23,0.0,454,339,267,206,478,2494,92,304,9,1266,3377,0
1538,22020,xdfT7UfbG0ewFi6FNN3zlNGBGpobyBrO,7GRhBDsirIGkRZBtSMEzNTyDr2JQm4xx,18,22,2,0,2,0,4,0,30,4.285714285714286,3,0.0,0,2,0,2,22,0,0,4,0,4,26,1
1539,22064,CGrk3ociol4MlctElZCSqn1gSvH3cMLH,7GRhBDsirIGkRZBtSMEzNTyDr2JQm4xx,5,2,1,0,1,0,2,0,6,0.8571428571428571,1,0.0,0,1,0,1,2,0,0,2,0,2,4,1
1540,22130,lw56FfuS5fUETVCyRkCnysAZop6MzvUe,7GRhBDsirIGkRZBtSMEzNTyDr2JQm4xx,15,27,10,4,3,4,9,0,57,8.142857142857142,4,0.0,8,10,3,3,19,4,1,9,0,24,33,0
1541,22139,sa9w6VcA4PxIhAJp2KzTSPJsL0X03ZNr,7GRhBDsirIGkRZBtSMEzNTyDr2JQm4xx,4,2,0,0,0,0,2,0,4,0.5714285714285714,1,0.0,0,0,0,0,2,0,0,2,0,0,4,1
1542,22148,IA6nFLwiYdBOXKobyV12AjVhFzxFaVpR,7GRhBDsirIGkRZBtSMEzNTyDr2JQm4xx,44,57,30,37,16,0,14,0,154,22.0,6,0.0,20,30,30,16,37,0,7,14,0,96,58,1
1543,22218,qpd1RINX0ghAugS9ZiQmRvWMQe2xJWfG,7GRhBDsirIGkRZBtSMEzNTyDr2JQm4xx,44,127,5,44,11,8,8,0,203,29.0,4,0.0,72,5,40,11,55,8,4,8,0,128,75,1
1544,22281,2cexeNbOsPyJY48G2QQ55NGzjHdqCk58,7GRhBDsirIGkRZBtSMEzNTyDr2JQm4xx,5,3,1,0,1,0,2,0,7,1.0,1,0.0,0,1,0,1,3,0,0,2,0,2,5,1
1545,22323,03GypNcV97nnANHSdnYU2JoGrwMsJjjG,5Gyp41oLVo7Gg7vF4vpmggWP5MU70QO6,46,168,110,55,31,232,32,4,632,90.28571428571429,8,0.0,42,110,44,31,126,232,11,32,4,227,405,0
1546,22333,M5c09jIn57vzZdodGoiXc2t3GBHKnEdj,5Gyp41oLVo7Gg7vF4vpmggWP5MU70QO6,1,0,0,0,0,0,1,0,1,0.14285714285714285,1,0.0,0,0,0,0,0,0,0,1,0,0,1,1
1547,22335,Tlq0qO6nXBDLjUKWSbwB4aDjlXu6yQ8B,5Gyp41oLVo7Gg7vF4vpmggWP5MU70QO6,1,0,0,0,0,0,1,0,1,0.14285714285714285,1,0.0,0,0,0,0,0,0,0,1,0,0,1,1
1548,22340,n48rQnATxELZcL0zBXDCQ5sZvWdVix8A,5Gyp41oLVo7Gg7vF4vpmggWP5MU70QO6,14,21,9,8,2,14,11,4,69,9.857142857142858,3,0.0,8,9,6,2,13,14,2,11,4,25,44,1
1549,22343,eATEjH6ls04OwwQEb2HkWiYXd1crpI5u,5Gyp41oLVo7Gg7vF4vpmggWP5MU70QO6,7,25,14,0,0,0,5,0,44,6.285714285714286,4,0.0,4,14,0,0,21,0,0,5,0,18,26,1
1550,22380,ozDqAa9NR19upljNiYSY9USOVIbRcORV,5Gyp41oLVo7Gg7vF4vpmggWP5MU70QO6,5,2,1,0,1,0,2,0,6,0.8571428571428571,1,0.0,0,1,0,1,2,0,0,2,0,2,4,0
1551,22443,EEKRPW8tn9Mg3QBn5MHwc7463f6P9lSa,5Gyp41oLVo7Gg7vF4vpmggWP5MU70QO6,4,2,0,0,0,0,4,0,6,0.8571428571428571,1,0.0,0,0,0,0,2,0,0,4,0,0,6,1
1552,22456,sK6gPt4M5YY6zXFjM4ov4x53oBKBEf7K,5Gyp41oLVo7Gg7vF4vpmggWP5MU70QO6,9,13,6,0,4,0,13,0,36,5.142857142857143,4,0.0,3,6,0,4,10,0,0,13,0,13,23,1
1553,22476,Q8lgDaE6CB6Qe5bNGFRY9Gtyuy1mU1jD,5Gyp41oLVo7Gg7vF4vpmggWP5MU70QO6,12,23,3,3,0,0,7,0,36,5.142857142857143,2,0.0,5,3,3,0,18,0,0,7,0,11,25,1
1554,22480,3oOqBk0mNUyJOixMnwNMAtDLNYAAzxVe,5Gyp41oLVo7Gg7vF4vpmggWP5MU70QO6,11,9,6,0,2,3,4,0,24,3.4285714285714284,2,0.0,0,6,0,2,9,3,0,4,0,8,16,1
1555,22515,cr5SiKXKH3eaQWReetZzUWaOld962waD,5Gyp41oLVo7Gg7vF4vpmggWP5MU70QO6,19,97,60,44,13,36,34,1,285,40.714285714285715,8,0.0,26,60,30,13,71,36,14,34,1,129,156,1
1556,22516,eOxm8XEI11Xs6eiBi1Nu5QzIagZXwEm9,5Gyp41oLVo7Gg7vF4vpmggWP5MU70QO6,19,27,17,0,5,10,9,0,68,9.714285714285714,6,0.0,1,17,0,5,26,10,0,9,0,23,45,0
1557,22551,62gWLZfO1hlvqiqA2FxcKx1rgbEBBe8F,5Gyp41oLVo7Gg7vF4vpmggWP5MU70QO6,1,0,0,0,0,0,1,0,1,0.14285714285714285,1,0.0,0,0,0,0,0,0,0,1,0,0,1,1
1558,22581,4rwe5BmciR8qkFj7YwyJ3a5aK2xp9xod,5Gyp41oLVo7Gg7vF4vpmggWP5MU70QO6,6,4,2,0,1,0,3,0,10,1.4285714285714286,2,0.0,0,2,0,1,4,0,0,3,0,3,7,1
1559,22585,HWY3GUChwPk4DS7QwwTsaS95hGhLWs4z,5Gyp41oLVo7Gg7vF4vpmggWP5MU70QO6,13,15,7,0,4,3,9,1,39,5.571428571428571,1,0.0,2,7,0,4,13,3,0,9,1,13,26,1
1560,22605,PF1vEW7ED75SvwErjajgQNwE9nRveOrK,5Gyp41oLVo7Gg7vF4vpmggWP5MU70QO6,1,0,0,0,0,0,2,0,2,0.2857142857142857,1,0.0,0,0,0,0,0,0,0,2,0,0,2,0
1561,22631,PFlXkj37sziMD1CZgqKLg1p2NiL2VluN,5Gyp41oLVo7Gg7vF4vpmggWP5MU70QO6,8,3,2,0,2,0,3,0,10,1.4285714285714286,1,0.0,0,2,0,2,3,0,0,3,0,4,6,1
1562,22649,kpDqfPKqqQYJmKMTzN1Sox48V4ZPJuXL,SpATywNh6bZuzm8s1ceuBUnMUAeoAHHw,25,38,15,26,6,5,13,0,103,14.714285714285714,4,0.0,15,15,20,6,23,5,6,13,0,56,47,1
1563,22660,nwlJxZtiMdof1orslmN8VJv3ydVnbeg5,RXDvfPUBYFlVdlueBFbLW0mhhAyGEqpt,5,4,2,0,2,0,1,0,9,1.2857142857142858,1,0.0,0,2,0,2,4,0,0,1,0,4,5,1
1564,22676,CMoV5dPTzwxV3W6HJJmvW8wSnp90ZPh2,SpATywNh6bZuzm8s1ceuBUnMUAeoAHHw,33,37,27,0,17,0,12,0,93,13.285714285714286,9,0.0,0,27,0,17,37,0,0,12,0,44,49,0
1565,22715,3cB0rEpxJxC0jjqfQ9EPT6ntxFajOXrx,SpATywNh6bZuzm8s1ceuBUnMUAeoAHHw,38,114,51,50,14,25,26,1,281,40.142857142857146,11,0.0,31,51,41,14,83,25,9,26,1,137,144,0
1566,22724,GXmYCsHMMMsjIL2A9DYKMEw8AEscVD5s,A3fsA9Zfv1X2fVEQhTw51lKENdNrEqT3,25,26,17,32,7,3,15,3,103,14.714285714285714,3,0.0,2,17,26,7,24,3,6,15,3,52,51,0
1567,22738,83J9IXuPcwdDBJoFENdSQFWzvgELVzeu,G8EPVSXsOYB5YQWZGiz1aVq5Pgr2GrQu,25,132,43,82,9,30,26,2,324,46.285714285714285,4,0.0,52,43,61,9,80,30,21,26,2,165,159,1
1568,22741,ooFElJ4ZPOLTBMQwigtvKfnHk0DNrR2R,SpATywNh6bZuzm8s1ceuBUnMUAeoAHHw,6,3,2,0,2,0,2,0,9,1.2857142857142858,2,0.0,0,2,0,2,3,0,0,2,0,4,5,1
1569,22744,D2ho5VQQzNWAcdswkNScRjqQiNPjKhpn,A3fsA9Zfv1X2fVEQhTw51lKENdNrEqT3,11,12,1,0,1,0,15,0,29,4.142857142857143,1,0.0,0,1,0,1,12,0,0,15,0,2,27,1
1570,22747,5GeMwmyzCXMcMYfcWdKaXbpNNdL8bmPq,A3fsA9Zfv1X2fVEQhTw51lKENdNrEqT3,7,4,2,0,1,0,7,0,14,2.0,3,0.0,0,2,0,1,4,0,0,7,0,3,11,1
1571,22757,LJYBef7iIBiSZz8D7KTtMTsdkyd91gnR,SpATywNh6bZuzm8s1ceuBUnMUAeoAHHw,28,56,28,18,12,8,16,0,138,19.714285714285715,8,0.0,9,28,16,12,47,8,2,16,0,65,73,0
1572,22762,MCJiDMInWw8URpDdqHAwEp0pExHWdLRC,SpATywNh6bZuzm8s1ceuBUnMUAeoAHHw,4,2,1,0,1,0,1,0,5,0.7142857142857143,1,0.0,0,1,0,1,2,0,0,1,0,2,3,1
1573,22766,BImVQpNaWI5ZZjLENiRV2V2LYkbW88m0,RXDvfPUBYFlVdlueBFbLW0mhhAyGEqpt,54,73,35,64,16,2,15,2,207,29.571428571428573,6,0.0,15,35,61,16,58,2,3,15,2,127,80,0
1574,22776,jaMKMvlU4KDCkm4HrM0MWVH43rDA8rY1,A3fsA9Zfv1X2fVEQhTw51lKENdNrEqT3,30,30,22,0,15,0,10,1,78,11.142857142857142,6,0.0,0,22,0,15,30,0,0,10,1,37,41,1
1575,22777,jpXIq3stqWScWG27acYJbNKpdTmc6kli,A3fsA9Zfv1X2fVEQhTw51lKENdNrEqT3,51,58,44,50,29,21,19,0,221,31.571428571428573,5,0.0,3,44,44,29,55,21,6,19,0,120,101,1
1576,22787,XCY83tv4aCv2fMTPmH1QE6tZOtr7KzJT,G8EPVSXsOYB5YQWZGiz1aVq5Pgr2GrQu,140,237,102,410,16,90,71,4,930,132.85714285714286,14,0.0,79,102,331,16,158,90,79,71,4,528,402,0
1577,22800,xiHLAVx1lOeJhtdb9rNdxGApg3TIwPUZ,SpATywNh6bZuzm8s1ceuBUnMUAeoAHHw,10,12,1,6,0,0,2,0,21,3.0,2,0.0,3,1,5,0,9,0,1,2,0,9,12,1
1578,22814,zyIWmJjaz36PnMZpAzR2HEZCUbJWe8iQ,A3fsA9Zfv1X2fVEQhTw51lKENdNrEqT3,13,11,8,2,5,0,5,0,31,4.428571428571429,3,0.0,0,8,2,5,11,0,0,5,0,15,16,1
1579,22859,JJDRXXLRU75H8Dx2cuK7Td1V7D7QoKg9,RXDvfPUBYFlVdlueBFbLW0mhhAyGEqpt,60,142,2,90,13,23,37,9,316,45.142857142857146,11,0.0,41,2,72,13,101,23,18,37,9,128,188,0
1580,22876,yZi2eaDxP9Hsc5TkKYLN2LUYSBmbQGTr,SpATywNh6bZuzm8s1ceuBUnMUAeoAHHw,28,32,13,27,7,0,4,0,83,11.857142857142858,2,0.0,17,13,21,7,15,0,6,4,0,58,25,0
1581,22877,qjNUBrpwN8flYc0VorTlQJNEWSbIR2KA,A3fsA9Zfv1X2fVEQhTw51lKENdNrEqT3,60,73,7,147,3,9,17,0,256,36.57142857142857,3,0.0,7,7,128,3,66,9,19,17,0,145,111,1
1582,22880,ti1hbICHLqROy8Y7XhKRxGlLqF2ITiDH,RXDvfPUBYFlVdlueBFbLW0mhhAyGEqpt,58,64,38,132,25,0,21,0,280,40.0,6,0.0,18,38,116,25,46,0,16,21,0,197,83,0
1583,22898,t2LtqHppiTuDN14mSCfUVu9qYG7mBNAD,A3fsA9Zfv1X2fVEQhTw51lKENdNrEqT3,77,58,35,180,20,6,11,0,310,44.285714285714285,5,0.0,5,35,157,20,53,6,23,11,0,217,93,0
1584,22899,AoDbGxsdtQ88iavwLYzXC5a1sZ4YMkt5,SpATywNh6bZuzm8s1ceuBUnMUAeoAHHw,23,36,18,18,8,12,9,0,101,14.428571428571429,4,0.0,13,18,15,8,23,12,3,9,0,54,47,1
1585,22905,i17yw0GYsvz8XFpq0Y9RtdPoiYFDGh9w,bWdj2GDclj5ofokWjzoa5jAwMkxCykd6,1,0,0,0,0,0,1,0,1,0.14285714285714285,1,0.0,0,0,0,0,0,0,0,1,0,0,1,1
1586,22906,CLsYy7g1hYWHJyj1aROfKK9oTeo5yxJx,A3fsA9Zfv1X2fVEQhTw51lKENdNrEqT3,58,26,21,66,17,2,11,1,144,20.571428571428573,2,0.0,1,21,60,17,25,2,6,11,1,99,45,1
1587,22911,i17yw0GYsvz8XFpq0Y9RtdPoiYFDGh9w,A3fsA9Zfv1X2fVEQhTw51lKENdNrEqT3,1,0,0,0,0,0,1,0,1,0.14285714285714285,1,0.0,0,0,0,0,0,0,0,1,0,0,1,1
1588,22915,dLoTMfurIDgppPqjn68MhR8oLIGjxbCC,bWdj2GDclj5ofokWjzoa5jAwMkxCykd6,37,105,43,92,28,54,15,0,337,48.142857142857146,6,0.0,35,43,85,28,70,54,7,15,0,191,146,1
1589,22924,SY3KixRowLNTROWYYZsbpxNmhMe23Wc3,SpATywNh6bZuzm8s1ceuBUnMUAeoAHHw,32,66,27,0,15,0,9,0,117,16.714285714285715,7,0.0,3,27,0,15,63,0,0,9,0,45,72,1
1590,22934,I4EJkH4zClhTB2lKNgq7Q2fKtUYoVDSA,A3fsA9Zfv1X2fVEQhTw51lKENdNrEqT3,13,36,5,0,2,3,20,2,68,9.714285714285714,4,0.0,0,5,0,2,36,3,0,20,2,7,61,1
1591,22937,7mQeRnk4E67KJHDHSAp1BOWEWVuxMvA2,SpATywNh6bZuzm8s1ceuBUnMUAeoAHHw,32,58,24,44,13,2,16,2,159,22.714285714285715,4,0.0,10,24,42,13,48,2,2,16,2,89,70,1
1592,22976,cVHCYdG6eoXKQe55dLZbvLgwBGbWam7p,RXDvfPUBYFlVdlueBFbLW0mhhAyGEqpt,1,0,0,0,0,0,1,0,1,0.14285714285714285,1,0.0,0,0,0,0,0,0,0,1,0,0,1,1
1593,22985,Dkp4ht4oz2wUhu9UvNTwrqC02rtqcSZH,SpATywNh6bZuzm8s1ceuBUnMUAeoAHHw,6,4,2,0,1,0,5,0,12,1.7142857142857142,2,0.0,0,2,0,1,4,0,0,5,0,3,9,1
1594,22998,nCARlKCtX8cCYdg9wv53tMq1HV8fOfAB,RXDvfPUBYFlVdlueBFbLW0mhhAyGEqpt,43,108,40,24,36,2,12,1,223,31.857142857142858,5,0.0,4,40,24,36,104,2,0,12,1,104,119,1
1595,22999,cbxqNQUcwI376TUiYgRRo2dXuIaImWoc,SpATywNh6bZuzm8s1ceuBUnMUAeoAHHw,26,50,32,2,15,1,25,2,127,18.142857142857142,2,0.0,7,32,2,15,43,1,0,25,2,56,71,1
1596,23011,Qi3PLuC7w2Yo9hFgq37MObjY8icnRdc6,A3fsA9Zfv1X2fVEQhTw51lKENdNrEqT3,156,179,82,454,28,75,53,2,873,124.71428571428571,14,0.0,13,82,363,28,166,75,91,53,2,486,387,0
1597,23016,jZn0klM9Bk084k9gvux7E5DK1oO1FwuJ,SpATywNh6bZuzm8s1ceuBUnMUAeoAHHw,35,45,32,16,14,0,11,0,118,16.857142857142858,6,0.0,0,32,14,14,45,0,2,11,0,60,58,0
1598,23032,UInMBEH8f1h2vxXVslRsWyLOTv8ggYq3,RXDvfPUBYFlVdlueBFbLW0mhhAyGEqpt,37,55,23,0,13,5,12,0,108,15.428571428571429,6,0.0,0,23,0,13,55,5,0,12,0,36,72,0
1599,23035,e09uq36QgLuBVK5DERoejsHeMH2uPMRM,SpATywNh6bZuzm8s1ceuBUnMUAeoAHHw,1,0,0,0,0,0,2,0,2,0.2857142857142857,2,0.0,0,0,0,0,0,0,0,2,0,0,2,1
1600,23038,0DzldTHKdoH90kklIAjpWyAEe6XDDjyM,SpATywNh6bZuzm8s1ceuBUnMUAeoAHHw,28,174,27,47,0,13,75,1,337,48.142857142857146,23,0.0,45,27,41,0,129,13,6,75,1,113,224,0
1601,23041,TJxPKDYS9NmvmYGlrCikboEkhHDTOEHy,SpATywNh6bZuzm8s1ceuBUnMUAeoAHHw,10,18,9,0,1,0,9,0,37,5.285714285714286,2,0.0,6,9,0,1,12,0,0,9,0,16,21,0
1602,23070,XHWdewLJ6o4Ir5vIcSMNfq1s8TFbjZbE,bWdj2GDclj5ofokWjzoa5jAwMkxCykd6,19,58,22,178,14,33,18,1,324,46.285714285714285,2,0.0,22,22,173,14,36,33,5,18,1,231,93,1
1603,23072,Pb0Dj6dRtTGmcuNxvaHjmGw0iPTyjSsN,bWdj2GDclj5ofokWjzoa5jAwMkxCykd6,7,5,3,0,2,0,7,0,17,2.4285714285714284,2,0.0,0,3,0,2,5,0,0,7,0,5,12,1
1604,23075,CUMuKIhvWkMSk50Or6FhgPf1tk7jntYp,SpATywNh6bZuzm8s1ceuBUnMUAeoAHHw,22,46,19,23,0,1,22,1,112,16.0,8,0.0,14,19,22,0,32,1,1,22,1,55,57,0
1605,23097,5wbqpjsRycE3Ij1gukLWuLp8it7vr80U,SpATywNh6bZuzm8s1ceuBUnMUAeoAHHw,36,133,64,25,1,267,47,4,541,77.28571428571429,11,0.0,43,64,24,1,90,267,1,47,4,132,409,1
1606,23113,Xcdjjhyr6mdJr4bRWqVyHg8s2pWIVQGq,SpATywNh6bZuzm8s1ceuBUnMUAeoAHHw,27,44,5,30,3,11,11,4,108,15.428571428571429,3,0.0,11,5,28,3,33,11,2,11,4,47,61,1
1607,23121,9S5uoFAiVHVF4D2DNR23wCkbQZ8LhtES,SpATywNh6bZuzm8s1ceuBUnMUAeoAHHw,17,25,5,14,1,0,8,0,53,7.571428571428571,5,0.0,4,5,13,1,21,0,1,8,0,23,30,0
1608,23123,rq9XJ5UGjNC0AliEbyfxvu7XJPaoSOc4,A3fsA9Zfv1X2fVEQhTw51lKENdNrEqT3,2,0,0,0,0,0,4,0,4,0.5714285714285714,1,0.0,0,0,0,0,0,0,0,4,0,0,4,1
1609,23131,hGDnsprgLmlBuNCzDAhbMdsa7xgZW8Z4,bWdj2GDclj5ofokWjzoa5jAwMkxCykd6,37,30,10,85,9,0,20,0,154,22.0,3,0.0,8,10,78,9,22,0,7,20,0,105,49,1
1610,23142,6j5Aoj3JOkcTRkyfXNVtTy229CS4uihi,G8EPVSXsOYB5YQWZGiz1aVq5Pgr2GrQu,123,225,103,198,75,1,29,3,634,90.57142857142857,19,0.0,53,103,161,75,172,1,37,29,3,392,242,0
1611,23166,4eKGhI4OMlwHB0DLaezQlJp1reuJgarH,SpATywNh6bZuzm8s1ceuBUnMUAeoAHHw,1,0,0,0,0,0,1,0,1,0.14285714285714285,1,0.0,0,0,0,0,0,0,0,1,0,0,1,1
1612,23183,HycevJIm7cBjf1oJ5QCBMMXEBTG8jyRF,A3fsA9Zfv1X2fVEQhTw51lKENdNrEqT3,175,134,82,306,31,0,40,0,593,84.71428571428571,11,0.0,24,82,252,31,110,0,54,40,0,389,204,0
1613,23185,HycevJIm7cBjf1oJ5QCBMMXEBTG8jyRF,bWdj2GDclj5ofokWjzoa5jAwMkxCykd6,42,48,31,56,4,1,25,0,165,23.571428571428573,12,0.0,5,31,54,4,43,1,2,25,0,94,71,0
1614,23197,BDdKHYPp1edgylVPYUBHaWJ6W3VobGdR,SpATywNh6bZuzm8s1ceuBUnMUAeoAHHw,30,87,37,32,15,9,14,0,194,27.714285714285715,5,0.0,29,37,28,15,58,9,4,14,0,109,85,1
1615,23201,mE5coXp72CvzVrqwpPF6wLVZrHDH0Vlq,SpATywNh6bZuzm8s1ceuBUnMUAeoAHHw,31,111,39,20,14,0,48,10,242,34.57142857142857,16,0.0,19,39,17,14,92,0,3,48,10,89,153,0
1616,23206,ieR2oDuOBOWrOSx08B7vLKsdvt41Kjgw,bWdj2GDclj5ofokWjzoa5jAwMkxCykd6,8,15,1,0,2,4,5,1,28,4.0,3,0.0,3,1,0,2,12,4,0,5,1,6,22,1
1617,23234,BDdKHYPp1edgylVPYUBHaWJ6W3VobGdR,A3fsA9Zfv1X2fVEQhTw51lKENdNrEqT3,5,2,1,0,1,0,2,0,6,0.8571428571428571,1,0.0,0,1,0,1,2,0,0,2,0,2,4,1
1618,23251,bzY7Zh4yWh2gGtmeq5pe4zgMiusHTGEG,SpATywNh6bZuzm8s1ceuBUnMUAeoAHHw,28,87,3,49,2,2,27,1,171,24.428571428571427,3,0.0,40,3,41,2,47,2,8,27,1,86,85,0
1619,23299,FuoDsqlUs6ZIyTkMTIVnWx4xFWKln8DR,SpATywNh6bZuzm8s1ceuBUnMUAeoAHHw,38,62,31,41,14,0,10,0,158,22.571428571428573,9,0.0,14,31,38,14,48,0,3,10,0,97,61,0
1620,23316,QdSH85e6TVvHCb4lCpuXbYzwkD8QbL3t,G8EPVSXsOYB5YQWZGiz1aVq5Pgr2GrQu,63,120,59,8,40,1,15,0,243,34.714285714285715,10,0.0,5,59,5,40,115,1,3,15,0,109,134,0
1621,23322,w2sKd0cOObBRKhbutYISAGM6GUL3hKiJ,A3fsA9Zfv1X2fVEQhTw51lKENdNrEqT3,1,0,0,0,0,0,3,0,3,0.42857142857142855,2,0.0,0,0,0,0,0,0,0,3,0,0,3,1
1622,23324,RPoX07eqJOUgad0B2fv5ckLas5jasaoP,SpATywNh6bZuzm8s1ceuBUnMUAeoAHHw,17,31,9,35,0,1,8,1,85,12.142857142857142,2,0.0,13,9,33,0,18,1,2,8,1,55,30,1
1623,23329,v8AEmfj5ScfNiqWSiB9twce4e05jQ9FQ,SpATywNh6bZuzm8s1ceuBUnMUAeoAHHw,14,36,3,22,2,0,3,0,66,9.428571428571429,3,0.0,23,3,19,2,13,0,3,3,0,47,19,1
1624,23332,V1z8w9SjLbULVqlANveH3qv7vwfEbAs7,A3fsA9Zfv1X2fVEQhTw51lKENdNrEqT3,85,90,56,146,24,7,91,2,416,59.42857142857143,14,0.0,6,56,128,24,84,7,18,91,2,214,202,0
1625,23382,JMglfzDzzLZlgpswShgX51nDQKwTuVTV,A3fsA9Zfv1X2fVEQhTw51lKENdNrEqT3,1,0,0,0,0,0,1,0,1,0.14285714285714285,1,0.0,0,0,0,0,0,0,0,1,0,0,1,1
1626,23385,YA61oYIgn1IPmbXidnuJfNVCdVlD8MoO,SpATywNh6bZuzm8s1ceuBUnMUAeoAHHw,15,12,0,14,0,0,3,0,29,4.142857142857143,1,0.0,1,0,12,0,11,0,2,3,0,13,16,1
1627,23387,BQkLFspAkEwZRgeuoSbQxFTr6POAaRzP,RXDvfPUBYFlVdlueBFbLW0mhhAyGEqpt,1,0,0,0,0,0,1,0,1,0.14285714285714285,1,0.0,0,0,0,0,0,0,0,1,0,0,1,1
1628,23391,X8qfNjsHrwR5R67KkU9t7FXc6jQSGsyo,bWdj2GDclj5ofokWjzoa5jAwMkxCykd6,30,57,8,58,8,67,32,0,230,32.857142857142854,6,0.0,8,8,51,8,49,67,7,32,0,75,155,1
1629,23401,xMuijSepoYpWnTVSuzhdordHJTyRt87I,SpATywNh6bZuzm8s1ceuBUnMUAeoAHHw,37,68,30,46,4,115,28,1,292,41.714285714285715,6,0.0,18,30,41,4,50,115,5,28,1,93,199,1
1630,23403,GWG8afsUfRei9CIZYg1Y2sBsF64D5J9k,A3fsA9Zfv1X2fVEQhTw51lKENdNrEqT3,132,79,44,284,28,0,16,0,451,64.42857142857143,10,0.0,7,44,239,28,72,0,45,16,0,318,133,0
1631,23408,3rgatvueGycmzmQ7x6De7keieQ0tMDvZ,A3fsA9Zfv1X2fVEQhTw51lKENdNrEqT3,43,42,20,50,18,14,8,1,153,21.857142857142858,2,0.0,1,20,45,18,41,14,5,8,1,84,69,1
1632,23410,yGTKMCuyZTpBDN6edeGIEf8UqO2mMowi,SpATywNh6bZuzm8s1ceuBUnMUAeoAHHw,23,20,12,18,7,0,4,0,61,8.714285714285714,3,0.0,4,12,15,7,16,0,3,4,0,38,23,1
1633,23425,rWIeDjJz93lBgbp2QkVHj8gv55De3Px0,G8EPVSXsOYB5YQWZGiz1aVq5Pgr2GrQu,58,59,27,62,16,2,12,4,182,26.0,3,0.0,17,27,44,16,42,2,18,12,4,104,78,1
1634,23443,2XRKCevyRsuXIpuLiEj19nm5B7ajsjxd,SpATywNh6bZuzm8s1ceuBUnMUAeoAHHw,15,16,10,2,5,1,10,1,45,6.428571428571429,2,0.0,1,10,2,5,15,1,0,10,1,18,27,1
1635,23454,mP7U4YN4Z2p45M3a970DvaALst8JAKLF,SpATywNh6bZuzm8s1ceuBUnMUAeoAHHw,22,41,1,32,1,0,14,0,89,12.714285714285714,2,0.0,25,1,28,1,16,0,4,14,0,55,34,1
1636,23458,cAyxesGtWW4tBzueSc3JcCfBcF1iSxzo,SpATywNh6bZuzm8s1ceuBUnMUAeoAHHw,41,76,37,40,19,0,15,0,187,26.714285714285715,7,0.0,20,37,33,19,56,0,7,15,0,109,78,0
1637,23469,OTkfNwsIOtoJh2hERixG2jmKnV6iaybJ,SpATywNh6bZuzm8s1ceuBUnMUAeoAHHw,1,0,0,0,0,0,1,0,1,0.14285714285714285,1,0.0,0,0,0,0,0,0,0,1,0,0,1,1
1638,23485,oAqokxwZETOc0FlXbPrJtKYU20wkk4k3,SpATywNh6bZuzm8s1ceuBUnMUAeoAHHw,16,10,6,0,6,0,2,0,24,3.4285714285714284,1,0.0,0,6,0,6,10,0,0,2,0,12,12,1
1639,23496,lbe9cMTwmlycpcYHc5ZN07ZsGdA6t7WW,SpATywNh6bZuzm8s1ceuBUnMUAeoAHHw,9,9,1,0,0,1,6,1,18,2.5714285714285716,1,0.0,2,1,0,0,7,1,0,6,1,3,15,1
1640,23502,wNbKFPX6oYsfVEr8buyWthBblPuPZGxv,A3fsA9Zfv1X2fVEQhTw51lKENdNrEqT3,135,64,43,286,25,52,17,1,488,69.71428571428571,5,0.0,13,43,243,25,51,52,43,17,1,324,164,0
1641,23521,sNkOLwlXc0EK57Dlcru7W9TUcu8lkNDn,bWdj2GDclj5ofokWjzoa5jAwMkxCykd6,16,17,11,0,7,0,6,0,41,5.857142857142857,1,0.0,1,11,0,7,16,0,0,6,0,19,22,1
1642,23523,DsdEYwXt7PO92K8VROCVVtUqrprzaIo4,RXDvfPUBYFlVdlueBFbLW0mhhAyGEqpt,18,48,0,0,0,19,7,1,75,10.714285714285714,2,0.0,0,0,0,0,48,19,0,7,1,0,75,1
1643,23526,xC7QA3lJWLoIMEwPvqIxcLnCt0KwsxwT,G8EPVSXsOYB5YQWZGiz1aVq5Pgr2GrQu,89,94,40,263,30,4,12,1,444,63.42857142857143,4,0.0,42,40,224,30,52,4,39,12,1,336,108,1
1644,23530,CfoeUJ6vk7a3PuEp1yrQNFUplkLjQYge,SpATywNh6bZuzm8s1ceuBUnMUAeoAHHw,42,81,39,49,19,7,8,0,203,29.0,6,0.0,30,39,43,19,51,7,6,8,0,131,72,0
1645,23541,ACrAvl4ssWNFndB2wDhI3oY0Vqi5B1FR,SpATywNh6bZuzm8s1ceuBUnMUAeoAHHw,54,61,37,40,16,6,19,0,179,25.571428571428573,9,0.0,16,37,37,16,45,6,3,19,0,106,73,0
1646,23550,7yphMCe2LQupOHSaDA3UQC9kbDeEuBie,SpATywNh6bZuzm8s1ceuBUnMUAeoAHHw,25,37,16,25,8,0,5,0,91,13.0,4,0.0,8,16,24,8,29,0,1,5,0,56,35,0
1647,23557,M6VmJD8JYDR5w6GV5uzAgWpIXM5eanml,SpATywNh6bZuzm8s1ceuBUnMUAeoAHHw,50,86,41,25,19,4,16,0,191,27.285714285714285,7,0.0,7,41,22,19,79,4,3,16,0,89,102,0
1648,23574,N8e8TX5f8OfPjOu3ngCuXkApyUMeZAHw,A3fsA9Zfv1X2fVEQhTw51lKENdNrEqT3,6,2,1,0,1,0,4,1,9,1.2857142857142858,1,0.0,0,1,0,1,2,0,0,4,1,2,7,1
1649,23576,mRXmcsJQnNw2mccUFVukDwZxk7roAYf4,SpATywNh6bZuzm8s1ceuBUnMUAeoAHHw,11,19,10,0,2,0,15,3,49,7.0,3,0.0,0,10,0,2,19,0,0,15,3,12,37,1
1650,23589,mptZxS2IRXAopBdChMP75EgVt5rtRsUT,SpATywNh6bZuzm8s1ceuBUnMUAeoAHHw,34,46,26,12,12,0,14,0,110,15.714285714285714,12,0.0,2,26,10,12,44,0,2,14,0,50,60,1
1651,23601,jKWIhuXmlYFBIapfd4E50TBTHed3oveP,A3fsA9Zfv1X2fVEQhTw51lKENdNrEqT3,13,15,7,0,5,0,3,0,30,4.285714285714286,3,0.0,0,7,0,5,15,0,0,3,0,12,18,1
1652,23616,VADc1m6JjTG2LuLkbhEfhADWJMHaDmqK,SpATywNh6bZuzm8s1ceuBUnMUAeoAHHw,47,125,72,50,21,20,23,1,312,44.57142857142857,16,0.0,30,72,42,21,95,20,8,23,1,165,147,0
1653,23621,HRaTe8gWBsDiLkzfbQMnooVDWfwWVb7m,SpATywNh6bZuzm8s1ceuBUnMUAeoAHHw,51,170,15,66,5,68,80,16,420,60.0,14,0.0,28,15,57,5,142,68,9,80,16,105,315,0
1654,23629,1GEou0jUAwSZvf4K9js5E10dDnbmQpAC,bWdj2GDclj5ofokWjzoa5jAwMkxCykd6,16,14,9,0,5,0,11,0,39,5.571428571428571,3,0.0,0,9,0,5,14,0,0,11,0,14,25,1
1655,23634,hs0BkyfSJv3crs4cIvcxkt53zip5FMPg,SpATywNh6bZuzm8s1ceuBUnMUAeoAHHw,15,20,13,12,4,1,6,0,56,8.0,5,0.0,3,13,12,4,17,1,0,6,0,32,24,1
1656,23642,04gG5zVwZ7Vr68t1LtjimV9KPqGTDxDK,SpATywNh6bZuzm8s1ceuBUnMUAeoAHHw,46,86,43,55,15,45,56,1,301,43.0,14,0.0,17,43,46,15,69,45,9,56,1,121,180,0
1657,23651,35E85h2ExBPeTd1VmxNX0GKo8krIMsCP,RXDvfPUBYFlVdlueBFbLW0mhhAyGEqpt,19,31,17,0,5,0,12,0,65,9.285714285714286,6,0.0,2,17,0,5,29,0,0,12,0,24,41,1
1658,23657,xM0eQ8CWGY7oZgCPJhirOkGhAfAvdQUi,SpATywNh6bZuzm8s1ceuBUnMUAeoAHHw,5,3,2,0,1,0,1,0,7,1.0,1,0.0,0,2,0,1,3,0,0,1,0,3,4,1
1659,23667,1NMKv7RE12uBMKwNJI30Cx8Z5ltMGoee,SpATywNh6bZuzm8s1ceuBUnMUAeoAHHw,30,49,29,16,19,0,8,0,121,17.285714285714285,5,0.0,12,29,16,19,37,0,0,8,0,76,45,0
1660,23672,F9d8ehlFxvqouYiZgUKxdbX5NI44Sbpl,SpATywNh6bZuzm8s1ceuBUnMUAeoAHHw,45,75,41,55,15,28,30,1,245,35.0,5,0.0,14,41,47,15,61,28,8,30,1,117,128,1
1661,23682,iSZJZtUn8nc9fyool89gRRN7Cq78oUfm,SpATywNh6bZuzm8s1ceuBUnMUAeoAHHw,26,19,10,21,7,8,5,0,70,10.0,3,0.0,7,10,20,7,12,8,1,5,0,44,26,0
1662,23694,PjedxGW8p1bztGxVlzTokusg6LFto1Md,bWdj2GDclj5ofokWjzoa5jAwMkxCykd6,1,0,0,0,0,0,1,0,1,0.14285714285714285,1,0.0,0,0,0,0,0,0,0,1,0,0,1,1
1663,23699,jM1yIagOMV2CwD8o07UMrVdo7z0hqKJ4,bWdj2GDclj5ofokWjzoa5jAwMkxCykd6,35,23,18,76,7,0,4,0,128,18.285714285714285,4,0.0,5,18,75,7,18,0,1,4,0,105,23,0
1664,23720,zJDljX1Y3FrDgAuEWJGqwBvE3KAWJPAz,A3fsA9Zfv1X2fVEQhTw51lKENdNrEqT3,6,1,1,0,1,0,5,0,8,1.1428571428571428,1,0.0,0,1,0,1,1,0,0,5,0,2,6,1
1665,23724,wQU3lY7mCoAWFqnxNLhiEFrdAWtS5Hh9,SpATywNh6bZuzm8s1ceuBUnMUAeoAHHw,33,40,15,10,8,7,16,0,96,13.714285714285714,7,0.0,0,15,10,8,40,7,0,16,0,33,63,0
1666,23747,x3sZblYMoUvQJbk7l9GY688n7RQqaQct,A3fsA9Zfv1X2fVEQhTw51lKENdNrEqT3,13,15,2,0,1,0,2,0,20,2.857142857142857,2,0.0,0,2,0,1,15,0,0,2,0,3,17,1
1667,23751,zvOHbaUWjxRZ9zCYxYPMcUH4Ef5dE8Ae,RXDvfPUBYFlVdlueBFbLW0mhhAyGEqpt,9,11,1,0,1,0,6,0,19,2.7142857142857144,2,0.0,0,1,0,1,11,0,0,6,0,2,17,1
1668,23772,bQK35cKsW9Hy5fNgckzz4Jo7bFzQOyma,G8EPVSXsOYB5YQWZGiz1aVq5Pgr2GrQu,79,114,40,162,21,17,27,4,385,55.0,3,0.0,62,40,119,21,52,17,43,27,4,242,143,0
1669,23776,JoruyAOmEeM1qjcSEWRUjLvQUHpNPZGp,SpATywNh6bZuzm8s1ceuBUnMUAeoAHHw,19,49,0,12,0,24,20,1,106,15.142857142857142,3,0.0,10,0,9,0,39,24,3,20,1,19,87,1
1670,23787,ct5yYqhcbduN7OPtxPDjwHer2K46eeEH,bWdj2GDclj5ofokWjzoa5jAwMkxCykd6,8,7,1,0,2,0,4,0,14,2.0,1,0.0,2,1,0,2,5,0,0,4,0,5,9,1
1671,23811,kj5o7wMZl1s4q0cggcmipnm7O7L6g4Ps,SpATywNh6bZuzm8s1ceuBUnMUAeoAHHw,32,29,15,30,7,3,13,1,98,14.0,3,0.0,8,15,27,7,21,3,3,13,1,57,41,1
1672,23818,oAs7swdosdDbKq3u64wlCP6EHVlCh67P,bWdj2GDclj5ofokWjzoa5jAwMkxCykd6,8,24,12,0,7,0,8,0,51,7.285714285714286,4,0.0,0,12,0,7,24,0,0,8,0,19,32,1
1673,23839,xHZbSROhwP4RRQerUVWvcNTfOGc2DHWf,bWdj2GDclj5ofokWjzoa5jAwMkxCykd6,20,100,50,0,12,23,59,0,244,34.857142857142854,24,0.0,0,50,0,12,100,23,0,59,0,62,182,0
1674,23845,TSxGfcluByCTxwgFYbniUiwGZJ5ZTUOD,RXDvfPUBYFlVdlueBFbLW0mhhAyGEqpt,24,18,15,13,9,4,6,0,65,9.285714285714286,3,0.0,0,15,12,9,18,4,1,6,0,36,29,1
1675,23853,RERZDO4CwF9dxtSu0h5YmBuy5kxPiJg0,SpATywNh6bZuzm8s1ceuBUnMUAeoAHHw,12,22,3,22,2,0,3,0,52,7.428571428571429,2,0.0,9,3,19,2,13,0,3,3,0,33,19,0
1676,23859,XNb7KU6KeHuNJzclGX2ePynnmu8yxV3v,SpATywNh6bZuzm8s1ceuBUnMUAeoAHHw,46,98,15,37,9,12,24,0,195,27.857142857142858,6,0.0,7,15,29,9,91,12,8,24,0,60,135,0
1677,23866,7WsRevbkgPhYSJirD1kBI2okhIiuBQwH,A3fsA9Zfv1X2fVEQhTw51lKENdNrEqT3,2,0,0,0,0,0,3,0,3,0.42857142857142855,1,0.0,0,0,0,0,0,0,0,3,0,0,3,1
1678,23884,GJmfZNR8PZRpI11B5boI8G7Sd4djdQgk,SpATywNh6bZuzm8s1ceuBUnMUAeoAHHw,14,17,8,19,4,0,4,0,52,7.428571428571429,3,0.0,3,8,16,4,14,0,3,4,0,31,21,1
1679,23906,XIUlzpQjeuAoBiPuklTmwavmE8N5buiR,bWdj2GDclj5ofokWjzoa5jAwMkxCykd6,9,6,4,0,3,0,6,1,20,2.857142857142857,1,0.0,0,4,0,3,6,0,0,6,1,7,13,1
1680,23913,6MGET4duNnhYB7elJoLURxwHMKRGtg9y,bWdj2GDclj5ofokWjzoa5jAwMkxCykd6,8,16,4,20,4,0,4,0,48,6.857142857142857,2,0.0,8,4,19,4,8,0,1,4,0,35,13,1
1681,23962,5pjAdY5K4FfgQPLSzQKwXaKF78ph9a0y,RXDvfPUBYFlVdlueBFbLW0mhhAyGEqpt,123,446,242,278,108,104,108,19,1305,186.42857142857142,19,0.0,66,242,251,108,380,104,27,108,19,667,638,0
1682,23977,tkDslnD6NXbenEreFtnV2nvNZ4GDJajz,RXDvfPUBYFlVdlueBFbLW0mhhAyGEqpt,6,5,2,0,0,0,6,0,13,1.8571428571428572,2,0.0,0,2,0,0,5,0,0,6,0,2,11,1
1683,23984,HAPPxnLUjIhcauBZnnWBFk3JE6gETTxa,SpATywNh6bZuzm8s1ceuBUnMUAeoAHHw,26,30,11,22,5,1,9,2,80,11.428571428571429,3,0.0,15,11,21,5,15,1,1,9,2,52,28,1
1684,23994,AkYabqnQmQubmhD6vLFPcIqa194wOTvs,SpATywNh6bZuzm8s1ceuBUnMUAeoAHHw,9,7,1,0,1,0,5,0,14,2.0,3,0.0,0,1,0,1,7,0,0,5,0,2,12,1
1685,24000,tML4IQ8jFiP4YuH9NbvzKQFqAdof0qcO,SpATywNh6bZuzm8s1ceuBUnMUAeoAHHw,35,82,0,50,0,135,35,4,306,43.714285714285715,10,0.0,24,0,43,0,58,135,7,35,4,67,239,0
1686,24021,wPWqnGAkrR45TEYOXZpjGrKRubMl9rFP,SpATywNh6bZuzm8s1ceuBUnMUAeoAHHw,23,79,3,28,1,29,22,0,162,23.142857142857142,13,0.0,17,3,25,1,62,29,3,22,0,46,116,0
1687,24024,OIPBfPb9802WcbHz02njDB4ysP5ao9fe,SpATywNh6bZuzm8s1ceuBUnMUAeoAHHw,24,44,2,22,0,5,17,2,92,13.142857142857142,5,0.0,9,2,20,0,35,5,2,17,2,31,61,0
1688,24025,REvshIGXuaBWprkQ9qA5D33qmf3QiAwV,SpATywNh6bZuzm8s1ceuBUnMUAeoAHHw,22,31,23,12,14,0,15,0,95,13.571428571428571,6,0.0,0,23,10,14,31,0,2,15,0,47,48,0
1689,24049,koZ8gxZRuDJaBnv7V4tJo48rZ57BbCd4,SpATywNh6bZuzm8s1ceuBUnMUAeoAHHw,19,13,7,18,4,0,4,0,46,6.571428571428571,1,0.0,4,7,17,4,9,0,1,4,0,32,14,1
1690,24056,UKrQdzHwNJRJK7ZoTzKsoWlrkEbsQk7X,A3fsA9Zfv1X2fVEQhTw51lKENdNrEqT3,1,0,0,0,0,0,1,0,1,0.14285714285714285,1,0.0,0,0,0,0,0,0,0,1,0,0,1,1
1691,24076,hWoXRoePYaW50QNR65rI6g0ffdFAubIq,SpATywNh6bZuzm8s1ceuBUnMUAeoAHHw,39,45,27,11,15,0,10,3,111,15.857142857142858,4,0.0,4,27,10,15,41,0,1,10,3,56,55,1
1692,24086,wx9LUKj4KCj2VrJqkWxv5NlmYX9Bw5rx,RXDvfPUBYFlVdlueBFbLW0mhhAyGEqpt,52,212,18,40,14,0,44,1,329,47.0,6,0.0,13,18,36,14,199,0,4,44,1,81,248,1
1693,24122,4e4wTy2Vsuz8jVFYgJOgi1kIGDWREiPH,bWdj2GDclj5ofokWjzoa5jAwMkxCykd6,65,147,54,165,15,89,31,6,507,72.42857142857143,7,0.0,35,54,144,15,112,89,21,31,6,248,259,0
1694,24132,je9A6l6tP7wnbFhNJD7vbbHTYhqshuqB,SpATywNh6bZuzm8s1ceuBUnMUAeoAHHw,8,28,9,0,2,1,6,0,46,6.571428571428571,4,0.0,12,9,0,2,16,1,0,6,0,23,23,1
1695,24135,yntNdGOvrRZS9CTrjjNKRRz96Mc1JGbf,bWdj2GDclj5ofokWjzoa5jAwMkxCykd6,7,10,2,46,2,0,2,0,62,8.857142857142858,2,0.0,5,2,46,2,5,0,0,2,0,55,7,1
1696,24138,tCb9JPhOhIatDlJOcmjorPeSIRsd6N1b,SpATywNh6bZuzm8s1ceuBUnMUAeoAHHw,28,71,3,26,3,0,20,0,123,17.571428571428573,6,0.0,17,3,20,3,54,0,6,20,0,43,80,0
1697,24148,uvl7kPB3Po3jrDtnQvCsunCWcJhdeQPU,bWdj2GDclj5ofokWjzoa5jAwMkxCykd6,1,0,0,0,0,0,2,0,2,0.2857142857142857,2,0.0,0,0,0,0,0,0,0,2,0,0,2,1
1698,24151,c7klirhrxknzNn3AkRTiBI36lun1Z17S,SpATywNh6bZuzm8s1ceuBUnMUAeoAHHw,7,4,3,0,2,0,2,0,11,1.5714285714285714,1,0.0,0,3,0,2,4,0,0,2,0,5,6,1
1699,24155,uUKSUB3HEdGhPX6CV6kspFVUkErIumI9,SpATywNh6bZuzm8s1ceuBUnMUAeoAHHw,18,11,5,14,4,6,4,0,44,6.285714285714286,2,0.0,2,5,12,4,9,6,2,4,0,23,21,1
1700,24169,s4TNdVBVykBR8x72RZEnjBx6ebkwwW3k,SpATywNh6bZuzm8s1ceuBUnMUAeoAHHw,1,0,0,0,0,0,1,0,1,0.14285714285714285,1,0.0,0,0,0,0,0,0,0,1,0,0,1,1
1701,24249,A1MWkFESy8kUA44NvA6UlE1jbCsV980k,SpATywNh6bZuzm8s1ceuBUnMUAeoAHHw,6,5,1,0,1,0,3,0,10,1.4285714285714286,1,0.0,0,1,0,1,5,0,0,3,0,2,8,1
1702,24277,hzJi6Q52SSiJSH5oo1cc45XsfYCFzZYG,SpATywNh6bZuzm8s1ceuBUnMUAeoAHHw,7,7,2,0,2,0,3,0,14,2.0,2,0.0,0,2,0,2,7,0,0,3,0,4,10,1
1703,24287,Ms0MC4W5moiGJLWP7iE3FImeH9CHN4KT,bWdj2GDclj5ofokWjzoa5jAwMkxCykd6,34,69,13,62,5,20,28,1,198,28.285714285714285,12,0.0,18,13,52,5,51,20,10,28,1,88,110,0
1704,24303,pYcnIzYPgb3xzrOvmR9y0UUIZo4gqKuO,RXDvfPUBYFlVdlueBFbLW0mhhAyGEqpt,108,186,114,177,42,17,33,3,572,81.71428571428571,14,0.0,34,114,156,42,152,17,21,33,3,346,226,0
1705,24304,UzwJVyLJF6Ih9iHYPyYWMullgIr89o5m,RXDvfPUBYFlVdlueBFbLW0mhhAyGEqpt,99,234,130,161,41,12,48,0,626,89.42857142857143,15,0.0,44,130,153,41,190,12,8,48,0,368,258,0
1706,24312,wGN3pCdk72KFTm52vXIRH474TFtQqduI,SpATywNh6bZuzm8s1ceuBUnMUAeoAHHw,41,53,32,44,20,0,9,0,158,22.571428571428573,5,0.0,13,32,42,20,40,0,2,9,0,107,51,0
1707,24325,bPrEBQILvyBjp3odJGGZ7KxlAV5Gu9sz,SpATywNh6bZuzm8s1ceuBUnMUAeoAHHw,33,93,51,23,17,9,33,7,233,33.285714285714285,6,0.0,27,51,22,17,66,9,1,33,7,117,116,0
1708,24332,NY9lbGArbud0VjFCO45IgKzDykuc5Wkn,SpATywNh6bZuzm8s1ceuBUnMUAeoAHHw,31,100,51,30,45,3,24,1,254,36.285714285714285,7,0.0,17,51,30,45,83,3,0,24,1,143,111,1
1709,24358,IIdYSsTHK0XdI7wZc5S09iVifP1zJLzN,SpATywNh6bZuzm8s1ceuBUnMUAeoAHHw,15,50,25,14,0,15,29,1,134,19.142857142857142,5,0.0,11,25,11,0,39,15,3,29,1,47,87,1
1710,24361,dWVj5G83xAxBDmPzLgLHfDC3pxyIk4K1,A3fsA9Zfv1X2fVEQhTw51lKENdNrEqT3,7,3,2,0,2,0,2,0,9,1.2857142857142858,1,0.0,0,2,0,2,3,0,0,2,0,4,5,1
1711,24370,nuKEM7FMFD9npzL9DafH3T1pYgMoLJoQ,SpATywNh6bZuzm8s1ceuBUnMUAeoAHHw,21,50,22,12,9,0,9,0,102,14.571428571428571,7,0.0,6,22,10,9,44,0,2,9,0,47,55,0
1712,24373,5p4xnVU1oXqeHfhqOsPC09VPLJWVQgy1,SpATywNh6bZuzm8s1ceuBUnMUAeoAHHw,20,18,13,8,6,2,12,1,60,8.571428571428571,3,0.0,2,13,7,6,16,2,1,12,1,28,32,1
1713,24383,Ialz252wY3knIVjOtCWLYcvvPO6EGRFT,SpATywNh6bZuzm8s1ceuBUnMUAeoAHHw,25,45,4,30,0,4,21,2,106,15.142857142857142,7,0.0,13,4,28,0,32,4,2,21,2,45,61,0
1714,24388,4v506xwnN2gFG9XeSNIeiBlmXImooi1O,SpATywNh6bZuzm8s1ceuBUnMUAeoAHHw,43,100,52,35,23,2,19,0,231,33.0,5,0.0,23,52,32,23,77,2,3,19,0,130,101,0
1715,24394,Zhz7dkJdB0wauB8JtGSDj0NsuH0ZH8Cd,SpATywNh6bZuzm8s1ceuBUnMUAeoAHHw,11,9,6,0,4,0,4,0,23,3.2857142857142856,2,0.0,0,6,0,4,9,0,0,4,0,10,13,1
1716,24410,F95Wv3qn0qNK1jUsJHuRDZbU4th6dVHD,RXDvfPUBYFlVdlueBFbLW0mhhAyGEqpt,1,0,0,0,0,0,1,0,1,0.14285714285714285,1,0.0,0,0,0,0,0,0,0,1,0,0,1,1
1717,24430,ADFd6U5gb8MuQY2di0urTV7aR0h11Ir1,bWdj2GDclj5ofokWjzoa5jAwMkxCykd6,2,0,0,0,0,0,2,0,2,0.2857142857142857,1,0.0,0,0,0,0,0,0,0,2,0,0,2,1
1718,24444,mFNGHC6aCmhHmhRXFCDO0uvnGnNYaro0,A3fsA9Zfv1X2fVEQhTw51lKENdNrEqT3,10,15,7,0,1,0,7,0,30,4.285714285714286,6,0.0,0,7,0,1,15,0,0,7,0,8,22,1
1719,24476,1yAfuEW0CNQiRXnPO0v79LFUyx4hhTWm,A3fsA9Zfv1X2fVEQhTw51lKENdNrEqT3,1,0,0,0,0,0,1,0,1,0.14285714285714285,1,0.0,0,0,0,0,0,0,0,1,0,0,1,1
1720,24481,MlSRfdfvLbnwipGT1vckZAUcsWbqV0Nz,bWdj2GDclj5ofokWjzoa5jAwMkxCykd6,62,38,15,235,6,0,29,0,323,46.142857142857146,8,0.0,14,15,211,6,24,0,24,29,0,246,77,0
1721,24484,B5XH6YQeVGrE18VTFwIQP3iU5E4UvLjO,SpATywNh6bZuzm8s1ceuBUnMUAeoAHHw,1,0,0,0,0,0,1,0,1,0.14285714285714285,1,0.0,0,0,0,0,0,0,0,1,0,0,1,1
1722,24495,MhaNzTwlOubA2mdN8jvZF4ySj9a3XsvZ,G8EPVSXsOYB5YQWZGiz1aVq5Pgr2GrQu,21,28,20,40,6,0,8,0,102,14.571428571428571,2,0.0,2,20,35,6,26,0,5,8,0,63,39,1
1723,24518,iXoEMwcJ5o4IM7VKZ5pyam9GxPy4olUQ,A3fsA9Zfv1X2fVEQhTw51lKENdNrEqT3,1,0,0,0,0,0,3,0,3,0.42857142857142855,2,0.0,0,0,0,0,0,0,0,3,0,0,3,1
1724,24521,iXoEMwcJ5o4IM7VKZ5pyam9GxPy4olUQ,SpATywNh6bZuzm8s1ceuBUnMUAeoAHHw,21,88,28,0,1,0,3,0,120,17.142857142857142,3,0.0,5,28,0,1,83,0,0,3,0,34,86,1
1725,24527,iXoEMwcJ5o4IM7VKZ5pyam9GxPy4olUQ,RXDvfPUBYFlVdlueBFbLW0mhhAyGEqpt,2,0,0,0,0,0,5,0,5,0.7142857142857143,2,0.0,0,0,0,0,0,0,0,5,0,0,5,1
1726,24532,Hxi6d4DzV7K1jcnZIhXlJzpIYDP4sYeZ,G8EPVSXsOYB5YQWZGiz1aVq5Pgr2GrQu,36,41,1,138,4,0,7,0,191,27.285714285714285,4,0.0,20,1,130,4,21,0,8,7,0,155,36,0
1727,24567,QDaW6SyhKIOYnUckUXKfy6A7QKIp9Kb8,bWdj2GDclj5ofokWjzoa5jAwMkxCykd6,3,0,0,0,0,8,4,0,12,1.7142857142857142,1,0.0,0,0,0,0,0,8,0,4,0,0,12,1
1728,24629,ja7eUjcxSqFnoRSNZAdtMUdo5WLyuwNj,RXDvfPUBYFlVdlueBFbLW0mhhAyGEqpt,23,26,16,22,7,0,13,3,87,12.428571428571429,6,0.0,3,16,17,7,23,0,5,13,3,43,44,1
1729,24630,oeteUY6248o0vNNJe36iI7NqucdIsIE6,5X6FeZozNMgE2VRi3MJYjkkFK8SETtu2,19,43,22,24,16,9,21,2,137,19.571428571428573,3,0.0,9,22,18,16,34,9,6,21,2,65,72,1
1730,24631,IZ5pWpBLzW50MjCCGxCjTz4w6DVz2MU3,SpATywNh6bZuzm8s1ceuBUnMUAeoAHHw,62,109,47,48,32,7,13,1,257,36.714285714285715,6,0.0,20,47,36,32,89,7,12,13,1,135,122,0
1731,24637,nyMA2zBXYm7HuZBPBaIREWxpIzdCqsDv,G8EPVSXsOYB5YQWZGiz1aVq5Pgr2GrQu,38,73,25,72,11,0,3,0,184,26.285714285714285,2,0.0,25,25,56,11,48,0,16,3,0,117,67,0
1732,24645,0JvlwMe8wRQNeLJu71UvJCaEJca2naUP,bWdj2GDclj5ofokWjzoa5jAwMkxCykd6,12,21,15,0,7,4,15,0,62,8.857142857142858,4,0.0,0,15,0,7,21,4,0,15,0,22,40,0
1733,24648,OYHp1KsItSZuhDkN8owngXagZYO1vfvR,RXDvfPUBYFlVdlueBFbLW0mhhAyGEqpt,1,0,0,0,0,0,3,0,3,0.42857142857142855,1,0.0,0,0,0,0,0,0,0,3,0,0,3,1
1734,24656,LpLPysd45mBlrVFCgTTBBbMGnlXmZLO1,7GRhBDsirIGkRZBtSMEzNTyDr2JQm4xx,34,125,31,41,10,29,28,4,268,38.285714285714285,6,0.0,46,31,39,10,79,29,2,28,4,126,142,1
1735,24674,99qhCmy07rsquumjTFRELTtrLHpQpj07,bWdj2GDclj5ofokWjzoa5jAwMkxCykd6,8,11,5,0,2,0,9,0,27,3.857142857142857,4,0.0,0,5,0,2,11,0,0,9,0,7,20,0
1736,24702,VPT5ZBddqdKmipdjPIcaTABROj9B5qkg,bWdj2GDclj5ofokWjzoa5jAwMkxCykd6,40,43,32,91,15,10,8,1,200,28.571428571428573,5,0.0,7,32,78,15,36,10,13,8,1,132,68,0
1737,24713,oORHpMno9LEiGfE2mvfpDDWKt1abfinf,5X6FeZozNMgE2VRi3MJYjkkFK8SETtu2,3,2,1,0,0,0,1,0,4,0.5714285714285714,1,0.0,0,1,0,0,2,0,0,1,0,1,3,1
1738,24729,z9sj5HIJml1DMOMfRKKBQ7IvS2IoE424,7GRhBDsirIGkRZBtSMEzNTyDr2JQm4xx,18,55,18,0,2,4,9,5,93,13.285714285714286,2,0.0,19,18,0,2,36,4,0,9,5,39,54,1
1739,24748,8QeNBSoAmfuMMwnfjCjhlHJfHWJb6Z8j,SpATywNh6bZuzm8s1ceuBUnMUAeoAHHw,1,0,0,0,0,0,1,0,1,0.14285714285714285,1,0.0,0,0,0,0,0,0,0,1,0,0,1,1
1740,24751,xeqerqtfOXdU1SxllK1RhCIMXKtA9tQH,SpATywNh6bZuzm8s1ceuBUnMUAeoAHHw,8,11,7,0,4,0,6,0,28,4.0,3,0.0,0,7,0,4,11,0,0,6,0,11,17,0
1741,24760,NVJD7a4veZi4dOPtkddbSAsIN5dFV8jt,SpATywNh6bZuzm8s1ceuBUnMUAeoAHHw,23,35,16,17,5,24,33,4,134,19.142857142857142,6,0.0,11,16,16,5,24,24,1,33,4,48,86,0
1742,24775,FeUvHE3xENj0OT6fhaRqvHDDKwwtsMRR,SpATywNh6bZuzm8s1ceuBUnMUAeoAHHw,44,65,36,36,17,0,16,0,170,24.285714285714285,10,0.0,14,36,33,17,51,0,3,16,0,100,70,0
1743,24779,8z0bBeHIqg82ZVTL51Hja0n0njQMZcyC,5X6FeZozNMgE2VRi3MJYjkkFK8SETtu2,3,0,0,0,0,0,6,0,6,0.8571428571428571,1,0.0,0,0,0,0,0,0,0,6,0,0,6,1
1744,24780,teqJGecOr4a6oVYU1O9bgvPkX5ZSKA8N,5X6FeZozNMgE2VRi3MJYjkkFK8SETtu2,32,60,10,33,11,0,15,0,129,18.428571428571427,7,0.0,16,10,29,11,44,0,4,15,0,66,63,1
1745,24787,I2CVLqjSbklpRSQ1uckbwTf2kYu0wpRa,SpATywNh6bZuzm8s1ceuBUnMUAeoAHHw,36,31,19,40,12,0,4,0,106,15.142857142857142,3,0.0,8,19,36,12,23,0,4,4,0,75,31,1
1746,24800,Di5QBu2p7TPbC0Y3BSJlyWARS6AhJ7rP,RXDvfPUBYFlVdlueBFbLW0mhhAyGEqpt,8,11,1,0,1,0,2,0,15,2.142857142857143,2,0.0,2,1,0,1,9,0,0,2,0,4,11,0
1747,24821,2Hx9g01WcHXaoIvHRFrUfZqDWuVhvV5b,SpATywNh6bZuzm8s1ceuBUnMUAeoAHHw,50,180,64,60,20,19,47,1,391,55.857142857142854,14,0.0,38,64,56,20,142,19,4,47,1,178,213,0
1748,24827,we18sTRqUifMn6WUmAqDbzypSRsCwq5X,SpATywNh6bZuzm8s1ceuBUnMUAeoAHHw,63,217,71,65,31,94,25,2,505,72.14285714285714,6,0.0,34,71,61,31,183,94,4,25,2,197,308,0
1749,24831,hqh6ySViVHtgDq8aiHphVYPr16SuPhaK,A3fsA9Zfv1X2fVEQhTw51lKENdNrEqT3,9,9,0,0,0,1,5,1,16,2.2857142857142856,2,0.0,0,0,0,0,9,1,0,5,1,0,16,1
1750,24841,GfRp1O86gI5zJJh8SIJ1bczUJPWlAqoK,7GRhBDsirIGkRZBtSMEzNTyDr2JQm4xx,37,130,28,40,8,16,26,2,250,35.714285714285715,8,0.0,15,28,32,8,115,16,8,26,2,83,167,1
1751,24844,4R3vIXDDqstJCBTEM96a5Mzkiuubyd9v,bWdj2GDclj5ofokWjzoa5jAwMkxCykd6,8,8,1,0,1,0,9,1,20,2.857142857142857,2,0.0,4,1,0,1,4,0,0,9,1,6,14,1
1752,24847,IhWjcgRzoXcWcgj0TSEsE1klKuKl9aDP,G8EPVSXsOYB5YQWZGiz1aVq5Pgr2GrQu,34,59,29,58,28,1,8,1,184,26.285714285714285,6,0.0,26,29,39,28,33,1,19,8,1,122,62,0
1753,24860,FPPbdZs5zRERbNXCB9udITtxlck6dBd9,SpATywNh6bZuzm8s1ceuBUnMUAeoAHHw,33,68,2,28,0,75,18,4,195,27.857142857142858,6,0.0,12,2,27,0,56,75,1,18,4,41,154,0
1754,24875,97rJErYjCaSZkM2sQr4Hy3em0yNLLl9Z,7GRhBDsirIGkRZBtSMEzNTyDr2JQm4xx,88,352,102,222,19,92,26,0,813,116.14285714285714,4,0.0,127,102,199,19,225,92,23,26,0,447,366,0
1755,24883,DLDhUvvvfnnYFJuV65Zt2yaS0jPJgvzq,A3fsA9Zfv1X2fVEQhTw51lKENdNrEqT3,7,14,0,0,0,1,18,0,33,4.714285714285714,4,0.0,0,0,0,0,14,1,0,18,0,0,33,0
1756,24911,IZHsTsrBUkoyBqF03uelIuzBd5mdFnWL,RXDvfPUBYFlVdlueBFbLW0mhhAyGEqpt,3,2,0,0,0,0,2,0,4,0.5714285714285714,2,0.0,0,0,0,0,2,0,0,2,0,0,4,1
1757,24924,IcgEG8I6oXszRO6jfoKDYvphefvau1gV,SpATywNh6bZuzm8s1ceuBUnMUAeoAHHw,8,5,3,0,2,0,3,0,13,1.8571428571428572,1,0.0,0,3,0,2,5,0,0,3,0,5,8,1
1758,24928,TG3ztGx3Y2jZOJDYHqGnCtBQf1aN9Xf7,7GRhBDsirIGkRZBtSMEzNTyDr2JQm4xx,15,36,15,12,11,2,17,1,94,13.428571428571429,3,0.0,14,15,10,11,22,2,2,17,1,50,44,1
1759,24960,JtMmp5BCDQnYE7CMI3NvnX4aRCZsQW9K,5X6FeZozNMgE2VRi3MJYjkkFK8SETtu2,1,0,0,0,0,0,1,0,1,0.14285714285714285,1,0.0,0,0,0,0,0,0,0,1,0,0,1,1
1760,24961,qXE8lsczz46VcSqxKdxLlIZNzChQNDah,SpATywNh6bZuzm8s1ceuBUnMUAeoAHHw,32,74,1,45,1,12,14,3,150,21.428571428571427,3,0.0,14,1,40,1,60,12,5,14,3,56,94,0
1761,24975,KKySZH8Vhrdd4z2bRf8FAPkHeGpE3JpX,7GRhBDsirIGkRZBtSMEzNTyDr2JQm4xx,17,29,3,16,1,0,9,0,58,8.285714285714286,3,0.0,5,3,15,1,24,0,1,9,0,24,34,1
1762,25008,AlPSASl29ys7OO31KpYSADARO0IiSNGm,SpATywNh6bZuzm8s1ceuBUnMUAeoAHHw,28,25,19,0,12,0,5,0,61,8.714285714285714,4,0.0,0,19,0,12,25,0,0,5,0,31,30,1
1763,25025,Kv8WT2LoDrISf4mI4ty4secTsdpqqYdt,G8EPVSXsOYB5YQWZGiz1aVq5Pgr2GrQu,4,2,1,0,1,0,1,0,5,0.7142857142857143,1,0.0,0,1,0,1,2,0,0,1,0,2,3,1
1764,25047,e8HsYbNWN6cCQbTmxFf7TraoRlE6iBxd,A3fsA9Zfv1X2fVEQhTw51lKENdNrEqT3,170,152,97,406,67,11,51,1,785,112.14285714285714,10,0.0,5,97,376,67,147,11,30,51,1,545,240,0
1765,25057,dOTfu9ZEDKw8CtbNBtHrVvUlMG00Zoil,SpATywNh6bZuzm8s1ceuBUnMUAeoAHHw,17,19,12,2,8,0,5,0,46,6.571428571428571,4,0.0,1,12,2,8,18,0,0,5,0,23,23,0
1766,25061,38evuz11qT1yopNFOWEFJXqo6AKQdprx,5X6FeZozNMgE2VRi3MJYjkkFK8SETtu2,63,96,6,107,24,0,11,9,253,36.142857142857146,4,0.0,57,6,87,24,39,0,20,11,9,174,79,0
1767,25086,ljqvAdk5ocV9irAsEHJ87jRvF9JOTCHu,SpATywNh6bZuzm8s1ceuBUnMUAeoAHHw,46,101,41,52,12,30,39,1,276,39.42857142857143,10,0.0,38,41,46,12,63,30,6,39,1,137,139,1
1768,25128,5ysSxswt94Gjj7n5OSEcRzDBWhgbKFUg,SpATywNh6bZuzm8s1ceuBUnMUAeoAHHw,56,76,37,35,17,0,12,0,177,25.285714285714285,11,0.0,27,37,33,17,49,0,2,12,0,114,63,0
1769,25140,s4t4u8r9weCt43Z5PXbFAgqmS5WJ6hj5,G8EPVSXsOYB5YQWZGiz1aVq5Pgr2GrQu,42,73,5,70,4,27,19,1,199,28.428571428571427,9,0.0,27,5,44,4,46,27,26,19,1,80,119,1
1770,25180,WPsBmScSkhBvWYkbz4VrY2pkOYr1mtCM,5X6FeZozNMgE2VRi3MJYjkkFK8SETtu2,11,22,3,0,2,0,25,6,58,8.285714285714286,4,0.0,4,3,0,2,18,0,0,25,6,9,49,1
1771,25187,hLAgP9b2jcQPOkjXyGWK7ubP9Fw7WnRM,SpATywNh6bZuzm8s1ceuBUnMUAeoAHHw,6,1,0,0,0,2,4,0,7,1.0,1,0.0,0,0,0,0,1,2,0,4,0,0,7,1
1772,25196,3Oka5GvBd9TakXRvr9D5vxoJEhxwuxJA,RXDvfPUBYFlVdlueBFbLW0mhhAyGEqpt,130,197,130,321,40,31,37,7,763,109.0,11,0.0,42,130,299,40,155,31,22,37,7,511,252,0
1773,25206,36GRXkIW2SpIWQz7gvMq2JRXacytqSzV,SpATywNh6bZuzm8s1ceuBUnMUAeoAHHw,40,77,43,25,22,24,32,1,224,32.0,9,0.0,16,43,25,22,61,24,0,32,1,106,118,0
1774,25216,di4VZBCNKfO3i72Xmq3X7LaoJf3R5cWe,SpATywNh6bZuzm8s1ceuBUnMUAeoAHHw,19,16,5,34,1,0,6,0,62,8.857142857142858,2,0.0,7,5,34,1,9,0,0,6,0,47,15,0
1775,25236,JmXGzVVfQa5TXaQwtZdggsgBkbZbIeH5,bWdj2GDclj5ofokWjzoa5jAwMkxCykd6,65,64,37,155,17,4,15,1,293,41.857142857142854,9,0.0,14,37,133,17,50,4,22,15,1,201,92,0
1776,25276,njVv4R6ptnKvcbEeNw52SkPNx5KL1jie,SpATywNh6bZuzm8s1ceuBUnMUAeoAHHw,55,39,30,25,20,0,5,0,119,17.0,4,0.0,6,30,24,20,33,0,1,5,0,80,39,0
1777,25282,IePFEx0pR5xLGQlWWjU59zR6qxTHOeo0,A3fsA9Zfv1X2fVEQhTw51lKENdNrEqT3,87,195,73,0,44,0,31,0,343,49.0,7,0.0,0,73,0,44,195,0,0,31,0,117,226,0
1778,25289,YfHmALaAUVJkTXPVPoa3sijNQuWgYS7R,SpATywNh6bZuzm8s1ceuBUnMUAeoAHHw,43,70,38,19,20,0,12,0,159,22.714285714285715,5,0.0,19,38,19,20,51,0,0,12,0,96,63,0
1779,25292,ETzcC9n39CwhBb4MTbqq1Ng4NqGIoiPj,A3fsA9Zfv1X2fVEQhTw51lKENdNrEqT3,10,18,1,0,0,0,7,0,26,3.7142857142857144,2,0.0,0,1,0,0,18,0,0,7,0,1,25,1
1780,25306,ETzcC9n39CwhBb4MTbqq1Ng4NqGIoiPj,7GRhBDsirIGkRZBtSMEzNTyDr2JQm4xx,4,2,1,0,1,0,1,0,5,0.7142857142857143,1,0.0,0,1,0,1,2,0,0,1,0,2,3,1
1781,25311,yG8wEEmCuC5YTy4CQDGA5I639Z9JzSu0,SpATywNh6bZuzm8s1ceuBUnMUAeoAHHw,14,19,9,0,8,0,3,0,39,5.571428571428571,2,0.0,0,9,0,8,19,0,0,3,0,17,22,1
1782,25333,SIdEQEXoagJ5WwAcAkPtkVF6pipatiIa,A3fsA9Zfv1X2fVEQhTw51lKENdNrEqT3,30,34,16,0,13,0,6,0,69,9.857142857142858,4,0.0,2,16,0,13,32,0,0,6,0,31,38,0
1783,25337,CZUZ5gxFyc2McH1tEW3brsCqSoaAYd4n,G8EPVSXsOYB5YQWZGiz1aVq5Pgr2GrQu,1,0,0,0,0,0,1,0,1,0.14285714285714285,1,0.0,0,0,0,0,0,0,0,1,0,0,1,1
1784,25356,fi7yn2cMGfx1Smhd75ueCIU0DN0YeZ9i,7GRhBDsirIGkRZBtSMEzNTyDr2JQm4xx,12,14,9,6,5,0,3,0,37,5.285714285714286,1,0.0,2,9,6,5,12,0,0,3,0,22,15,1
1785,25362,5wDUV9eufUWwuEFkF2r5hVPvdmezPjXY,SpATywNh6bZuzm8s1ceuBUnMUAeoAHHw,7,5,4,0,3,0,2,0,14,2.0,1,0.0,0,4,0,3,5,0,0,2,0,7,7,1
1786,25380,hGzoosS2IrdNGucTc4VvSDpEfSFx1kOZ,5X6FeZozNMgE2VRi3MJYjkkFK8SETtu2,3,2,1,0,0,0,4,0,7,1.0,1,0.0,0,1,0,0,2,0,0,4,0,1,6,1
1787,25416,RyJBTIZudHI18CHfqwWV9lrFHUkffvwx,SpATywNh6bZuzm8s1ceuBUnMUAeoAHHw,44,72,30,26,14,6,13,0,161,23.0,3,0.0,9,30,24,14,63,6,2,13,0,77,84,1
1788,25420,jNRA434lMAMZjPiQhPmaP5pXlW3ni5X9,SpATywNh6bZuzm8s1ceuBUnMUAeoAHHw,7,3,2,0,2,0,2,0,9,1.2857142857142858,2,0.0,0,2,0,2,3,0,0,2,0,4,5,1
1789,25468,7e4M5QQTsLcXzFpcPHrVWPenswbNvayx,5X6FeZozNMgE2VRi3MJYjkkFK8SETtu2,2,0,0,0,0,0,4,0,4,0.5714285714285714,2,0.0,0,0,0,0,0,0,0,4,0,0,4,1
1790,25481,nXaqEEEC1RuDpdV8FF2KPpkhT6oc7g9j,bWdj2GDclj5ofokWjzoa5jAwMkxCykd6,17,28,11,108,8,7,15,1,178,25.428571428571427,3,0.0,13,11,104,8,15,7,4,15,1,136,42,1
1791,25504,QwlvYaP7UrFUsGUYZvCsolFqg7cM2XS7,7GRhBDsirIGkRZBtSMEzNTyDr2JQm4xx,35,95,45,49,16,8,27,3,243,34.714285714285715,2,0.0,36,45,40,16,59,8,9,27,3,137,106,1
1792,25508,ymIU6ycPRruHx8VRvXTFr9yvjJtz8pmG,SpATywNh6bZuzm8s1ceuBUnMUAeoAHHw,26,27,11,23,4,18,6,0,89,12.714285714285714,4,0.0,7,11,22,4,20,18,1,6,0,44,45,0
1793,25510,SXQudUQxotVyHX3jIj58IdonMUWj4z4L,SpATywNh6bZuzm8s1ceuBUnMUAeoAHHw,52,142,79,51,30,31,65,6,404,57.714285714285715,13,0.0,31,79,44,30,111,31,7,65,6,184,220,0
1794,25518,Vrjrap5JcUBcGnZI9GyoeJ8llD9p1BxJ,G8EPVSXsOYB5YQWZGiz1aVq5Pgr2GrQu,106,92,76,0,56,7,41,4,276,39.42857142857143,7,0.0,5,76,0,56,87,7,0,41,4,137,139,0
1795,25549,ilsWvfOwvBDq0ZQxDoerp77CgQs3yFBs,SpATywNh6bZuzm8s1ceuBUnMUAeoAHHw,21,25,15,5,7,0,8,0,60,8.571428571428571,4,0.0,0,15,5,7,25,0,0,8,0,27,33,0
1796,25577,s5bmHBniKJzstjkFlsJcJn6YQEnj7XjP,RXDvfPUBYFlVdlueBFbLW0mhhAyGEqpt,12,20,8,9,5,0,6,0,48,6.857142857142857,4,0.0,3,8,9,5,17,0,0,6,0,25,23,1
1797,25581,8eVt8Ny7RBlThXRzjRM9qg0Q2kL5QEc7,SpATywNh6bZuzm8s1ceuBUnMUAeoAHHw,1,0,0,0,0,0,1,0,1,0.14285714285714285,1,0.0,0,0,0,0,0,0,0,1,0,0,1,1
1798,25593,BiaPgBnlrEY2EiwA20PKZL3VeANI5Sfw,SpATywNh6bZuzm8s1ceuBUnMUAeoAHHw,20,40,16,37,2,0,9,0,104,14.857142857142858,5,0.0,18,16,31,2,22,0,6,9,0,67,37,1
1799,25612,Cft94WQ1J7ZOP8ubrVNkQTUMHNF32NER,SpATywNh6bZuzm8s1ceuBUnMUAeoAHHw,19,70,28,12,1,2,15,1,129,18.428571428571427,3,0.0,14,28,10,1,56,2,2,15,1,53,76,0
1800,25630,F1N61tazho7ZYPRPggPaCszBndAmmJFa,7GRhBDsirIGkRZBtSMEzNTyDr2JQm4xx,1,0,0,0,0,0,1,0,1,0.14285714285714285,1,0.0,0,0,0,0,0,0,0,1,0,0,1,1
1801,25633,LeLXLvHK2djzEG514AFcju6wr7gFXkH2,SpATywNh6bZuzm8s1ceuBUnMUAeoAHHw,30,98,41,41,10,89,53,10,342,48.857142857142854,8,0.0,34,41,35,10,64,89,6,53,10,120,222,1
1802,25637,zrKKa8AP5la65fKoXkp4sUMfYYb2eAtF,G8EPVSXsOYB5YQWZGiz1aVq5Pgr2GrQu,16,42,5,0,2,1,19,0,69,9.857142857142858,7,0.0,0,5,0,2,42,1,0,19,0,7,62,1
1803,25652,HrUHfBacH3u3gfsauI41ANlvNzWZshRh,A3fsA9Zfv1X2fVEQhTw51lKENdNrEqT3,168,104,60,610,40,0,21,0,835,119.28571428571429,9,0.0,5,60,540,40,99,0,70,21,0,645,190,0
1804,25653,TJlb1m2PM0vBaKFhpndqRNwoSVpMlE8f,A3fsA9Zfv1X2fVEQhTw51lKENdNrEqT3,44,27,9,111,4,0,12,0,163,23.285714285714285,4,0.0,3,9,97,4,24,0,14,12,0,113,50,1
1805,25658,HlYiU2TA92it9HWOPDlsBmlpdZ7J7QTJ,bWdj2GDclj5ofokWjzoa5jAwMkxCykd6,11,12,3,0,1,1,9,1,27,3.857142857142857,4,0.0,0,3,0,1,12,1,0,9,1,4,23,1
1806,25663,GXhnYeLJGU7thFAyP76FesLSBQZtYEFj,5X6FeZozNMgE2VRi3MJYjkkFK8SETtu2,2,0,0,0,0,0,3,0,3,0.42857142857142855,2,0.0,0,0,0,0,0,0,0,3,0,0,3,0
1807,25673,gyFw0Vge0Tj4Yoavkd7TNvnmTGksA31j,SpATywNh6bZuzm8s1ceuBUnMUAeoAHHw,43,42,18,54,12,0,6,0,132,18.857142857142858,3,0.0,21,18,45,12,21,0,9,6,0,96,36,0
1808,25688,pjY4fWx7BSbcq40Z5pbf9uDCj5HcVuUi,SpATywNh6bZuzm8s1ceuBUnMUAeoAHHw,10,9,5,11,2,0,2,0,29,4.142857142857143,1,0.0,1,5,9,2,8,0,2,2,0,17,12,0
1809,25693,bOaaa5pq6CHfEgyWnmZd4nE6w4eBrY8n,bWdj2GDclj5ofokWjzoa5jAwMkxCykd6,1,0,0,0,0,0,1,0,1,0.14285714285714285,1,0.0,0,0,0,0,0,0,0,1,0,0,1,1
1810,25713,wuaIkUodYTr49NZ7BbMPsEdpO0t0C8Nt,5X6FeZozNMgE2VRi3MJYjkkFK8SETtu2,96,153,6,149,45,0,14,0,367,52.42857142857143,8,0.0,90,6,124,45,63,0,25,14,0,265,102,0
1811,25724,edYhJsFcs7Y8S1yA5J1UkF2OnFEDfEmL,5X6FeZozNMgE2VRi3MJYjkkFK8SETtu2,63,63,17,128,26,15,21,9,279,39.857142857142854,1,0.0,40,17,114,26,23,15,14,21,9,197,82,1
1812,25735,pwnvfCtqibSBzw9gewKZFVOUFkyHecrp,SpATywNh6bZuzm8s1ceuBUnMUAeoAHHw,6,9,0,0,0,0,3,0,12,1.7142857142857142,2,0.0,0,0,0,0,9,0,0,3,0,0,12,1
1813,25765,E31WqWw5nCEWlSKgmhsOSj5j4T79ypCl,SpATywNh6bZuzm8s1ceuBUnMUAeoAHHw,46,95,46,54,16,3,27,1,242,34.57142857142857,11,0.0,32,46,45,16,63,3,9,27,1,139,103,0
1814,25793,V2mnxM1tJc479TW7qqC55qpZNUZBAJ2y,G8EPVSXsOYB5YQWZGiz1aVq5Pgr2GrQu,97,122,54,281,23,24,35,1,540,77.14285714285714,5,0.0,53,54,217,23,69,24,64,35,1,347,193,0
1815,25807,Zl8ThqnwtmFsX5mPsLsbut5BCVNIbE7S,SpATywNh6bZuzm8s1ceuBUnMUAeoAHHw,30,53,32,12,13,3,13,1,127,18.142857142857142,6,0.0,3,32,10,13,50,3,2,13,1,58,69,0
1816,25815,GWprCjSOfnhkIpSV2QR3x0GXabXNfPBZ,bWdj2GDclj5ofokWjzoa5jAwMkxCykd6,6,4,1,0,2,1,4,0,12,1.7142857142857142,1,0.0,2,1,0,2,2,1,0,4,0,5,7,1
1817,25834,j5n4sTa6PLfZD2NvGDdgp6H4HCwWt2aE,5X6FeZozNMgE2VRi3MJYjkkFK8SETtu2,1,0,0,0,0,0,1,0,1,0.14285714285714285,1,0.0,0,0,0,0,0,0,0,1,0,0,1,1
1818,25837,b5Gj1OyeYKLhLlGsleyNSSJpbJ2lneFj,SpATywNh6bZuzm8s1ceuBUnMUAeoAHHw,39,58,9,42,4,0,20,1,134,19.142857142857142,6,0.0,20,9,40,4,38,0,2,20,1,73,61,1
1819,25844,o9m1fMq17KjyGUhfLHLXFO5hoKQ5jU6O,SpATywNh6bZuzm8s1ceuBUnMUAeoAHHw,20,45,1,0,0,0,10,0,56,8.0,5,0.0,5,1,0,0,40,0,0,10,0,6,50,1
1820,25846,lLuFFXHZLIm1dQPs5nCzpljCAy6MOLmS,SpATywNh6bZuzm8s1ceuBUnMUAeoAHHw,6,3,1,0,1,0,3,0,8,1.1428571428571428,1,0.0,0,1,0,1,3,0,0,3,0,2,6,1
1821,25864,koGmxwg6FRa19ZshKXnyLXLosS5G7cau,7GRhBDsirIGkRZBtSMEzNTyDr2JQm4xx,33,133,1,75,10,1,24,5,249,35.57142857142857,5,0.0,66,1,65,10,67,1,10,24,5,142,107,1
1822,25867,8AVk1xYha38NNysY3dSGM9P4W7fXA7gi,SpATywNh6bZuzm8s1ceuBUnMUAeoAHHw,22,29,17,0,11,0,7,0,64,9.142857142857142,4,0.0,0,17,0,11,29,0,0,7,0,28,36,0
1823,25875,CPn2qTyzfSb84Q5RXZs22HrPl5sixCdu,A3fsA9Zfv1X2fVEQhTw51lKENdNrEqT3,1,0,0,0,0,0,1,0,1,0.14285714285714285,1,0.0,0,0,0,0,0,0,0,1,0,0,1,1
1824,25883,HrUHfBacH3u3gfsauI41ANlvNzWZshRh,SpATywNh6bZuzm8s1ceuBUnMUAeoAHHw,37,99,53,36,16,6,38,4,252,36.0,13,0.0,19,53,32,16,80,6,4,38,4,120,132,0
1825,25888,81OLbBMdpNpbkVstjKtzJy0bjbBi99mi,SpATywNh6bZuzm8s1ceuBUnMUAeoAHHw,46,45,22,50,13,0,16,3,149,21.285714285714285,6,0.0,15,22,41,13,30,0,9,16,3,91,58,1
1826,25894,PnzdvfzXkg5rDeQmv0vRztwvfQb99Bwj,5X6FeZozNMgE2VRi3MJYjkkFK8SETtu2,38,108,29,48,34,1,8,0,228,32.57142857142857,5,0.0,56,29,42,34,52,1,6,8,0,161,67,1
1827,25895,DLDhUvvvfnnYFJuV65Zt2yaS0jPJgvzq,SpATywNh6bZuzm8s1ceuBUnMUAeoAHHw,30,80,0,48,0,24,49,3,204,29.142857142857142,13,0.0,31,0,43,0,49,24,5,49,3,74,130,0
1828,25898,cGrHiRjztN9fSltHujpfWaaWfYWiidiG,A3fsA9Zfv1X2fVEQhTw51lKENdNrEqT3,6,6,3,0,0,0,4,0,13,1.8571428571428572,1,0.0,0,3,0,0,6,0,0,4,0,3,10,1
1829,25901,pIkx6nDAjTla5NYVEsjhMXOIu5zXDzmO,SpATywNh6bZuzm8s1ceuBUnMUAeoAHHw,34,31,20,0,13,3,20,3,90,12.857142857142858,5,0.0,0,20,0,13,31,3,0,20,3,33,57,0
1830,25904,cGrHiRjztN9fSltHujpfWaaWfYWiidiG,bWdj2GDclj5ofokWjzoa5jAwMkxCykd6,3,3,1,0,0,0,1,0,5,0.7142857142857143,1,0.0,0,1,0,0,3,0,0,1,0,1,4,1
1831,25919,SIdEQEXoagJ5WwAcAkPtkVF6pipatiIa,bWdj2GDclj5ofokWjzoa5jAwMkxCykd6,10,4,1,30,1,1,6,1,44,6.285714285714286,2,0.0,1,1,29,1,3,1,1,6,1,32,12,1
1832,25952,TzT0azKrocJxLmhFJi2IdfFfROivFDi7,7GRhBDsirIGkRZBtSMEzNTyDr2JQm4xx,7,7,0,0,0,0,4,1,12,1.7142857142857142,1,0.0,0,0,0,0,7,0,0,4,1,0,12,1
1833,25963,3Ew3yAxjSntFFYCyahG9TNwPBtEjhvBu,SpATywNh6bZuzm8s1ceuBUnMUAeoAHHw,38,59,34,4,23,11,18,6,155,22.142857142857142,7,0.0,7,34,4,23,52,11,0,18,6,68,87,1
1834,25980,piSFwoJk8ecTZvpcQFfQWuNzR6UBK2aS,A3fsA9Zfv1X2fVEQhTw51lKENdNrEqT3,15,36,1,0,2,1,10,0,50,7.142857142857143,2,0.0,0,1,0,2,36,1,0,10,0,3,47,1
1835,25994,2jj1hSNZOKn7YixrkMYiulmQRlxNCAKp,SpATywNh6bZuzm8s1ceuBUnMUAeoAHHw,8,7,0,4,0,0,2,0,13,1.8571428571428572,2,0.0,0,0,4,0,7,0,0,2,0,4,9,1
1836,26003,AYGrfwmCqnoFaB5IuQBeL8PTqSOc0bJ5,5X6FeZozNMgE2VRi3MJYjkkFK8SETtu2,6,4,0,0,0,0,2,0,6,0.8571428571428571,1,0.0,0,0,0,0,4,0,0,2,0,0,6,1
1837,26027,l5LfU8gApOG72AnBkdAbfOLQLwFH7Zo2,A3fsA9Zfv1X2fVEQhTw51lKENdNrEqT3,36,34,4,90,2,0,11,0,141,20.142857142857142,6,0.0,3,4,72,2,31,0,18,11,0,81,60,0
1838,26033,6izQCEneEK1X6C1taxn0XENXkSv3cl84,A3fsA9Zfv1X2fVEQhTw51lKENdNrEqT3,25,30,15,22,10,2,6,1,86,12.285714285714286,2,0.0,0,15,20,10,30,2,2,6,1,45,41,0
1839,26069,xlgnT59n6M1QNareeSjN1ytXGFL5M34H,G8EPVSXsOYB5YQWZGiz1aVq5Pgr2GrQu,64,70,28,100,16,0,6,0,220,31.428571428571427,2,0.0,38,28,76,16,32,0,24,6,0,158,62,0
1840,26111,GMCQBmsjUSXeJd8f6yOlc7Bh24TS4rkv,SpATywNh6bZuzm8s1ceuBUnMUAeoAHHw,8,3,2,0,2,1,19,0,27,3.857142857142857,1,0.0,0,2,0,2,3,1,0,19,0,4,23,1
1841,26126,EfoxsYvaiqTPtWZL7NNMHTBPpoZQt5UK,SpATywNh6bZuzm8s1ceuBUnMUAeoAHHw,19,69,29,21,11,6,11,0,147,21.0,3,0.0,31,29,19,11,38,6,2,11,0,90,57,0
1842,26137,z8UGly3uiugF5PDT4DP7AAVP1m1jK5W8,bWdj2GDclj5ofokWjzoa5jAwMkxCykd6,1,0,0,0,0,0,3,0,3,0.42857142857142855,1,0.0,0,0,0,0,0,0,0,3,0,0,3,1
1843,26148,JqvGTplcVBLcq3YzEUVslmYGYOBREBZ1,SpATywNh6bZuzm8s1ceuBUnMUAeoAHHw,44,105,28,39,7,50,37,1,267,38.142857142857146,16,0.0,25,28,33,7,80,50,6,37,1,93,174,0
1844,26150,IUS8Ce0Mk0XPctlXRjc3h0Z2l95mH9Of,SpATywNh6bZuzm8s1ceuBUnMUAeoAHHw,2,0,0,0,0,0,2,0,2,0.2857142857142857,1,0.0,0,0,0,0,0,0,0,2,0,0,2,1
1845,26168,6izQCEneEK1X6C1taxn0XENXkSv3cl84,5X6FeZozNMgE2VRi3MJYjkkFK8SETtu2,10,29,6,7,6,0,4,0,52,7.428571428571429,4,0.0,10,6,7,6,19,0,0,4,0,29,23,0
1846,26190,FlHDZPKBaAynG5XiDYuhXZZ01PMUHJc5,A3fsA9Zfv1X2fVEQhTw51lKENdNrEqT3,52,92,68,0,55,0,23,1,239,34.142857142857146,3,0.0,4,68,0,55,88,0,0,23,1,127,112,0
1847,26205,OR7EWwoao6bYv7TsfkmzJ7Oec16YYNDq,SpATywNh6bZuzm8s1ceuBUnMUAeoAHHw,9,4,3,0,3,0,10,0,20,2.857142857142857,2,0.0,0,3,0,3,4,0,0,10,0,6,14,1
1848,26208,USLTnsAwagwK2c83KXd1SNEeENnzkTTo,7GRhBDsirIGkRZBtSMEzNTyDr2JQm4xx,10,6,4,0,3,42,35,0,90,12.857142857142858,15,0.0,0,4,0,3,6,42,0,35,0,7,83,0
1849,26216,AbUJGk67ueUV6YWXpG4Dr2koeNrU2Sk8,SpATywNh6bZuzm8s1ceuBUnMUAeoAHHw,8,22,6,0,6,0,40,0,74,10.571428571428571,3,0.0,0,6,0,6,22,0,0,40,0,12,62,1
1850,26218,fUPF1tlYv3HJPtJf0Z0k6ib0tZMjiWj6,5X6FeZozNMgE2VRi3MJYjkkFK8SETtu2,6,7,3,0,2,0,2,0,14,2.0,1,0.0,0,3,0,2,7,0,0,2,0,5,9,1
1851,26228,snMfOULya9Q09SdSZY2Ys7iviCn6vdB6,5X6FeZozNMgE2VRi3MJYjkkFK8SETtu2,6,1,1,0,1,0,3,0,6,0.8571428571428571,1,0.0,0,1,0,1,1,0,0,3,0,2,4,1
1852,26236,b3xaxczfVryBkeC1YPbXWEZUleYIZAnq,SpATywNh6bZuzm8s1ceuBUnMUAeoAHHw,45,66,34,57,24,16,23,1,221,31.571428571428573,5,0.0,30,34,50,24,36,16,7,23,1,138,83,1
1853,26248,pJmb8msDK6UJTKUXmJdXuhyoQrk5GlVv,SpATywNh6bZuzm8s1ceuBUnMUAeoAHHw,7,4,3,0,3,0,3,0,13,1.8571428571428572,1,0.0,0,3,0,3,4,0,0,3,0,6,7,1
1854,26255,v6GmjzoPMSZcgdRV04c3r4zmEQVHxeod,A3fsA9Zfv1X2fVEQhTw51lKENdNrEqT3,11,10,6,0,5,0,3,0,24,3.4285714285714284,2,0.0,0,6,0,5,10,0,0,3,0,11,13,1
1855,26274,Y51MqWhaiGyWdNickwBkKEZ7LC7se5uV,bWdj2GDclj5ofokWjzoa5jAwMkxCykd6,14,37,8,0,9,3,10,1,68,9.714285714285714,4,0.0,0,8,0,9,37,3,0,10,1,17,51,0
1856,26277,m3MqtCVwUomC1r1STaTTddPYjy0l0hZb,bWdj2GDclj5ofokWjzoa5jAwMkxCykd6,2,0,0,0,0,0,2,0,2,0.2857142857142857,2,0.0,0,0,0,0,0,0,0,2,0,0,2,1
1857,26286,d5fIWN5kvqsn40aHFJvoDDo4RHSEcHNo,SpATywNh6bZuzm8s1ceuBUnMUAeoAHHw,13,19,10,3,5,0,7,0,44,6.285714285714286,5,0.0,0,10,3,5,19,0,0,7,0,18,26,1
1858,26295,C47wZ77Ppvq0cRz56MIplUrxzRboyv9h,SpATywNh6bZuzm8s1ceuBUnMUAeoAHHw,24,48,10,12,5,0,12,0,87,12.428571428571429,1,0.0,0,10,10,5,48,0,2,12,0,25,62,1
1859,26297,UjnOd8eB67vR87Hc1uvDJpBawBhqSd4C,SpATywNh6bZuzm8s1ceuBUnMUAeoAHHw,40,77,31,61,18,0,11,0,198,28.285714285714285,8,0.0,33,31,53,18,44,0,8,11,0,135,63,1
1860,26310,vuslHI1UxdeXKs1vDUvKXYQqg3X9k91E,7GRhBDsirIGkRZBtSMEzNTyDr2JQm4xx,7,3,2,0,2,0,3,0,10,1.4285714285714286,3,0.0,0,2,0,2,3,0,0,3,0,4,6,1
1861,26322,XMtcnsDNasKCOMBWrsjCVH5NONQyEryR,A3fsA9Zfv1X2fVEQhTw51lKENdNrEqT3,49,45,31,70,22,2,19,1,190,27.142857142857142,6,0.0,2,31,60,22,43,2,10,19,1,115,75,0
1862,26326,drIV8ws6G2eFjZA06SdUOTyJLvhyaXrd,SpATywNh6bZuzm8s1ceuBUnMUAeoAHHw,25,35,15,23,2,4,18,3,100,14.285714285714286,9,0.0,13,15,22,2,22,4,1,18,3,52,48,0
1863,26335,IW0jtTZGLkJezOCVgyOKwdgLTuPt0owB,SpATywNh6bZuzm8s1ceuBUnMUAeoAHHw,43,66,4,65,1,9,9,1,155,22.142857142857142,6,0.0,23,4,54,1,43,9,11,9,1,82,73,0
1864,26336,2s1w2v8MgoByNGqR51pltJWsiHzHAFZ1,SpATywNh6bZuzm8s1ceuBUnMUAeoAHHw,40,48,0,38,0,3,7,0,96,13.714285714285714,6,0.0,10,0,33,0,38,3,5,7,0,43,53,0
1865,26362,SAfnpYIfr0KwKQRQDGxyE1fyeIIuapJW,bWdj2GDclj5ofokWjzoa5jAwMkxCykd6,1,0,0,0,0,0,1,0,1,0.14285714285714285,1,0.0,0,0,0,0,0,0,0,1,0,0,1,1
1866,26372,n9pMeUNiRSC6CgcSbq2dPbx8FhUkGah9,A3fsA9Zfv1X2fVEQhTw51lKENdNrEqT3,44,37,27,0,21,2,15,0,102,14.571428571428571,5,0.0,0,27,0,21,37,2,0,15,0,48,54,0
1867,26383,PLKfIj5PWmJ1pq6F2TAT2ZidBGAMa6pt,SpATywNh6bZuzm8s1ceuBUnMUAeoAHHw,2,0,0,0,0,0,3,0,3,0.42857142857142855,1,0.0,0,0,0,0,0,0,0,3,0,0,3,1
1868,26407,Do8hbesbT6OBtmo3AMshqQTnDUWGEYzY,bWdj2GDclj5ofokWjzoa5jAwMkxCykd6,16,28,16,38,9,6,6,0,103,14.714285714285714,4,0.0,2,16,35,9,26,6,3,6,0,62,41,0
1869,26410,hIRmhKUbv5EQgDyxP7vWP9iwTw6fJ29b,A3fsA9Zfv1X2fVEQhTw51lKENdNrEqT3,1,0,0,0,0,0,1,0,1,0.14285714285714285,1,0.0,0,0,0,0,0,0,0,1,0,0,1,1
1870,26411,XGWArK05Wzjd8AdGaPxkShZOu2YZKkZ4,SpATywNh6bZuzm8s1ceuBUnMUAeoAHHw,29,51,22,24,9,6,10,1,123,17.571428571428573,4,0.0,8,22,19,9,43,6,5,10,1,58,65,0
1871,26419,yCobmn3bYowOXtgM2MWC1dOZIX5337iq,5X6FeZozNMgE2VRi3MJYjkkFK8SETtu2,9,8,5,0,6,0,4,0,23,3.2857142857142856,2,0.0,2,5,0,6,6,0,0,4,0,13,10,1
1872,26435,N0Sos51WanCzoSGKDmMPzQtMlLxY3bFb,bWdj2GDclj5ofokWjzoa5jAwMkxCykd6,75,165,103,119,45,38,94,5,569,81.28571428571429,17,0.0,22,103,106,45,143,38,13,94,5,276,293,0
1873,26442,C8XrXSQZNN8RR6xEeSRWbKA5jTxVTtPT,SpATywNh6bZuzm8s1ceuBUnMUAeoAHHw,31,39,27,0,17,0,7,0,90,12.857142857142858,4,0.0,7,27,0,17,32,0,0,7,0,51,39,0
1874,26443,rop0ItXlfQaL7isXEgn3BRt60tvyrDtS,SpATywNh6bZuzm8s1ceuBUnMUAeoAHHw,8,8,4,0,1,0,2,0,15,2.142857142857143,2,0.0,0,4,0,1,8,0,0,2,0,5,10,1
1875,26499,5dvfr5EjWeXuIobwrgh7MVbCslwNXi21,SpATywNh6bZuzm8s1ceuBUnMUAeoAHHw,42,115,26,32,17,0,17,0,207,29.571428571428573,10,0.0,27,26,29,17,88,0,3,17,0,99,108,0
1876,26511,wdK5DIKl9qd73hM1uOx3ufcKj0J9AcRr,SpATywNh6bZuzm8s1ceuBUnMUAeoAHHw,32,84,53,27,25,1,20,0,210,30.0,14,0.0,13,53,24,25,71,1,3,20,0,115,95,1
1877,26537,zzDcC2Q7qPZNjUcDFhhRKUy0mGAUmUju,5X6FeZozNMgE2VRi3MJYjkkFK8SETtu2,1,0,0,0,0,0,1,0,1,0.14285714285714285,1,0.0,0,0,0,0,0,0,0,1,0,0,1,1
1878,26538,aEpxyypSZgchkPG1jGPLZvADGPtcFbJZ,SpATywNh6bZuzm8s1ceuBUnMUAeoAHHw,25,49,1,72,0,0,9,0,131,18.714285714285715,3,0.0,29,1,61,0,20,0,11,9,0,91,40,0
1879,26547,Jb792VQeMGhUz59LQDa5JysSU082aNRs,SpATywNh6bZuzm8s1ceuBUnMUAeoAHHw,4,3,1,0,0,0,1,0,5,0.7142857142857143,1,0.0,0,1,0,0,3,0,0,1,0,1,4,0
1880,26549,pw6cK2a1Sg11o70Y9sMOyOCkYUg7dGT2,SpATywNh6bZuzm8s1ceuBUnMUAeoAHHw,2,0,0,0,0,0,2,0,2,0.2857142857142857,1,0.0,0,0,0,0,0,0,0,2,0,0,2,0
1881,26580,Ce9saCYn5kapFVCsZrhP2U86gMYaxqgR,5X6FeZozNMgE2VRi3MJYjkkFK8SETtu2,4,6,1,0,2,0,1,0,10,1.4285714285714286,1,0.0,4,1,0,2,2,0,0,1,0,7,3,1
1882,26584,3jDnMuiM4IBbYvTjjX7VYaBZ7em1ZL1E,SpATywNh6bZuzm8s1ceuBUnMUAeoAHHw,3,3,0,0,0,0,1,0,4,0.5714285714285714,1,0.0,0,0,0,0,3,0,0,1,0,0,4,1
1883,26593,yYrk7RmkclaZIv32ppfmidCUMKYlGdCg,7GRhBDsirIGkRZBtSMEzNTyDr2JQm4xx,37,44,13,61,12,13,11,1,155,22.142857142857142,3,0.0,26,13,53,12,18,13,8,11,1,104,51,1
1884,26595,ZRB8OhpRpRUzGZm1XUTryPd3ZIuqeZkS,SpATywNh6bZuzm8s1ceuBUnMUAeoAHHw,39,61,11,41,4,4,13,3,137,19.571428571428573,6,0.0,16,11,34,4,45,4,7,13,3,65,72,0
1885,26599,U67fb5QeZtT5a6ySqaXNsz9xNIhOXSpr,A3fsA9Zfv1X2fVEQhTw51lKENdNrEqT3,4,2,1,0,1,0,1,0,5,0.7142857142857143,1,0.0,0,1,0,1,2,0,0,1,0,2,3,1
1886,26607,xZfmqTm2RfHtIZNcfGRoxYWwTYC59P9Y,SpATywNh6bZuzm8s1ceuBUnMUAeoAHHw,19,11,8,12,4,0,9,0,44,6.285714285714286,2,0.0,2,8,12,4,9,0,0,9,0,26,18,1
1887,26625,chwuEH1iMc682zjOmO4zFwwfUl1drv8Q,RXDvfPUBYFlVdlueBFbLW0mhhAyGEqpt,99,150,62,155,59,9,33,0,468,66.85714285714286,12,0.0,81,62,148,59,69,9,7,33,0,350,118,0
1888,26646,FTFqKwImn2g5HOczngN9ivdTWQOMMnhK,5X6FeZozNMgE2VRi3MJYjkkFK8SETtu2,26,16,3,36,3,0,4,0,62,8.857142857142858,2,0.0,9,3,32,3,7,0,4,4,0,47,15,0
1889,26665,BBhw3UYl7bLm8HtrStGuhGw3LOKEYu9g,SpATywNh6bZuzm8s1ceuBUnMUAeoAHHw,5,2,1,0,1,0,2,0,6,0.8571428571428571,1,0.0,0,1,0,1,2,0,0,2,0,2,4,1
1890,26666,Fz1sWAbM71xoTZjBdVXZ9gkwHcmS3vjC,G8EPVSXsOYB5YQWZGiz1aVq5Pgr2GrQu,67,109,42,186,23,10,21,0,391,55.857142857142854,4,0.0,46,42,141,23,63,10,45,21,0,252,139,0
1891,26673,otvwHl0K2Si9acp5jqqo5PZYsAo2LLFQ,SpATywNh6bZuzm8s1ceuBUnMUAeoAHHw,9,6,5,0,3,0,2,0,16,2.2857142857142856,1,0.0,0,5,0,3,6,0,0,2,0,8,8,0
1892,26678,OsS1Y0pb3ORCYhSo3uyNzAmfIGWlMI5F,SpATywNh6bZuzm8s1ceuBUnMUAeoAHHw,31,91,21,21,8,29,25,7,202,28.857142857142858,5,0.0,13,21,20,8,78,29,1,25,7,62,140,1
1893,26699,2WPAcVd6xHOkO7YPphHLRGJqR9SuLhLc,SpATywNh6bZuzm8s1ceuBUnMUAeoAHHw,50,98,57,59,17,32,23,4,290,41.42857142857143,8,0.0,32,57,54,17,66,32,5,23,4,160,130,0
1894,26704,OF8cZCIXPsuM4CdS1yd3vA1SWWYblMbf,SpATywNh6bZuzm8s1ceuBUnMUAeoAHHw,40,55,28,44,7,0,13,0,147,21.0,8,0.0,17,28,41,7,38,0,3,13,0,93,54,0
1895,26733,M507IlBQp64NkSWnSkchjsahApLaE1kJ,7GRhBDsirIGkRZBtSMEzNTyDr2JQm4xx,5,4,2,0,1,0,2,0,9,1.2857142857142858,2,0.0,0,2,0,1,4,0,0,2,0,3,6,1
1896,26735,tHsxhnUu7P3M7UPovo290TeoX2E43yvd,SpATywNh6bZuzm8s1ceuBUnMUAeoAHHw,31,48,20,13,12,3,9,0,105,15.0,2,0.0,10,20,13,12,38,3,0,9,0,55,50,0
1897,26744,6ukzVV282fPHH5seR4Ah1PDJIZzJboQW,5X6FeZozNMgE2VRi3MJYjkkFK8SETtu2,1,0,0,0,0,0,1,0,1,0.14285714285714285,1,0.0,0,0,0,0,0,0,0,1,0,0,1,1
1898,26745,mVxXM4uqYYFxw6xO5ph13dgwKbKNNXKw,SpATywNh6bZuzm8s1ceuBUnMUAeoAHHw,8,11,7,0,6,0,4,0,28,4.0,2,0.0,0,7,0,6,11,0,0,4,0,13,15,0
1899,26746,6ukzVV282fPHH5seR4Ah1PDJIZzJboQW,bWdj2GDclj5ofokWjzoa5jAwMkxCykd6,8,11,1,0,1,0,3,0,16,2.2857142857142856,1,0.0,0,1,0,1,11,0,0,3,0,2,14,0
1900,26753,rtgTs2kGzBpdKATcXoyCz0DWaiz8id28,A3fsA9Zfv1X2fVEQhTw51lKENdNrEqT3,1,0,0,0,0,0,1,0,1,0.14285714285714285,1,0.0,0,0,0,0,0,0,0,1,0,0,1,1
1901,26756,MV7MV74nJFl2EzcPH6rDJPH3UeLlvY9k,SpATywNh6bZuzm8s1ceuBUnMUAeoAHHw,39,30,25,5,19,0,3,0,82,11.714285714285714,3,0.0,1,25,4,19,29,0,1,3,0,49,33,1
1902,26759,JjnxjfFF8FHgjBS10KWmcZYKQ28dG2oi,bWdj2GDclj5ofokWjzoa5jAwMkxCykd6,2,0,0,0,0,63,4,0,67,9.571428571428571,3,0.0,0,0,0,0,0,63,0,4,0,0,67,0
1903,26769,QKh6yCjm7KCBJwTgcTdbJMWujg3bWjbd,SpATywNh6bZuzm8s1ceuBUnMUAeoAHHw,48,97,19,62,6,12,26,1,223,31.857142857142858,8,0.0,26,19,56,6,71,12,6,26,1,107,116,0
1904,26806,v3af5rWc4AOfzZv6mvaIgDKPH5PLVH0T,RXDvfPUBYFlVdlueBFbLW0mhhAyGEqpt,32,70,40,0,13,115,45,4,287,41.0,7,0.0,4,40,0,13,66,115,0,45,4,57,230,0
1905,26827,k7pBdSa1col2rksCm2mKNY7Iwzq5nzuk,A3fsA9Zfv1X2fVEQhTw51lKENdNrEqT3,18,36,0,0,0,6,14,1,57,8.142857142857142,2,0.0,0,0,0,0,36,6,0,14,1,0,57,0
1906,26844,q2xQCstASp96wpspi8iqsuaqJ7gzfsux,G8EPVSXsOYB5YQWZGiz1aVq5Pgr2GrQu,4,8,2,0,0,0,1,0,11,1.5714285714285714,1,0.0,5,2,0,0,3,0,0,1,0,7,4,1
1907,26849,kXgQA1U58eIoQjOXj3HfFHyjJQARpnZR,bWdj2GDclj5ofokWjzoa5jAwMkxCykd6,17,16,10,14,5,2,16,3,66,9.428571428571429,3,0.0,1,10,13,5,15,2,1,16,3,29,37,0
1908,26854,wuDEBYwzFc59ROSpgH7aHeQr4AtmTI28,A3fsA9Zfv1X2fVEQhTw51lKENdNrEqT3,25,27,14,12,10,0,11,0,74,10.571428571428571,4,0.0,0,14,11,10,27,0,1,11,0,35,39,1
1909,26857,g44r9jnfvUwG99HEAhIahumgutn1iCtI,SpATywNh6bZuzm8s1ceuBUnMUAeoAHHw,56,74,38,38,19,0,20,0,189,27.0,8,0.0,19,38,34,19,55,0,4,20,0,110,79,0
1910,26878,zNRtwNQkiCM9OW1nTIM2OGHUm9Iu3JVP,RXDvfPUBYFlVdlueBFbLW0mhhAyGEqpt,66,123,10,161,9,23,23,2,351,50.142857142857146,11,0.0,32,10,147,9,91,23,14,23,2,198,153,0
1911,26879,nE23LYiQpabdXkj6YvKSja9sZnHRizmo,A3fsA9Zfv1X2fVEQhTw51lKENdNrEqT3,15,63,1,0,0,0,9,0,73,10.428571428571429,16,0.0,0,1,0,0,63,0,0,9,0,1,72,0
1912,26891,aKISRtXoCAGczNk9HVhnPtc5abILvx15,bWdj2GDclj5ofokWjzoa5jAwMkxCykd6,4,4,0,0,0,8,2,0,14,2.0,1,0.0,0,0,0,0,4,8,0,2,0,0,14,1
1913,26892,KqTFA16VVILHiK0IYy8jaNTctvzYX8nu,5X6FeZozNMgE2VRi3MJYjkkFK8SETtu2,8,38,2,0,17,0,2,0,59,8.428571428571429,1,0.0,27,2,0,17,11,0,0,2,0,46,13,1
1914,26894,oEaD8Zao03KxJihTh9QEYpbyK6kjdhuu,bWdj2GDclj5ofokWjzoa5jAwMkxCykd6,5,2,1,0,1,0,2,0,6,0.8571428571428571,2,0.0,0,1,0,1,2,0,0,2,0,2,4,1
1915,26896,BlnTp1ja3KvzV481CDJ0HdNG9k4YWwl6,SpATywNh6bZuzm8s1ceuBUnMUAeoAHHw,8,9,5,0,2,0,5,0,21,3.0,1,0.0,0,5,0,2,9,0,0,5,0,7,14,1
1916,26899,SKqtOWa2uBCWLrCYlzFMjf1B70kuA2m8,SpATywNh6bZuzm8s1ceuBUnMUAeoAHHw,44,47,25,30,10,10,15,0,137,19.571428571428573,4,0.0,10,25,27,10,37,10,3,15,0,72,65,0
1917,26917,y4PYMDG8u2c0Sgi9Ir3ypCxWz9jGy1hk,7GRhBDsirIGkRZBtSMEzNTyDr2JQm4xx,2,0,0,0,0,0,2,0,2,0.2857142857142857,1,0.0,0,0,0,0,0,0,0,2,0,0,2,1
1918,26923,PQxAX7A8tQB7sGIcC9YvDjqPxTwtHPvm,SpATywNh6bZuzm8s1ceuBUnMUAeoAHHw,26,59,12,48,1,2,30,1,153,21.857142857142858,8,0.0,19,12,41,1,40,2,7,30,1,73,80,0
1919,26924,vptj4ETLtFQ4ma0zcDVByNO4VFhFTiIc,SpATywNh6bZuzm8s1ceuBUnMUAeoAHHw,20,85,11,15,5,8,23,1,148,21.142857142857142,9,0.0,28,11,15,5,57,8,0,23,1,59,89,0
1920,26932,j8DKRXlbBhJ6ifZiglKMxqN6K5Ef7FDx,SpATywNh6bZuzm8s1ceuBUnMUAeoAHHw,5,4,2,0,3,0,2,0,11,1.5714285714285714,1,0.0,0,2,0,3,4,0,0,2,0,5,6,1
1921,26935,5QSnLk3nUbOoWCmYIjRNg8lJNQJ2jQBA,5X6FeZozNMgE2VRi3MJYjkkFK8SETtu2,8,6,3,0,1,0,7,2,19,2.7142857142857144,3,0.0,0,3,0,1,6,0,0,7,2,4,15,1
1922,26946,DsHgWZRTJ1y1l15smwhB78ZQq3d8dyKP,A3fsA9Zfv1X2fVEQhTw51lKENdNrEqT3,2,0,0,0,0,0,6,0,6,0.8571428571428571,6,0.0,0,0,0,0,0,0,0,6,0,0,6,0
1923,26952,CoJba6QLtYix733vlbUGcTkbe73oqQlb,A3fsA9Zfv1X2fVEQhTw51lKENdNrEqT3,1,0,0,0,0,0,1,0,1,0.14285714285714285,1,0.0,0,0,0,0,0,0,0,1,0,0,1,1
1924,26980,eHoa4dnAqoZqw72CCle00GlHxpp5Lihg,SpATywNh6bZuzm8s1ceuBUnMUAeoAHHw,33,54,23,27,12,13,10,0,139,19.857142857142858,6,0.0,18,23,26,12,36,13,1,10,0,79,60,0
1925,27002,65UOsOYgBFCK8lFA2oh4JXpCpEJQ6Qpa,SpATywNh6bZuzm8s1ceuBUnMUAeoAHHw,7,3,2,0,2,0,2,0,9,1.2857142857142858,1,0.0,0,2,0,2,3,0,0,2,0,4,5,1
1926,27004,YA7ruJHya4O17V317Yx8gXDQAyqYdgpH,A3fsA9Zfv1X2fVEQhTw51lKENdNrEqT3,10,5,4,0,4,0,1,0,14,2.0,1,0.0,0,4,0,4,5,0,0,1,0,8,6,1
1927,27011,v56sXsiqO16CihVjx7LnUaL1FBKZRJGr,SpATywNh6bZuzm8s1ceuBUnMUAeoAHHw,2,0,0,0,0,0,3,0,3,0.42857142857142855,1,0.0,0,0,0,0,0,0,0,3,0,0,3,1
1928,27025,gpa1OPqp1fw56hdOLoug5JiJSiTGCtE4,bWdj2GDclj5ofokWjzoa5jAwMkxCykd6,48,56,10,98,0,23,11,3,201,28.714285714285715,4,0.0,13,10,95,0,43,23,3,11,3,118,83,0
1929,27036,5iaVnotpymFcumonl8g2gZO9P5jogtd2,bWdj2GDclj5ofokWjzoa5jAwMkxCykd6,2,0,0,0,0,0,3,0,3,0.42857142857142855,2,0.0,0,0,0,0,0,0,0,3,0,0,3,0
1930,27041,jJiAYOerqhZGMDZThRRrc2HdWKEBffOQ,SpATywNh6bZuzm8s1ceuBUnMUAeoAHHw,1,0,0,0,0,0,2,0,2,0.2857142857142857,1,0.0,0,0,0,0,0,0,0,2,0,0,2,1
1931,27049,NyRX8nPDWLIgLtE9cch3ACh6oFi0cOSx,SpATywNh6bZuzm8s1ceuBUnMUAeoAHHw,7,11,2,0,1,0,3,0,17,2.4285714285714284,2,0.0,0,2,0,1,11,0,0,3,0,3,14,0
1932,27064,ZMTcKQbBQl56kBXzK6ZZeR0SWzh1XSjd,A3fsA9Zfv1X2fVEQhTw51lKENdNrEqT3,14,32,22,0,10,1,19,0,84,12.0,8,0.0,0,22,0,10,32,1,0,19,0,32,52,0
1933,27065,36ku7KQDPB0sZM9OZArWOX1N3O9xu440,SpATywNh6bZuzm8s1ceuBUnMUAeoAHHw,1,0,0,0,0,0,1,0,1,0.14285714285714285,1,0.0,0,0,0,0,0,0,0,1,0,0,1,1
1934,27107,GNsGzjFSidI9fBCvT9fI5F8kfuYTc1I2,SpATywNh6bZuzm8s1ceuBUnMUAeoAHHw,34,35,24,48,13,6,12,0,138,19.714285714285715,4,0.0,6,24,41,13,29,6,7,12,0,84,54,0
1935,27116,Y1uVq657IWCue4abNsh62IVHKtmwsQHQ,G8EPVSXsOYB5YQWZGiz1aVq5Pgr2GrQu,59,76,57,8,18,0,15,0,174,24.857142857142858,6,0.0,9,57,4,18,67,0,4,15,0,88,86,0
1936,27135,4n96XjFWm119IxNfDqefEGXTwnnmn5om,SpATywNh6bZuzm8s1ceuBUnMUAeoAHHw,29,37,2,42,0,0,5,0,86,12.285714285714286,3,0.0,11,2,35,0,26,0,7,5,0,48,38,1
1937,27149,JUWUvJcphX1ykyuSffeN4ZAztcLzCvae,SpATywNh6bZuzm8s1ceuBUnMUAeoAHHw,4,1,0,0,0,0,3,0,4,0.5714285714285714,1,0.0,0,0,0,0,1,0,0,3,0,0,4,0
1938,27161,TNArortVQm3F09odJ2W3xdM27lVc5PiX,7GRhBDsirIGkRZBtSMEzNTyDr2JQm4xx,50,64,19,45,21,1,14,0,164,23.428571428571427,7,0.0,18,19,41,21,46,1,4,14,0,99,65,1
1939,27164,q0GZFChoVOuhzxYur1QICnKH6imiHQh6,SpATywNh6bZuzm8s1ceuBUnMUAeoAHHw,19,53,22,24,0,1,26,1,127,18.142857142857142,9,0.0,9,22,24,0,44,1,0,26,1,55,72,0
1940,27169,TMLHDEunctUbbn16KffZHzQrVcud2Q9Y,bWdj2GDclj5ofokWjzoa5jAwMkxCykd6,36,49,29,130,20,0,7,0,235,33.57142857142857,3,0.0,12,29,108,20,37,0,22,7,0,169,66,0
1941,27174,ZSKBKnD8wfegggUigWIwrMo7a1rGr9YG,A3fsA9Zfv1X2fVEQhTw51lKENdNrEqT3,8,6,4,0,3,0,3,0,16,2.2857142857142856,1,0.0,0,4,0,3,6,0,0,3,0,7,9,0
1942,27176,cs1e0x90m3RHg7MlT1h0YOwuL4MzngHW,7GRhBDsirIGkRZBtSMEzNTyDr2JQm4xx,12,16,5,1,0,3,9,1,35,5.0,1,0.0,11,5,1,0,5,3,0,9,1,17,18,1
1943,27178,3GyWUBVi0ZEtgDniG78bG37zc4UZrPNu,RXDvfPUBYFlVdlueBFbLW0mhhAyGEqpt,108,192,86,232,39,37,34,2,622,88.85714285714286,9,0.0,37,86,216,39,155,37,16,34,2,378,244,1
1944,27186,dI0jOfzj8SJw9E2PkA63bWlxL71OLyUr,bWdj2GDclj5ofokWjzoa5jAwMkxCykd6,7,8,2,0,0,21,7,1,39,5.571428571428571,2,0.0,0,2,0,0,8,21,0,7,1,2,37,0
1945,27187,imtJFGBCtMAkOvvJ09P5N0sgBTGSUYzd,SpATywNh6bZuzm8s1ceuBUnMUAeoAHHw,17,19,9,16,5,0,4,0,53,7.571428571428571,3,0.0,7,9,14,5,12,0,2,4,0,35,18,0
1946,27189,PYm9QxL1CCjHYX7XOqp8vXAiT1dnOhc3,SpATywNh6bZuzm8s1ceuBUnMUAeoAHHw,5,3,2,0,2,0,2,0,9,1.2857142857142858,2,0.0,0,2,0,2,3,0,0,2,0,4,5,1
1947,27212,4DdK8TmenB23ZCgCZB7QoDxAHSAI2lo5,A3fsA9Zfv1X2fVEQhTw51lKENdNrEqT3,5,2,1,0,1,0,2,0,6,0.8571428571428571,1,0.0,0,1,0,1,2,0,0,2,0,2,4,1
1948,27223,amNosdi6Uiilljdy8esSBA3F29NKPLUW,SpATywNh6bZuzm8s1ceuBUnMUAeoAHHw,27,33,21,27,10,0,14,0,105,15.0,6,0.0,6,21,27,10,27,0,0,14,0,64,41,1
1949,27252,623I0R5YkXD8Jxqbb7RUIvBlbAWDAwhe,bWdj2GDclj5ofokWjzoa5jAwMkxCykd6,6,0,0,0,0,0,5,1,6,0.8571428571428571,1,0.0,0,0,0,0,0,0,0,5,1,0,6,1
1950,27268,KmrafWa5j0EoSlyTehpuPHeKeDiU4jD1,SpATywNh6bZuzm8s1ceuBUnMUAeoAHHw,17,36,20,16,9,3,5,0,89,12.714285714285714,4,0.0,10,20,15,9,26,3,1,5,0,54,35,1
1951,27305,mvWG8WfFoikkAB9Wg1mtbCZJVje4NMeg,bWdj2GDclj5ofokWjzoa5jAwMkxCykd6,71,66,35,201,21,126,21,2,472,67.42857142857143,8,0.0,19,35,179,21,47,126,22,21,2,254,218,0
1952,27316,oJmCgDBYDqQXUsH41PFzwJxrFZzGvukQ,7GRhBDsirIGkRZBtSMEzNTyDr2JQm4xx,2,0,0,0,0,2,1,0,3,0.42857142857142855,1,0.0,0,0,0,0,0,2,0,1,0,0,3,1
1953,27323,y27oPhdLREvZCyVoOXXG4AcQOB5tYXaz,5X6FeZozNMgE2VRi3MJYjkkFK8SETtu2,8,8,0,12,0,0,2,0,22,3.142857142857143,1,0.0,3,0,9,0,5,0,3,2,0,12,10,1
1954,27324,fJRilHVpgCFPzgCMD6Xh8rgK6259Z6TQ,7GRhBDsirIGkRZBtSMEzNTyDr2JQm4xx,10,13,5,10,4,4,3,0,39,5.571428571428571,2,0.0,4,5,8,4,9,4,2,3,0,21,18,1
1955,27331,xrLVCjvq2WZdMIKT9yLmMgpNoKuooAqk,bWdj2GDclj5ofokWjzoa5jAwMkxCykd6,4,2,1,0,1,0,2,0,6,0.8571428571428571,1,0.0,0,1,0,1,2,0,0,2,0,2,4,1
1956,27332,rz8gqb0xki7JyRvmBK5JfOlM8YmBiT6q,SpATywNh6bZuzm8s1ceuBUnMUAeoAHHw,51,89,42,44,26,6,22,1,230,32.857142857142854,12,0.0,29,42,41,26,60,6,3,22,1,138,92,0
1957,27336,uHeTIz8GkglZUts3zio1tGR2aBoYwiQE,A3fsA9Zfv1X2fVEQhTw51lKENdNrEqT3,70,30,22,118,15,11,12,1,209,29.857142857142858,3,0.0,2,22,112,15,28,11,6,12,1,151,58,1
1958,27350,BFcEovexz00IfJUn8TqPcKhZyCRYBP66,RXDvfPUBYFlVdlueBFbLW0mhhAyGEqpt,2,0,0,0,0,0,2,0,2,0.2857142857142857,1,0.0,0,0,0,0,0,0,0,2,0,0,2,1
1959,27364,VxTZo8wWibkIng7J8YPkqWh1rsEKvqTC,7GRhBDsirIGkRZBtSMEzNTyDr2JQm4xx,5,18,12,0,12,0,2,0,44,6.285714285714286,18,0.0,0,12,0,12,18,0,0,2,0,24,20,0
1960,27393,zeAmUBAf1zNTSGXoE3zumd8rzCoIwZ5W,5X6FeZozNMgE2VRi3MJYjkkFK8SETtu2,6,2,1,0,1,1,3,0,8,1.1428571428571428,1,0.0,0,1,0,1,2,1,0,3,0,2,6,1
1961,27404,HDD1g3rYbRszzNZAvMB0irAHbU4W6xUO,SpATywNh6bZuzm8s1ceuBUnMUAeoAHHw,28,101,15,38,7,21,24,6,212,30.285714285714285,8,0.0,33,15,33,7,68,21,5,24,6,88,124,1
1962,27425,QKFgXpDRmtAntqyPA4XZkFAYLg7Q7QGI,5X6FeZozNMgE2VRi3MJYjkkFK8SETtu2,9,16,5,0,3,7,8,0,39,5.571428571428571,6,0.0,2,5,0,3,14,7,0,8,0,10,29,1
1963,27429,IYFIdswDKEsO4j14D9vS4fhZEQBqA7vK,SpATywNh6bZuzm8s1ceuBUnMUAeoAHHw,17,39,20,8,8,13,24,0,112,16.0,10,0.0,7,20,8,8,32,13,0,24,0,43,69,0
1964,27449,M8C9BDFICk4ida59GU0jjp556zazDEi1,SpATywNh6bZuzm8s1ceuBUnMUAeoAHHw,44,88,38,36,19,1,20,0,202,28.857142857142858,10,0.0,26,38,35,19,62,1,1,20,0,118,84,0
1965,27450,h5vEAVTb94xGNGjpn4Ohi5mNcXfM0rMl,G8EPVSXsOYB5YQWZGiz1aVq5Pgr2GrQu,4,2,0,0,0,0,4,0,6,0.8571428571428571,1,0.0,0,0,0,0,2,0,0,4,0,0,6,1
1966,27462,CYUGDG4GDnccqiwcMR066vcF013j1TMy,7GRhBDsirIGkRZBtSMEzNTyDr2JQm4xx,1,0,0,0,0,0,1,0,1,0.14285714285714285,1,0.0,0,0,0,0,0,0,0,1,0,0,1,1
1967,27485,CYUGDG4GDnccqiwcMR066vcF013j1TMy,5X6FeZozNMgE2VRi3MJYjkkFK8SETtu2,1,0,0,0,0,0,1,0,1,0.14285714285714285,1,0.0,0,0,0,0,0,0,0,1,0,0,1,1
1968,27497,g6Nv7zrAUSY5suYgQ1EV1HY4bAaM1IoO,A3fsA9Zfv1X2fVEQhTw51lKENdNrEqT3,2,0,0,0,0,0,9,0,9,1.2857142857142858,4,0.0,0,0,0,0,0,0,0,9,0,0,9,1
1969,27501,rfOApTbQ4xF2665bHZIBhoJqQcTU6i9L,SpATywNh6bZuzm8s1ceuBUnMUAeoAHHw,50,68,38,25,16,21,24,1,193,27.571428571428573,7,0.0,15,38,22,16,53,21,3,24,1,91,102,0
1970,27505,GqvZlCSL2xoDXr8RnEtKoBCGOMk7l8qe,bWdj2GDclj5ofokWjzoa5jAwMkxCykd6,6,3,2,0,2,0,2,0,9,1.2857142857142858,1,0.0,0,2,0,2,3,0,0,2,0,4,5,1
1971,27527,95RaJ62uNSmKXeQXyHNyaKGynHoKJ32a,SpATywNh6bZuzm8s1ceuBUnMUAeoAHHw,38,78,10,54,6,9,22,0,179,25.571428571428573,7,0.0,11,10,49,6,67,9,5,22,0,76,103,0
1972,27535,VQ4FtoMJj29hpPrAQ6LMEGesAofjErC4,G8EPVSXsOYB5YQWZGiz1aVq5Pgr2GrQu,79,253,18,224,14,20,45,4,578,82.57142857142857,11,0.0,72,18,161,14,181,20,63,45,4,265,313,0
1973,27536,p7V6MquT5r2C7VmRzYjQEOsKx7s5gJug,SpATywNh6bZuzm8s1ceuBUnMUAeoAHHw,25,42,26,0,21,0,6,0,95,13.571428571428571,6,0.0,0,26,0,21,42,0,0,6,0,47,48,0
1974,27544,IKxphgSgfhmDrYkWEy2UPL1kCSRYS8xw,5X6FeZozNMgE2VRi3MJYjkkFK8SETtu2,1,0,0,0,0,0,1,0,1,0.14285714285714285,1,0.0,0,0,0,0,0,0,0,1,0,0,1,1
1975,27607,drUu3tyovHqnF7EAaPHayHDYbWMe2Od6,5Gyp41oLVo7Gg7vF4vpmggWP5MU70QO6,1,0,0,0,0,0,1,0,1,0.14285714285714285,1,0.0,0,0,0,0,0,0,0,1,0,0,1,1
1976,27616,bGUkoSiHaU85ol0k2itTO3o20n3CqprE,5Gyp41oLVo7Gg7vF4vpmggWP5MU70QO6,10,18,9,0,7,0,3,0,37,5.285714285714286,5,0.0,3,9,0,7,15,0,0,3,0,19,18,1
1977,27617,v4KRIvW2fm59UFurmYoSZsK2mZZrmnsA,5Gyp41oLVo7Gg7vF4vpmggWP5MU70QO6,6,2,2,0,2,0,3,1,10,1.4285714285714286,1,0.0,0,2,0,2,2,0,0,3,1,4,6,1
1978,27706,p9aMxBwlOcsOm8IZAr1KbsAeyAVOsJip,5Gyp41oLVo7Gg7vF4vpmggWP5MU70QO6,16,32,1,10,5,16,7,0,71,10.142857142857142,3,0.0,13,1,5,5,19,16,5,7,0,24,47,1
1979,27754,1LtLQwRGDjWRPORAmpPeWuHr93qsG62M,5Gyp41oLVo7Gg7vF4vpmggWP5MU70QO6,17,58,13,23,1,0,24,0,119,17.0,14,0.0,8,13,17,1,50,0,6,24,0,39,80,0
1980,27768,6Eab82jqo4MMXOkEe4r2Db4dOEnEqpR0,5Gyp41oLVo7Gg7vF4vpmggWP5MU70QO6,1,0,0,0,0,0,1,0,1,0.14285714285714285,1,0.0,0,0,0,0,0,0,0,1,0,0,1,1
1981,27783,70uIHzP1IIZFMEduQZw3st02yaDjKlgb,5Gyp41oLVo7Gg7vF4vpmggWP5MU70QO6,1,0,0,0,0,0,1,0,1,0.14285714285714285,1,0.0,0,0,0,0,0,0,0,1,0,0,1,1
1982,27819,CUbueK74RGsaWBcRtztdoMN84Z7TxEjm,5Gyp41oLVo7Gg7vF4vpmggWP5MU70QO6,25,116,59,35,11,61,26,0,308,44.0,9,0.0,18,59,33,11,98,61,2,26,0,121,187,1
1983,27820,viy9SL8VsZTV3spMPC3VdzWUDXysWUO1,5Gyp41oLVo7Gg7vF4vpmggWP5MU70QO6,1,0,0,0,0,0,1,0,1,0.14285714285714285,1,0.0,0,0,0,0,0,0,0,1,0,0,1,1
1984,27822,77MPHfwkkt42tGmBSCy7dOnuW7DkYTkO,5Gyp41oLVo7Gg7vF4vpmggWP5MU70QO6,14,28,14,4,6,17,14,1,84,12.0,4,0.0,8,14,2,6,20,17,2,14,1,30,54,1
1985,27843,mHvBsRgkyfNYyV05aPYKWU64f2SEzjkY,5Gyp41oLVo7Gg7vF4vpmggWP5MU70QO6,3,1,0,0,0,0,3,0,4,0.5714285714285714,1,0.0,0,0,0,0,1,0,0,3,0,0,4,1
1986,27846,MtgML9U5DTFJBtDSHAqmZpBwcT6z3Qr8,5Gyp41oLVo7Gg7vF4vpmggWP5MU70QO6,7,3,2,0,2,2,3,0,12,1.7142857142857142,2,0.0,0,2,0,2,3,2,0,3,0,4,8,1
1987,27850,waaEVaw01xHv5SPp8nsqyoks4dnT71r2,5Gyp41oLVo7Gg7vF4vpmggWP5MU70QO6,1,0,0,0,0,0,1,0,1,0.14285714285714285,1,0.0,0,0,0,0,0,0,0,1,0,0,1,1
1988,27873,YxIxtbwFYAh0BVMShR21NdO0uOmG0LY5,5Gyp41oLVo7Gg7vF4vpmggWP5MU70QO6,41,123,76,49,24,24,21,2,319,45.57142857142857,6,0.0,30,76,39,24,93,24,10,21,2,169,150,0
1989,27877,3tUwJI9fq5MBYvk22zmtcZQjmB4I2cFy,5Gyp41oLVo7Gg7vF4vpmggWP5MU70QO6,43,141,37,30,31,36,21,2,298,42.57142857142857,10,0.0,36,37,21,31,105,36,9,21,2,125,173,1
1990,27879,rSEfJyHxNlxmmbC9ORIbqcFKKq08QDrh,5Gyp41oLVo7Gg7vF4vpmggWP5MU70QO6,34,276,112,36,52,33,52,6,567,81.0,14,0.0,66,112,25,52,210,33,11,52,6,255,312,0
1991,27928,oeNNee8VLaOZ4JNiDLP3KQElGyoff6sR,5Gyp41oLVo7Gg7vF4vpmggWP5MU70QO6,52,149,74,58,30,40,24,3,378,54.0,10,0.0,44,74,44,30,105,40,14,24,3,192,186,0
1992,27974,tikKWc2z3n1yGsQSvUOjLhEnyUq9uxRj,5Gyp41oLVo7Gg7vF4vpmggWP5MU70QO6,28,41,20,20,10,7,4,0,102,14.571428571428571,1,0.0,14,20,10,10,27,7,10,4,0,54,48,1
1993,27979,srNyZjyBFnbcDeb5BmRH5eEYCCmYaMEw,5Gyp41oLVo7Gg7vF4vpmggWP5MU70QO6,5,2,1,0,1,0,2,0,6,0.8571428571428571,1,0.0,0,1,0,1,2,0,0,2,0,2,4,1
1994,28007,DevStKADWJCs4VIgaRDuaZTBfJdFYa9g,5Gyp41oLVo7Gg7vF4vpmggWP5MU70QO6,12,12,0,2,0,2,10,1,27,3.857142857142857,1,0.0,1,0,1,0,11,2,1,10,1,2,25,1
1995,28013,h6u0wQj42DYQTidZif6qRzNNOufvDl7O,5Gyp41oLVo7Gg7vF4vpmggWP5MU70QO6,11,15,5,4,2,0,6,0,32,4.571428571428571,1,0.0,4,5,2,2,11,0,2,6,0,13,19,0
1996,28028,33S47D1TFrB6jvfJjcWGTReyNgi4HDab,5Gyp41oLVo7Gg7vF4vpmggWP5MU70QO6,22,60,29,23,9,8,17,0,146,20.857142857142858,6,0.0,15,29,17,9,45,8,6,17,0,70,76,1
1997,28057,ADWuLZoohNdwALlHCNREgIacghlfqz70,5Gyp41oLVo7Gg7vF4vpmggWP5MU70QO6,7,4,3,0,3,0,3,0,13,1.8571428571428572,1,0.0,0,3,0,3,4,0,0,3,0,6,7,1
1998,28088,p2WxyRGvLvUMOSoEWtLVx9Ca2AiCwjk0,5Gyp41oLVo7Gg7vF4vpmggWP5MU70QO6,25,47,28,12,13,0,17,0,117,16.714285714285715,9,0.0,7,28,10,13,40,0,2,17,0,58,59,1
1999,28112,NdlZQ93nuUtsQYuMit4K3FYA797jHC8C,5Gyp41oLVo7Gg7vF4vpmggWP5MU70QO6,32,112,43,16,26,7,28,2,234,33.42857142857143,8,0.0,54,43,9,26,58,7,7,28,2,132,102,1
2000,28145,nlIlTPImkmx3RycwckjSOt8ecoDGrhVu,5Gyp41oLVo7Gg7vF4vpmggWP5MU70QO6,1,0,0,0,0,0,1,0,1,0.14285714285714285,1,0.0,0,0,0,0,0,0,0,1,0,0,1,1
2001,28189,UHZZkddRJgMR0bCu07Tnczse0VrYi3iZ,5Gyp41oLVo7Gg7vF4vpmggWP5MU70QO6,9,5,3,0,4,0,2,0,14,2.0,1,0.0,1,3,0,4,4,0,0,2,0,8,6,1
2002,28218,9nRMm1PA3GIKd2fFGQBMEaDBV01scEDf,5Gyp41oLVo7Gg7vF4vpmggWP5MU70QO6,27,23,11,15,2,0,13,0,64,9.142857142857142,5,0.0,11,11,14,2,12,0,1,13,0,38,26,1
2003,28231,9sUYEAOdTSko17AkFIhOnmpUMN8uDHrD,5Gyp41oLVo7Gg7vF4vpmggWP5MU70QO6,5,2,1,0,1,0,2,0,6,0.8571428571428571,1,0.0,0,1,0,1,2,0,0,2,0,2,4,1
2004,28242,CQEE5jXQnQdeSsabuKkk73kWPFKaO3GL,5Gyp41oLVo7Gg7vF4vpmggWP5MU70QO6,13,35,16,2,8,13,12,0,86,12.285714285714286,6,0.0,7,16,1,8,28,13,1,12,0,32,54,1
2005,28253,NngfiLWKtmRngSqwhm1xLIuOMPkjqqCR,5Gyp41oLVo7Gg7vF4vpmggWP5MU70QO6,1,0,0,0,0,0,1,0,1,0.14285714285714285,1,0.0,0,0,0,0,0,0,0,1,0,0,1,1
2006,28271,2WcVsjeOm3ona29kPjgUdn7qc1GQAfCa,5Gyp41oLVo7Gg7vF4vpmggWP5MU70QO6,27,45,13,49,17,0,33,1,158,22.571428571428573,7,0.0,17,13,42,17,28,0,7,33,1,89,69,1
2007,28296,wxDnmvTLHWGwCYYCjH3qEOtgLqGKeB8y,5Gyp41oLVo7Gg7vF4vpmggWP5MU70QO6,41,182,33,12,41,7,24,15,314,44.857142857142854,11,0.0,46,33,7,41,136,7,5,24,15,127,187,1
2008,28307,8pbtepvLHKYhhqvn4VghNNHAGw8nBJaB,5Gyp41oLVo7Gg7vF4vpmggWP5MU70QO6,41,74,44,70,16,0,12,0,216,30.857142857142858,10,0.0,19,44,50,16,55,0,20,12,0,129,87,1
2009,28328,9Cl0RXvHs0leQ1PBsYPWvbt2EpF3zWdx,5Gyp41oLVo7Gg7vF4vpmggWP5MU70QO6,28,61,20,26,7,7,25,4,150,21.428571428571427,3,0.0,27,20,19,7,34,7,7,25,4,73,77,1
2010,28367,wCtJVdIYmv9Ms8iZG8chc5znpGA7mYoM,5Gyp41oLVo7Gg7vF4vpmggWP5MU70QO6,7,8,2,0,2,0,2,0,14,2.0,1,0.0,0,2,0,2,8,0,0,2,0,4,10,1
2011,28376,m7dQRuIWJcVuQOdc14mARu3GfoCyBYQO,5Gyp41oLVo7Gg7vF4vpmggWP5MU70QO6,1,0,0,0,0,0,1,0,1,0.14285714285714285,1,0.0,0,0,0,0,0,0,0,1,0,0,1,1
2012,28389,zXvgHfBVkiLefO10bIMvxqrtbllI8QiV,5Gyp41oLVo7Gg7vF4vpmggWP5MU70QO6,1,0,0,0,0,0,1,0,1,0.14285714285714285,1,0.0,0,0,0,0,0,0,0,1,0,0,1,1
2013,28437,mUsneGKGGtjpeKrQAc5CoB6gvO9CvofU,5Gyp41oLVo7Gg7vF4vpmggWP5MU70QO6,21,49,23,6,14,0,15,0,107,15.285714285714286,7,0.0,18,23,5,14,31,0,1,15,0,60,47,1
2014,28465,HYcYXnKZ11ZiED2AGb0isAMMeWUBvmoH,5Gyp41oLVo7Gg7vF4vpmggWP5MU70QO6,12,30,15,2,8,8,8,0,71,10.142857142857142,3,0.0,8,15,1,8,22,8,1,8,0,32,39,1
2015,28466,TgfUDub3GKAehIIzA0jeuMPCKRYYqncC,5Gyp41oLVo7Gg7vF4vpmggWP5MU70QO6,1,0,0,0,0,0,2,0,2,0.2857142857142857,1,0.0,0,0,0,0,0,0,0,2,0,0,2,1
2016,28479,YYnNGp0Y5eLRtkILBLNkAtUGBjLA3jPV,5Gyp41oLVo7Gg7vF4vpmggWP5MU70QO6,1,0,0,0,0,0,2,0,2,0.2857142857142857,2,0.0,0,0,0,0,0,0,0,2,0,0,2,1
2017,28493,5ESBYT4YXwThMhRWcyNvUGRmyEr1sxDg,5Gyp41oLVo7Gg7vF4vpmggWP5MU70QO6,17,37,16,4,9,2,7,0,75,10.714285714285714,4,0.0,8,16,2,9,29,2,2,7,0,35,40,0
2018,28514,wy2vY5aiYwg0C5zglGAXrG2vaWLSbGC9,5Gyp41oLVo7Gg7vF4vpmggWP5MU70QO6,34,112,22,11,7,71,28,2,253,36.142857142857146,11,0.0,13,22,8,7,99,71,3,28,2,50,203,0
2019,28528,v4hK9ikpjeYzPcAbZUA4mSmZ1iseqmpe,5Gyp41oLVo7Gg7vF4vpmggWP5MU70QO6,1,0,0,0,0,0,5,0,5,0.7142857142857143,2,0.0,0,0,0,0,0,0,0,5,0,0,5,1
2020,28535,6O4ynOxdnlabP5dKzzkEL18OruuOmtCz,5Gyp41oLVo7Gg7vF4vpmggWP5MU70QO6,8,2,1,0,0,3,8,1,15,2.142857142857143,2,0.0,0,1,0,0,2,3,0,8,1,1,14,1
2021,28550,w85QVmINOIyrXRzegh8uuBeGTw3K4uG8,5Gyp41oLVo7Gg7vF4vpmggWP5MU70QO6,23,48,26,8,14,12,10,0,118,16.857142857142858,5,0.0,13,26,7,14,35,12,1,10,0,60,58,1
2022,28551,ZmfdNNznGUKjrKBTFXV9DMVwFsyogQYG,5Gyp41oLVo7Gg7vF4vpmggWP5MU70QO6,12,24,6,0,3,0,6,0,39,5.571428571428571,2,0.0,9,6,0,3,15,0,0,6,0,18,21,0
2023,28563,p8pFuUg19xWGOlJygMvSlQjonA3l7FUn,5Gyp41oLVo7Gg7vF4vpmggWP5MU70QO6,44,156,97,27,24,10,42,1,357,51.0,18,0.0,23,97,21,24,133,10,6,42,1,165,192,0
2024,28568,AHkapH9QrrJ7u3LaJauuxoDD2RWC3zpf,5Gyp41oLVo7Gg7vF4vpmggWP5MU70QO6,13,8,6,2,3,0,3,0,22,3.142857142857143,2,0.0,0,6,1,3,8,0,1,3,0,10,12,0
2025,28607,9CRp8j1wgGbGaOcSurkiNrWOLPDhf4In,5Gyp41oLVo7Gg7vF4vpmggWP5MU70QO6,11,15,5,0,2,0,3,0,25,3.5714285714285716,2,0.0,0,5,0,2,15,0,0,3,0,7,18,0
2026,28610,hkI32MAgHvJ4T3I3Up79daEJ8l4sKHaC,5Gyp41oLVo7Gg7vF4vpmggWP5MU70QO6,18,14,7,3,6,3,7,1,41,5.857142857142857,3,0.0,4,7,2,6,10,3,1,7,1,19,22,0
2027,28633,4ZT746t8DiUlfdfcjqyaZJkio3erWKNc,5Gyp41oLVo7Gg7vF4vpmggWP5MU70QO6,6,4,2,0,3,0,3,0,12,1.7142857142857142,1,0.0,1,2,0,3,3,0,0,3,0,6,6,1
2028,28636,EiO5bky9R1Iqlpv4ItUpPBUgGb1eJItE,5Gyp41oLVo7Gg7vF4vpmggWP5MU70QO6,29,99,63,1,22,139,54,0,378,54.0,14,0.0,10,63,1,22,89,139,0,54,0,96,282,0
2029,28640,FFlICu8a1PeaY8oKBFESJAT3q6I5h6Xu,5Gyp41oLVo7Gg7vF4vpmggWP5MU70QO6,32,67,31,16,10,20,15,1,160,22.857142857142858,5,0.0,16,31,9,10,51,20,7,15,1,66,94,0
2030,28643,qzwoKNXvzaDCrQhr2gKh5368mKxrHA8O,5Gyp41oLVo7Gg7vF4vpmggWP5MU70QO6,10,6,4,2,2,0,5,0,19,2.7142857142857144,1,0.0,1,4,1,2,5,0,1,5,0,8,11,1
2031,28667,1YsC73tsWGiQDhyPcroSv5S1b65G3rWX,5Gyp41oLVo7Gg7vF4vpmggWP5MU70QO6,10,6,3,0,2,1,5,0,17,2.4285714285714284,2,0.0,0,3,0,2,6,1,0,5,0,5,12,1
2032,28671,0vzaI9g7CKCHfy8YoHkcGVFFgOW49jnb,5Gyp41oLVo7Gg7vF4vpmggWP5MU70QO6,13,17,8,0,9,1,4,1,40,5.714285714285714,2,0.0,0,8,0,9,17,1,0,4,1,17,23,1
2033,28715,LgPlpopSU02baX8XsEJO6rWixplusEKm,5Gyp41oLVo7Gg7vF4vpmggWP5MU70QO6,4,2,1,0,0,0,2,0,5,0.7142857142857143,1,0.0,0,1,0,0,2,0,0,2,0,1,4,1
2034,28732,8hZKWjYrckVlJBg63KWqw5hJHkhK9cfW,5Gyp41oLVo7Gg7vF4vpmggWP5MU70QO6,8,8,3,4,2,7,3,0,27,3.857142857142857,2,0.0,2,3,2,2,6,7,2,3,0,9,18,1
2035,28760,fol611Bi6YnD4zjFVUOPJixEwpbUH6yt,5Gyp41oLVo7Gg7vF4vpmggWP5MU70QO6,6,5,3,0,2,0,3,0,13,1.8571428571428572,2,0.0,0,3,0,2,5,0,0,3,0,5,8,1
2036,28763,FKoq4lPDlg9drsZxrDcZxTmLcsNctbfa,5Gyp41oLVo7Gg7vF4vpmggWP5MU70QO6,8,7,6,0,4,0,2,0,19,2.7142857142857144,1,0.0,0,6,0,4,7,0,0,2,0,10,9,1
2037,28780,mdVjkXaBdB9YW6Ol7L167d1GVkUMVcrc,5Gyp41oLVo7Gg7vF4vpmggWP5MU70QO6,29,71,22,18,7,6,16,0,140,20.0,5,0.0,6,22,9,7,65,6,9,16,0,44,96,0
2038,28788,frVA77S2ve21UyKXpi7aZkvcgdjXAJyT,5Gyp41oLVo7Gg7vF4vpmggWP5MU70QO6,28,75,41,17,18,12,29,2,194,27.714285714285715,5,0.0,16,41,9,18,59,12,8,29,2,84,110,1
2039,28796,PzbAAQBdNIO5q0hDkxJETX7v12Y9h0xH,5Gyp41oLVo7Gg7vF4vpmggWP5MU70QO6,48,94,47,40,30,10,14,0,235,33.57142857142857,9,0.0,24,47,29,30,70,10,11,14,0,130,105,0
2040,28860,c08HsQcychm8AwpMV8YSi2xSr7I0E7bE,5Gyp41oLVo7Gg7vF4vpmggWP5MU70QO6,11,10,6,0,3,3,6,1,29,4.142857142857143,2,0.0,0,6,0,3,10,3,0,6,1,9,20,1
2041,28878,mu7Zdr1ChN6xNMWE8Otd7Si7TQhm7pEQ,5Gyp41oLVo7Gg7vF4vpmggWP5MU70QO6,21,33,19,0,15,0,36,0,103,14.714285714285714,8,0.0,0,19,0,15,33,0,0,36,0,34,69,0
2042,28890,yQYMLm30GwIRmqXNc4Jn3nUgA6vXILUA,5Gyp41oLVo7Gg7vF4vpmggWP5MU70QO6,64,245,105,75,42,90,54,11,622,88.85714285714286,20,0.0,46,105,55,42,199,90,20,54,11,248,374,0
2043,28891,ic6pjUfgxHe0ndQH7kHuGrLDFqrjZins,5Gyp41oLVo7Gg7vF4vpmggWP5MU70QO6,23,38,27,0,10,40,18,1,134,19.142857142857142,5,0.0,4,27,0,10,34,40,0,18,1,41,93,1
2044,28945,uhXQuUUUVKIwun4V8mG56AtnRcH7YsHS,5Gyp41oLVo7Gg7vF4vpmggWP5MU70QO6,55,127,71,32,65,37,39,1,372,53.142857142857146,12,0.0,51,71,25,65,76,37,7,39,1,212,160,0
2045,28985,Sd54wuYLJGE9pQgAE1cFvsQCM2O9iNXw,5Gyp41oLVo7Gg7vF4vpmggWP5MU70QO6,12,14,8,4,4,0,11,0,41,5.857142857142857,3,0.0,4,8,2,4,10,0,2,11,0,18,23,1
2046,28986,wT7a5vDiVzDXkRsNiuW9QKVvWByJ0Qi5,5Gyp41oLVo7Gg7vF4vpmggWP5MU70QO6,5,2,1,0,1,4,3,0,11,1.5714285714285714,2,0.0,0,1,0,1,2,4,0,3,0,2,9,1
2047,29037,qRW1NJFi20MzuEcmYfBMGU0039ucrG2e,5Gyp41oLVo7Gg7vF4vpmggWP5MU70QO6,11,7,5,0,4,0,2,0,18,2.5714285714285716,2,0.0,0,5,0,4,7,0,0,2,0,9,9,1
2048,29055,mkvSz33MEIqqx5kghC6tYYiyjKCjfl96,5Gyp41oLVo7Gg7vF4vpmggWP5MU70QO6,25,77,5,18,12,20,10,0,142,20.285714285714285,5,0.0,24,5,12,12,53,20,6,10,0,53,89,1
2049,29068,TgbjfjUFSMyIygN3wQCm7khTpUBgPmir,5Gyp41oLVo7Gg7vF4vpmggWP5MU70QO6,7,3,3,0,3,0,6,0,15,2.142857142857143,3,0.0,0,3,0,3,3,0,0,6,0,6,9,1
2050,29093,SFygdEesOWeEamKu8iZBsgHneiDiai0R,5Gyp41oLVo7Gg7vF4vpmggWP5MU70QO6,17,44,3,18,5,23,13,1,107,15.285714285714286,4,0.0,16,3,15,5,28,23,3,13,1,39,68,1
2051,29104,ttGeClEg7U7l2A1yOwZnUOxTG4fiBvUu,5Gyp41oLVo7Gg7vF4vpmggWP5MU70QO6,31,74,31,12,10,24,24,2,177,25.285714285714285,5,0.0,30,31,8,10,44,24,4,24,2,79,98,0
2052,29127,9Deod69Pavn4hLb5cpG0UIDdFFESLD48,5Gyp41oLVo7Gg7vF4vpmggWP5MU70QO6,40,103,68,36,24,12,29,0,272,38.857142857142854,10,0.0,18,68,30,24,85,12,6,29,0,140,132,0
2053,29145,2b2oMscZ1TebdXSExRxc1Bj8PyIwjK6W,5Gyp41oLVo7Gg7vF4vpmggWP5MU70QO6,14,12,7,2,3,6,10,5,45,6.428571428571429,2,0.0,1,7,1,3,11,6,1,10,5,12,33,1
2054,29187,mdSCcL6byi6i0rQq7vUuOfZa5NPcjPwa,5Gyp41oLVo7Gg7vF4vpmggWP5MU70QO6,12,18,9,0,2,0,12,1,42,6.0,4,0.0,2,9,0,2,16,0,0,12,1,13,29,1
2055,29195,yYQocPsuMZkLILVBlIi2Rx8RiVGy4Kig,5Gyp41oLVo7Gg7vF4vpmggWP5MU70QO6,15,25,12,8,4,1,8,0,58,8.285714285714286,4,0.0,8,12,4,4,17,1,4,8,0,28,30,1
2056,29225,uOfATV0WsL0BPHDdVyS70rl0sYjdudpd,5Gyp41oLVo7Gg7vF4vpmggWP5MU70QO6,14,22,13,0,6,0,12,0,53,7.571428571428571,3,0.0,3,13,0,6,19,0,0,12,0,22,31,1
2057,29240,1Olz0ty9MvTmtUb0M52tOOOcEs0aIaEY,5Gyp41oLVo7Gg7vF4vpmggWP5MU70QO6,1,0,0,0,0,0,1,0,1,0.14285714285714285,1,0.0,0,0,0,0,0,0,0,1,0,0,1,1
2058,29250,kl6dUylPscrmRxWR7PKwfLKeebQbD2NE,5Gyp41oLVo7Gg7vF4vpmggWP5MU70QO6,25,37,19,45,6,1,18,0,126,18.0,4,0.0,7,19,26,6,30,1,19,18,0,58,68,1
2059,29262,idKVU6p7Q7GgRNB8N8uPXj3SONpH1Rke,5Gyp41oLVo7Gg7vF4vpmggWP5MU70QO6,1,0,0,0,0,0,1,0,1,0.14285714285714285,1,0.0,0,0,0,0,0,0,0,1,0,0,1,1
2060,29294,bZSiNUbAIuydDBd77IMAJ15Hy6k2A1kT,5Gyp41oLVo7Gg7vF4vpmggWP5MU70QO6,35,60,34,0,35,0,14,0,143,20.428571428571427,7,0.0,13,34,0,35,47,0,0,14,0,82,61,0
2061,29367,dm4zpyltgmDIt6SIOPnfzTRvAHU2zRpp,5Gyp41oLVo7Gg7vF4vpmggWP5MU70QO6,20,44,18,17,11,1,15,1,107,15.285714285714286,4,0.0,12,18,10,11,32,1,7,15,1,51,56,1
2062,29394,37lByEE8WN5dPOAL2dEzbVefMVMHIaPH,5Gyp41oLVo7Gg7vF4vpmggWP5MU70QO6,8,4,3,0,2,0,3,0,12,1.7142857142857142,2,0.0,0,3,0,2,4,0,0,3,0,5,7,1
2063,29464,98wdVgRpIzzxv6FEBv2es1MV8Ls3L0ff,5Gyp41oLVo7Gg7vF4vpmggWP5MU70QO6,2,0,0,0,0,0,2,0,2,0.2857142857142857,1,0.0,0,0,0,0,0,0,0,2,0,0,2,1
2064,29467,rwMpuxSfD7Lu5aEL6nFb4pXB5iDR4ILs,5Gyp41oLVo7Gg7vF4vpmggWP5MU70QO6,19,22,8,11,8,0,7,0,56,8.0,5,0.0,10,8,6,8,12,0,5,7,0,32,24,1
2065,29473,eZT1tCGv7ql9L5dEX3d6J5TryJHsMnpT,5Gyp41oLVo7Gg7vF4vpmggWP5MU70QO6,20,65,32,41,6,27,13,0,184,26.285714285714285,5,0.0,19,32,32,6,46,27,9,13,0,89,95,1
2066,29546,iO6L3vok1fllqPx0z6YlAf4W2nodktEN,5Gyp41oLVo7Gg7vF4vpmggWP5MU70QO6,7,9,0,0,0,0,3,0,12,1.7142857142857142,2,0.0,0,0,0,0,9,0,0,3,0,0,12,1
2067,29548,t1wUeepuMaeBvweqDP1pkKhuC8LiCavy,5Gyp41oLVo7Gg7vF4vpmggWP5MU70QO6,1,0,0,0,0,0,1,0,1,0.14285714285714285,1,0.0,0,0,0,0,0,0,0,1,0,0,1,1
2068,29559,TZGLsnS0OskuSmNrW3qdgst3uvhaNLjD,5Gyp41oLVo7Gg7vF4vpmggWP5MU70QO6,26,55,5,25,2,7,16,0,110,15.714285714285714,10,0.0,11,5,15,2,44,7,10,16,0,33,77,0
2069,29566,sT9hGAnww95aeGvqwQpJlS3ORhWDT49F,5Gyp41oLVo7Gg7vF4vpmggWP5MU70QO6,49,158,80,45,46,36,20,0,385,55.0,13,0.0,47,80,39,46,111,36,6,20,0,212,173,0
2070,29577,7wwHSUUi5ouCvH7RjsBJGH89ztv8nsnA,5Gyp41oLVo7Gg7vF4vpmggWP5MU70QO6,32,85,41,45,23,7,15,1,217,31.0,8,0.0,27,41,32,23,58,7,13,15,1,123,94,0
2071,29633,dsdOD3NrPkc2eTt8dL4TaCyvJ5rogMJq,3VkHkmOtom3jM2wCu94xgzzu1d6Dn7or,13,40,2,9,3,3,2,0,59,8.428571428571429,3,0.0,12,2,8,3,28,3,1,2,0,25,34,0
2072,29667,pg03VLobZ1zAAslEUdBaTgGu7kih28vz,3VkHkmOtom3jM2wCu94xgzzu1d6Dn7or,9,9,5,0,4,2,5,0,25,3.5714285714285716,2,0.0,0,5,0,4,9,2,0,5,0,9,16,1
2073,29671,WAn6J5qLSuupwso8SwtC7r0DqitXUS7t,3VkHkmOtom3jM2wCu94xgzzu1d6Dn7or,75,168,87,45,80,41,20,0,441,63.0,9,0.0,66,87,38,80,102,41,7,20,0,271,170,0
2074,29732,X1cnM6NzueQKdaGAohdVsBX0QRaVauMf,3VkHkmOtom3jM2wCu94xgzzu1d6Dn7or,88,308,107,100,63,71,20,2,671,95.85714285714286,7,0.0,121,107,95,63,187,71,5,20,2,386,285,1
2075,29735,fO58OblePrlYqNXkY14ASaYtA3H6kwGM,3VkHkmOtom3jM2wCu94xgzzu1d6Dn7or,49,90,51,59,2,42,4,0,248,35.42857142857143,4,0.0,35,51,53,2,55,42,6,4,0,141,107,0
2076,29770,DqvbpPfr9acXSV6QO6M6ES8wMSG8SUrG,3VkHkmOtom3jM2wCu94xgzzu1d6Dn7or,60,45,6,0,29,0,9,0,89,12.714285714285714,7,0.0,0,6,0,29,45,0,0,9,0,35,54,0
2077,29777,8XstJLDa8agdHppUFVVZbvtgkIjc1hSo,3VkHkmOtom3jM2wCu94xgzzu1d6Dn7or,75,239,87,46,65,17,57,10,521,74.42857142857143,16,0.0,51,87,37,65,188,17,9,57,10,240,281,0
2078,29780,tvzs5lw4yebuwJVV8CY40WNCneNIfwfG,3VkHkmOtom3jM2wCu94xgzzu1d6Dn7or,18,24,11,3,7,2,23,1,71,10.142857142857142,6,0.0,5,11,3,7,19,2,0,23,1,26,45,1
2079,29798,dZ0Tp80YaLSVwZx2HA5LGLVQa5b5xsfa,3VkHkmOtom3jM2wCu94xgzzu1d6Dn7or,4,6,2,0,3,0,1,0,12,1.7142857142857142,2,0.0,3,2,0,3,3,0,0,1,0,8,4,1
2080,29806,mFEkB6ZRZ9NSA8FsafZjEjQoXSnz45rD,3VkHkmOtom3jM2wCu94xgzzu1d6Dn7or,7,4,2,0,1,0,5,0,12,1.7142857142857142,2,0.0,0,2,0,1,4,0,0,5,0,3,9,0
2081,29825,KSfQPUyfWWfWDmmi6m3KXcKzxz89wkwt,3VkHkmOtom3jM2wCu94xgzzu1d6Dn7or,81,212,36,52,65,29,38,3,435,62.142857142857146,9,0.0,59,36,46,65,153,29,6,38,3,206,229,0
2082,29858,2jLM7Yi5RJYMPqOXOcapsjfy9JxX4cwG,3VkHkmOtom3jM2wCu94xgzzu1d6Dn7or,95,177,56,81,70,5,36,2,427,61.0,17,0.0,99,56,60,70,78,5,21,36,2,285,142,0
2083,29898,rwVFzRApiQw3vAU5Rpa6do3mD0uc5CXG,3VkHkmOtom3jM2wCu94xgzzu1d6Dn7or,68,219,69,110,59,21,51,2,531,75.85714285714286,16,0.0,101,69,93,59,118,21,17,51,2,322,209,0
2084,29936,XVEoTrdeHB4XjrmhKuWAwbiVsL2RLQJk,3VkHkmOtom3jM2wCu94xgzzu1d6Dn7or,54,157,88,0,21,18,12,0,296,42.285714285714285,18,0.0,2,88,0,21,155,18,0,12,0,111,185,0
2085,29968,QmiSyu11fn1nDX0iNcInUfGfKZJu6upP,3VkHkmOtom3jM2wCu94xgzzu1d6Dn7or,67,150,93,29,61,32,17,9,391,55.857142857142854,17,0.0,50,93,27,61,100,32,2,17,9,231,160,0
2086,29999,5kqorcxIJejDFcc1de7q3uie94xFSgMJ,3VkHkmOtom3jM2wCu94xgzzu1d6Dn7or,60,274,117,121,0,55,39,0,606,86.57142857142857,10,0.0,98,117,119,0,176,55,2,39,0,334,272,0
2087,30007,gDo9M8HDbXmLQPxqqLTsn9N4ZUEPKvcn,3VkHkmOtom3jM2wCu94xgzzu1d6Dn7or,42,145,50,30,32,15,16,0,288,41.142857142857146,4,0.0,36,50,25,32,109,15,5,16,0,143,145,0
2088,30011,Slk5JcZSYHmDLQZXaNVmcMDmjJ16kBhI,3VkHkmOtom3jM2wCu94xgzzu1d6Dn7or,65,243,9,83,15,38,58,19,465,66.42857142857143,15,0.0,85,9,78,15,158,38,5,58,19,187,278,0
2089,30099,1v41istydAF4xDubBoWMWYIs9r6KOsSl,3VkHkmOtom3jM2wCu94xgzzu1d6Dn7or,63,169,43,59,62,31,26,1,391,55.857142857142854,11,0.0,104,43,48,62,65,31,11,26,1,257,134,0
2090,30128,Ovk8jBBHwwhBttek79ARCgIpAVxMH1wF,3VkHkmOtom3jM2wCu94xgzzu1d6Dn7or,84,214,68,107,47,35,27,10,508,72.57142857142857,15,0.0,96,68,106,47,118,35,1,27,10,317,191,0
2091,30131,r5nHhhPp8wNqkUKwaWfUvmNqly1MZrKz,3VkHkmOtom3jM2wCu94xgzzu1d6Dn7or,49,134,28,37,16,41,20,1,277,39.57142857142857,9,0.0,31,28,36,16,103,41,1,20,1,111,166,0
2092,30142,3rQp9Pg1jh14kwWG2t2nthBHhNXGFa82,3VkHkmOtom3jM2wCu94xgzzu1d6Dn7or,84,143,60,47,62,5,17,1,335,47.857142857142854,10,0.0,60,60,44,62,83,5,3,17,1,226,109,0
2093,30155,JS66kD0s0JzvdxjXoj25UPnuGjR15s0e,3VkHkmOtom3jM2wCu94xgzzu1d6Dn7or,87,253,89,59,87,51,20,7,566,80.85714285714286,9,0.0,139,89,52,87,114,51,7,20,7,367,199,0
2094,30172,m7jLYh84m9f53uDPmmpRCKYuGkwpenOB,3VkHkmOtom3jM2wCu94xgzzu1d6Dn7or,57,100,62,13,41,5,22,2,245,35.0,10,0.0,10,62,10,41,90,5,3,22,2,123,122,0
2095,30175,qxtccqDGdpmW3MuPEOxMGh1ykxuH1P3R,3VkHkmOtom3jM2wCu94xgzzu1d6Dn7or,1,0,0,0,0,0,1,0,1,0.14285714285714285,1,0.0,0,0,0,0,0,0,0,1,0,0,1,1
2096,30188,HIt61VCQ5zz5HCTk7oYfdjcKhSUyK2YR,3VkHkmOtom3jM2wCu94xgzzu1d6Dn7or,37,83,24,53,27,2,15,2,206,29.428571428571427,8,0.0,46,24,45,27,37,2,8,15,2,142,64,1
2097,30244,6qeY7D4uPIs5tgq1S8ChR85fAeSaBpIZ,3VkHkmOtom3jM2wCu94xgzzu1d6Dn7or,22,70,33,7,22,89,20,0,241,34.42857142857143,5,0.0,25,33,7,22,45,89,0,20,0,87,154,1
2098,30280,Afqa0e6snHIpElZH8llhZ4r1dJaGoZZy,3VkHkmOtom3jM2wCu94xgzzu1d6Dn7or,10,8,5,0,5,0,3,0,21,3.0,1,0.0,0,5,0,5,8,0,0,3,0,10,11,1
2099,30337,NyeTkq313QL5kAKn6ZnLblvLSgZR58bd,3VkHkmOtom3jM2wCu94xgzzu1d6Dn7or,9,9,4,0,2,3,18,0,36,5.142857142857143,6,0.0,0,4,0,2,9,3,0,18,0,6,30,1
2100,30349,kjmB7rYJ6COKWLfV3I2XFdbyEP1GXHRT,3VkHkmOtom3jM2wCu94xgzzu1d6Dn7or,9,7,0,0,0,4,11,1,23,3.2857142857142856,2,0.0,2,0,0,0,5,4,0,11,1,2,21,0
2101,30381,artMcWhuxDvKZlHhCoLq6TeOK3memzwM,3VkHkmOtom3jM2wCu94xgzzu1d6Dn7or,6,5,3,0,2,0,3,0,13,1.8571428571428572,1,0.0,0,3,0,2,5,0,0,3,0,5,8,1
2102,30383,I5NS9TaNpjWXja9K1FgfoAA30bpJOAs7,3VkHkmOtom3jM2wCu94xgzzu1d6Dn7or,51,224,21,26,7,44,38,7,367,52.42857142857143,11,0.0,68,21,25,7,156,44,1,38,7,121,246,0
2103,30398,5Fp6zT5AKFMQmNFvYerZcjV0FupJGrAT,3VkHkmOtom3jM2wCu94xgzzu1d6Dn7or,62,202,102,33,59,64,20,0,480,68.57142857142857,10,0.0,67,102,29,59,135,64,4,20,0,257,223,0
2104,30407,RJwnOph0p8T6UAPo7WZFtHqjtt1K7VgK,3VkHkmOtom3jM2wCu94xgzzu1d6Dn7or,97,210,113,91,78,43,67,2,604,86.28571428571429,15,0.0,56,113,83,78,154,43,8,67,2,330,274,0
2105,30411,SZ5q3TqDiWq8s23sHXWpsG5po2IH5JPk,3VkHkmOtom3jM2wCu94xgzzu1d6Dn7or,48,122,5,39,4,0,13,0,183,26.142857142857142,11,0.0,25,5,32,4,97,0,7,13,0,66,117,0
2106,30433,sHKJOZO850rbGXrdoemFGCG92qkecGY0,3VkHkmOtom3jM2wCu94xgzzu1d6Dn7or,67,221,35,59,13,3,10,0,341,48.714285714285715,11,0.0,71,35,53,13,150,3,6,10,0,172,169,0
2107,30439,ctdO04zd7K8QUa5HFdH2dxaEs6nEQGcX,3VkHkmOtom3jM2wCu94xgzzu1d6Dn7or,66,165,26,46,21,8,13,4,283,40.42857142857143,6,0.0,99,26,45,21,66,8,1,13,4,191,92,1
2108,30442,IDNwyiCMAiwxgw0U0b9BrtE0TLcWOqS0,3VkHkmOtom3jM2wCu94xgzzu1d6Dn7or,4,2,1,0,0,0,2,0,5,0.7142857142857143,1,0.0,0,1,0,0,2,0,0,2,0,1,4,1
2109,30469,wkfBzItw0JCH6ZUz2WUZn7ngJ5M4Oksy,3VkHkmOtom3jM2wCu94xgzzu1d6Dn7or,6,2,1,0,1,0,4,0,8,1.1428571428571428,1,0.0,0,1,0,1,2,0,0,4,0,2,6,1
2110,30474,mrf0o1UB2V4aDgKrZVpLlOVi6iROZ8B8,3VkHkmOtom3jM2wCu94xgzzu1d6Dn7or,24,42,10,19,12,17,35,1,136,19.428571428571427,3,0.0,18,10,16,12,24,17,3,35,1,56,80,1
2111,30479,YqCc1EVkrnp1zeYgFSXXp9IfOfsT1x10,3VkHkmOtom3jM2wCu94xgzzu1d6Dn7or,1,0,0,0,0,0,1,0,1,0.14285714285714285,1,0.0,0,0,0,0,0,0,0,1,0,0,1,1
2112,30486,FELnhQR0c7GZZX82ioYJEZsqujOrfyf7,3VkHkmOtom3jM2wCu94xgzzu1d6Dn7or,77,130,49,76,40,25,28,2,350,50.0,8,0.0,41,49,62,40,89,25,14,28,2,192,158,0
2113,30533,DHyGbluRYDb9YK4sD54nYIDtRwaCVU4f,3VkHkmOtom3jM2wCu94xgzzu1d6Dn7or,94,190,85,60,55,39,35,7,471,67.28571428571429,12,0.0,65,85,56,55,125,39,4,35,7,261,210,0
2114,30622,3w3oVzXQmE457clbfwy8fl67WyFwWeZX,3VkHkmOtom3jM2wCu94xgzzu1d6Dn7or,20,48,21,26,9,12,18,3,137,19.571428571428573,3,0.0,4,21,22,9,44,12,4,18,3,56,81,1
2115,30635,l5LfU8gApOG72AnBkdAbfOLQLwFH7Zo2,3VkHkmOtom3jM2wCu94xgzzu1d6Dn7or,96,176,92,90,79,17,32,4,490,70.0,12,0.0,61,92,81,79,115,17,9,32,4,313,177,0
2116,30636,6DSuISWcDoqSW3Fjsz6tgWgsz6o5ZWJK,3VkHkmOtom3jM2wCu94xgzzu1d6Dn7or,59,186,70,27,45,3,72,1,404,57.714285714285715,11,0.0,64,70,25,45,122,3,2,72,1,204,200,0
2117,30656,NtU1IyW3HJl1pm4Tp4BEiaKIm4SZ64WI,7GRhBDsirIGkRZBtSMEzNTyDr2JQm4xx,11,8,6,0,5,0,2,0,21,3.0,1,0.0,0,6,0,5,8,0,0,2,0,11,10,1
2118,30658,Sk4DUKJRImF6lijTnkABuH01jDj9zcnP,7GRhBDsirIGkRZBtSMEzNTyDr2JQm4xx,43,83,32,28,18,5,15,1,182,26.0,6,0.0,42,32,17,18,41,5,11,15,1,109,73,0
2119,30659,3maFRlOOd3EYa40kgTAIu1lm1eFDh0j4,7GRhBDsirIGkRZBtSMEzNTyDr2JQm4xx,7,4,2,0,1,1,8,0,16,2.2857142857142856,1,0.0,0,2,0,1,4,1,0,8,0,3,13,0
2120,30660,RUwvt9IgBwxYizmuYQEH8XKuThZiqYF8,7GRhBDsirIGkRZBtSMEzNTyDr2JQm4xx,25,20,12,4,8,0,9,0,53,7.571428571428571,1,0.0,3,12,3,8,17,0,1,9,0,26,27,0
2121,30663,xeya2cHcAbAMxP30XnqxgcIBc9AC6RUk,7GRhBDsirIGkRZBtSMEzNTyDr2JQm4xx,30,66,13,16,10,3,2,0,110,15.714285714285714,1,0.0,26,13,8,10,40,3,8,2,0,57,53,0
2122,30668,OXZ6du3ugmpMvD1ZOwbzOlvOjr4PkR7j,7GRhBDsirIGkRZBtSMEzNTyDr2JQm4xx,2,0,0,0,0,0,4,0,4,0.5714285714285714,3,0.0,0,0,0,0,0,0,0,4,0,0,4,0
2123,30669,qerVuOcN5RDlT8Xm5Md7fl5nWFxIxkMg,7GRhBDsirIGkRZBtSMEzNTyDr2JQm4xx,11,8,4,0,3,0,2,0,17,2.4285714285714284,1,0.0,0,4,0,3,8,0,0,2,0,7,10,1
2124,30673,hMsNCldAkGadwgGX6yjkMuu7X3GLTjYs,7GRhBDsirIGkRZBtSMEzNTyDr2JQm4xx,47,51,19,30,17,0,9,0,126,18.0,2,0.0,26,19,16,17,25,0,14,9,0,78,48,0
2125,30676,H98nROYI5ks5CHxEsgYii9bCzrDc1klK,7GRhBDsirIGkRZBtSMEzNTyDr2JQm4xx,27,36,27,2,19,1,4,0,89,12.714285714285714,2,0.0,4,27,1,19,32,1,1,4,0,51,38,0
2126,30682,qNcXXMS6gofQ1zxFTFUpTVwHS32UZFmm,7GRhBDsirIGkRZBtSMEzNTyDr2JQm4xx,18,21,9,0,10,0,5,0,45,6.428571428571429,2,0.0,9,9,0,10,12,0,0,5,0,28,17,1
2127,30683,MvaDWypMmkxHk7Ock5CxxQuhKgqiD605,7GRhBDsirIGkRZBtSMEzNTyDr2JQm4xx,1,0,0,0,0,0,1,0,1,0.14285714285714285,1,0.0,0,0,0,0,0,0,0,1,0,0,1,1
2128,30684,kkNrpXfkeU300G4R897Q9HTV5p9hVKGz,7GRhBDsirIGkRZBtSMEzNTyDr2JQm4xx,1,0,0,0,0,0,1,0,1,0.14285714285714285,1,0.0,0,0,0,0,0,0,0,1,0,0,1,1
2129,30685,4sj7W3cGgiwnZG5WoCWQsakUkJaFReoi,7GRhBDsirIGkRZBtSMEzNTyDr2JQm4xx,21,28,0,12,3,12,6,0,61,8.714285714285714,1,0.0,15,0,7,3,13,12,5,6,0,25,36,0
2130,30700,uAXW7zeSaEEtMIdMcVsYpUquscAKUnr7,7GRhBDsirIGkRZBtSMEzNTyDr2JQm4xx,41,122,74,8,33,0,14,0,251,35.857142857142854,6,0.0,16,74,7,33,106,0,1,14,0,130,121,1
2131,30706,2aVoBs6PX62Evhzhd5ZYUQ5juZY4Z8Ua,7GRhBDsirIGkRZBtSMEzNTyDr2JQm4xx,102,338,8,157,62,17,7,0,589,84.14285714285714,9,0.0,167,8,109,62,171,17,48,7,0,346,243,0
2132,30707,HieynNXGTcRrvcPwh1BycmrnVEVwSnTe,7GRhBDsirIGkRZBtSMEzNTyDr2JQm4xx,3,0,0,0,0,0,4,0,4,0.5714285714285714,1,0.0,0,0,0,0,0,0,0,4,0,0,4,1
2133,30711,1XvURm7yGc5tr3i493QgWxpiog16HjjL,7GRhBDsirIGkRZBtSMEzNTyDr2JQm4xx,1,0,0,0,0,0,1,0,1,0.14285714285714285,1,0.0,0,0,0,0,0,0,0,1,0,0,1,1
2134,30712,0tL89xWcZEpMYz2wwgMI1fL3hUww7LB1,7GRhBDsirIGkRZBtSMEzNTyDr2JQm4xx,9,5,1,0,1,0,5,0,12,1.7142857142857142,1,0.0,0,1,0,1,5,0,0,5,0,2,10,1
2135,30714,4cbLQfIw8Oe5QJLksNPGddAvTWPccsWm,7GRhBDsirIGkRZBtSMEzNTyDr2JQm4xx,1,0,0,0,0,0,1,0,1,0.14285714285714285,1,0.0,0,0,0,0,0,0,0,1,0,0,1,1
2136,30718,R2bf9dlDhtEUgfKzXR1GPBa12LhUfZ8W,7GRhBDsirIGkRZBtSMEzNTyDr2JQm4xx,69,110,61,23,68,5,5,0,272,38.857142857142854,3,0.0,43,61,21,68,67,5,2,5,0,193,79,0
2137,30725,KKucKF6t4sZFfWrdZzwn5P82gPTUtVUB,7GRhBDsirIGkRZBtSMEzNTyDr2JQm4xx,1,0,0,0,0,0,1,0,1,0.14285714285714285,1,0.0,0,0,0,0,0,0,0,1,0,0,1,1
2138,30726,hY0CpdrgIS3oleTusy8P7kOvruPJKF3n,7GRhBDsirIGkRZBtSMEzNTyDr2JQm4xx,27,50,1,0,1,12,19,3,86,12.285714285714286,1,0.0,7,1,0,1,43,12,0,19,3,9,77,0
2139,30727,ti4xCNRvk7jmkirx440k5R1VXr1Il2pA,7GRhBDsirIGkRZBtSMEzNTyDr2JQm4xx,2,0,0,0,0,0,3,0,3,0.42857142857142855,1,0.0,0,0,0,0,0,0,0,3,0,0,3,1
2140,30749,EzcskHbN4FkKLdpIaSUaIKRBG0Df45oD,7GRhBDsirIGkRZBtSMEzNTyDr2JQm4xx,5,2,1,0,1,0,2,0,6,0.8571428571428571,1,0.0,0,1,0,1,2,0,0,2,0,2,4,0
2141,30759,vocq2qTAQIpXo7NloCyQjKAwRekZv7g6,5X6FeZozNMgE2VRi3MJYjkkFK8SETtu2,16,81,23,10,7,14,20,1,156,22.285714285714285,5,0.0,25,23,10,7,56,14,0,20,1,65,91,1
2142,30764,KanwbfDrW8kxJGgebHYUwn7eXlMzxejx,SpATywNh6bZuzm8s1ceuBUnMUAeoAHHw,25,65,41,0,0,0,16,1,123,17.571428571428573,2,0.0,20,41,0,0,45,0,0,16,1,61,62,0
2143,30778,vocq2qTAQIpXo7NloCyQjKAwRekZv7g6,A3fsA9Zfv1X2fVEQhTw51lKENdNrEqT3,46,95,31,68,11,38,53,3,299,42.714285714285715,8,0.0,1,31,55,11,94,38,13,53,3,98,201,1
2144,30785,rf4oo5VCac1USN0w21Ny3OOp1AZe5MC5,RXDvfPUBYFlVdlueBFbLW0mhhAyGEqpt,92,49,18,113,12,4,5,0,201,28.714285714285715,2,0.0,18,18,112,12,31,4,1,5,0,160,41,1
2145,30794,Px6gq8I7FxGPVyAUXddechLbGi5DqbHP,SpATywNh6bZuzm8s1ceuBUnMUAeoAHHw,5,3,0,0,0,0,2,0,5,0.7142857142857143,1,0.0,0,0,0,0,3,0,0,2,0,0,5,0
2146,30804,xVvNMYPAdkOMbR8cyTeqVHpVoO8wZQ2b,SpATywNh6bZuzm8s1ceuBUnMUAeoAHHw,48,69,31,63,14,0,10,0,187,26.714285714285715,4,0.0,30,31,49,14,39,0,14,10,0,124,63,1
2147,30813,9mbf3ur4VQ377zp6wWXm0F44HQK66rP5,SpATywNh6bZuzm8s1ceuBUnMUAeoAHHw,41,89,10,35,8,6,26,4,178,25.428571428571427,10,0.0,21,10,29,8,68,6,6,26,4,68,110,0
2148,30817,tZijFtzNclgTMdwkMQrTBxI1LQ4YUcIA,SpATywNh6bZuzm8s1ceuBUnMUAeoAHHw,2,0,0,0,0,0,2,0,2,0.2857142857142857,1,0.0,0,0,0,0,0,0,0,2,0,0,2,1
2149,30818,aRrVk5Mj3FLAOkeQfPKXeuOPNpHy5HUB,RXDvfPUBYFlVdlueBFbLW0mhhAyGEqpt,77,97,57,153,26,20,22,2,377,53.857142857142854,6,0.0,18,57,141,26,79,20,12,22,2,242,135,0
2150,30819,RA66CdkyaZBWcwFww8Jk434ejvfq5mi3,SpATywNh6bZuzm8s1ceuBUnMUAeoAHHw,15,12,6,17,3,2,3,0,43,6.142857142857143,1,0.0,4,6,15,3,8,2,2,3,0,28,15,0
2151,30823,jLGWqcJWbPwbqDpaLuVE2buM1VcjzYrZ,A3fsA9Zfv1X2fVEQhTw51lKENdNrEqT3,166,101,81,384,63,0,11,0,640,91.42857142857143,8,0.0,5,81,337,63,96,0,47,11,0,486,154,0
2152,30831,BRyXI2jlP9arzZoLjKD1qwawYxBWQDfb,5X6FeZozNMgE2VRi3MJYjkkFK8SETtu2,17,22,7,19,9,0,6,0,63,9.0,2,0.0,13,7,18,9,9,0,1,6,0,47,16,1
2153,30847,gXLitrmdBVXj6hOavgwX5Kv8nSH9hE13,A3fsA9Zfv1X2fVEQhTw51lKENdNrEqT3,6,3,2,0,2,0,1,0,8,1.1428571428571428,1,0.0,0,2,0,2,3,0,0,1,0,4,4,1
2154,30856,4LLdV2zTWS697dAsOgAPJZPFwfNnrjt6,RXDvfPUBYFlVdlueBFbLW0mhhAyGEqpt,44,40,27,56,22,7,10,5,167,23.857142857142858,4,0.0,8,27,51,22,32,7,5,10,5,108,59,1
2155,30875,7xwH0IGxUu9oyiAWk7HpSQpakcHGIuLy,G8EPVSXsOYB5YQWZGiz1aVq5Pgr2GrQu,92,242,21,248,31,101,51,29,723,103.28571428571429,10,0.0,53,21,212,31,189,101,36,51,29,317,406,0
2156,30876,oUNptzxKR6Tg3LMdUCW3RAFgD2fbf3ju,SpATywNh6bZuzm8s1ceuBUnMUAeoAHHw,27,43,3,15,2,9,15,1,88,12.571428571428571,4,0.0,7,3,14,2,36,9,1,15,1,26,62,0
2157,30884,XVh0ciKNvtUkxzspZoTcqEEmyNc2FeL5,7GRhBDsirIGkRZBtSMEzNTyDr2JQm4xx,3,3,1,0,0,0,1,0,5,0.7142857142857143,1,0.0,0,1,0,0,3,0,0,1,0,1,4,1
2158,30915,8HJiZoOTUArj8ouKObToEc9cbZd1p0Hh,SpATywNh6bZuzm8s1ceuBUnMUAeoAHHw,56,93,44,39,23,2,17,0,218,31.142857142857142,8,0.0,28,44,38,23,65,2,1,17,0,133,85,1
2159,30926,JODIGhSXEMOFdMb0BMfI1hphmGCcGiv9,7GRhBDsirIGkRZBtSMEzNTyDr2JQm4xx,34,33,15,42,14,1,9,0,114,16.285714285714285,3,0.0,14,15,37,14,19,1,5,9,0,80,34,1
2160,30929,9rkUO9AmZpdcwHkQIT6O3wGbPIgRHhIC,7GRhBDsirIGkRZBtSMEzNTyDr2JQm4xx,15,12,4,16,0,1,10,1,44,6.285714285714286,3,0.0,3,4,14,0,9,1,2,10,1,21,23,1
2161,30931,QX72AQjqYFwDzN5BrvMTm1brfdxDPl0n,7GRhBDsirIGkRZBtSMEzNTyDr2JQm4xx,24,44,16,20,13,0,3,1,97,13.857142857142858,2,0.0,20,16,19,13,24,0,1,3,1,68,29,1
2162,30935,VJHbWvAWybz77B40hY0AnZI5qx2EBxFd,SpATywNh6bZuzm8s1ceuBUnMUAeoAHHw,12,9,0,0,0,1,5,1,16,2.2857142857142856,1,0.0,0,0,0,0,9,1,0,5,1,0,16,1
2163,30954,nwtHcoMSMQeJaqDcIan7rd572O7TnAbe,SpATywNh6bZuzm8s1ceuBUnMUAeoAHHw,12,32,14,0,0,1,13,1,61,8.714285714285714,2,0.0,6,14,0,0,26,1,0,13,1,20,41,1
2164,30956,c1367E6Oj62TEXxGVpjanEuma6l30slZ,SpATywNh6bZuzm8s1ceuBUnMUAeoAHHw,17,13,7,15,5,0,4,0,44,6.285714285714286,2,0.0,4,7,14,5,9,0,1,4,0,30,14,1
2165,30958,pUAD8nrBU2agaJjO2oyqax3esP7bDAod,SpATywNh6bZuzm8s1ceuBUnMUAeoAHHw,35,70,12,18,8,39,45,11,203,29.0,7,0.0,6,12,18,8,64,39,0,45,11,44,159,0
2166,30960,HFSA5mZu8SjtTZt5y8xxQ1NSNLuijpbs,SpATywNh6bZuzm8s1ceuBUnMUAeoAHHw,44,47,35,27,25,1,15,0,150,21.428571428571427,4,0.0,6,35,25,25,41,1,2,15,0,91,59,0
2167,30969,8tVilTDlazfHpulhk6UMP8XQcjzE96hh,SpATywNh6bZuzm8s1ceuBUnMUAeoAHHw,8,4,3,0,3,0,3,0,13,1.8571428571428572,1,0.0,0,3,0,3,4,0,0,3,0,6,7,1
2168,30974,Jtu9eyRuUZ3eoiMeBPyruGhl6SYuWTeV,SpATywNh6bZuzm8s1ceuBUnMUAeoAHHw,24,33,0,26,0,9,10,2,80,11.428571428571429,2,0.0,11,0,25,0,22,9,1,10,2,36,44,1
2169,30977,n3dfmjOaJZ6J4GfeFM8ghGfKc9Mr8r4f,SpATywNh6bZuzm8s1ceuBUnMUAeoAHHw,16,28,12,17,6,0,4,0,67,9.571428571428571,5,0.0,10,12,15,6,18,0,2,4,0,43,24,1
2170,30986,8KSstsh3YYhIzd54fsYY1T96OfiCGWLi,SpATywNh6bZuzm8s1ceuBUnMUAeoAHHw,23,120,33,57,2,9,62,2,285,40.714285714285715,12,0.0,64,33,51,2,56,9,6,62,2,150,135,0
2171,30988,CRT8cgYCFunKga5R1j2C55Lv6W5lDPpk,A3fsA9Zfv1X2fVEQhTw51lKENdNrEqT3,9,4,3,0,3,0,3,0,13,1.8571428571428572,1,0.0,0,3,0,3,4,0,0,3,0,6,7,1
2172,30989,tHNSnLtZK1vGs5MVrEoD7S1mcW3GtFm4,G8EPVSXsOYB5YQWZGiz1aVq5Pgr2GrQu,37,40,13,66,5,0,2,0,126,18.0,2,0.0,18,13,43,5,22,0,23,2,0,79,47,0
2173,30996,WNlTer437rP0ycEd1BKVfCjGSSopiPqX,SpATywNh6bZuzm8s1ceuBUnMUAeoAHHw,47,124,24,35,7,142,86,12,430,61.42857142857143,12,0.0,25,24,32,7,99,142,3,86,12,88,342,0
2174,31002,EfteYUnYYLq9uOBoKEC0F2UwFqIZoKtW,RXDvfPUBYFlVdlueBFbLW0mhhAyGEqpt,88,92,60,138,41,2,11,0,344,49.142857142857146,10,0.0,22,60,132,41,70,2,6,11,0,255,89,0
2175,31021,t069DROGMOy4O12B9Ty0yznUmNUBGFUp,SpATywNh6bZuzm8s1ceuBUnMUAeoAHHw,7,3,2,0,2,0,2,0,9,1.2857142857142858,1,0.0,0,2,0,2,3,0,0,2,0,4,5,1
2176,31033,uUSTKM8g1hIskJbYHh1UiIQ6epHTSTNR,SpATywNh6bZuzm8s1ceuBUnMUAeoAHHw,24,55,22,32,7,0,7,0,123,17.571428571428573,5,0.0,23,22,28,7,32,0,4,7,0,80,43,0
2177,31037,RdgmuKDafp9WprcWAoiQpEVTFO65q45I,SpATywNh6bZuzm8s1ceuBUnMUAeoAHHw,19,67,4,16,3,1,8,0,99,14.142857142857142,3,0.0,12,4,15,3,55,1,1,8,0,34,65,0
2178,31056,oqq9xRnlYeqOhAsbS4FyM4hs04sEJX6q,5X6FeZozNMgE2VRi3MJYjkkFK8SETtu2,4,6,3,0,0,0,2,0,11,1.5714285714285714,2,0.0,0,3,0,0,6,0,0,2,0,3,8,1
2179,31103,ryJmWExgm9yTclw7BCk3i7dcrSS7nazZ,bWdj2GDclj5ofokWjzoa5jAwMkxCykd6,1,0,0,0,0,0,1,0,1,0.14285714285714285,1,0.0,0,0,0,0,0,0,0,1,0,0,1,1
2180,31114,NGCjg1L5IFyOkl1pLM5r5gRwzJYb60Ux,RXDvfPUBYFlVdlueBFbLW0mhhAyGEqpt,10,14,1,0,1,0,6,0,22,3.142857142857143,1,0.0,0,1,0,1,14,0,0,6,0,2,20,0
2181,31116,zvONfuJex2FW0S3q02qmyYC9aBQXin0x,SpATywNh6bZuzm8s1ceuBUnMUAeoAHHw,2,0,0,0,0,0,2,0,2,0.2857142857142857,1,0.0,0,0,0,0,0,0,0,2,0,0,2,1
2182,31123,UrqgguXQUa7JPAQb45jcbkHT0yjSwZHu,7GRhBDsirIGkRZBtSMEzNTyDr2JQm4xx,8,2,0,0,0,4,18,0,24,3.4285714285714284,2,0.0,0,0,0,0,2,4,0,18,0,0,24,1
2183,31134,VbzTq4oG2Bxw9gO7S4JkRgwsnSWStKWu,SpATywNh6bZuzm8s1ceuBUnMUAeoAHHw,15,24,5,12,5,0,2,0,48,6.857142857142857,5,0.0,5,5,12,5,19,0,0,2,0,27,21,0
2184,31148,qHG1oWpzWvpmEhIIZP6X7w56WP8YkNuv,SpATywNh6bZuzm8s1ceuBUnMUAeoAHHw,1,0,0,0,0,0,2,0,2,0.2857142857142857,2,0.0,0,0,0,0,0,0,0,2,0,0,2,1
2185,31152,AdsXlEjQFIksauSrVM6XkycFKpsPMY96,G8EPVSXsOYB5YQWZGiz1aVq5Pgr2GrQu,33,96,54,88,23,1,10,1,273,39.0,6,0.0,33,54,69,23,63,1,19,10,1,179,94,0
2186,31153,rIlg2veK76CYPAY7z09GokFHQqwC8sW7,SpATywNh6bZuzm8s1ceuBUnMUAeoAHHw,45,72,5,35,5,0,12,0,129,18.428571428571427,10,0.0,17,5,32,5,55,0,3,12,0,59,70,0
2187,31167,4bLrsVDvLnrTqHqeIpcqQPyvl02eai7n,A3fsA9Zfv1X2fVEQhTw51lKENdNrEqT3,48,26,24,88,19,0,16,0,173,24.714285714285715,4,0.0,2,24,75,19,24,0,13,16,0,120,53,1
2188,31186,71r0cSGOl797B6z3Ozx79KsmcnthtUKF,RXDvfPUBYFlVdlueBFbLW0mhhAyGEqpt,101,278,56,148,42,125,58,23,730,104.28571428571429,11,0.0,63,56,136,42,215,125,12,58,23,297,433,0
2189,31190,kXddmLayC1d9WaJe3TKDiaTRDePETcmW,5X6FeZozNMgE2VRi3MJYjkkFK8SETtu2,1,0,0,0,0,0,1,0,1,0.14285714285714285,1,0.0,0,0,0,0,0,0,0,1,0,0,1,1
2190,31194,tmChInaMXXu9irUncZR3i9YkdWc4vJk2,bWdj2GDclj5ofokWjzoa5jAwMkxCykd6,13,6,4,0,4,1,6,1,22,3.142857142857143,1,0.0,0,4,0,4,6,1,0,6,1,8,14,1
2191,31202,LmENAtavcDqxVrPN7j8xNGTLxeQMLi2E,SpATywNh6bZuzm8s1ceuBUnMUAeoAHHw,57,73,50,56,29,30,13,0,251,35.857142857142854,4,0.0,12,50,51,29,61,30,5,13,0,142,109,0
2192,31204,YOx6Tvp6HBSp6Lo310sbWxV28yIh3XN8,G8EPVSXsOYB5YQWZGiz1aVq5Pgr2GrQu,71,83,50,0,40,1,18,0,192,27.428571428571427,9,0.0,20,50,0,40,63,1,0,18,0,110,82,0
2193,31205,JzHC5tjVySaXz4V3Y0e4piHyrkmeSqU5,SpATywNh6bZuzm8s1ceuBUnMUAeoAHHw,55,161,59,30,29,149,91,7,526,75.14285714285714,12,0.0,6,59,27,29,155,149,3,91,7,121,405,0
2194,31206,0BcL7ZtEYe3RI9nGI6Aco1FB9QlygugP,G8EPVSXsOYB5YQWZGiz1aVq5Pgr2GrQu,11,6,4,8,1,0,10,3,32,4.571428571428571,2,0.0,0,4,7,1,6,0,1,10,3,12,20,1
2195,31212,il1jb11meB8GElsqKZc5yFOH5MUNs2Pa,G8EPVSXsOYB5YQWZGiz1aVq5Pgr2GrQu,34,21,0,80,0,1,18,1,121,17.285714285714285,2,0.0,2,0,70,0,19,1,10,18,1,72,49,0
2196,31220,s6iksgptFmyh2vfiarKdJkiKnp6RLi3f,SpATywNh6bZuzm8s1ceuBUnMUAeoAHHw,34,50,30,13,15,71,15,0,194,27.714285714285715,7,0.0,7,30,12,15,43,71,1,15,0,64,130,0
2197,31235,RgbUdG1GQBwET95sOwD6asbZ70PPcqWM,SpATywNh6bZuzm8s1ceuBUnMUAeoAHHw,47,73,34,27,27,0,4,0,165,23.571428571428573,2,0.0,34,34,21,27,39,0,6,4,0,116,49,1
2198,31242,Qn3OccgDXQpcut9yLA9jXfau6FPbS72n,SpATywNh6bZuzm8s1ceuBUnMUAeoAHHw,39,65,0,23,0,20,28,1,137,19.571428571428573,8,0.0,13,0,23,0,52,20,0,28,1,36,101,0
2199,31250,oqq9xRnlYeqOhAsbS4FyM4hs04sEJX6q,7GRhBDsirIGkRZBtSMEzNTyDr2JQm4xx,13,20,11,0,0,2,5,1,39,5.571428571428571,2,0.0,4,11,0,0,16,2,0,5,1,15,24,1
2200,31254,m8tZWvMesr1zQS0esJJogsiMlXHxe2Cd,SpATywNh6bZuzm8s1ceuBUnMUAeoAHHw,15,28,9,15,4,2,2,0,60,8.571428571428571,2,0.0,11,9,13,4,17,2,2,2,0,37,23,1
2201,31273,llEGY9nmTOZhiXi105AGZUS4gAhSawAh,SpATywNh6bZuzm8s1ceuBUnMUAeoAHHw,60,86,37,67,20,5,19,1,235,33.57142857142857,8,0.0,16,37,57,20,70,5,10,19,1,130,105,0
2202,31276,XydvMA0BgL1Al10q3L0D2wz1Y6wVb2rC,SpATywNh6bZuzm8s1ceuBUnMUAeoAHHw,27,44,27,0,21,0,9,0,101,14.428571428571429,2,0.0,0,27,0,21,44,0,0,9,0,48,53,0
2203,31280,juUpKesViORjdDJidJ4RSlxH0qwbmcck,SpATywNh6bZuzm8s1ceuBUnMUAeoAHHw,40,87,44,5,33,3,5,0,177,25.285714285714285,8,0.0,8,44,4,33,79,3,1,5,0,89,88,0
2204,31285,U04y5vFf0AfyJVGIOJHlryTyRQEOm5pT,A3fsA9Zfv1X2fVEQhTw51lKENdNrEqT3,5,2,1,0,1,0,2,0,6,0.8571428571428571,1,0.0,0,1,0,1,2,0,0,2,0,2,4,1
2205,31292,ikF95Qfsm5YUIhe2VDD6pkwaNOjQrQVG,5X6FeZozNMgE2VRi3MJYjkkFK8SETtu2,5,2,1,0,1,0,2,0,6,0.8571428571428571,1,0.0,0,1,0,1,2,0,0,2,0,2,4,1
2206,31313,vAwmKvW9O3gDJNDrzxbIT5kjf2troQFn,SpATywNh6bZuzm8s1ceuBUnMUAeoAHHw,27,24,13,10,8,3,13,1,72,10.285714285714286,6,0.0,2,13,10,8,22,3,0,13,1,33,39,1
2207,31316,sl67PTvziUv3kTFj6qEnYHRaFoNTaM8y,SpATywNh6bZuzm8s1ceuBUnMUAeoAHHw,43,69,34,14,22,0,10,0,149,21.285714285714285,6,0.0,23,34,13,22,46,0,1,10,0,92,57,0
2208,31356,zIHhHIwIbH6mJbe3ZAvW2ovaPewaq0E0,SpATywNh6bZuzm8s1ceuBUnMUAeoAHHw,53,97,34,45,14,111,35,2,338,48.285714285714285,11,0.0,31,34,43,14,66,111,2,35,2,122,216,0
2209,31360,QVtQEOECDBxqQMPDJLsWNOlhwI5DCP74,SpATywNh6bZuzm8s1ceuBUnMUAeoAHHw,54,105,39,71,19,117,26,4,381,54.42857142857143,8,0.0,29,39,62,19,76,117,9,26,4,149,232,0
2210,31371,YkxwabMuriYpqC21021WUsYLLutSSx4O,SpATywNh6bZuzm8s1ceuBUnMUAeoAHHw,57,87,45,70,19,0,14,6,241,34.42857142857143,14,0.0,31,45,61,19,56,0,9,14,6,156,85,0
2211,31375,G0jh1TPX9Mh6rk1y3utHKZiSI9nuHlJZ,SpATywNh6bZuzm8s1ceuBUnMUAeoAHHw,52,70,36,39,14,7,6,0,172,24.571428571428573,2,0.0,27,36,36,14,43,7,3,6,0,113,59,0
2212,31389,QAV02IL7ajntDdHVirqabwTRIN1Sa6iz,SpATywNh6bZuzm8s1ceuBUnMUAeoAHHw,39,132,3,43,0,0,43,2,223,31.857142857142858,13,0.0,20,3,42,0,112,0,1,43,2,65,158,0
2213,31392,p6Izm60d3R0uvZiSe15AoVnOEu77nAhg,SpATywNh6bZuzm8s1ceuBUnMUAeoAHHw,18,19,11,15,8,4,4,0,61,8.714285714285714,4,0.0,4,11,12,8,15,4,3,4,0,35,26,0
2214,31393,r34rPDX6ByafwVaTkz0clTKu9qISzj8Y,RXDvfPUBYFlVdlueBFbLW0mhhAyGEqpt,11,5,4,0,4,0,2,0,15,2.142857142857143,1,0.0,0,4,0,4,5,0,0,2,0,8,7,0
2215,31397,CGQBVll6e8XrZqlx2vLhIruhp3CAtM89,SpATywNh6bZuzm8s1ceuBUnMUAeoAHHw,24,45,23,15,12,5,10,0,110,15.714285714285714,4,0.0,10,23,14,12,35,5,1,10,0,59,51,0
2216,31399,VBP5PzVQEKJYFH0y5ffEek5WfP9EW7uc,SpATywNh6bZuzm8s1ceuBUnMUAeoAHHw,46,39,25,21,12,1,21,1,120,17.142857142857142,10,0.0,6,25,20,12,33,1,1,21,1,63,57,0
2217,31400,S9MHz2GfayML2H9BuRARNQ0WUO9mAJgZ,SpATywNh6bZuzm8s1ceuBUnMUAeoAHHw,56,69,39,43,17,7,29,1,205,29.285714285714285,13,0.0,13,39,35,17,56,7,8,29,1,104,101,0
2218,31413,SH0aDKwXzCQh4OYU9lg9pT5oeYUI6Uqk,bWdj2GDclj5ofokWjzoa5jAwMkxCykd6,1,0,0,0,0,0,1,0,1,0.14285714285714285,1,0.0,0,0,0,0,0,0,0,1,0,0,1,1
2219,31415,6pb2LEsVjBBvAGI7h0XcyCiR12k7UvwH,bWdj2GDclj5ofokWjzoa5jAwMkxCykd6,19,30,7,47,5,6,10,1,106,15.142857142857142,4,0.0,5,7,42,5,25,6,5,10,1,59,47,1
2220,31445,l7cIWSn2QdqLoOKMFO8yNQGKfk999nJh,SpATywNh6bZuzm8s1ceuBUnMUAeoAHHw,17,36,21,2,13,0,6,0,78,11.142857142857142,4,0.0,1,21,2,13,35,0,0,6,0,37,41,0
2221,31459,1xFsl22T8LEiEJ3kwPWguQfPNcGWZ8JV,7GRhBDsirIGkRZBtSMEzNTyDr2JQm4xx,22,75,3,0,3,4,32,3,120,17.142857142857142,7,0.0,40,3,0,3,35,4,0,32,3,46,74,1
2222,31461,xiUWvWEihscVybXMyohV1BQnGMd6dznz,G8EPVSXsOYB5YQWZGiz1aVq5Pgr2GrQu,8,6,2,0,1,0,4,0,13,1.8571428571428572,1,0.0,0,2,0,1,6,0,0,4,0,3,10,1
2223,31485,TJFpdHl1wQVU7Cnvm5Co4MJsJuGM9yMG,G8EPVSXsOYB5YQWZGiz1aVq5Pgr2GrQu,32,63,31,96,14,17,27,4,252,36.0,5,0.0,19,31,75,14,44,17,21,27,4,139,113,0
2224,31494,koNIIdoqi1yUhLIZAXp5I3Fl17qrPzNm,7GRhBDsirIGkRZBtSMEzNTyDr2JQm4xx,1,0,0,0,0,0,1,0,1,0.14285714285714285,1,0.0,0,0,0,0,0,0,0,1,0,0,1,1
2225,31500,EQgg3GYPXWNLa9U010kt5ZSvruPXJLGA,SpATywNh6bZuzm8s1ceuBUnMUAeoAHHw,51,78,40,60,21,23,21,3,246,35.142857142857146,10,0.0,18,40,50,21,60,23,10,21,3,129,117,0
2226,31503,YwFTXHSC31SX1LraRWOGlHPt5rdaD4Vy,SpATywNh6bZuzm8s1ceuBUnMUAeoAHHw,46,132,71,36,18,92,32,2,383,54.714285714285715,7,0.0,40,71,36,18,92,92,0,32,2,165,218,0
2227,31544,NqCDW2Wa7d0wWx7VYLXJDwB6ylSM8NEL,G8EPVSXsOYB5YQWZGiz1aVq5Pgr2GrQu,105,150,52,161,0,1,18,0,382,54.57142857142857,9,0.0,68,52,112,0,82,1,49,18,0,232,150,0
2228,31549,xI8Nr9tpm5UYMfkPTEK7ZnHqHm9s1zwr,5X6FeZozNMgE2VRi3MJYjkkFK8SETtu2,11,15,1,10,3,0,3,0,32,4.571428571428571,2,0.0,5,1,10,3,10,0,0,3,0,19,13,1
2229,31556,EUH6YdpZbHrgFPsGzhB2GBpcW28Zm8MI,SpATywNh6bZuzm8s1ceuBUnMUAeoAHHw,3,0,0,0,0,1,2,0,3,0.42857142857142855,1,0.0,0,0,0,0,0,1,0,2,0,0,3,1
2230,31560,jjkN8jWOYOEAYsDrxyK6cmAsmAkCK35N,SpATywNh6bZuzm8s1ceuBUnMUAeoAHHw,2,0,0,0,0,0,2,0,2,0.2857142857142857,1,0.0,0,0,0,0,0,0,0,2,0,0,2,1
2231,31570,xiUWvWEihscVybXMyohV1BQnGMd6dznz,bWdj2GDclj5ofokWjzoa5jAwMkxCykd6,5,4,1,0,2,0,2,0,9,1.2857142857142858,1,0.0,2,1,0,2,2,0,0,2,0,5,4,1
2232,31573,VWrks7JFbeZpwdWqwwZkJoHpmfIv7cqz,7GRhBDsirIGkRZBtSMEzNTyDr2JQm4xx,27,37,20,39,14,1,2,0,113,16.142857142857142,4,0.0,10,20,37,14,27,1,2,2,0,81,32,0
2233,31626,u9ct741hHXVhfVaAyqKR4FkuKqd1yywt,5X6FeZozNMgE2VRi3MJYjkkFK8SETtu2,30,40,15,93,8,0,9,1,166,23.714285714285715,2,0.0,15,15,78,8,25,0,15,9,1,116,50,1
2234,31642,Vr0kaKAkI4p2upUYNB1MMKsTShBZob66,7GRhBDsirIGkRZBtSMEzNTyDr2JQm4xx,29,50,22,56,10,63,3,0,204,29.142857142857142,5,0.0,22,22,45,10,28,63,11,3,0,99,105,1
2235,31655,MDJK2KVw2sHLHwyALdBdwbko7CJt3B5W,SpATywNh6bZuzm8s1ceuBUnMUAeoAHHw,15,26,13,17,6,1,3,0,66,9.428571428571429,1,0.0,12,13,14,6,14,1,3,3,0,45,21,1
2236,31661,e1CSwKLgflGiW7QjzYRNEoHjbDEH3F2k,SpATywNh6bZuzm8s1ceuBUnMUAeoAHHw,4,3,1,0,0,0,2,0,6,0.8571428571428571,1,0.0,0,1,0,0,3,0,0,2,0,1,5,1
2237,31682,YTga640T6i241jGBhxN7pUtNHHrQTFGS,5X6FeZozNMgE2VRi3MJYjkkFK8SETtu2,1,0,0,0,0,0,2,0,2,0.2857142857142857,2,0.0,0,0,0,0,0,0,0,2,0,0,2,1
2238,31691,TUAvpbJIqPqAXiWUMr89vm0HdACTuiA8,SpATywNh6bZuzm8s1ceuBUnMUAeoAHHw,38,80,5,46,5,2,17,0,155,22.142857142857142,8,0.0,11,5,42,5,69,2,4,17,0,63,92,0
2239,31699,Qy8CH3HeVFKSAKB7lN9KLpldaNyLNVBG,SpATywNh6bZuzm8s1ceuBUnMUAeoAHHw,33,69,25,25,9,18,16,4,166,23.714285714285715,2,0.0,38,25,19,9,31,18,6,16,4,91,75,0
2240,31728,mpNBMReKZvwryUvgjwY0cwVFK7aOune8,SpATywNh6bZuzm8s1ceuBUnMUAeoAHHw,62,77,42,60,20,10,37,2,248,35.42857142857143,11,0.0,18,42,54,20,59,10,6,37,2,134,114,0
2241,31739,xM8lVcqU5uqtxPXKRkobTl3b50GvL7Y6,G8EPVSXsOYB5YQWZGiz1aVq5Pgr2GrQu,5,3,1,0,0,0,4,0,8,1.1428571428571428,2,0.0,0,1,0,0,3,0,0,4,0,1,7,1
2242,31752,wPzdadJQCMqeSkdOMEDoRKUnWYSrFakI,SpATywNh6bZuzm8s1ceuBUnMUAeoAHHw,6,3,1,0,1,0,2,0,7,1.0,1,0.0,0,1,0,1,3,0,0,2,0,2,5,1
2243,31783,vIRjdLIHX9c1cFPQvvVL2i5iSd9iyYFO,bWdj2GDclj5ofokWjzoa5jAwMkxCykd6,5,3,0,0,0,1,2,0,6,0.8571428571428571,1,0.0,0,0,0,0,3,1,0,2,0,0,6,0
2244,31795,7hgrCmgcIS5jUcjMit9fbVMwjtk3kZoQ,A3fsA9Zfv1X2fVEQhTw51lKENdNrEqT3,148,128,63,309,26,83,64,3,676,96.57142857142857,4,0.0,9,63,244,26,119,83,65,64,3,342,334,0
2245,31804,lHdOeTUXYVL6iAgJVxxf5RxusHAIMUqu,SpATywNh6bZuzm8s1ceuBUnMUAeoAHHw,61,101,47,54,23,18,32,1,276,39.42857142857143,11,0.0,32,47,54,23,69,18,0,32,1,156,120,0
2246,31806,Oy358ZwdDb0AucMXZWcENmoGqtYaKoro,5X6FeZozNMgE2VRi3MJYjkkFK8SETtu2,8,11,3,0,3,0,3,0,20,2.857142857142857,2,0.0,5,3,0,3,6,0,0,3,0,11,9,1
2247,31818,7xwH0IGxUu9oyiAWk7HpSQpakcHGIuLy,SpATywNh6bZuzm8s1ceuBUnMUAeoAHHw,6,12,2,0,2,0,4,0,20,2.857142857142857,2,0.0,0,2,0,2,12,0,0,4,0,4,16,0
2248,31834,8nijJeJQ3xDzhCTAr7Z0RTVPHqfdjajs,SpATywNh6bZuzm8s1ceuBUnMUAeoAHHw,18,12,10,5,7,0,9,1,44,6.285714285714286,2,0.0,0,10,5,7,12,0,0,9,1,22,22,0
2249,31842,NdwHkfPAGY642SdmHZmzVw6m0frBuabE,A3fsA9Zfv1X2fVEQhTw51lKENdNrEqT3,1,0,0,0,0,0,1,0,1,0.14285714285714285,1,0.0,0,0,0,0,0,0,0,1,0,0,1,1
2250,31850,FHnafb4WtG7KIA4g5wSxwyrxJnQm1rLA,SpATywNh6bZuzm8s1ceuBUnMUAeoAHHw,13,28,6,0,2,0,7,1,44,6.285714285714286,3,0.0,0,6,0,2,28,0,0,7,1,8,36,0
2251,31853,KaKtAqB6wZUiYOmsdmlOHr8tGIxhLHqA,SpATywNh6bZuzm8s1ceuBUnMUAeoAHHw,18,27,10,16,5,0,11,0,69,9.857142857142858,1,0.0,9,10,12,5,18,0,4,11,0,36,33,0
2252,31861,yqRjX5x5mZ97nU5DkAkyboMSXTOKxqGq,A3fsA9Zfv1X2fVEQhTw51lKENdNrEqT3,2,0,0,0,0,0,3,0,3,0.42857142857142855,2,0.0,0,0,0,0,0,0,0,3,0,0,3,1
2253,31878,VXwRO03Gu4QrNRkeAj0lYc8T94Ap4aw5,SpATywNh6bZuzm8s1ceuBUnMUAeoAHHw,29,58,4,35,2,7,7,0,113,16.142857142857142,5,0.0,20,4,32,2,38,7,3,7,0,58,55,0
2254,31890,sk0kQOUwAh1v0YADh5vJvida6bS0Nrut,SpATywNh6bZuzm8s1ceuBUnMUAeoAHHw,22,31,3,39,0,7,9,0,89,12.714285714285714,3,0.0,14,3,36,0,17,7,3,9,0,53,36,1
2255,31938,RhP34FulOqviNgYNHriUPZSAmxJIhLoG,SpATywNh6bZuzm8s1ceuBUnMUAeoAHHw,4,3,1,0,0,0,2,0,6,0.8571428571428571,1,0.0,0,1,0,0,3,0,0,2,0,1,5,1
2256,31941,FICzrXMfesudq4nhzQP6bu1HcoWb8Dvz,RXDvfPUBYFlVdlueBFbLW0mhhAyGEqpt,6,2,2,0,1,0,2,0,7,1.0,1,0.0,0,2,0,1,2,0,0,2,0,3,4,1
2257,31954,uF7MMiNuAhfDpnPmpDdXphXG8nc4K2eb,SpATywNh6bZuzm8s1ceuBUnMUAeoAHHw,35,29,15,39,10,4,6,1,104,14.857142857142858,2,0.0,11,15,34,10,18,4,5,6,1,70,34,0
2258,31984,uDOAJpmX4dISx06kO0710v1O7qHbWnTL,7GRhBDsirIGkRZBtSMEzNTyDr2JQm4xx,1,0,0,0,0,0,1,0,1,0.14285714285714285,1,0.0,0,0,0,0,0,0,0,1,0,0,1,1
2259,31989,UcALsB3dLy3PVgkCMPXFbGXL5qreVuCZ,bWdj2GDclj5ofokWjzoa5jAwMkxCykd6,4,0,0,0,0,1,3,1,5,0.7142857142857143,1,0.0,0,0,0,0,0,1,0,3,1,0,5,1
2260,32014,t8eDuPU4MsZrMH2MoE1n7JeYLVBJZOGD,SpATywNh6bZuzm8s1ceuBUnMUAeoAHHw,36,73,30,49,5,14,30,4,205,29.285714285714285,8,0.0,29,30,44,5,44,14,5,30,4,108,97,0
2261,32036,0cTpxJTmQX3vdhwTGFk6XNSGmyhZVjmQ,A3fsA9Zfv1X2fVEQhTw51lKENdNrEqT3,9,4,3,0,3,0,6,0,16,2.2857142857142856,2,0.0,0,3,0,3,4,0,0,6,0,6,10,1
2262,32050,Riab3VyglmNWp0Owd5qXDcD82NpeagyQ,A3fsA9Zfv1X2fVEQhTw51lKENdNrEqT3,3,0,0,0,0,0,4,0,4,0.5714285714285714,1,0.0,0,0,0,0,0,0,0,4,0,0,4,0
2263,32052,2H4u8GVrslTygmZOsXRsjmcwUzRVI1ow,SpATywNh6bZuzm8s1ceuBUnMUAeoAHHw,14,37,29,6,8,0,13,0,93,13.285714285714286,7,0.0,0,29,5,8,37,0,1,13,0,42,51,0
2264,32077,c5VQ7usVz15dB8BPhVLpOqLw5w7gBiZC,SpATywNh6bZuzm8s1ceuBUnMUAeoAHHw,2,0,0,0,0,0,2,0,2,0.2857142857142857,1,0.0,0,0,0,0,0,0,0,2,0,0,2,1
2265,32098,NoD6YMXskGBRHNBn1mSKWYblJxZC5tcQ,A3fsA9Zfv1X2fVEQhTw51lKENdNrEqT3,85,125,58,24,42,3,23,1,276,39.42857142857143,5,0.0,1,58,20,42,124,3,4,23,1,121,155,0
2266,32114,MOcMwRKo0dtFqZ5xWBgRzquuZGKtQyf4,7GRhBDsirIGkRZBtSMEzNTyDr2JQm4xx,53,151,45,47,32,3,21,0,299,42.714285714285715,9,0.0,49,45,44,32,102,3,3,21,0,170,129,1
2267,32118,WMPYVFkG1npps8BU0n5fJtN4LOF8N9L7,7GRhBDsirIGkRZBtSMEzNTyDr2JQm4xx,5,7,2,0,0,0,2,0,11,1.5714285714285714,2,0.0,2,2,0,0,5,0,0,2,0,4,7,1
2268,32122,ZvU0YqNTtgKWTlVIbqvnVys23p5WRiDJ,SpATywNh6bZuzm8s1ceuBUnMUAeoAHHw,21,49,28,0,7,142,10,0,236,33.714285714285715,8,0.0,0,28,0,7,49,142,0,10,0,35,201,0
2269,32131,zXFkIw8DuFccBrwnvphRo3Cgz2Rm6ssF,SpATywNh6bZuzm8s1ceuBUnMUAeoAHHw,8,3,2,0,1,1,6,0,13,1.8571428571428572,1,0.0,0,2,0,1,3,1,0,6,0,3,10,1
2270,32157,bvPCU5RqjygEgnyzflwAQn5yVX8FneOX,bWdj2GDclj5ofokWjzoa5jAwMkxCykd6,4,2,1,0,0,0,2,0,5,0.7142857142857143,1,0.0,0,1,0,0,2,0,0,2,0,1,4,1
2271,32168,RHl3DsvAX7TisJ7qBptmgrrtDAQvH7mr,SpATywNh6bZuzm8s1ceuBUnMUAeoAHHw,22,32,12,36,1,0,9,0,90,12.857142857142858,7,0.0,8,12,33,1,24,0,3,9,0,54,36,0
2272,32185,xVQ88VrIuIA75ygDlevnROobNkwcFnsc,5X6FeZozNMgE2VRi3MJYjkkFK8SETtu2,6,5,2,0,1,0,3,0,11,1.5714285714285714,3,0.0,0,2,0,1,5,0,0,3,0,3,8,1
2273,32207,a1hltiyDilurEIFnwffjQJuCpkjLjysQ,A3fsA9Zfv1X2fVEQhTw51lKENdNrEqT3,1,0,0,0,0,0,1,0,1,0.14285714285714285,1,0.0,0,0,0,0,0,0,0,1,0,0,1,1
2274,32208,bNZH4hUHavni696ZcBLvxZCrBSALUDxX,SpATywNh6bZuzm8s1ceuBUnMUAeoAHHw,33,58,6,43,5,31,16,0,159,22.714285714285715,17,0.0,7,6,39,5,51,31,4,16,0,57,102,0
2275,32211,EjR7iUwsiJVzqJrC7t3D1JWVRCEYToml,SpATywNh6bZuzm8s1ceuBUnMUAeoAHHw,12,37,0,18,0,9,5,0,69,9.857142857142858,2,0.0,19,0,15,0,18,9,3,5,0,34,35,0
2276,32224,F6Z891neSaKlQQ7AswDi5tVrGxLhStNq,SpATywNh6bZuzm8s1ceuBUnMUAeoAHHw,8,8,1,0,1,0,4,0,14,2.0,2,0.0,0,1,0,1,8,0,0,4,0,2,12,1
2277,32226,4TtGjmtd4ISORDD5okRgx7kXAcGUW8IN,SpATywNh6bZuzm8s1ceuBUnMUAeoAHHw,44,73,35,36,16,4,58,5,227,32.42857142857143,15,0.0,22,35,30,16,51,4,6,58,5,103,124,0
2278,32234,jfy4hnEgaFTKN19h4DEcVSUHQ69g3McY,SpATywNh6bZuzm8s1ceuBUnMUAeoAHHw,26,22,16,0,12,0,8,0,58,8.285714285714286,1,0.0,0,16,0,12,22,0,0,8,0,28,30,1
2279,32241,kIttG9NXpnCAK6Uau8oyBBFc61rFQfTE,7GRhBDsirIGkRZBtSMEzNTyDr2JQm4xx,8,14,4,4,3,2,2,0,29,4.142857142857143,2,0.0,1,4,3,3,13,2,1,2,0,11,18,1
2280,32244,jN0wpnfaU5DsLxvEqII5WFiC356NJUbF,SpATywNh6bZuzm8s1ceuBUnMUAeoAHHw,33,52,23,33,6,1,37,5,157,22.428571428571427,6,0.0,16,23,30,6,36,1,3,37,5,75,82,1
2281,32256,pNgLScEwGgq81vg0a0cEXKNs5eG2UXph,SpATywNh6bZuzm8s1ceuBUnMUAeoAHHw,28,32,16,26,8,0,4,0,86,12.285714285714286,3,0.0,13,16,25,8,19,0,1,4,0,62,24,1
2282,32261,L6TEQcXe2Cfo7rlXEZ1k4dVXCx2fwc1Y,7GRhBDsirIGkRZBtSMEzNTyDr2JQm4xx,8,9,2,0,1,0,2,0,14,2.0,1,0.0,4,2,0,1,5,0,0,2,0,7,7,1
2283,32263,kAQFM0dEgOQIxOG9jTMe5puRtNxZZWMN,bWdj2GDclj5ofokWjzoa5jAwMkxCykd6,78,62,3,284,3,2,11,0,365,52.142857142857146,9,0.0,17,3,255,3,45,2,29,11,0,278,87,0
2284,32264,JJuYhhMtwjDb5sLEitOV6r0dnSA7ABFH,bWdj2GDclj5ofokWjzoa5jAwMkxCykd6,1,0,0,0,0,0,1,0,1,0.14285714285714285,1,0.0,0,0,0,0,0,0,0,1,0,0,1,1
2285,32269,kCqsvQZpasUHfVJzYbijAKww9O0shrRg,RXDvfPUBYFlVdlueBFbLW0mhhAyGEqpt,43,67,8,38,5,14,26,0,158,22.571428571428573,8,0.0,0,8,30,5,67,14,8,26,0,43,115,0
2286,32279,coj5NqErnlD9ozminSGxVugmS0slNqs1,A3fsA9Zfv1X2fVEQhTw51lKENdNrEqT3,2,0,0,0,0,0,2,0,2,0.2857142857142857,1,0.0,0,0,0,0,0,0,0,2,0,0,2,1
2287,32280,onsmNYIoPFEi185f5ZLsQXD70I3K25Cb,7GRhBDsirIGkRZBtSMEzNTyDr2JQm4xx,6,4,3,0,2,0,2,0,11,1.5714285714285714,1,0.0,0,3,0,2,4,0,0,2,0,5,6,1
2288,32284,wkkLqkPlDLOrNrbR4UCtQIDxtXcGov1B,SpATywNh6bZuzm8s1ceuBUnMUAeoAHHw,25,32,1,33,0,0,13,1,80,11.428571428571429,5,0.0,7,1,29,0,25,0,4,13,1,37,43,1
2289,32288,8rXJHeqrLpho5nIQgbDcpBTvBrVnGged,SpATywNh6bZuzm8s1ceuBUnMUAeoAHHw,32,72,11,50,4,1,19,0,157,22.428571428571427,7,0.0,22,11,42,4,50,1,8,19,0,79,78,0
2290,32309,MZpeXlPtlAGSfwuC5xwB1U0DIOZvGtVZ,SpATywNh6bZuzm8s1ceuBUnMUAeoAHHw,38,102,6,54,6,17,26,4,215,30.714285714285715,10,0.0,38,6,44,6,64,17,10,26,4,94,121,0
2291,32314,SSlieJULaqRb1C7jSzOwyPvbJnH3adQv,SpATywNh6bZuzm8s1ceuBUnMUAeoAHHw,5,2,1,0,1,0,2,0,6,0.8571428571428571,1,0.0,0,1,0,1,2,0,0,2,0,2,4,0
2292,32319,PZyZDM2uyBRGPZg3kQscavWjpR2bFYiU,SpATywNh6bZuzm8s1ceuBUnMUAeoAHHw,17,15,11,11,5,4,13,1,60,8.571428571428571,4,0.0,0,11,11,5,15,4,0,13,1,27,33,0
2293,32346,rrZSZFoEgH3bOKdkZ0UyNzOq7Pdyx5G0,SpATywNh6bZuzm8s1ceuBUnMUAeoAHHw,36,113,18,28,5,13,25,3,205,29.285714285714285,5,0.0,26,18,21,5,87,13,7,25,3,70,135,0
2294,32358,nOWwmMm8RUDfPfoqvXy3xmkIL6qZiu0a,7GRhBDsirIGkRZBtSMEzNTyDr2JQm4xx,13,20,2,9,0,9,19,1,60,8.571428571428571,3,0.0,2,2,7,0,18,9,2,19,1,11,49,0
2295,32359,aLRP3ahB5SIcOn5vpM1VPEh9ib2QIioX,SpATywNh6bZuzm8s1ceuBUnMUAeoAHHw,50,98,31,37,20,0,25,0,211,30.142857142857142,13,0.0,12,31,32,20,86,0,5,25,0,95,116,0
2296,32370,GOdZPKxg9MdVj14btOWyItDawZqHjDVK,SpATywNh6bZuzm8s1ceuBUnMUAeoAHHw,1,0,0,0,0,0,1,0,1,0.14285714285714285,1,0.0,0,0,0,0,0,0,0,1,0,0,1,1
2297,32385,rIb3lxEaK77vmLDTqDgCNFDZAYjyvbtK,7GRhBDsirIGkRZBtSMEzNTyDr2JQm4xx,68,98,40,72,30,21,19,0,280,40.0,9,0.0,44,40,67,30,54,21,5,19,0,181,99,1
2298,32396,89fRk1YEdJUeQGPjVnsGQ0GQ8bLBbWd5,SpATywNh6bZuzm8s1ceuBUnMUAeoAHHw,1,0,0,0,0,0,2,0,2,0.2857142857142857,1,0.0,0,0,0,0,0,0,0,2,0,0,2,1
2299,32399,c1hCF7HTdRs4Y6rOtE1XyYf2lHzz2oi1,A3fsA9Zfv1X2fVEQhTw51lKENdNrEqT3,32,18,1,66,2,0,3,0,90,12.857142857142858,1,0.0,1,1,61,2,17,0,5,3,0,65,25,1
2300,32403,Y1JlPlROA4JTEL6KTk03lVA5AU6bTZzS,SpATywNh6bZuzm8s1ceuBUnMUAeoAHHw,57,67,33,67,19,1,11,0,198,28.285714285714285,5,0.0,12,33,58,19,55,1,9,11,0,122,76,0
2301,32409,9iGaqBGS5kkoXjLd87hUL2eIJMVUVKfU,G8EPVSXsOYB5YQWZGiz1aVq5Pgr2GrQu,30,44,20,52,1,0,17,0,134,19.142857142857142,6,0.0,0,20,51,1,44,0,1,17,0,72,62,0
2302,32421,FW47VC0lzmys2S4k8Ky52JrXCSFDeyeP,bWdj2GDclj5ofokWjzoa5jAwMkxCykd6,20,18,8,26,6,1,7,1,67,9.571428571428571,1,0.0,8,8,22,6,10,1,4,7,1,44,23,1
2303,32426,gGSMkNgPdXpBQgdZzyjzifomyCxFSNyt,bWdj2GDclj5ofokWjzoa5jAwMkxCykd6,28,82,36,64,13,20,40,2,257,36.714285714285715,13,0.0,8,36,59,13,74,20,5,40,2,116,141,0
2304,32434,KDcZpMgh43fWN3yQZLS7ca0RsmMFrFC9,SpATywNh6bZuzm8s1ceuBUnMUAeoAHHw,15,62,2,0,2,0,9,0,75,10.714285714285714,6,0.0,3,2,0,2,59,0,0,9,0,7,68,0
2305,32436,QqE2Xjwy9gUzOvFdkDqAwAaNZLBZkxvd,SpATywNh6bZuzm8s1ceuBUnMUAeoAHHw,48,130,6,60,6,50,44,0,296,42.285714285714285,16,0.0,15,6,49,6,115,50,11,44,0,76,220,0
2306,32448,PFladZHBxKsed81P3VF9JVKRBqF9WnYc,SpATywNh6bZuzm8s1ceuBUnMUAeoAHHw,21,21,11,11,6,0,4,0,53,7.571428571428571,2,0.0,5,11,10,6,16,0,1,4,0,32,21,0
2307,32464,QAguKdvn52pCJKW91rO3BCY8l8ZCAdvQ,A3fsA9Zfv1X2fVEQhTw51lKENdNrEqT3,88,88,64,86,42,8,34,4,326,46.57142857142857,7,0.0,3,64,78,42,85,8,8,34,4,187,139,0
2308,32481,lQl2XdAeRVWLDaT8AEiVu5dRdtWn15nB,G8EPVSXsOYB5YQWZGiz1aVq5Pgr2GrQu,55,62,2,31,3,0,11,1,110,15.714285714285714,2,0.0,9,2,24,3,53,0,7,11,1,38,72,0
2309,32484,QqE2Xjwy9gUzOvFdkDqAwAaNZLBZkxvd,A3fsA9Zfv1X2fVEQhTw51lKENdNrEqT3,31,80,5,0,5,8,41,0,139,19.857142857142858,13,0.0,1,5,0,5,79,8,0,41,0,11,128,0
2310,32488,wctOEAfOfHjaIn2ukTVBg3NDDfP2Pt1c,5X6FeZozNMgE2VRi3MJYjkkFK8SETtu2,4,5,2,0,0,0,4,0,11,1.5714285714285714,2,0.0,0,2,0,0,5,0,0,4,0,2,9,1
2311,32492,5NsbP59FWlyl4NFONUzt3drLLr5EFRFj,G8EPVSXsOYB5YQWZGiz1aVq5Pgr2GrQu,64,101,40,154,14,9,16,1,335,47.857142857142854,5,0.0,52,40,114,14,49,9,40,16,1,220,115,1
2312,32501,mOJqDc22cg6Tc62XCr7iPStv8YxEXhpp,SpATywNh6bZuzm8s1ceuBUnMUAeoAHHw,41,117,54,39,18,76,43,4,351,50.142857142857146,9,0.0,23,54,33,18,94,76,6,43,4,128,223,0
2313,32512,wtJKiskMN99Zm4elrGO0NchnwPdR8XuA,7GRhBDsirIGkRZBtSMEzNTyDr2JQm4xx,1,0,0,0,0,0,1,0,1,0.14285714285714285,1,0.0,0,0,0,0,0,0,0,1,0,0,1,1
2314,32540,HSjU01iBnfvM2G4XxxIf0I2L8a5YKkxl,G8EPVSXsOYB5YQWZGiz1aVq5Pgr2GrQu,22,4,2,102,1,0,6,0,115,16.428571428571427,1,0.0,0,2,92,1,4,0,10,6,0,95,20,1
2315,32557,Wjr4gEVxD7mA3Z7r2t3nCQSUbpX54OOZ,SpATywNh6bZuzm8s1ceuBUnMUAeoAHHw,4,2,0,0,0,0,2,0,4,0.5714285714285714,1,0.0,0,0,0,0,2,0,0,2,0,0,4,1
2316,32577,fNAZ3rWuqq8OkAKKKUzZOQQ9DpAle4lu,SpATywNh6bZuzm8s1ceuBUnMUAeoAHHw,63,144,58,57,22,3,46,2,332,47.42857142857143,12,0.0,52,58,53,22,92,3,4,46,2,185,147,0
2317,32591,RIjNzTzWwuMpVu0vcsF9N8cORAAtLFQn,5X6FeZozNMgE2VRi3MJYjkkFK8SETtu2,3,10,0,0,0,0,2,0,12,1.7142857142857142,2,0.0,1,0,0,0,9,0,0,2,0,1,11,1
2318,32602,Ly65lkxGurCaK23EMf3qmWsOuD8e8vVr,5X6FeZozNMgE2VRi3MJYjkkFK8SETtu2,31,29,9,55,11,24,4,1,133,19.0,2,0.0,16,9,52,11,13,24,3,4,1,88,45,0
2319,32605,qsZvEBpmKtR7CWAJRnu6MxEuwHlYua64,A3fsA9Zfv1X2fVEQhTw51lKENdNrEqT3,11,6,5,0,5,0,2,0,18,2.5714285714285716,1,0.0,0,5,0,5,6,0,0,2,0,10,8,1
2320,32616,MVcepYvxjrdyzudBtT6xf978LVM5p04U,SpATywNh6bZuzm8s1ceuBUnMUAeoAHHw,55,59,31,56,19,25,25,6,221,31.571428571428573,5,0.0,15,31,46,19,44,25,10,25,6,111,110,0
2321,32642,dCHgtAVwX12C1h73zUIzcSalawnmf1Ly,5X6FeZozNMgE2VRi3MJYjkkFK8SETtu2,5,2,1,0,1,0,2,0,6,0.8571428571428571,1,0.0,0,1,0,1,2,0,0,2,0,2,4,0
2322,32647,vBbIZDmFTh3FCbK0DEiE7jyE0eCpDvg4,RXDvfPUBYFlVdlueBFbLW0mhhAyGEqpt,68,54,30,119,18,4,14,1,240,34.285714285714285,3,0.0,13,30,114,18,41,4,5,14,1,175,65,0
2323,32682,81lJT3F2fPa9QkCp8pe9hQda3s6sqwFw,SpATywNh6bZuzm8s1ceuBUnMUAeoAHHw,5,2,1,0,1,0,2,0,6,0.8571428571428571,1,0.0,0,1,0,1,2,0,0,2,0,2,4,1
2324,32685,MaXB6YBpSNUvXtEuCcY3Jwa8jwvsWVE8,G8EPVSXsOYB5YQWZGiz1aVq5Pgr2GrQu,38,77,4,8,4,0,9,1,103,14.714285714285714,3,0.0,16,4,4,4,61,0,4,9,1,28,75,0
2325,32694,bVveXRWwKdTb7eqX4rWDKBUhdf8PtEkw,SpATywNh6bZuzm8s1ceuBUnMUAeoAHHw,32,52,11,37,1,0,4,0,105,15.0,11,0.0,9,11,30,1,43,0,7,4,0,51,54,0
2326,32711,i5sxjfIaHjwYnZjZ10HPMUmgQCjmnGnv,SpATywNh6bZuzm8s1ceuBUnMUAeoAHHw,17,55,20,8,10,21,16,3,133,19.0,2,0.0,23,20,8,10,32,21,0,16,3,61,72,0
2327,32725,NHPpKvbnrSpxM8e1DORBWJbRCpmrxZw8,G8EPVSXsOYB5YQWZGiz1aVq5Pgr2GrQu,8,8,3,0,2,1,2,0,16,2.2857142857142856,2,0.0,2,3,0,2,6,1,0,2,0,7,9,0
2328,32738,AaS8GsfaaiK26oA6b0QdGhs8opVCkjvV,5X6FeZozNMgE2VRi3MJYjkkFK8SETtu2,2,0,0,0,0,0,2,0,2,0.2857142857142857,1,0.0,0,0,0,0,0,0,0,2,0,0,2,1
2329,32790,mPCmohVETKOBEAkMNdnfTJW7kVWg1ArQ,5X6FeZozNMgE2VRi3MJYjkkFK8SETtu2,1,0,0,0,0,0,1,0,1,0.14285714285714285,1,0.0,0,0,0,0,0,0,0,1,0,0,1,1
2330,32805,mPCmohVETKOBEAkMNdnfTJW7kVWg1ArQ,7GRhBDsirIGkRZBtSMEzNTyDr2JQm4xx,1,0,0,0,0,0,1,0,1,0.14285714285714285,1,0.0,0,0,0,0,0,0,0,1,0,0,1,1
2331,32844,b1eRrhapWSjtM2Ih9Xn0eBEZAyjqmlvI,SpATywNh6bZuzm8s1ceuBUnMUAeoAHHw,55,170,83,69,20,103,69,13,527,75.28571428571429,15,0.0,45,83,56,20,125,103,13,69,13,204,323,0
2332,32863,sKtqWeRv0wdA3L7xK3bpYs1OPqE06BS0,SpATywNh6bZuzm8s1ceuBUnMUAeoAHHw,4,2,1,0,1,0,1,0,5,0.7142857142857143,1,0.0,0,1,0,1,2,0,0,1,0,2,3,1
2333,32874,67ZqfHh3zcLqo5qUacGllEiszIkOne95,G8EPVSXsOYB5YQWZGiz1aVq5Pgr2GrQu,56,181,121,0,118,1,44,1,466,66.57142857142857,11,0.0,12,121,0,118,169,1,0,44,1,251,215,0
2334,32880,4Zj3rSr4SVLur34IbcdhBk6xi5qGX4FT,A3fsA9Zfv1X2fVEQhTw51lKENdNrEqT3,2,0,0,0,0,0,2,0,2,0.2857142857142857,1,0.0,0,0,0,0,0,0,0,2,0,0,2,1
2335,32883,l99Zcol89MEEF7ym4ZK8FY1ESaelZnlP,SpATywNh6bZuzm8s1ceuBUnMUAeoAHHw,26,26,16,10,9,10,7,1,79,11.285714285714286,2,0.0,5,16,9,9,21,10,1,7,1,39,40,1
2336,32891,yInJev2CVKf0hE352QQBnfHh6HRrGN4N,SpATywNh6bZuzm8s1ceuBUnMUAeoAHHw,7,11,6,0,4,0,3,0,24,3.4285714285714284,3,0.0,0,6,0,4,11,0,0,3,0,10,14,1
2337,32901,4JyZWYWxxqGCPr9dTz7bgpLcCXWs003A,SpATywNh6bZuzm8s1ceuBUnMUAeoAHHw,63,222,97,97,35,10,75,3,539,77.0,12,0.0,82,97,89,35,140,10,8,75,3,303,236,0
2338,32910,C5UZjhK8Hk16c49ZEIDZjaPkOGF8vpVr,G8EPVSXsOYB5YQWZGiz1aVq5Pgr2GrQu,14,28,14,0,2,2,5,1,52,7.428571428571429,1,0.0,0,14,0,2,28,2,0,5,1,16,36,1
2339,32928,sCoQh17BXp4WNRE2P5HolZcCCCZZqqMT,SpATywNh6bZuzm8s1ceuBUnMUAeoAHHw,10,10,0,5,0,0,2,0,17,2.4285714285714284,4,0.0,2,0,5,0,8,0,0,2,0,7,10,1
2340,32931,8d3h1mcAmphWja0z3YCYQ3jOAHgKDV8O,7GRhBDsirIGkRZBtSMEzNTyDr2JQm4xx,6,4,1,6,1,0,1,0,13,1.8571428571428572,1,0.0,1,1,5,1,3,0,1,1,0,8,5,1
2341,32938,zZwP4suQybM1gcslFDQ5UITiG9iZ789v,SpATywNh6bZuzm8s1ceuBUnMUAeoAHHw,28,86,52,26,11,9,24,6,214,30.571428571428573,9,0.0,12,52,19,11,74,9,7,24,6,94,120,0
2342,32944,QKx78QTSpSsgDUOeao6DG0scNkDycWWw,bWdj2GDclj5ofokWjzoa5jAwMkxCykd6,10,7,3,0,3,2,4,1,20,2.857142857142857,1,0.0,2,3,0,3,5,2,0,4,1,8,12,1
2343,32959,rwYtVwtpIXZswHnkH0HuiJPA0dz7YY0K,RXDvfPUBYFlVdlueBFbLW0mhhAyGEqpt,13,11,2,0,2,0,5,0,20,2.857142857142857,2,0.0,0,2,0,2,11,0,0,5,0,4,16,1
2344,32988,mZVWUPFbkuZINQtykHT2ZyZY5zMXgvJ7,SpATywNh6bZuzm8s1ceuBUnMUAeoAHHw,31,46,12,34,7,2,23,3,127,18.142857142857142,5,0.0,4,12,29,7,42,2,5,23,3,52,75,0
2345,33001,ZFpXjzvya7Y5x9HmUsgToer6v1L16WM2,SpATywNh6bZuzm8s1ceuBUnMUAeoAHHw,37,65,38,31,17,2,23,0,176,25.142857142857142,8,0.0,11,38,28,17,54,2,3,23,0,94,82,0
2346,33002,xeJGzWUjx44ZoqgxXXQMDl4oymPhxaNW,bWdj2GDclj5ofokWjzoa5jAwMkxCykd6,1,0,0,0,0,0,1,0,1,0.14285714285714285,1,0.0,0,0,0,0,0,0,0,1,0,0,1,1
2347,33017,GFBEJrga7DM4UEcrt340p3oRNaL97Gn4,SpATywNh6bZuzm8s1ceuBUnMUAeoAHHw,52,65,37,41,18,129,61,8,359,51.285714285714285,8,0.0,12,37,36,18,53,129,5,61,8,103,256,0
2348,33018,gi1cGXmBNmpbe6lA2hzKFh8EEd7gQMCM,SpATywNh6bZuzm8s1ceuBUnMUAeoAHHw,7,11,2,0,0,0,4,0,17,2.4285714285714284,3,0.0,4,2,0,0,7,0,0,4,0,6,11,0
2349,33023,XzkMRCsMMuNT5Al9kV5PMqeThOnNDLN6,7GRhBDsirIGkRZBtSMEzNTyDr2JQm4xx,6,11,5,0,0,4,6,0,26,3.7142857142857144,3,0.0,0,5,0,0,11,4,0,6,0,5,21,1
2350,33032,pZUzbLssBaqgpMaS6P8QU9NPm4T9bYZn,A3fsA9Zfv1X2fVEQhTw51lKENdNrEqT3,22,27,20,0,12,0,9,0,68,9.714285714285714,3,0.0,1,20,0,12,26,0,0,9,0,33,35,1
2351,33049,gi1cGXmBNmpbe6lA2hzKFh8EEd7gQMCM,5X6FeZozNMgE2VRi3MJYjkkFK8SETtu2,1,0,0,0,0,0,1,0,1,0.14285714285714285,1,0.0,0,0,0,0,0,0,0,1,0,0,1,1
2352,33050,rALCIi3DuIdQyJaY6En5rKpCFJjvIHQe,SpATywNh6bZuzm8s1ceuBUnMUAeoAHHw,8,10,5,0,2,0,14,1,32,4.571428571428571,4,0.0,1,5,0,2,9,0,0,14,1,8,24,1
2353,33058,fNAZ3rWuqq8OkAKKKUzZOQQ9DpAle4lu,RXDvfPUBYFlVdlueBFbLW0mhhAyGEqpt,108,153,91,310,46,8,33,0,641,91.57142857142857,9,0.0,27,91,277,46,126,8,33,33,0,441,200,0
2354,33062,ZVmjT1rppq7ilCPRRtmAl1wo0gOugsCt,RXDvfPUBYFlVdlueBFbLW0mhhAyGEqpt,87,141,76,206,49,21,21,0,514,73.42857142857143,13,0.0,25,76,193,49,116,21,13,21,0,343,171,0
2355,33087,jaMKMvlU4KDCkm4HrM0MWVH43rDA8rY1,5X6FeZozNMgE2VRi3MJYjkkFK8SETtu2,5,2,1,0,1,0,3,0,7,1.0,2,0.0,0,1,0,1,2,0,0,3,0,2,5,1
2356,33088,kpIACQKuTNWV6fjF4g1htB9bVtHJR1X6,A3fsA9Zfv1X2fVEQhTw51lKENdNrEqT3,8,9,2,0,1,0,5,0,17,2.4285714285714284,3,0.0,0,2,0,1,9,0,0,5,0,3,14,0
2357,33093,Yf3ElbSSbwyhjAhOrCYCRfmhcQeNbhGe,SpATywNh6bZuzm8s1ceuBUnMUAeoAHHw,8,6,4,0,1,1,3,0,15,2.142857142857143,1,0.0,0,4,0,1,6,1,0,3,0,5,10,1
2358,33097,RJ1FVW8gXQIpK321uzh2Sh69ojlsqnvg,bWdj2GDclj5ofokWjzoa5jAwMkxCykd6,19,47,20,52,8,5,21,1,154,22.0,4,0.0,11,20,48,8,36,5,4,21,1,87,67,0
2359,33113,PjZvizXDkcC0c394BYUQIpEWacrPH7EJ,SpATywNh6bZuzm8s1ceuBUnMUAeoAHHw,35,45,0,59,0,25,24,2,155,22.142857142857142,6,0.0,15,0,53,0,30,25,6,24,2,68,87,1
2360,33121,pKcgftm88lERht9rjtO6yDT8uF9jnp1z,7GRhBDsirIGkRZBtSMEzNTyDr2JQm4xx,39,116,54,79,31,6,15,2,303,43.285714285714285,6,0.0,46,54,73,31,70,6,6,15,2,204,99,1
2361,33133,06aGzysIv9Mn9nTndk3LjWWIGMMHY5p5,A3fsA9Zfv1X2fVEQhTw51lKENdNrEqT3,2,0,0,0,0,0,2,0,2,0.2857142857142857,1,0.0,0,0,0,0,0,0,0,2,0,0,2,1
2362,33145,UUY3BPLR7A3Xa6FGsztMCn6xCbxtdCYu,SpATywNh6bZuzm8s1ceuBUnMUAeoAHHw,47,52,27,28,15,2,9,0,133,19.0,6,0.0,19,27,25,15,33,2,3,9,0,86,47,0
2363,33146,aFVLxK4Hau9wDglF79kWvvimpoa2MXNc,SpATywNh6bZuzm8s1ceuBUnMUAeoAHHw,41,59,26,43,10,71,20,3,232,33.142857142857146,6,0.0,12,26,39,10,47,71,4,20,3,87,145,1
2364,33156,NgffOurIf9EDLm5SB7efcduZd82QhoOU,RXDvfPUBYFlVdlueBFbLW0mhhAyGEqpt,29,43,16,18,14,14,8,0,113,16.142857142857142,5,0.0,16,16,18,14,27,14,0,8,0,64,49,0
2365,33167,vMr1CEZaNupiDJLnYazOeogaMOoVPtGu,SpATywNh6bZuzm8s1ceuBUnMUAeoAHHw,8,10,6,0,3,0,3,0,22,3.142857142857143,2,0.0,0,6,0,3,10,0,0,3,0,9,13,0
2366,33168,9JOIbfI4KnzV1NdU7sH8tM8NLWIOBzCF,5X6FeZozNMgE2VRi3MJYjkkFK8SETtu2,14,11,7,0,4,1,6,0,29,4.142857142857143,2,0.0,0,7,0,4,11,1,0,6,0,11,18,1
2367,33173,poxISkj7mtTTcUTxHuC9BFrrsaF9KDef,7GRhBDsirIGkRZBtSMEzNTyDr2JQm4xx,30,69,23,54,20,5,5,0,176,25.142857142857142,3,0.0,42,23,48,20,27,5,6,5,0,133,43,1
2368,33187,yiWok4eQ5hgdJ8eYi2O0qHhy67Y9EA3E,SpATywNh6bZuzm8s1ceuBUnMUAeoAHHw,62,70,36,66,21,6,13,1,213,30.428571428571427,7,0.0,17,36,57,21,53,6,9,13,1,131,82,0
2369,33199,r9mrNmOIUUDf7AorDYXKUl4G7R8wfHcf,SpATywNh6bZuzm8s1ceuBUnMUAeoAHHw,45,53,30,55,16,4,19,3,180,25.714285714285715,5,0.0,12,30,50,16,41,4,5,19,3,108,72,0
2370,33234,we9tWnySpl1G7k7FqyXPj8wmC2gUYK0W,A3fsA9Zfv1X2fVEQhTw51lKENdNrEqT3,44,130,20,95,1,6,21,0,273,39.0,7,0.0,3,20,74,1,127,6,21,21,0,98,175,0
2371,33256,we9tWnySpl1G7k7FqyXPj8wmC2gUYK0W,5X6FeZozNMgE2VRi3MJYjkkFK8SETtu2,21,38,2,14,4,1,6,0,65,9.285714285714286,5,0.0,7,2,13,4,31,1,1,6,0,26,39,0
2372,33271,tD36vn1aCu8pvS184dpJPyASEvtRWzdE,SpATywNh6bZuzm8s1ceuBUnMUAeoAHHw,25,19,10,35,7,0,3,0,74,10.571428571428571,2,0.0,5,10,31,7,14,0,4,3,0,53,21,0
2373,33280,1vY5OZ1u5dkB4jIpVDeMNw33uHVvYDm0,G8EPVSXsOYB5YQWZGiz1aVq5Pgr2GrQu,109,315,113,124,122,50,35,11,770,110.0,11,0.0,64,113,87,122,251,50,37,35,11,386,384,0
2374,33303,Xd1D2NT89CxigSKUZtesNm0ASQy2UOok,5X6FeZozNMgE2VRi3MJYjkkFK8SETtu2,4,2,1,0,1,0,1,0,5,0.7142857142857143,1,0.0,0,1,0,1,2,0,0,1,0,2,3,1
2375,33321,vIBcYbs1BLdmaaP30fcE2FS7kB7v7QRn,RXDvfPUBYFlVdlueBFbLW0mhhAyGEqpt,8,12,7,0,1,0,8,0,28,4.0,3,0.0,0,7,0,1,12,0,0,8,0,8,20,1
2376,33325,jXgMhQKbkiBaFyvNHAIM6AePvnnTFQC0,SpATywNh6bZuzm8s1ceuBUnMUAeoAHHw,35,48,28,36,0,5,16,0,133,19.0,9,0.0,11,28,35,0,37,5,1,16,0,74,59,0
2377,33337,096xYyhB9kL7G6lT7J9rVrXyGNwUToLF,bWdj2GDclj5ofokWjzoa5jAwMkxCykd6,1,0,0,0,0,0,2,0,2,0.2857142857142857,1,0.0,0,0,0,0,0,0,0,2,0,0,2,0
2378,33338,d5hgUNbUFsJ3QWa3NXhPxhtqZKrkuHi4,SpATywNh6bZuzm8s1ceuBUnMUAeoAHHw,43,47,24,39,11,0,11,0,132,18.857142857142858,6,0.0,17,24,35,11,30,0,4,11,0,87,45,0
2379,33366,fYLWMGJsW3Aq1nrs0wiSji5Q7ysltFRD,SpATywNh6bZuzm8s1ceuBUnMUAeoAHHw,12,11,6,0,3,0,8,0,28,4.0,3,0.0,0,6,0,3,11,0,0,8,0,9,19,1
2380,33367,LnKkSZayo1wLV2Hw9QpVLPVlZlTuJ9NQ,SpATywNh6bZuzm8s1ceuBUnMUAeoAHHw,18,23,5,22,2,2,6,0,60,8.571428571428571,2,0.0,8,5,20,2,15,2,2,6,0,35,25,0
2381,33375,BkBVFyB4tBI41wvM1Ppa7iaH93pA565M,7GRhBDsirIGkRZBtSMEzNTyDr2JQm4xx,3,0,0,0,0,12,2,0,14,2.0,1,0.0,0,0,0,0,0,12,0,2,0,0,14,1
2382,33383,8iImyyS3GD4CMDnaLhe4nYGG4OYOw3ov,5X6FeZozNMgE2VRi3MJYjkkFK8SETtu2,2,0,0,0,0,0,2,0,2,0.2857142857142857,1,0.0,0,0,0,0,0,0,0,2,0,0,2,1
2383,33392,WczGVRZMmNzgMggUe3ZQ1bOs2IuTwUWO,RXDvfPUBYFlVdlueBFbLW0mhhAyGEqpt,66,99,3,145,9,18,20,6,300,42.857142857142854,6,0.0,28,3,134,9,71,18,11,20,6,174,126,0
2384,33400,R3LdCHGJ0oYuX8fUQhI8dRkzUs6gLWrE,SpATywNh6bZuzm8s1ceuBUnMUAeoAHHw,32,43,18,66,2,19,21,3,172,24.571428571428573,5,0.0,15,18,54,2,28,19,12,21,3,89,83,0
2385,33401,qV3ci4HSmOh0O2gqYUVjaVHqqz2r9u2d,G8EPVSXsOYB5YQWZGiz1aVq5Pgr2GrQu,31,37,4,62,2,2,18,1,126,18.0,3,0.0,0,4,51,2,37,2,11,18,1,57,69,1
2386,33407,9JeL7tgnIZOgdZSlSf2iznMdgXHHfyfp,SpATywNh6bZuzm8s1ceuBUnMUAeoAHHw,3,0,0,0,0,0,5,0,5,0.7142857142857143,1,0.0,0,0,0,0,0,0,0,5,0,0,5,1
2387,33416,viuKt4GgrX0rYL5EpHoxJbsiC9TblSuk,SpATywNh6bZuzm8s1ceuBUnMUAeoAHHw,37,212,99,0,38,230,75,2,656,93.71428571428571,15,0.0,40,99,0,38,172,230,0,75,2,177,479,0
2388,33418,DhR1dVNu38f3nLpjw93piUdYWwpJko8O,SpATywNh6bZuzm8s1ceuBUnMUAeoAHHw,44,46,23,21,16,0,3,0,109,15.571428571428571,2,0.0,6,23,21,16,40,0,0,3,0,66,43,0
2389,33425,TiIBZzk8mSsTxaXRp2od0vsYA3E53d4W,G8EPVSXsOYB5YQWZGiz1aVq5Pgr2GrQu,10,8,2,0,1,2,7,1,21,3.0,1,0.0,1,2,0,1,7,2,0,7,1,4,17,0
2390,33426,SbSUciasvLhHVTorJDvZBPRhwTmOgntH,SpATywNh6bZuzm8s1ceuBUnMUAeoAHHw,54,94,22,89,14,1,18,0,238,34.0,7,0.0,36,22,80,14,58,1,9,18,0,152,86,0
2391,33428,YlMrjX7ibus8JFFbvjYaUFTOz92jaztw,SpATywNh6bZuzm8s1ceuBUnMUAeoAHHw,24,46,25,12,12,22,5,0,122,17.428571428571427,5,0.0,12,25,12,12,34,22,0,5,0,61,61,0
2392,33475,0KNVWAChIRBDwntcO5Dr5l3KgkUsRh3O,SpATywNh6bZuzm8s1ceuBUnMUAeoAHHw,15,28,3,2,1,3,4,0,41,5.857142857142857,5,0.0,3,3,2,1,25,3,0,4,0,9,32,0
2393,33478,6elPfoQqoXapHUr4bMvtkwGvYr52KIX8,A3fsA9Zfv1X2fVEQhTw51lKENdNrEqT3,40,27,11,50,10,0,10,0,108,15.428571428571429,3,0.0,0,11,42,10,27,0,8,10,0,63,45,0
2394,33493,1vY5OZ1u5dkB4jIpVDeMNw33uHVvYDm0,SpATywNh6bZuzm8s1ceuBUnMUAeoAHHw,55,131,53,25,22,5,26,0,262,37.42857142857143,9,0.0,33,53,21,22,98,5,4,26,0,129,133,0
2395,33495,JPJY1WqUvz4liBz4XkK3wlVfpnOL0ou5,A3fsA9Zfv1X2fVEQhTw51lKENdNrEqT3,14,10,8,0,4,0,7,0,29,4.142857142857143,1,0.0,0,8,0,4,10,0,0,7,0,12,17,1
2396,33513,H2Rgqo3kRDsNdbNVEDl0788s9SSdLM8P,7GRhBDsirIGkRZBtSMEzNTyDr2JQm4xx,40,106,10,44,17,1,16,1,195,27.857142857142858,10,0.0,46,10,40,17,60,1,4,16,1,113,82,1
2397,33520,qmYTrueiQKfoQnGxjqfwlMlw7HOR9CKj,A3fsA9Zfv1X2fVEQhTw51lKENdNrEqT3,66,1300,61,158,23,3,38,2,1585,226.42857142857142,11,0.0,7,61,128,23,1293,3,30,38,2,219,1366,0
2398,33533,WO3YPzdDqV1ST6B0Mqs4I1kcRrnmBAmm,bWdj2GDclj5ofokWjzoa5jAwMkxCykd6,1,0,0,0,0,0,3,0,3,0.42857142857142855,1,0.0,0,0,0,0,0,0,0,3,0,0,3,0
2399,33548,096xYyhB9kL7G6lT7J9rVrXyGNwUToLF,SpATywNh6bZuzm8s1ceuBUnMUAeoAHHw,23,23,20,0,0,0,3,0,46,6.571428571428571,1,0.0,0,20,0,0,23,0,0,3,0,20,26,0
2400,33577,YZSZ4TOtqHUreAioK1x0YBDmIRumwoti,7GRhBDsirIGkRZBtSMEzNTyDr2JQm4xx,12,17,3,15,3,0,3,0,41,5.857142857142857,2,0.0,5,3,13,3,12,0,2,3,0,24,17,1
2401,33579,wFWVvTUKN4Nj5vWrbX5PVi6EvLKq8sqa,SpATywNh6bZuzm8s1ceuBUnMUAeoAHHw,48,53,24,55,13,4,17,9,175,25.0,5,0.0,20,24,45,13,33,4,10,17,9,102,73,0
2402,33601,B9KqNNxXBxHFUsJnQKQysblL3f8zF7sg,7GRhBDsirIGkRZBtSMEzNTyDr2JQm4xx,75,226,12,0,31,0,17,0,286,40.857142857142854,11,0.0,116,12,0,31,110,0,0,17,0,159,127,0
2403,33603,U4egSBuIz4Tp2aExbhUIhaem6H1lHi4I,5X6FeZozNMgE2VRi3MJYjkkFK8SETtu2,4,3,1,0,0,0,6,0,10,1.4285714285714286,4,0.0,0,1,0,0,3,0,0,6,0,1,9,1
2404,33606,ZnX7TVb7MRgZ03kXc2dvy6H2fx2hKiTB,G8EPVSXsOYB5YQWZGiz1aVq5Pgr2GrQu,6,6,0,0,1,0,3,0,10,1.4285714285714286,1,0.0,2,0,0,1,4,0,0,3,0,3,7,1
2405,33612,884KSEusRiMlLTSulMFf41A22MivDNwN,A3fsA9Zfv1X2fVEQhTw51lKENdNrEqT3,26,67,9,0,4,0,13,0,93,13.285714285714286,4,0.0,0,9,0,4,67,0,0,13,0,13,80,0
2406,33626,0nurC1CJC0crrXKGvfCOGeDuwbw5nhmi,SpATywNh6bZuzm8s1ceuBUnMUAeoAHHw,8,9,6,0,1,0,6,0,22,3.142857142857143,1,0.0,0,6,0,1,9,0,0,6,0,7,15,0
2407,33639,3bwizzI2zhkZarj0AirZFGuMorcba8W4,SpATywNh6bZuzm8s1ceuBUnMUAeoAHHw,62,99,54,53,26,35,49,8,324,46.285714285714285,11,0.0,20,54,43,26,79,35,10,49,8,143,181,1
2408,33643,InrAmtl2MgoSpFoohTtv1oXbh4bisxXW,bWdj2GDclj5ofokWjzoa5jAwMkxCykd6,38,55,15,138,4,3,29,2,246,35.142857142857146,9,0.0,6,15,117,4,49,3,21,29,2,142,104,0
2409,33658,TD22TgKgdIWZaUQs2l8DFuWLFK83eNHv,A3fsA9Zfv1X2fVEQhTw51lKENdNrEqT3,13,13,11,0,11,3,7,1,46,6.571428571428571,1,0.0,1,11,0,11,12,3,0,7,1,23,23,1
2410,33666,RCdcltNaQLfcoxT7YKTjQxAYUbCmzzKd,A3fsA9Zfv1X2fVEQhTw51lKENdNrEqT3,51,65,51,86,28,15,26,0,271,38.714285714285715,14,0.0,2,51,71,28,63,15,15,26,0,152,119,0
2411,33739,gdn2XK07FW9va0I0cqCJx123li1climD,3VkHkmOtom3jM2wCu94xgzzu1d6Dn7or,11,8,6,0,5,1,4,0,24,3.4285714285714284,2,0.0,0,6,0,5,8,1,0,4,0,11,13,1
2412,33775,B1A1Rk1i9RwjdQC3OufTERem5rR8AT54,3VkHkmOtom3jM2wCu94xgzzu1d6Dn7or,71,119,46,49,32,11,37,18,312,44.57142857142857,18,0.0,46,46,49,32,73,11,0,37,18,173,139,0
2413,33802,rgfuJRvILCyoZ3ACpGqTeELGaXbZOX9A,3VkHkmOtom3jM2wCu94xgzzu1d6Dn7or,97,200,77,97,67,5,67,1,514,73.42857142857143,16,0.0,70,77,97,67,130,5,0,67,1,311,203,0
2414,33805,3Xw7sSY5dpZPjwkazu6UTwQ4M7Pr8Xfi,3VkHkmOtom3jM2wCu94xgzzu1d6Dn7or,16,31,16,0,7,0,19,0,73,10.428571428571429,7,0.0,0,16,0,7,31,0,0,19,0,23,50,0
2415,33907,LPI0fLr9LjLyZaDgsGVsvoyyhyLXX0iz,3VkHkmOtom3jM2wCu94xgzzu1d6Dn7or,5,3,0,0,2,0,5,0,10,1.4285714285714286,2,0.0,0,0,0,2,3,0,0,5,0,2,8,1
2416,33911,YoEOoHSSJvpnm9mKUUaYYw17z3Oqeke4,3VkHkmOtom3jM2wCu94xgzzu1d6Dn7or,5,1,0,0,0,0,13,1,15,2.142857142857143,2,0.0,0,0,0,0,1,0,0,13,1,0,15,1
2417,33956,ooiLFMC6LmFwALnsQsV41Hy63EhHYfZI,3VkHkmOtom3jM2wCu94xgzzu1d6Dn7or,24,49,13,12,16,21,11,1,123,17.571428571428573,4,0.0,29,13,12,16,20,21,0,11,1,70,53,1
2418,34006,aZ1jaFsPkThraNBN6FchjwyZAyj6hSy3,3VkHkmOtom3jM2wCu94xgzzu1d6Dn7or,1,0,0,0,0,0,1,0,1,0.14285714285714285,1,0.0,0,0,0,0,0,0,0,1,0,0,1,1
2419,34025,2NbgOs46HWMRNsVHOWRPOpKO7ulJjEac,3VkHkmOtom3jM2wCu94xgzzu1d6Dn7or,1,0,0,0,0,0,1,0,1,0.14285714285714285,1,0.0,0,0,0,0,0,0,0,1,0,0,1,1
2420,34081,aXVVveJT1EMTrK18orLW4FdAnq2Nzu9u,3VkHkmOtom3jM2wCu94xgzzu1d6Dn7or,6,5,1,0,2,1,3,1,13,1.8571428571428572,1,0.0,4,1,0,2,1,1,0,3,1,7,6,1
2421,34150,tsrLQC0lV1sZ8LCxoRmunUV9mkqpjmjC,3VkHkmOtom3jM2wCu94xgzzu1d6Dn7or,7,4,1,0,0,1,7,1,14,2.0,2,0.0,0,1,0,0,4,1,0,7,1,1,13,1
2422,34164,FZWt1vapJFvo3kXFvlr3Pcq5dqSsXIdl,3VkHkmOtom3jM2wCu94xgzzu1d6Dn7or,65,189,64,76,61,37,39,1,467,66.71428571428571,9,0.0,93,64,70,61,96,37,6,39,1,288,179,0
2423,34168,Rjq3XI3sJgbsQzOAqulSUkFuGk4UEX7x,3VkHkmOtom3jM2wCu94xgzzu1d6Dn7or,62,156,35,42,68,12,12,0,325,46.42857142857143,9,0.0,111,35,39,68,45,12,3,12,0,253,72,1
2424,34195,2pj9dHHbYoDCs5MS65snrPL5uR3OD5Lh,3VkHkmOtom3jM2wCu94xgzzu1d6Dn7or,96,408,184,69,94,64,123,0,942,134.57142857142858,21,0.0,121,184,57,94,287,64,12,123,0,456,486,0
2425,34217,RKAPccQbF04WFjvpPrrz3H1bcBykoWKC,3VkHkmOtom3jM2wCu94xgzzu1d6Dn7or,1,0,0,0,0,0,2,0,2,0.2857142857142857,1,0.0,0,0,0,0,0,0,0,2,0,0,2,1
2426,34228,I1UyztOe06FJeROTPzN6DbCbmc8CXQ91,3VkHkmOtom3jM2wCu94xgzzu1d6Dn7or,21,27,12,11,10,6,21,2,89,12.714285714285714,2,0.0,8,12,8,10,19,6,3,21,2,38,51,1
2427,34248,FtP5J6LR9t3GWYYm2BB6BaIAep1tOlB2,3VkHkmOtom3jM2wCu94xgzzu1d6Dn7or,27,26,14,15,14,2,3,0,74,10.571428571428571,2,0.0,9,14,12,14,17,2,3,3,0,49,25,1
2428,34277,NxFyNsgKtERXuEF6F8exx7Gs202RXGOk,3VkHkmOtom3jM2wCu94xgzzu1d6Dn7or,5,3,1,0,2,0,2,0,8,1.1428571428571428,1,0.0,0,1,0,2,3,0,0,2,0,3,5,1
2429,34297,ROEJI4wPM4hl5HJvXJtuG7qEVHlU64nL,3VkHkmOtom3jM2wCu94xgzzu1d6Dn7or,1,0,0,0,0,0,1,0,1,0.14285714285714285,1,0.0,0,0,0,0,0,0,0,1,0,0,1,1
2430,34408,YRvoydpc37Vpysmtw8O9rzowfgsZu7lO,3VkHkmOtom3jM2wCu94xgzzu1d6Dn7or,80,88,42,44,28,14,12,2,230,32.857142857142854,7,0.0,35,42,40,28,53,14,4,12,2,145,85,0
2431,34422,4TE0YwEikT84fXsOy3F1reADl0bBBf10,3VkHkmOtom3jM2wCu94xgzzu1d6Dn7or,15,41,13,6,2,6,8,0,76,10.857142857142858,5,0.0,6,13,5,2,35,6,1,8,0,26,50,1
2432,34450,f1RdhphkihsZPXjGaeUcF80F5PgPD1Mj,3VkHkmOtom3jM2wCu94xgzzu1d6Dn7or,5,2,1,0,1,0,5,0,9,1.2857142857142858,2,0.0,0,1,0,1,2,0,0,5,0,2,7,1
2433,34480,MKNBl3hhuuRZuBxyPOWBVV1OHzyXBuxg,3VkHkmOtom3jM2wCu94xgzzu1d6Dn7or,63,152,57,68,43,42,35,0,397,56.714285714285715,5,0.0,33,57,65,43,119,42,3,35,0,198,199,0
2434,34559,4iE8erzNZza1Ul4e6hPr0spJlerWRU2v,3VkHkmOtom3jM2wCu94xgzzu1d6Dn7or,75,232,90,46,44,46,37,12,507,72.42857142857143,11,0.0,76,90,44,44,156,46,2,37,12,254,253,0
2435,34574,eU7O6SlQ9Aa2vwin8Uq1FASqW5nuEsaN,3VkHkmOtom3jM2wCu94xgzzu1d6Dn7or,5,6,3,0,1,0,3,0,13,1.8571428571428572,3,0.0,0,3,0,1,6,0,0,3,0,4,9,1
2436,34602,bS2IOWKbnbandmSXQXzI1vhjNhpDoKfN,7GRhBDsirIGkRZBtSMEzNTyDr2JQm4xx,30,47,16,90,6,17,11,0,187,26.714285714285715,11,0.0,16,16,78,6,31,17,12,11,0,116,71,1
2437,34683,tEGUB4A2P1CFVrtUpVRZCuET3K7QndSr,7GRhBDsirIGkRZBtSMEzNTyDr2JQm4xx,8,5,3,0,2,0,6,0,16,2.2857142857142856,3,0.0,0,3,0,2,5,0,0,6,0,5,11,1
2438,34706,qZhmmNUvkNXdf3u04DTUQOFEBxxO10p4,5X6FeZozNMgE2VRi3MJYjkkFK8SETtu2,37,36,9,40,18,0,5,0,108,15.428571428571429,3,0.0,20,9,36,18,16,0,4,5,0,83,25,0
2439,34750,dZiWNJzMYOhdEdmTnxnlGn0TB2qVPzZP,7GRhBDsirIGkRZBtSMEzNTyDr2JQm4xx,7,3,2,0,2,0,4,0,11,1.5714285714285714,2,0.0,0,2,0,2,3,0,0,4,0,4,7,1
2440,34758,phhASQ029vNNdFMJmgP5NypplnmnI83R,7GRhBDsirIGkRZBtSMEzNTyDr2JQm4xx,21,23,13,117,1,0,6,0,160,22.857142857142858,5,0.0,4,13,105,1,19,0,12,6,0,123,37,0
2441,34766,PJE8xaLvi7LkfqoaW5URpwOl6Zp0XkBz,7GRhBDsirIGkRZBtSMEzNTyDr2JQm4xx,1,0,0,0,0,0,1,0,1,0.14285714285714285,1,0.0,0,0,0,0,0,0,0,1,0,0,1,1
2442,34792,dIopyk7eN7utmmbDdsk2JIW9Z0tySqPS,7GRhBDsirIGkRZBtSMEzNTyDr2JQm4xx,64,88,3,69,19,1,7,0,187,26.714285714285715,6,0.0,45,3,53,19,43,1,16,7,0,120,67,0
2443,34804,27KU7J0xhwne5RAwWlMtoP7JA6sMyYoP,7GRhBDsirIGkRZBtSMEzNTyDr2JQm4xx,1,0,0,0,0,0,1,0,1,0.14285714285714285,1,0.0,0,0,0,0,0,0,0,1,0,0,1,1
2444,34821,TRB5qhhumnbB7Yl6OQQJ0TCXgatMT1rj,7GRhBDsirIGkRZBtSMEzNTyDr2JQm4xx,6,3,2,0,2,0,1,0,8,1.1428571428571428,1,0.0,0,2,0,2,3,0,0,1,0,4,4,1
2445,34842,LyBG9vpZvAGsIKFzeD4gB6XRCVzk12fF,7GRhBDsirIGkRZBtSMEzNTyDr2JQm4xx,9,11,7,0,5,0,4,0,27,3.857142857142857,1,0.0,2,7,0,5,9,0,0,4,0,14,13,1
2446,34846,zVTKdKxLJYjz5XCh3vZ8AWdcMxkpEsE1,7GRhBDsirIGkRZBtSMEzNTyDr2JQm4xx,24,29,15,0,10,1,11,0,66,9.428571428571429,3,0.0,1,15,0,10,28,1,0,11,0,26,40,1
2447,34848,iBXl7c5cfIbBo4iOvRO7FtL1YDwjYkZC,7GRhBDsirIGkRZBtSMEzNTyDr2JQm4xx,1,0,0,0,0,0,1,0,1,0.14285714285714285,1,0.0,0,0,0,0,0,0,0,1,0,0,1,1
2448,34857,pelK71W03sE3yGvlh2inDZDZzii32E4l,7GRhBDsirIGkRZBtSMEzNTyDr2JQm4xx,1,0,0,0,0,0,2,0,2,0.2857142857142857,1,0.0,0,0,0,0,0,0,0,2,0,0,2,1
2449,34876,8Iba92MciDzfCVuZ0K5vCkx7lFQmElPx,5X6FeZozNMgE2VRi3MJYjkkFK8SETtu2,2,0,0,0,0,0,2,0,2,0.2857142857142857,1,0.0,0,0,0,0,0,0,0,2,0,0,2,1
2450,34882,zykXzhSqjaQF2TOV7bisEs6kRKezoegb,5X6FeZozNMgE2VRi3MJYjkkFK8SETtu2,17,14,7,10,5,9,4,0,49,7.0,2,0.0,2,7,8,5,12,9,2,4,0,22,27,1
2451,34883,C4q4gNQYEpjKh7pq1qjN8i3L7uSpUX9d,7GRhBDsirIGkRZBtSMEzNTyDr2JQm4xx,78,150,33,12,48,0,5,0,248,35.42857142857143,4,0.0,49,33,10,48,101,0,2,5,0,140,108,0
2452,34897,I7MInQU0IyHrO5RwKExwH0rTfGFmb00M,7GRhBDsirIGkRZBtSMEzNTyDr2JQm4xx,33,39,16,32,18,0,2,0,107,15.285714285714286,4,0.0,20,16,18,18,19,0,14,2,0,72,35,1
2453,34936,CUk1cSByLM0WdwmPEC4VGIc51EiVS5sq,5X6FeZozNMgE2VRi3MJYjkkFK8SETtu2,4,2,1,0,0,0,2,0,5,0.7142857142857143,1,0.0,0,1,0,0,2,0,0,2,0,1,4,0
2454,34942,hWZOZWrbvyzscOAFXsJvbbMN6COKZZlo,5X6FeZozNMgE2VRi3MJYjkkFK8SETtu2,6,10,1,0,1,0,10,1,23,3.2857142857142856,2,0.0,2,1,0,1,8,0,0,10,1,4,19,0
2455,34944,g2ieOC0GwkKqaZWeJNXowTArkXtXRKC6,5X6FeZozNMgE2VRi3MJYjkkFK8SETtu2,5,3,1,0,0,0,3,0,7,1.0,1,0.0,0,1,0,0,3,0,0,3,0,1,6,1
2456,34968,ganxR6HGA35mA8rG8lqwM374IiEISz9t,5X6FeZozNMgE2VRi3MJYjkkFK8SETtu2,38,45,11,42,23,7,27,3,158,22.571428571428573,7,0.0,29,11,38,23,16,7,4,27,3,101,57,0
2457,35033,xLkn5A65RKV3kvWji4FrgPZOEBlW1QGF,5X6FeZozNMgE2VRi3MJYjkkFK8SETtu2,5,2,1,0,1,0,2,0,6,0.8571428571428571,1,0.0,0,1,0,1,2,0,0,2,0,2,4,1
2458,35039,URPpxYyCEjr1OE9SkqYA4izrGFGWLVkB,7GRhBDsirIGkRZBtSMEzNTyDr2JQm4xx,60,136,33,80,23,2,13,1,288,41.142857142857146,4,0.0,50,33,62,23,86,2,18,13,1,168,120,1
2459,35082,8WC0ll7mpckRF9WawvJVdrokISfPhV8m,7GRhBDsirIGkRZBtSMEzNTyDr2JQm4xx,1,0,0,0,0,0,1,0,1,0.14285714285714285,1,0.0,0,0,0,0,0,0,0,1,0,0,1,1
2460,35109,oiUHDt5e0cU5z0JTxVcs5GBEfUv9FQOW,7GRhBDsirIGkRZBtSMEzNTyDr2JQm4xx,1,0,0,0,0,0,1,0,1,0.14285714285714285,1,0.0,0,0,0,0,0,0,0,1,0,0,1,1
2461,35139,Xr28fYjVCLAzrdEH9JR11PVrZPTquhGC,5X6FeZozNMgE2VRi3MJYjkkFK8SETtu2,1,0,0,0,0,0,1,0,1,0.14285714285714285,1,0.0,0,0,0,0,0,0,0,1,0,0,1,1
2462,35141,LgFsEu5TARkqPf6cgrTX0NqpOzewq5Lk,5X6FeZozNMgE2VRi3MJYjkkFK8SETtu2,7,7,3,0,1,0,3,0,14,2.0,2,0.0,0,3,0,1,7,0,0,3,0,4,10,0
2463,35142,V1VqVvaNADQhdwUg7X6GrtUrah1AYvnF,5X6FeZozNMgE2VRi3MJYjkkFK8SETtu2,21,33,4,17,7,7,9,2,79,11.285714285714286,4,0.0,12,4,17,7,21,7,0,9,2,40,39,0
2464,35143,7eHsOwDNMYF4417CWrgdB8gK0Wr4kfqA,7GRhBDsirIGkRZBtSMEzNTyDr2JQm4xx,93,305,89,175,50,6,43,1,669,95.57142857142857,13,0.0,174,89,148,50,131,6,27,43,1,461,208,0
2465,35149,0MLatjoztZTXhoA4l9vLnoup5p3z66PW,7GRhBDsirIGkRZBtSMEzNTyDr2JQm4xx,9,7,5,0,5,0,5,0,22,3.142857142857143,1,0.0,0,5,0,5,7,0,0,5,0,10,12,1
2466,35208,c0bjMduOwhlaRS3h8xRhAhid9jTsLzPD,7GRhBDsirIGkRZBtSMEzNTyDr2JQm4xx,5,5,2,0,1,0,1,0,9,1.2857142857142858,1,0.0,0,2,0,1,5,0,0,1,0,3,6,1
2467,35219,NloNzaDH3veeVFXcbcubNhXbjetvTiHo,3VkHkmOtom3jM2wCu94xgzzu1d6Dn7or,69,74,47,0,43,0,17,1,182,26.0,11,0.0,13,47,0,43,61,0,0,17,1,103,79,1
2468,35226,VrcAU2QLiPqVHHKHjhnkgJoQe1xmnYFr,3VkHkmOtom3jM2wCu94xgzzu1d6Dn7or,1,0,0,0,0,0,1,0,1,0.14285714285714285,1,0.0,0,0,0,0,0,0,0,1,0,0,1,1
2469,35244,Cg295oxP98ulacOMxj82Z33zofvX8NDO,3VkHkmOtom3jM2wCu94xgzzu1d6Dn7or,11,18,3,0,5,0,7,0,33,4.714285714285714,3,0.0,8,3,0,5,10,0,0,7,0,16,17,0
2470,35252,AQZEINvP5VjnvKTOLYKEEEE98JV5srZS,3VkHkmOtom3jM2wCu94xgzzu1d6Dn7or,1,0,0,0,0,0,1,0,1,0.14285714285714285,1,0.0,0,0,0,0,0,0,0,1,0,0,1,1
2471,35260,3YYhb9GPUHHEjFq4nmovkLqSAc47hw87,3VkHkmOtom3jM2wCu94xgzzu1d6Dn7or,44,171,44,48,0,52,23,3,341,48.714285714285715,6,0.0,54,44,43,0,117,52,5,23,3,141,200,1
2472,35262,Q3GN20FdAaB1MZlGBgPmcNQhTBDLwGfM,3VkHkmOtom3jM2wCu94xgzzu1d6Dn7or,4,11,4,0,0,0,3,0,18,2.5714285714285716,6,0.0,0,4,0,0,11,0,0,3,0,4,14,0
2473,35266,YQloiHp4EDEAnQ7UnBm1Re3dyFVVFj8Z,3VkHkmOtom3jM2wCu94xgzzu1d6Dn7or,69,221,7,62,71,2,53,4,420,60.0,9,0.0,109,7,54,71,112,2,8,53,4,241,179,0
2474,35271,EGnr1DIwxVClT1AEp500AEDbsdeKCZPX,3VkHkmOtom3jM2wCu94xgzzu1d6Dn7or,35,44,16,26,16,2,8,0,112,16.0,4,0.0,21,16,22,16,23,2,4,8,0,75,37,1
2475,35282,5ZXd1XQgfLUmCPlMx8OnxXzNyNKOWDdZ,3VkHkmOtom3jM2wCu94xgzzu1d6Dn7or,1,0,0,0,0,0,1,0,1,0.14285714285714285,1,0.0,0,0,0,0,0,0,0,1,0,0,1,1
2476,35288,JpPOjxQ25IFbccGav6d5GeYc4gSRLmTh,3VkHkmOtom3jM2wCu94xgzzu1d6Dn7or,2,0,0,0,0,0,5,0,5,0.7142857142857143,1,0.0,0,0,0,0,0,0,0,5,0,0,5,1
2477,35303,G5gPqpN0Dlyu1X04lWjkXJjbYNBs8e1L,3VkHkmOtom3jM2wCu94xgzzu1d6Dn7or,47,170,31,47,63,2,30,2,345,49.285714285714285,7,0.0,105,31,44,63,65,2,3,30,2,243,102,0
2478,35309,i2lUV72IHqqXWYqLFMWv3y4XGmlq2lXa,3VkHkmOtom3jM2wCu94xgzzu1d6Dn7or,49,144,83,104,0,52,33,2,418,59.714285714285715,14,0.0,40,83,99,0,104,52,5,33,2,222,196,0
2479,35319,3rgatvueGycmzmQ7x6De7keieQ0tMDvZ,3VkHkmOtom3jM2wCu94xgzzu1d6Dn7or,62,85,6,26,26,21,25,3,192,27.428571428571427,8,0.0,31,6,26,26,54,21,0,25,3,89,103,0
2480,35334,oIZupP8mtjvTucUgRpisbdhVhywamlH4,3VkHkmOtom3jM2wCu94xgzzu1d6Dn7or,31,68,30,44,20,15,12,0,189,27.0,9,0.0,21,30,38,20,47,15,6,12,0,109,80,1
2481,35338,J7Z2kbIusBdg4vDNSEXsBqvF3Z5aB0VS,3VkHkmOtom3jM2wCu94xgzzu1d6Dn7or,7,4,1,0,0,2,20,4,31,4.428571428571429,1,0.0,0,1,0,0,4,2,0,20,4,1,30,1
2482,35345,V5yC8Sc1UiRa5SVlGIrYAvwTvYKzzr9V,3VkHkmOtom3jM2wCu94xgzzu1d6Dn7or,5,2,1,0,1,0,2,0,6,0.8571428571428571,1,0.0,0,1,0,1,2,0,0,2,0,2,4,1
2483,35364,F7LLRj3C3OHWoTHHOtX1hOxCNCJMv4e2,3VkHkmOtom3jM2wCu94xgzzu1d6Dn7or,9,6,2,7,3,1,3,0,22,3.142857142857143,1,0.0,3,2,6,3,3,1,1,3,0,14,8,1
2484,35366,GYZiEWORkvdb98HTlXPlZY67c9EwOLPh,3VkHkmOtom3jM2wCu94xgzzu1d6Dn7or,39,139,58,1,29,1,16,6,250,35.714285714285715,2,0.0,9,58,1,29,130,1,0,16,6,97,153,1
2485,35371,9A1ZQrzcYlbBSb63MFLqCvCueyg4FsvP,3VkHkmOtom3jM2wCu94xgzzu1d6Dn7or,1,0,0,0,0,0,1,0,1,0.14285714285714285,1,0.0,0,0,0,0,0,0,0,1,0,0,1,1
2486,35379,swFSBeVvTnBYaeb15rO3Azeazpu85Bvg,3VkHkmOtom3jM2wCu94xgzzu1d6Dn7or,6,2,0,0,0,0,7,0,9,1.2857142857142858,1,0.0,0,0,0,0,2,0,0,7,0,0,9,1
2487,35380,1yNvYTbjWPtGip8F7Y4Mte6NTH0OJtD0,3VkHkmOtom3jM2wCu94xgzzu1d6Dn7or,26,38,11,13,14,9,23,3,111,15.857142857142858,3,0.0,21,11,13,14,17,9,0,23,3,59,52,1
2488,35385,YYPEucCdDZvSoz6R7Fuc1GsZB3bn6s7b,3VkHkmOtom3jM2wCu94xgzzu1d6Dn7or,25,55,10,7,15,12,9,0,108,15.428571428571429,5,0.0,24,10,7,15,31,12,0,9,0,56,52,1
2489,35393,sg4VVv9cgk6nt80dZvUKhL5H7RMgLm0l,3VkHkmOtom3jM2wCu94xgzzu1d6Dn7or,95,123,58,59,42,62,33,0,377,53.857142857142854,10,0.0,47,58,55,42,76,62,4,33,0,202,175,0
2490,35411,WVDlpVdT5mqaYV2jwUU0OJMNLxqJCz3F,3VkHkmOtom3jM2wCu94xgzzu1d6Dn7or,2,0,0,0,0,0,3,0,3,0.42857142857142855,1,0.0,0,0,0,0,0,0,0,3,0,0,3,1
2491,35413,tCaITUvSbtVWtN97HSN8SiFnJq6fQQbA,3VkHkmOtom3jM2wCu94xgzzu1d6Dn7or,7,2,1,0,1,0,6,1,11,1.5714285714285714,2,0.0,0,1,0,1,2,0,0,6,1,2,9,1
2492,35414,qjwWMZIT8GPuhKM2uz6F9PBHE6dfIr5u,3VkHkmOtom3jM2wCu94xgzzu1d6Dn7or,2,0,0,0,0,0,2,0,2,0.2857142857142857,1,0.0,0,0,0,0,0,0,0,2,0,0,2,1
2493,35415,hXeJsHYt7Lw33OwJ9XWEmEMIulVpOLUH,3VkHkmOtom3jM2wCu94xgzzu1d6Dn7or,7,9,3,1,2,5,3,0,23,3.2857142857142856,3,0.0,3,3,1,2,6,5,0,3,0,9,14,1
2494,35444,RCs47yV8g50jkPyVnv7MaTTXpYxAFYTV,7GRhBDsirIGkRZBtSMEzNTyDr2JQm4xx,2,0,0,0,0,0,2,0,2,0.2857142857142857,1,0.0,0,0,0,0,0,0,0,2,0,0,2,1
2495,35463,JtMmp5BCDQnYE7CMI3NvnX4aRCZsQW9K,7GRhBDsirIGkRZBtSMEzNTyDr2JQm4xx,1,0,0,0,0,0,1,0,1,0.14285714285714285,1,0.0,0,0,0,0,0,0,0,1,0,0,1,0
2496,35508,3T6lo0hNKqGF8AeLHQEHxxeYIjJqOuY5,7GRhBDsirIGkRZBtSMEzNTyDr2JQm4xx,1,0,0,0,0,0,1,0,1,0.14285714285714285,1,0.0,0,0,0,0,0,0,0,1,0,0,1,1
2497,35514,m3BtjHPB6UJjyfA5xn0d2GYhJL5pNCbr,7GRhBDsirIGkRZBtSMEzNTyDr2JQm4xx,7,3,2,0,2,0,2,0,9,1.2857142857142858,1,0.0,0,2,0,2,3,0,0,2,0,4,5,1
2498,35607,2LWu6JMOYyxkKMq63i00WbtT7iPpdOSr,7GRhBDsirIGkRZBtSMEzNTyDr2JQm4xx,2,0,0,0,0,0,4,0,4,0.5714285714285714,2,0.0,0,0,0,0,0,0,0,4,0,0,4,1
2499,35608,nH0kSZNGQd9lZaOsssfRVpCIHD2KW4j6,7GRhBDsirIGkRZBtSMEzNTyDr2JQm4xx,66,112,40,151,40,4,7,0,354,50.57142857142857,6,0.0,51,40,135,40,61,4,16,7,0,266,88,1
2500,35634,U3LNfYcdRIeU9qhiaPG7Yg8NuZRGOnSS,7GRhBDsirIGkRZBtSMEzNTyDr2JQm4xx,3,0,0,0,0,0,7,0,7,1.0,3,0.0,0,0,0,0,0,0,0,7,0,0,7,1
2501,35641,V4bFVaM4pBFZgsA7pP7LuDbbkkFXZJkm,7GRhBDsirIGkRZBtSMEzNTyDr2JQm4xx,7,4,1,0,1,0,2,0,8,1.1428571428571428,1,0.0,0,1,0,1,4,0,0,2,0,2,6,1
2502,35652,8rRjFsPi04nQAO9F6yKNcWF37hukO3JR,7GRhBDsirIGkRZBtSMEzNTyDr2JQm4xx,55,99,43,84,43,3,8,0,280,40.0,1,0.0,51,43,74,43,48,3,10,8,0,211,69,0
2503,35662,ISNkLbVsU7lMqk5vdrFnPCVx4y3a9MZD,7GRhBDsirIGkRZBtSMEzNTyDr2JQm4xx,42,78,33,30,24,15,6,0,186,26.571428571428573,2,0.0,32,33,19,24,46,15,11,6,0,108,78,1
2504,35686,skJn7dtfSekFrPHRHs9swZ9AtSUKi36u,7GRhBDsirIGkRZBtSMEzNTyDr2JQm4xx,58,150,55,54,32,61,21,0,373,53.285714285714285,5,0.0,80,55,48,32,70,61,6,21,0,215,158,0
2505,35696,Vtwq7W3DodckYgwQIiThiTk1zWdBpMl0,7GRhBDsirIGkRZBtSMEzNTyDr2JQm4xx,10,10,2,2,3,0,5,1,23,3.2857142857142856,4,0.0,5,2,2,3,5,0,0,5,1,12,11,1
2506,35725,BqXfJC2PEXaOut3jaDziE5COnZJ5tCVg,7GRhBDsirIGkRZBtSMEzNTyDr2JQm4xx,63,66,26,53,27,2,2,0,176,25.142857142857142,5,0.0,37,26,28,27,29,2,25,2,0,118,58,1
2507,35826,GMULrMSqUlOdEP2r4yoabrka9qt4yKGP,7GRhBDsirIGkRZBtSMEzNTyDr2JQm4xx,21,29,9,0,10,0,1,0,49,7.0,1,0.0,19,9,0,10,10,0,0,1,0,38,11,0
2508,35861,DhtCawfOEQUsJbImq8OS7DKZj4eiXUQq,7GRhBDsirIGkRZBtSMEzNTyDr2JQm4xx,6,1,1,0,1,0,4,0,7,1.0,1,0.0,0,1,0,1,1,0,0,4,0,2,5,1
2509,35881,712ruuJBHxwe16Nyde1AP6y2j0cVhIJD,7GRhBDsirIGkRZBtSMEzNTyDr2JQm4xx,81,63,16,94,11,0,6,0,190,27.142857142857142,2,0.0,33,16,93,11,30,0,1,6,0,153,37,0
2510,37552,gL9BFkziNrTyhzKvF4GTh7vW4ctCxqfr,SpATywNh6bZuzm8s1ceuBUnMUAeoAHHw,16,22,5,12,4,0,2,0,45,6.428571428571429,5,0.0,2,5,10,4,20,0,2,2,0,21,24,0
2511,37553,AVMp8F9T45cyhHDRnad5d9bxFkDP4PTv,A3fsA9Zfv1X2fVEQhTw51lKENdNrEqT3,35,21,2,74,1,1,11,1,111,15.857142857142858,3,0.0,2,2,66,1,19,1,8,11,1,71,40,1
2512,37581,mwc0YjZS72xD4dO6Zk7KmFewdh7PWkAS,SpATywNh6bZuzm8s1ceuBUnMUAeoAHHw,7,8,3,0,2,0,3,0,16,2.2857142857142856,4,0.0,0,3,0,2,8,0,0,3,0,5,11,0
2513,37584,06eFfwi64z4CVxg9kYU89F0UCK6M3gh2,G8EPVSXsOYB5YQWZGiz1aVq5Pgr2GrQu,19,27,2,10,4,0,6,0,49,7.0,2,0.0,12,2,5,4,15,0,5,6,0,23,26,1
2514,37586,rVtxqWpWg55yh0PkkVeeVKt0oQv342j9,G8EPVSXsOYB5YQWZGiz1aVq5Pgr2GrQu,8,10,9,0,9,0,6,0,34,4.857142857142857,3,0.0,0,9,0,9,10,0,0,6,0,18,16,0
2515,37587,9RND50Xx7veKeepJEVVvFKwUGiemuZp5,G8EPVSXsOYB5YQWZGiz1aVq5Pgr2GrQu,10,12,6,0,3,0,5,0,26,3.7142857142857144,5,0.0,0,6,0,3,12,0,0,5,0,9,17,1
2516,37588,XY4zkM1XF8dydjqcvDmQyLNW1UDj6PeN,A3fsA9Zfv1X2fVEQhTw51lKENdNrEqT3,37,31,13,60,7,0,6,0,117,16.714285714285715,2,0.0,3,13,51,7,28,0,9,6,0,74,43,1
2517,37610,v7t0p3xAszbLv0yg1dCcAEjixfvU7JCE,SpATywNh6bZuzm8s1ceuBUnMUAeoAHHw,48,102,48,48,19,14,45,3,279,39.857142857142854,8,0.0,36,48,40,19,66,14,8,45,3,143,136,0
2518,37611,unrsquMc9aFN95z680VOYlXL0dwyjnVg,bWdj2GDclj5ofokWjzoa5jAwMkxCykd6,12,30,10,36,3,1,9,1,90,12.857142857142858,5,0.0,6,10,34,3,24,1,2,9,1,53,37,1
2519,37625,6lLAZ0WiQMBHvxtAmgARKrfLfmbRRaSM,A3fsA9Zfv1X2fVEQhTw51lKENdNrEqT3,1,0,0,0,0,0,1,0,1,0.14285714285714285,1,0.0,0,0,0,0,0,0,0,1,0,0,1,1
2520,37629,KxrIXB4R6FFhAWrOx18fBUJq6eOomhrO,bWdj2GDclj5ofokWjzoa5jAwMkxCykd6,5,2,1,0,1,0,4,0,8,1.1428571428571428,2,0.0,0,1,0,1,2,0,0,4,0,2,6,1
2521,37636,08uQSEeVi17JB9WOQMIOM89vv6wgWS2O,SpATywNh6bZuzm8s1ceuBUnMUAeoAHHw,28,36,5,33,3,2,15,2,96,13.714285714285714,4,0.0,11,5,30,3,25,2,3,15,2,49,47,1
2522,37644,9irvFFpWGWd3HRZTxsfDJTqmA07T10ig,SpATywNh6bZuzm8s1ceuBUnMUAeoAHHw,7,2,1,0,1,3,4,1,12,1.7142857142857142,1,0.0,0,1,0,1,2,3,0,4,1,2,10,1
2523,37666,zeUi2UnQZPPF6bRQXw2s8LZ41ZOdqRAa,SpATywNh6bZuzm8s1ceuBUnMUAeoAHHw,46,58,34,19,15,16,17,1,160,22.857142857142858,12,0.0,9,34,19,15,49,16,0,17,1,77,83,0
2524,37683,fmWFGOtr4qK1lNBCrTOCxVLVNU6IZ5bU,bWdj2GDclj5ofokWjzoa5jAwMkxCykd6,1,0,0,0,0,0,1,0,1,0.14285714285714285,1,0.0,0,0,0,0,0,0,0,1,0,0,1,1
2525,37688,GcLKL1EMGPSsuLaGpCB2Rrlv3EuS2ngA,SpATywNh6bZuzm8s1ceuBUnMUAeoAHHw,6,2,1,0,1,0,3,0,7,1.0,1,0.0,0,1,0,1,2,0,0,3,0,2,5,1
2526,37690,1Ti3XKNP5gzLh1si7Apz4GKt53UijsKr,SpATywNh6bZuzm8s1ceuBUnMUAeoAHHw,44,71,25,46,12,0,14,0,168,24.0,6,0.0,19,25,44,12,52,0,2,14,0,100,68,0
2527,37691,FisqRa6EMb5EsK7GdBjEQwdg4YXD4Xed,bWdj2GDclj5ofokWjzoa5jAwMkxCykd6,30,78,47,106,13,25,20,0,289,41.285714285714285,8,0.0,10,47,92,13,68,25,14,20,0,162,127,1
2528,37706,5D134KQAUnU8gDw5hYnvC82YSO8giiEU,SpATywNh6bZuzm8s1ceuBUnMUAeoAHHw,45,60,24,34,13,10,16,1,158,22.571428571428573,6,0.0,25,24,28,13,35,10,6,16,1,90,68,0
2529,37708,YQZ85qW2KiDmX9GD2Tq3oRYH6ucmQmKe,RXDvfPUBYFlVdlueBFbLW0mhhAyGEqpt,15,19,11,8,6,0,4,0,48,6.857142857142857,2,0.0,1,11,7,6,18,0,1,4,0,25,23,1
2530,37710,t89Lbc9NyQ1awHKwpUunu51m4E6DMYhk,SpATywNh6bZuzm8s1ceuBUnMUAeoAHHw,20,33,12,22,1,8,10,1,87,12.428571428571429,5,0.0,12,12,20,1,21,8,2,10,1,45,42,0
2531,37713,7fOZzyBcCx06Vw2a40A0eroSD5VkDcNa,SpATywNh6bZuzm8s1ceuBUnMUAeoAHHw,45,74,42,36,22,56,22,2,254,36.285714285714285,9,0.0,21,42,30,22,53,56,6,22,2,115,139,0
2532,37722,NuWa1wNN62sioyREqwjInndithPqIOD8,A3fsA9Zfv1X2fVEQhTw51lKENdNrEqT3,5,3,2,0,1,0,3,0,9,1.2857142857142858,1,0.0,0,2,0,1,3,0,0,3,0,3,6,1
2533,37737,m7GeMdFl22gaxUtAD72z73B5tIK1shlq,SpATywNh6bZuzm8s1ceuBUnMUAeoAHHw,13,7,5,0,4,0,7,2,25,3.5714285714285716,3,0.0,0,5,0,4,7,0,0,7,2,9,16,1
2534,37761,bzoYFRQVu6SapCnsZ0DOXeU3JXiLIJu3,SpATywNh6bZuzm8s1ceuBUnMUAeoAHHw,30,31,13,25,7,19,13,3,111,15.857142857142858,6,0.0,14,13,25,7,17,19,0,13,3,59,52,0
2535,37764,b9kodEhA94IDSBT3ykY4QWiqr6rjyws0,SpATywNh6bZuzm8s1ceuBUnMUAeoAHHw,2,0,0,0,0,0,2,0,2,0.2857142857142857,1,0.0,0,0,0,0,0,0,0,2,0,0,2,1
2536,37769,gsdvPbnmqv3G3TICTRxTHCvyG0vd5lw3,G8EPVSXsOYB5YQWZGiz1aVq5Pgr2GrQu,33,52,28,56,12,32,18,1,199,28.428571428571427,2,0.0,18,28,37,12,34,32,19,18,1,95,104,1
2537,37782,MT2eJtF59AVNdUs7mwFqputROb2HgEm3,SpATywNh6bZuzm8s1ceuBUnMUAeoAHHw,23,18,10,25,5,3,3,0,64,9.142857142857142,3,0.0,5,10,22,5,13,3,3,3,0,42,22,0
2538,37784,BarsBzOr7FgzlrusMqrDFOsYw63YD64d,A3fsA9Zfv1X2fVEQhTw51lKENdNrEqT3,6,3,0,0,0,5,6,2,16,2.2857142857142856,1,0.0,0,0,0,0,3,5,0,6,2,0,16,1
2539,37788,y1rNC08s1iP76iivJMPjmiTg1SiPQTDp,SpATywNh6bZuzm8s1ceuBUnMUAeoAHHw,9,17,0,4,0,2,3,0,26,3.7142857142857144,2,0.0,1,0,4,0,16,2,0,3,0,5,21,1
2540,37831,fmoIo5oPDyRcnHhnGH8MKyUTeXZvimIR,SpATywNh6bZuzm8s1ceuBUnMUAeoAHHw,30,64,30,22,11,70,38,1,236,33.714285714285715,7,0.0,14,30,20,11,50,70,2,38,1,75,161,0
2541,37834,nEvQSo5dnPEv9AKi5Mbvgqg4cF9OoMSW,SpATywNh6bZuzm8s1ceuBUnMUAeoAHHw,16,13,7,7,3,4,10,1,45,6.428571428571429,1,0.0,3,7,6,3,10,4,1,10,1,19,26,1
2542,37873,dpBOLaUWFOAehWXZrpwiocVfiOMhN5GL,SpATywNh6bZuzm8s1ceuBUnMUAeoAHHw,29,52,17,37,12,5,13,0,136,19.428571428571427,2,0.0,24,17,30,12,28,5,7,13,0,83,53,0
2543,37883,9Uee7oEuuMmgPx2IzPfFkWgkHZyPbWr0,SpATywNh6bZuzm8s1ceuBUnMUAeoAHHw,61,121,70,48,39,0,16,0,294,42.0,9,0.0,33,70,44,39,88,0,4,16,0,186,108,0
2544,37887,5vUuq5ZeDCNce4LmvH0naoUjpb3qbNOp,bWdj2GDclj5ofokWjzoa5jAwMkxCykd6,8,17,7,18,3,0,6,0,51,7.285714285714286,4,0.0,3,7,16,3,14,0,2,6,0,29,22,1
2545,37893,UOoqOWQxtJ6HvrytZgfqguIfOgaBqbBw,SpATywNh6bZuzm8s1ceuBUnMUAeoAHHw,7,5,1,0,1,0,2,0,9,1.2857142857142858,1,0.0,0,1,0,1,5,0,0,2,0,2,7,1
2546,37894,qPQsrCDbNr80CImeaDwXdvYkweQdyVus,RXDvfPUBYFlVdlueBFbLW0mhhAyGEqpt,14,12,9,0,3,1,6,1,32,4.571428571428571,3,0.0,0,9,0,3,12,1,0,6,1,12,20,0
2547,37904,313ZU7SnTnilkzRb4b84vNDTmwgTEy5n,G8EPVSXsOYB5YQWZGiz1aVq5Pgr2GrQu,21,12,10,0,10,0,3,0,35,5.0,2,0.0,0,10,0,10,12,0,0,3,0,20,15,1
2548,37905,lV4ifbsehEXWBwQOY9bU762jcRSMFY5M,SpATywNh6bZuzm8s1ceuBUnMUAeoAHHw,55,76,36,29,17,2,22,2,184,26.285714285714285,8,0.0,16,36,28,17,60,2,1,22,2,97,87,0
2549,37908,JWUvlcN404PLe0TeFXcH9piP650rZWof,SpATywNh6bZuzm8s1ceuBUnMUAeoAHHw,9,36,9,0,2,1,16,0,64,9.142857142857142,4,0.0,0,9,0,2,36,1,0,16,0,11,53,1
2550,37913,iBI4oBYQahSrgJM5NHLRivWj4vPgILKH,G8EPVSXsOYB5YQWZGiz1aVq5Pgr2GrQu,9,10,4,0,4,0,2,0,20,2.857142857142857,2,0.0,5,4,0,4,5,0,0,2,0,13,7,1
2551,37926,mUOanMUrsiycv8pF8RX4xyc7qtUXAMUs,bWdj2GDclj5ofokWjzoa5jAwMkxCykd6,15,26,12,52,12,0,4,0,106,15.142857142857142,5,0.0,10,12,47,12,16,0,5,4,0,81,25,1
2552,37929,Trm6c0xRzFyegURuKBBdNUenucp5uZb9,G8EPVSXsOYB5YQWZGiz1aVq5Pgr2GrQu,8,21,8,0,3,1,8,0,41,5.857142857142857,1,0.0,7,8,0,3,14,1,0,8,0,18,23,1
2553,37932,UYyUkvxHd4tIc6aiQcuHfsTYHPlQXaAb,G8EPVSXsOYB5YQWZGiz1aVq5Pgr2GrQu,103,139,71,303,39,9,26,9,596,85.14285714285714,5,0.0,60,71,220,39,79,9,83,26,9,390,206,1
2554,37949,QRq9SneqdOEdNrPCbzGfNOJsUrpMzzSX,A3fsA9Zfv1X2fVEQhTw51lKENdNrEqT3,6,2,1,0,0,1,6,1,11,1.5714285714285714,1,0.0,0,1,0,0,2,1,0,6,1,1,10,1
2555,37958,O3fc8NICaVWUo8M4PzoZRSLRDAOYKQm9,G8EPVSXsOYB5YQWZGiz1aVq5Pgr2GrQu,6,12,0,6,0,0,2,0,20,2.857142857142857,2,0.0,3,0,4,0,9,0,2,2,0,7,13,1
2556,37961,lI4gYBH1elniUs6lU536XKdTVOMiS4n1,SpATywNh6bZuzm8s1ceuBUnMUAeoAHHw,16,37,11,11,3,0,21,2,85,12.142857142857142,3,0.0,7,11,11,3,30,0,0,21,2,32,53,1
2557,37963,zyXPxdyvET7shVCE1kkdKwMY47AukbuA,G8EPVSXsOYB5YQWZGiz1aVq5Pgr2GrQu,13,11,2,0,2,12,10,1,38,5.428571428571429,2,0.0,2,2,0,2,9,12,0,10,1,6,32,0
2558,37968,o4fNZaSYX3UHutrkuKOAdzPPx4q40e5R,G8EPVSXsOYB5YQWZGiz1aVq5Pgr2GrQu,4,5,0,0,0,0,2,0,7,1.0,2,0.0,0,0,0,0,5,0,0,2,0,0,7,1
2559,37972,k0lvFNaTVHTtB1XHBZ8229ej4v1r4rPk,A3fsA9Zfv1X2fVEQhTw51lKENdNrEqT3,13,11,5,0,2,3,12,1,34,4.857142857142857,3,0.0,0,5,0,2,11,3,0,12,1,7,27,0
2560,37977,0w9tP8TINgzfbBeYFJprB82ry0PjYiWn,A3fsA9Zfv1X2fVEQhTw51lKENdNrEqT3,8,9,1,0,1,0,2,0,13,1.8571428571428572,1,0.0,0,1,0,1,9,0,0,2,0,2,11,1
2561,37992,lFmplH6KaQigIQOByvMn1p8i4p6OLLhs,SpATywNh6bZuzm8s1ceuBUnMUAeoAHHw,41,41,23,47,15,0,8,0,134,19.142857142857142,4,0.0,10,23,41,15,31,0,6,8,0,89,45,1
2562,37993,pYcnIzYPgb3xzrOvmR9y0UUIZo4gqKuO,SpATywNh6bZuzm8s1ceuBUnMUAeoAHHw,48,115,74,31,32,8,23,1,284,40.57142857142857,9,0.0,22,74,25,32,93,8,6,23,1,153,131,0
2563,37997,Y65j88wkyz5DKML6XOG6DUVrzLQhWfST,A3fsA9Zfv1X2fVEQhTw51lKENdNrEqT3,1,0,0,0,0,0,1,0,1,0.14285714285714285,1,0.0,0,0,0,0,0,0,0,1,0,0,1,1
2564,38005,u82lBhpDxJIwlZISEntCxj1zgVFdW0vT,RXDvfPUBYFlVdlueBFbLW0mhhAyGEqpt,1,0,0,0,0,0,1,0,1,0.14285714285714285,1,0.0,0,0,0,0,0,0,0,1,0,0,1,1
2565,38028,vxPhImq7e3kAhm2TgSi6LMfFEt4O2oEs,G8EPVSXsOYB5YQWZGiz1aVq5Pgr2GrQu,1,0,0,0,0,0,1,0,1,0.14285714285714285,1,0.0,0,0,0,0,0,0,0,1,0,0,1,1
2566,38049,7n0QZ7z1Xa9itNmJQbQwoSvEI6n7oD9f,G8EPVSXsOYB5YQWZGiz1aVq5Pgr2GrQu,32,27,19,22,15,8,10,5,106,15.142857142857142,3,0.0,2,19,18,15,25,8,4,10,5,54,52,0
2567,38066,3JBai7u7WOgX09HExPUwVpNowvdvIz4R,SpATywNh6bZuzm8s1ceuBUnMUAeoAHHw,8,14,3,0,3,0,6,0,26,3.7142857142857144,1,0.0,0,3,0,3,14,0,0,6,0,6,20,1
2568,38077,ltTao4EsmrwmN0pXNyC05GxRX7ymLAGM,SpATywNh6bZuzm8s1ceuBUnMUAeoAHHw,28,58,10,39,7,49,19,4,186,26.571428571428573,3,0.0,13,10,31,7,45,49,8,19,4,61,125,1
2569,38080,OF5BECbAO5zdcqQHFPvLM1mTcTskbMIs,SpATywNh6bZuzm8s1ceuBUnMUAeoAHHw,5,2,1,0,1,0,2,0,6,0.8571428571428571,1,0.0,0,1,0,1,2,0,0,2,0,2,4,1
2570,38096,EjRGtyRd7Px8PMzWSSey4NzmMFY5f6ai,A3fsA9Zfv1X2fVEQhTw51lKENdNrEqT3,7,5,0,0,0,0,3,0,8,1.1428571428571428,1,0.0,1,0,0,0,4,0,0,3,0,1,7,1
2571,38115,iVCEmNfeCwWMGAqNUnWf3L8wEjKUErLk,SpATywNh6bZuzm8s1ceuBUnMUAeoAHHw,13,10,7,8,6,0,2,0,33,4.714285714285714,1,0.0,2,7,7,6,8,0,1,2,0,22,11,1
2572,38117,udxFfabXtaVUvVlT3wEleIvfDBGe9yE2,SpATywNh6bZuzm8s1ceuBUnMUAeoAHHw,38,134,11,48,5,33,39,3,273,39.0,12,0.0,38,11,41,5,96,33,7,39,3,95,178,0
2573,38119,53oi8zKKD3qFJiM7JZLKGYnyxQCMyuUV,SpATywNh6bZuzm8s1ceuBUnMUAeoAHHw,24,38,24,3,13,0,15,0,93,13.285714285714286,5,0.0,2,24,3,13,36,0,0,15,0,42,51,0
2574,38128,UwkR7Vh4zbozAucPqUcQw4h7SMZr9zo0,G8EPVSXsOYB5YQWZGiz1aVq5Pgr2GrQu,31,51,14,46,12,3,22,3,151,21.571428571428573,1,0.0,18,14,35,12,33,3,11,22,3,79,72,1
2575,38133,cqdnmjbJq0lDv2xgeKuzXqVr5xQytWr0,SpATywNh6bZuzm8s1ceuBUnMUAeoAHHw,14,31,13,12,5,5,13,2,81,11.571428571428571,3,0.0,10,13,10,5,21,5,2,13,2,38,43,1
2576,38138,mInRZ91i4VWL94xI1UV5JCnlg7Y6Us1i,SpATywNh6bZuzm8s1ceuBUnMUAeoAHHw,9,9,3,19,1,2,3,0,37,5.285714285714286,1,0.0,5,3,16,1,4,2,3,3,0,25,12,1
2577,38143,NuIu6w9t8Lc1HMDSYdxabpGimNAWlvNQ,SpATywNh6bZuzm8s1ceuBUnMUAeoAHHw,1,0,0,0,0,0,3,0,3,0.42857142857142855,1,0.0,0,0,0,0,0,0,0,3,0,0,3,1
2578,38158,i1weaEaafaiWi31Ms4bwoF6JM4IRf714,SpATywNh6bZuzm8s1ceuBUnMUAeoAHHw,45,69,39,44,23,0,16,0,191,27.285714285714285,5,0.0,15,39,34,23,54,0,10,16,0,111,80,0
2579,38221,cANiCKhLAefO0FGisAnCzMrx1JIRd95C,SpATywNh6bZuzm8s1ceuBUnMUAeoAHHw,1,0,0,0,0,0,1,0,1,0.14285714285714285,1,0.0,0,0,0,0,0,0,0,1,0,0,1,1
2580,38230,iazFnp0WwUGX79mDdFk78xSp9PPvWXim,G8EPVSXsOYB5YQWZGiz1aVq5Pgr2GrQu,9,2,1,0,1,5,9,1,19,2.7142857142857144,1,0.0,0,1,0,1,2,5,0,9,1,2,17,1
2581,38233,ysJor7TWBYA7e95uEgB7VNWumWxuU518,SpATywNh6bZuzm8s1ceuBUnMUAeoAHHw,17,19,10,8,4,7,4,1,53,7.571428571428571,1,0.0,7,10,8,4,12,7,0,4,1,29,24,1
2582,38246,LTRNxyAcyQ3kCcXCEOrswo8s3Qc2KMU6,SpATywNh6bZuzm8s1ceuBUnMUAeoAHHw,9,21,3,0,2,0,9,0,35,5.0,4,0.0,0,3,0,2,21,0,0,9,0,5,30,1
2583,38247,jSpQCS8wUT6MHpQaGbLVjdDCTF3dAoT8,SpATywNh6bZuzm8s1ceuBUnMUAeoAHHw,27,53,26,24,14,22,22,1,162,23.142857142857142,4,0.0,18,26,20,14,35,22,4,22,1,78,84,0
2584,38253,sfuANiSFq72qS7aoKnyvPaRtXw7bLFiY,RXDvfPUBYFlVdlueBFbLW0mhhAyGEqpt,29,17,12,24,10,0,2,0,65,9.285714285714286,2,0.0,3,12,24,10,14,0,0,2,0,49,16,1
2585,38268,JDTEn5xJLcPCagcpPFhmwRsZ0N8AbJZ6,A3fsA9Zfv1X2fVEQhTw51lKENdNrEqT3,33,39,15,32,12,0,19,1,118,16.857142857142858,6,0.0,3,15,25,12,36,0,7,19,1,55,63,1
2586,38270,Dw8R0agU0UT0CHCyap3lEB834WRdn2Bl,SpATywNh6bZuzm8s1ceuBUnMUAeoAHHw,12,65,24,5,14,0,24,0,132,18.857142857142858,6,0.0,0,24,5,14,65,0,0,24,0,43,89,1
2587,38298,5FKi7MQVDgjqvQXvzQgvsTDVCkGiyjdK,SpATywNh6bZuzm8s1ceuBUnMUAeoAHHw,26,22,17,10,14,0,32,2,97,13.857142857142858,6,0.0,4,17,10,14,18,0,0,32,2,45,52,0
2588,38314,AVyodBv8C1SQfOiSO7xOfqn4Ds4wiCRY,A3fsA9Zfv1X2fVEQhTw51lKENdNrEqT3,17,14,1,0,0,15,10,1,41,5.857142857142857,2,0.0,0,1,0,0,14,15,0,10,1,1,40,1
2589,38327,rB1ONc72srD5rc2RXozcacnvBYqDF9fo,SpATywNh6bZuzm8s1ceuBUnMUAeoAHHw,14,25,1,9,3,1,5,0,44,6.285714285714286,2,0.0,14,1,9,3,11,1,0,5,0,27,17,1
2590,38328,XwPjxWDcCDaPkH71IgDdIxnm3Wz6b30d,SpATywNh6bZuzm8s1ceuBUnMUAeoAHHw,7,5,4,0,3,0,2,0,14,2.0,1,0.0,0,4,0,3,5,0,0,2,0,7,7,1
2591,38346,0KKudduxSM0i9qq9j381LmD3t0z9aJ9R,SpATywNh6bZuzm8s1ceuBUnMUAeoAHHw,14,29,2,10,0,5,19,1,66,9.428571428571429,6,0.0,14,2,10,0,15,5,0,19,1,26,40,0
2592,38356,DJeWlgB4cP1RQ3JZLa1wZwd4zgAbYOxv,SpATywNh6bZuzm8s1ceuBUnMUAeoAHHw,20,26,20,0,12,0,5,0,63,9.0,4,0.0,1,20,0,12,25,0,0,5,0,33,30,1
2593,38373,tiRtyjdLAEYu3JNWmyxWqeCTg4ly9Ea3,A3fsA9Zfv1X2fVEQhTw51lKENdNrEqT3,1,0,0,0,0,0,1,0,1,0.14285714285714285,1,0.0,0,0,0,0,0,0,0,1,0,0,1,1
2594,38379,bA9VLpiTLkvmdt5uyFO2FBNAiu4jehWj,SpATywNh6bZuzm8s1ceuBUnMUAeoAHHw,6,2,1,0,1,0,3,1,8,1.1428571428571428,1,0.0,0,1,0,1,2,0,0,3,1,2,6,1
2595,38386,MAkHN0TS4uaTPgKLso4eQ3LTCDiU28De,A3fsA9Zfv1X2fVEQhTw51lKENdNrEqT3,5,2,1,0,1,0,7,0,11,1.5714285714285714,2,0.0,0,1,0,1,2,0,0,7,0,2,9,1
2596,38396,4hVUUGEGYiw6Bdgp8UlEBQC8ko8eVYqV,G8EPVSXsOYB5YQWZGiz1aVq5Pgr2GrQu,10,17,1,6,1,0,2,0,27,3.857142857142857,2,0.0,6,1,4,1,11,0,2,2,0,12,15,1
2597,38414,sDWigCKujHowENc4QsnIRZ8UQl2larGF,RXDvfPUBYFlVdlueBFbLW0mhhAyGEqpt,6,9,2,0,1,0,1,0,13,1.8571428571428572,1,0.0,1,2,0,1,8,0,0,1,0,4,9,1
2598,38416,3koO9aMoYp8zzErC814zevxBi6TaaAOF,SpATywNh6bZuzm8s1ceuBUnMUAeoAHHw,27,35,14,43,4,43,17,8,164,23.428571428571427,3,0.0,11,14,35,4,24,43,8,17,8,64,100,0
2599,38436,v9mjKPlqj9n2M1xFKzFtpQVo3yi6HxGV,A3fsA9Zfv1X2fVEQhTw51lKENdNrEqT3,32,59,35,54,17,1,14,0,180,25.714285714285715,4,0.0,9,35,43,17,50,1,11,14,0,104,76,1
2600,38441,iwk5jwRoUXpb7apwoAzA2sr9pA9dpqVB,bWdj2GDclj5ofokWjzoa5jAwMkxCykd6,2,0,0,0,0,0,6,0,6,0.8571428571428571,2,0.0,0,0,0,0,0,0,0,6,0,0,6,1
2601,38442,r6bvKJ2a2G72TbQZE3LacWwmKi7rGXEx,G8EPVSXsOYB5YQWZGiz1aVq5Pgr2GrQu,8,11,3,0,3,0,2,0,19,2.7142857142857144,1,0.0,0,3,0,3,11,0,0,2,0,6,13,1
2602,38444,hBkBlAVjz5BY7zZnohogA0eA3ndLKNkg,SpATywNh6bZuzm8s1ceuBUnMUAeoAHHw,32,61,27,30,8,8,29,3,166,23.714285714285715,4,0.0,18,27,28,8,43,8,2,29,3,81,85,1
2603,38462,VUqbVeGCU5BsVYNffcOAJ9BDqeO65P9U,G8EPVSXsOYB5YQWZGiz1aVq5Pgr2GrQu,34,9,6,126,3,9,8,1,162,23.142857142857142,1,0.0,0,6,105,3,9,9,21,8,1,114,48,1
2604,38468,SHRanMph56qnHJKMofxrIA8VyLg99gvL,SpATywNh6bZuzm8s1ceuBUnMUAeoAHHw,16,57,25,12,11,3,35,0,143,20.428571428571427,9,0.0,9,25,10,11,48,3,2,35,0,55,88,0
2605,38469,kOr03XnYLBaytLqdfTXgh6ll5b7wmEto,SpATywNh6bZuzm8s1ceuBUnMUAeoAHHw,23,29,13,36,3,17,9,1,108,15.428571428571429,5,0.0,12,13,30,3,17,17,6,9,1,58,50,0
2606,38478,wYSxpzhDGDxqe5tb8zcGOA1V0q1ivqUs,SpATywNh6bZuzm8s1ceuBUnMUAeoAHHw,9,14,5,0,2,0,2,0,23,3.2857142857142856,1,0.0,8,5,0,2,6,0,0,2,0,15,8,1
2607,38487,G9YOnYlxMjTyBQskKi3FlOCiDMxWpomt,SpATywNh6bZuzm8s1ceuBUnMUAeoAHHw,18,22,10,5,6,0,3,0,46,6.571428571428571,2,0.0,1,10,4,6,21,0,1,3,0,21,25,1
2608,38491,UEGgGFOddxp081siu8g5s2awm2LAgg2C,SpATywNh6bZuzm8s1ceuBUnMUAeoAHHw,12,19,0,8,0,0,5,0,32,4.571428571428571,2,0.0,7,0,7,0,12,0,1,5,0,14,18,0
2609,38510,OsVYZ2chBGfS6TvOshYA5qBASHIKNM7Z,SpATywNh6bZuzm8s1ceuBUnMUAeoAHHw,18,26,15,16,6,35,14,2,114,16.285714285714285,4,0.0,2,15,14,6,24,35,2,14,2,37,77,1
2610,38516,5zW7QL5PVg4tmiZ3UmDwoFtZ0u1EHg1C,G8EPVSXsOYB5YQWZGiz1aVq5Pgr2GrQu,1,0,0,0,0,0,1,0,1,0.14285714285714285,1,0.0,0,0,0,0,0,0,0,1,0,0,1,1
2611,38521,WRiHtWJX61VUGyAGQFSHJ3czdrgqxeQW,G8EPVSXsOYB5YQWZGiz1aVq5Pgr2GrQu,4,3,1,0,0,2,7,0,13,1.8571428571428572,6,0.0,0,1,0,0,3,2,0,7,0,1,12,1
2612,38524,0utD2vP6cBRtrip5Htxbgl8CGlMSWQLX,SpATywNh6bZuzm8s1ceuBUnMUAeoAHHw,6,1,1,0,1,2,5,0,10,1.4285714285714286,3,0.0,0,1,0,1,1,2,0,5,0,2,8,1
2613,38533,pqUcxq00SFcjmnxHDdHJfvpMD3HzyhM8,A3fsA9Zfv1X2fVEQhTw51lKENdNrEqT3,12,22,12,0,3,2,9,0,48,6.857142857142857,11,0.0,0,12,0,3,22,2,0,9,0,15,33,0
2614,38542,kzXC5gLwxzrAZMym3dLm7LbQsy5flpkC,SpATywNh6bZuzm8s1ceuBUnMUAeoAHHw,1,0,0,0,0,0,1,0,1,0.14285714285714285,1,0.0,0,0,0,0,0,0,0,1,0,0,1,1
2615,38559,fd1NhQTFxl8TsBhiRc4F6bEwrFxQh7qC,bWdj2GDclj5ofokWjzoa5jAwMkxCykd6,5,2,1,0,1,0,2,0,6,0.8571428571428571,1,0.0,0,1,0,1,2,0,0,2,0,2,4,1
2616,38560,op5Oi3uTeIRoABlsMVgAwjAoITQ3GmAH,SpATywNh6bZuzm8s1ceuBUnMUAeoAHHw,23,41,16,15,7,0,13,0,92,13.142857142857142,5,0.0,12,16,13,7,29,0,2,13,0,48,44,1
2617,38566,LU9kxt8aKnlOn8SnA2EuX2MLajf5Sg2a,A3fsA9Zfv1X2fVEQhTw51lKENdNrEqT3,9,5,2,0,3,0,2,0,12,1.7142857142857142,1,0.0,1,2,0,3,4,0,0,2,0,6,6,1
2618,38569,5Rbvag4nzKt7RfTqiThTliUWaR0ZVWak,RXDvfPUBYFlVdlueBFbLW0mhhAyGEqpt,29,32,25,29,12,21,20,17,156,22.285714285714285,3,0.0,3,25,27,12,29,21,2,20,17,67,89,1
2619,38603,BK89tGWFvtCB5b9BaDDNxW929HW7wR4P,G8EPVSXsOYB5YQWZGiz1aVq5Pgr2GrQu,20,24,11,8,8,0,4,0,55,7.857142857142857,6,0.0,5,11,5,8,19,0,3,4,0,29,26,0
2620,38604,piuFZPcLrtqUCR4Mz7Dvqp0k5ELkq8NC,G8EPVSXsOYB5YQWZGiz1aVq5Pgr2GrQu,12,16,10,0,9,0,6,0,41,5.857142857142857,2,0.0,3,10,0,9,13,0,0,6,0,22,19,1
2621,38608,J0IJ83RVowrJWkvIAkcS1VNIhpCHoyob,A3fsA9Zfv1X2fVEQhTw51lKENdNrEqT3,5,1,1,0,1,0,2,0,5,0.7142857142857143,1,0.0,0,1,0,1,1,0,0,2,0,2,3,1
2622,38624,1eeJGwVZl6tkgP8o5hxfgeveRzoyzGC1,SpATywNh6bZuzm8s1ceuBUnMUAeoAHHw,17,12,7,10,3,5,5,1,43,6.142857142857143,2,0.0,2,7,8,3,10,5,2,5,1,20,23,1
2623,38626,vmk0Cb97y6KFP4NN2aQejQh8kNwAKs9K,SpATywNh6bZuzm8s1ceuBUnMUAeoAHHw,5,5,0,0,0,0,2,0,7,1.0,2,0.0,0,0,0,0,5,0,0,2,0,0,7,1
2624,38648,74izHUTVIKwdbm5ACRGoK7PWOEfmZhU5,bWdj2GDclj5ofokWjzoa5jAwMkxCykd6,6,4,2,10,1,0,1,0,18,2.5714285714285716,1,0.0,1,2,9,1,3,0,1,1,0,13,5,0
2625,38650,k1hHR6rkUwES1hOj6qPmM0zEpPF3eP6v,SpATywNh6bZuzm8s1ceuBUnMUAeoAHHw,7,4,3,0,3,0,2,0,12,1.7142857142857142,1,0.0,0,3,0,3,4,0,0,2,0,6,6,1
2626,38654,wJIBDD9rPqnYMIKUazC26GmZhLI0Mfvr,RXDvfPUBYFlVdlueBFbLW0mhhAyGEqpt,30,49,27,0,17,12,19,3,127,18.142857142857142,7,0.0,9,27,0,17,40,12,0,19,3,53,74,1
2627,38678,TZQB6KsadY5lwvd9JKuw3u0s2cwQm2RY,A3fsA9Zfv1X2fVEQhTw51lKENdNrEqT3,1,0,0,0,0,0,1,0,1,0.14285714285714285,1,0.0,0,0,0,0,0,0,0,1,0,0,1,1
2628,38683,7uDVcwukNss0paMtTOJXNPZUXWP9vYuG,A3fsA9Zfv1X2fVEQhTw51lKENdNrEqT3,5,2,1,0,1,0,2,0,6,0.8571428571428571,1,0.0,0,1,0,1,2,0,0,2,0,2,4,1
2629,38686,pNgLScEwGgq81vg0a0cEXKNs5eG2UXph,A3fsA9Zfv1X2fVEQhTw51lKENdNrEqT3,57,36,19,112,11,9,11,1,199,28.428571428571427,4,0.0,4,19,112,11,32,9,0,11,1,146,53,1
2630,38691,dCqryZS5yEyDDbYzWpFyoRjFGlVzafA6,SpATywNh6bZuzm8s1ceuBUnMUAeoAHHw,23,50,25,5,10,0,8,0,98,14.0,6,0.0,14,25,4,10,36,0,1,8,0,53,45,0
2631,38701,E4KzNEU3ybRlAOiHqHHsGQEXiaxyHgoT,RXDvfPUBYFlVdlueBFbLW0mhhAyGEqpt,62,83,39,151,24,34,26,19,376,53.714285714285715,6,0.0,31,39,136,24,52,34,15,26,19,230,146,0
2632,38718,KtiXcHNNiby4TrKgvBuU25mstwPooCPe,SpATywNh6bZuzm8s1ceuBUnMUAeoAHHw,16,24,7,16,3,0,5,0,55,7.857142857142857,2,0.0,14,7,14,3,10,0,2,5,0,38,17,1
2633,38728,afat5vUgkwgUU0apBrv11YGTyd4OwYTu,SpATywNh6bZuzm8s1ceuBUnMUAeoAHHw,4,0,0,0,0,1,3,0,4,0.5714285714285714,1,0.0,0,0,0,0,0,1,0,3,0,0,4,1
2634,38737,afat5vUgkwgUU0apBrv11YGTyd4OwYTu,A3fsA9Zfv1X2fVEQhTw51lKENdNrEqT3,2,0,0,0,0,0,2,0,2,0.2857142857142857,1,0.0,0,0,0,0,0,0,0,2,0,0,2,1
2635,38739,nPRsjektHdbQkeAf1fIK4JbhrESPbPsA,A3fsA9Zfv1X2fVEQhTw51lKENdNrEqT3,5,4,0,0,0,21,3,0,28,4.0,2,0.0,0,0,0,0,4,21,0,3,0,0,28,1
2636,38742,0kgVI4xJnG62oDVcCEoC6XWb9EsWLjc0,bWdj2GDclj5ofokWjzoa5jAwMkxCykd6,1,0,0,0,0,0,1,0,1,0.14285714285714285,1,0.0,0,0,0,0,0,0,0,1,0,0,1,1
2637,38763,8YWaMVS3w7XpLYfFIo5KA8X2u5rBj2lm,bWdj2GDclj5ofokWjzoa5jAwMkxCykd6,1,0,0,0,0,0,1,0,1,0.14285714285714285,1,0.0,0,0,0,0,0,0,0,1,0,0,1,1
2638,38768,7mwJyfao5KIX49E5WhJbQSfLSpyhsypU,SpATywNh6bZuzm8s1ceuBUnMUAeoAHHw,2,0,0,0,0,0,2,0,2,0.2857142857142857,1,0.0,0,0,0,0,0,0,0,2,0,0,2,1
2639,38796,krjhlLET7SMyK6bykccAT1LqXqo0aBBB,A3fsA9Zfv1X2fVEQhTw51lKENdNrEqT3,1,0,0,0,0,0,1,0,1,0.14285714285714285,1,0.0,0,0,0,0,0,0,0,1,0,0,1,1
2640,38799,RzMIvT7jMzqf1FBzeYDC0G8NjaFmpbg8,SpATywNh6bZuzm8s1ceuBUnMUAeoAHHw,9,9,7,0,6,0,2,0,24,3.4285714285714284,2,0.0,0,7,0,6,9,0,0,2,0,13,11,0
2641,38828,RtAy5lws7b5k9geORbL2U1lmgZpp3fVx,SpATywNh6bZuzm8s1ceuBUnMUAeoAHHw,9,13,1,0,1,0,8,0,23,3.2857142857142856,2,0.0,0,1,0,1,13,0,0,8,0,2,21,1
2642,38840,cXYtpsZ2fQmsdTOBAQ6nuO3uUXQTXgSe,SpATywNh6bZuzm8s1ceuBUnMUAeoAHHw,2,0,0,0,0,0,2,0,2,0.2857142857142857,1,0.0,0,0,0,0,0,0,0,2,0,0,2,1
2643,38845,BuxVbSmnOVgkaYnbyCiqICvSSomeF2JH,G8EPVSXsOYB5YQWZGiz1aVq5Pgr2GrQu,12,16,1,2,1,2,10,0,32,4.571428571428571,2,0.0,1,1,1,1,15,2,1,10,0,4,28,1
2644,38854,Xi85gYtmIKPj1CmvXveeSMqfVqnWSguE,bWdj2GDclj5ofokWjzoa5jAwMkxCykd6,8,9,6,0,3,50,9,0,77,11.0,5,0.0,0,6,0,3,9,50,0,9,0,9,68,0
2645,38855,uEJhWNudTN4AiJAcLu3Q22sgnPRHYbuv,G8EPVSXsOYB5YQWZGiz1aVq5Pgr2GrQu,129,278,110,154,65,2,42,2,653,93.28571428571429,10,0.0,55,110,139,65,223,2,15,42,2,369,284,0
2646,38857,9803qM4isShkjkoVAPID7DQVAjFPwCDe,A3fsA9Zfv1X2fVEQhTw51lKENdNrEqT3,2,0,0,0,0,0,8,0,8,1.1428571428571428,2,0.0,0,0,0,0,0,0,0,8,0,0,8,1
2647,38870,jaeRBfNSkyTpFxAZieHe5vTAkzlHFDmm,A3fsA9Zfv1X2fVEQhTw51lKENdNrEqT3,61,61,36,176,7,19,19,1,319,45.57142857142857,3,0.0,6,36,148,7,55,19,28,19,1,197,122,1
2648,38878,gSi0VgWgYBTsmYmeH4PYrjNlMDLA1S2c,SpATywNh6bZuzm8s1ceuBUnMUAeoAHHw,12,14,1,7,3,1,7,3,36,5.142857142857143,2,0.0,2,1,6,3,12,1,1,7,3,12,24,1
2649,38882,KbRlzY47exomwt4drbIiBF6s4vNevAUk,bWdj2GDclj5ofokWjzoa5jAwMkxCykd6,8,5,4,0,3,0,1,0,13,1.8571428571428572,1,0.0,0,4,0,3,5,0,0,1,0,7,6,1
2650,38894,lxM1uzj9RbEKW6MEHQHbWmFRP8lCwFlm,RXDvfPUBYFlVdlueBFbLW0mhhAyGEqpt,5,2,1,0,1,0,2,0,6,0.8571428571428571,1,0.0,0,1,0,1,2,0,0,2,0,2,4,1
2651,38899,uOTUidrDT0SJfarFY02mqsETfS65OeG7,SpATywNh6bZuzm8s1ceuBUnMUAeoAHHw,1,0,0,0,0,0,1,0,1,0.14285714285714285,1,0.0,0,0,0,0,0,0,0,1,0,0,1,1
2652,38905,Zfldpr4XdX0KviQz44l3WyKQ1DUv2CZO,bWdj2GDclj5ofokWjzoa5jAwMkxCykd6,5,2,1,0,1,0,4,0,8,1.1428571428571428,2,0.0,0,1,0,1,2,0,0,4,0,2,6,1
2653,38907,arTGhRrKZksM4iY72XDJ8i8oBmMABS0m,bWdj2GDclj5ofokWjzoa5jAwMkxCykd6,8,6,1,0,0,1,5,1,14,2.0,2,0.0,0,1,0,0,6,1,0,5,1,1,13,1
2654,38920,0a9a6o0rpJD7kzJZwGRL9kB3jevQvRa8,SpATywNh6bZuzm8s1ceuBUnMUAeoAHHw,22,42,1,34,0,4,32,4,117,16.714285714285715,6,0.0,12,1,26,0,30,4,8,32,4,39,78,0
2655,38935,Bv9FSXvHlE6wLC4E4yrAKqe3BQhrrtfx,bWdj2GDclj5ofokWjzoa5jAwMkxCykd6,11,16,0,40,1,0,4,0,61,8.714285714285714,2,0.0,5,0,39,1,11,0,1,4,0,45,16,1
2656,38949,7HiGv3GGo0SXqM9pqC4B8FvUEghdfkna,A3fsA9Zfv1X2fVEQhTw51lKENdNrEqT3,74,79,33,168,19,4,37,0,340,48.57142857142857,9,0.0,5,33,144,19,74,4,24,37,0,201,139,0
2657,38975,pYuNHmli0QywI9Z1zHRuk8HH63MuG9ox,SpATywNh6bZuzm8s1ceuBUnMUAeoAHHw,7,4,3,0,1,0,2,0,10,1.4285714285714286,1,0.0,0,3,0,1,4,0,0,2,0,4,6,1
2658,38998,GxuI91smqBqnZvedxTapokE0d2tIuvjB,SpATywNh6bZuzm8s1ceuBUnMUAeoAHHw,11,12,1,16,0,0,3,1,33,4.714285714285714,1,0.0,5,1,14,0,7,0,2,3,1,20,13,1
2659,39003,kdrVEJc2I4GXXrnMfkE91hbE8pwDL5M5,SpATywNh6bZuzm8s1ceuBUnMUAeoAHHw,16,16,2,9,2,0,5,1,35,5.0,2,0.0,2,2,9,2,14,0,0,5,1,15,20,0
2660,39004,v74bXrlUV6ca8Hla1JfufyayJvtXjR7H,SpATywNh6bZuzm8s1ceuBUnMUAeoAHHw,6,3,1,0,1,0,2,0,7,1.0,1,0.0,0,1,0,1,3,0,0,2,0,2,5,1
2661,39023,t66hZYQIW0VPLqiRabyUSn9c1rXaD96i,G8EPVSXsOYB5YQWZGiz1aVq5Pgr2GrQu,10,13,5,0,6,0,6,1,31,4.428571428571429,2,0.0,6,5,0,6,7,0,0,6,1,17,14,1
2662,39030,sUk3OLEiiNZtlo4krMYRLjkp5xwgbsPl,RXDvfPUBYFlVdlueBFbLW0mhhAyGEqpt,1,0,0,0,0,0,1,0,1,0.14285714285714285,1,0.0,0,0,0,0,0,0,0,1,0,0,1,1
2663,39031,3aJcxnpBDknIFELx5q7A1ed9nLB6csNj,A3fsA9Zfv1X2fVEQhTw51lKENdNrEqT3,8,4,3,0,3,0,1,0,11,1.5714285714285714,1,0.0,0,3,0,3,4,0,0,1,0,6,5,1
2664,39056,T4lMOZ9NGQ0RS4ue5IeZuDcW1ySIGZ9u,bWdj2GDclj5ofokWjzoa5jAwMkxCykd6,19,14,5,74,3,3,7,1,107,15.285714285714286,2,0.0,4,5,67,3,10,3,7,7,1,79,28,1
2665,39075,XyYnnl4AI9tScnU7RGEEZZNUDhUKeoxB,SpATywNh6bZuzm8s1ceuBUnMUAeoAHHw,4,3,2,0,1,0,3,0,9,1.2857142857142858,1,0.0,0,2,0,1,3,0,0,3,0,3,6,1
2666,39081,blQFA8HzhNQeb8MMYJXyJW6sPMdvZQKn,SpATywNh6bZuzm8s1ceuBUnMUAeoAHHw,13,14,5,6,4,1,1,0,31,4.428571428571429,1,0.0,8,5,6,4,6,1,0,1,0,23,8,1
2667,39083,1r2nGZGkg8GEqN3RApjS0ItoQ0nF4xaw,SpATywNh6bZuzm8s1ceuBUnMUAeoAHHw,1,0,0,0,0,0,2,0,2,0.2857142857142857,2,0.0,0,0,0,0,0,0,0,2,0,0,2,1
2668,39088,UvSPzXNBScAU9ByvT8o3qVBXbi67b3h8,G8EPVSXsOYB5YQWZGiz1aVq5Pgr2GrQu,5,5,1,0,1,0,1,0,8,1.1428571428571428,1,0.0,0,1,0,1,5,0,0,1,0,2,6,1
2669,39091,CJISoHtkGNnkB0CRrvBDw2uUj4sPNv5j,bWdj2GDclj5ofokWjzoa5jAwMkxCykd6,5,8,1,0,0,0,3,0,12,1.7142857142857142,3,0.0,0,1,0,0,8,0,0,3,0,1,11,1
2670,39095,Lc5TZPB93C58CDuO8VjF5g6g9boxDaHr,SpATywNh6bZuzm8s1ceuBUnMUAeoAHHw,36,84,3,53,1,62,29,2,234,33.42857142857143,4,0.0,20,3,47,1,64,62,6,29,2,71,163,1
2671,39098,N1NANPOEzVcSgsnoCvLHz8IcJu1p6TeM,bWdj2GDclj5ofokWjzoa5jAwMkxCykd6,1,0,0,0,0,0,1,0,1,0.14285714285714285,1,0.0,0,0,0,0,0,0,0,1,0,0,1,1
2672,39114,2nqqGgbA0MihvBXBZoRijk6wA6yRTkC8,SpATywNh6bZuzm8s1ceuBUnMUAeoAHHw,44,95,50,37,21,70,18,1,292,41.714285714285715,11,0.0,9,50,33,21,86,70,4,18,1,113,179,1
2673,39121,UflKWNcvi2MA5nN1C1yYIrKHClWLnxXf,SpATywNh6bZuzm8s1ceuBUnMUAeoAHHw,3,0,0,0,0,7,3,0,10,1.4285714285714286,2,0.0,0,0,0,0,0,7,0,3,0,0,10,1
2674,39134,wjTC7wnlKcnUR3GStNksYXKWSSmG8wiR,SpATywNh6bZuzm8s1ceuBUnMUAeoAHHw,28,37,21,28,10,1,14,1,112,16.0,2,0.0,11,21,25,10,26,1,3,14,1,67,45,1
2675,39140,zVX5LPwTGC1SEitxSfv31cubNXKJSEc2,SpATywNh6bZuzm8s1ceuBUnMUAeoAHHw,12,8,4,28,0,0,14,0,54,7.714285714285714,4,0.0,4,4,26,0,4,0,2,14,0,34,20,0
2676,39141,ILzL3Mkktf2JWNBXHKy152QukNojyWoV,SpATywNh6bZuzm8s1ceuBUnMUAeoAHHw,14,10,5,0,3,0,7,0,25,3.5714285714285716,2,0.0,0,5,0,3,10,0,0,7,0,8,17,1
2677,39145,AVMp8F9T45cyhHDRnad5d9bxFkDP4PTv,bWdj2GDclj5ofokWjzoa5jAwMkxCykd6,1,0,0,0,0,0,1,0,1,0.14285714285714285,1,0.0,0,0,0,0,0,0,0,1,0,0,1,1
2678,39149,4UqKAySXvYrQJCWmxoUDAB7q5gWLAioi,SpATywNh6bZuzm8s1ceuBUnMUAeoAHHw,5,2,1,0,1,0,2,0,6,0.8571428571428571,1,0.0,0,1,0,1,2,0,0,2,0,2,4,1
2679,39154,BGVVwabO5K2aC65VwhxWT01Y18m3Nzj6,SpATywNh6bZuzm8s1ceuBUnMUAeoAHHw,43,126,3,37,4,130,22,15,337,48.142857142857146,6,0.0,22,3,33,4,104,130,4,22,15,62,275,0
2680,39157,1NMKv7RE12uBMKwNJI30Cx8Z5ltMGoee,RXDvfPUBYFlVdlueBFbLW0mhhAyGEqpt,1,0,0,0,0,0,1,0,1,0.14285714285714285,1,0.0,0,0,0,0,0,0,0,1,0,0,1,1
2681,39164,7GjcmlDBrfMQgiPOO8hsiYQuQLOINerQ,SpATywNh6bZuzm8s1ceuBUnMUAeoAHHw,32,57,26,32,9,0,12,0,136,19.428571428571427,6,0.0,21,26,28,9,36,0,4,12,0,84,52,0
2682,39173,ZzLLcAQUfjtXFFVyip2u00anhVLGCjVt,SpATywNh6bZuzm8s1ceuBUnMUAeoAHHw,6,3,1,0,1,0,2,0,7,1.0,1,0.0,0,1,0,1,3,0,0,2,0,2,5,1
2683,39177,HzHckETSltPKPBe9aHJBFKMPGsxyznRF,RXDvfPUBYFlVdlueBFbLW0mhhAyGEqpt,105,189,111,291,64,29,29,0,713,101.85714285714286,10,0.0,56,111,261,64,133,29,30,29,0,492,221,0
2684,39195,E4KzNEU3ybRlAOiHqHHsGQEXiaxyHgoT,G8EPVSXsOYB5YQWZGiz1aVq5Pgr2GrQu,43,85,30,110,16,3,11,0,255,36.42857142857143,4,0.0,47,30,76,16,38,3,34,11,0,169,86,0
2685,39200,mhEXeYR4fhAtV2BL9wCEhGJhQCxsqkvm,SpATywNh6bZuzm8s1ceuBUnMUAeoAHHw,10,8,3,0,5,0,11,0,27,3.857142857142857,1,0.0,5,3,0,5,3,0,0,11,0,13,14,1
2686,39228,46Kekotwda3n13NUXnmxT29j0BxeYz12,SpATywNh6bZuzm8s1ceuBUnMUAeoAHHw,5,2,1,0,1,0,2,0,6,0.8571428571428571,1,0.0,0,1,0,1,2,0,0,2,0,2,4,1
2687,39251,hmgBnYFDyZngu0mjeUhp0xYSYQ6O53Mz,SpATywNh6bZuzm8s1ceuBUnMUAeoAHHw,1,0,0,0,0,0,1,0,1,0.14285714285714285,1,0.0,0,0,0,0,0,0,0,1,0,0,1,1
2688,39253,eBPwvAxm4arXAr6DDABCeVRfgkKzrVG9,A3fsA9Zfv1X2fVEQhTw51lKENdNrEqT3,63,78,4,134,4,3,27,1,251,35.857142857142854,5,0.0,10,4,124,4,68,3,10,27,1,142,109,1
2689,39257,PATQ2JDuYcR1iRnRPNzs82w3vSQnScOh,A3fsA9Zfv1X2fVEQhTw51lKENdNrEqT3,1,0,0,0,0,0,1,0,1,0.14285714285714285,1,0.0,0,0,0,0,0,0,0,1,0,0,1,1
2690,39262,1w8EW76qmBSgQ2s8Jb4yoPsNX01KUcoD,SpATywNh6bZuzm8s1ceuBUnMUAeoAHHw,4,2,1,0,1,0,1,0,5,0.7142857142857143,1,0.0,0,1,0,1,2,0,0,1,0,2,3,1
2691,39271,MuWLBiVwYCkYNKOHYGJD8tH8opD9K24n,G8EPVSXsOYB5YQWZGiz1aVq5Pgr2GrQu,24,30,0,36,1,5,9,1,82,11.714285714285714,2,0.0,12,0,27,1,18,5,9,9,1,40,42,1
2692,39279,MbSy3vYucWpXbJ8XgmPxO6zrZOjC9oUB,SpATywNh6bZuzm8s1ceuBUnMUAeoAHHw,26,50,29,16,15,0,14,0,124,17.714285714285715,6,0.0,6,29,13,15,44,0,3,14,0,63,61,1
2693,39285,YqUtlfMe9rLKsCC9IaplFVEXt8vH7Xc8,SpATywNh6bZuzm8s1ceuBUnMUAeoAHHw,7,15,1,0,0,0,2,0,18,2.5714285714285716,1,0.0,4,1,0,0,11,0,0,2,0,5,13,1
2694,39321,zFmjJfAeKUvggwuYYEK06j1MuKf2V5Jp,G8EPVSXsOYB5YQWZGiz1aVq5Pgr2GrQu,8,2,1,0,1,0,5,1,10,1.4285714285714286,1,0.0,0,1,0,1,2,0,0,5,1,2,8,1
2695,39328,iJftBP3zncmjUCwGWSZ77IUrDb3Dt8rz,A3fsA9Zfv1X2fVEQhTw51lKENdNrEqT3,36,26,17,70,12,0,5,0,130,18.571428571428573,3,0.0,1,17,54,12,25,0,16,5,0,84,46,0
2696,39355,z3YnX73v2uoVHmuLGzQD2gKKBoJqIQxK,A3fsA9Zfv1X2fVEQhTw51lKENdNrEqT3,48,49,38,90,30,9,11,0,227,32.42857142857143,6,0.0,6,38,72,30,43,9,18,11,0,146,81,1
2697,39364,yl2extq9BiirsP1wIY2qyqtEIn2eAosn,A3fsA9Zfv1X2fVEQhTw51lKENdNrEqT3,12,15,7,0,1,2,8,1,34,4.857142857142857,1,0.0,1,7,0,1,14,2,0,8,1,9,25,1
2698,39369,nACUst6Z3nbYOefsNnWJBD4yiz9OCgPb,A3fsA9Zfv1X2fVEQhTw51lKENdNrEqT3,2,0,0,0,0,0,2,0,2,0.2857142857142857,1,0.0,0,0,0,0,0,0,0,2,0,0,2,1
2699,39386,xcD6YWhnGA2xukGmX4eaYrm6VS9ffz1H,A3fsA9Zfv1X2fVEQhTw51lKENdNrEqT3,1,0,0,0,0,0,1,0,1,0.14285714285714285,1,0.0,0,0,0,0,0,0,0,1,0,0,1,1
2700,39408,mC2fzvwPaO34Kq32ibCwzrJ2EjHwbRrb,A3fsA9Zfv1X2fVEQhTw51lKENdNrEqT3,23,63,34,0,23,0,12,1,133,19.0,3,0.0,0,34,0,23,63,0,0,12,1,57,76,1
2701,39416,NiOuJ51IxTtojHMts8OdX2AfCH09G7vK,SpATywNh6bZuzm8s1ceuBUnMUAeoAHHw,13,12,8,0,5,0,8,0,33,4.714285714285714,3,0.0,0,8,0,5,12,0,0,8,0,13,20,1
2702,39435,eOxm8XEI11Xs6eiBi1Nu5QzIagZXwEm9,A3fsA9Zfv1X2fVEQhTw51lKENdNrEqT3,1,0,0,0,0,0,1,0,1,0.14285714285714285,1,0.0,0,0,0,0,0,0,0,1,0,0,1,1
2703,39437,YaP2AuckukEZITP3IVvIt6Z8ci6RHew7,A3fsA9Zfv1X2fVEQhTw51lKENdNrEqT3,33,39,35,18,21,1,7,1,122,17.428571428571427,2,0.0,0,35,15,21,39,1,3,7,1,71,51,1
2704,39438,PCU2OsmEUaGQvWJWbob5pKb7iiPbQ7ze,SpATywNh6bZuzm8s1ceuBUnMUAeoAHHw,20,46,5,8,4,2,35,1,101,14.428571428571429,8,0.0,11,5,8,4,35,2,0,35,1,28,73,1
2705,39445,P8w9ro0HOkoKzPyzFHSnLuYXXRtV1BHH,RXDvfPUBYFlVdlueBFbLW0mhhAyGEqpt,15,25,11,0,6,0,5,0,47,6.714285714285714,2,0.0,0,11,0,6,25,0,0,5,0,17,30,1
2706,39461,6Trp4kpO6fwwtbebtvF77MGUNovs9zvp,SpATywNh6bZuzm8s1ceuBUnMUAeoAHHw,15,12,8,14,6,0,5,0,45,6.428571428571429,2,0.0,3,8,13,6,9,0,1,5,0,30,15,1
2707,39480,CFP5BToaLlKEM1IV3uFEyj5nP0RKpJGG,RXDvfPUBYFlVdlueBFbLW0mhhAyGEqpt,14,20,11,0,6,5,8,0,50,7.142857142857143,1,0.0,0,11,0,6,20,5,0,8,0,17,33,1
2708,39481,evkJ1tKmVFYbszWTpTeoBUR5H84hykAY,SpATywNh6bZuzm8s1ceuBUnMUAeoAHHw,13,38,10,13,2,2,15,0,80,11.428571428571429,4,0.0,11,10,10,2,27,2,3,15,0,33,47,0
2709,39493,Sw0laYN5mow6XiHfrWCJl4qnRcU0Nesb,SpATywNh6bZuzm8s1ceuBUnMUAeoAHHw,57,54,36,57,18,0,9,0,174,24.857142857142858,7,0.0,9,36,53,18,45,0,4,9,0,116,58,0
2710,39498,iVCEmNfeCwWMGAqNUnWf3L8wEjKUErLk,A3fsA9Zfv1X2fVEQhTw51lKENdNrEqT3,1,0,0,0,0,0,1,0,1,0.14285714285714285,1,0.0,0,0,0,0,0,0,0,1,0,0,1,1
2711,39518,jeuXS3tUDyyNfvbrveLA3P9Aday4J2bg,SpATywNh6bZuzm8s1ceuBUnMUAeoAHHw,42,43,24,37,13,0,12,0,129,18.428571428571427,7,0.0,7,24,36,13,36,0,1,12,0,80,49,0
2712,39521,KkCL9hhbl4No8xC8Kgerd95M1LSlSYMD,G8EPVSXsOYB5YQWZGiz1aVq5Pgr2GrQu,49,109,4,140,2,19,36,2,312,44.57142857142857,4,0.0,50,4,114,2,59,19,26,36,2,170,142,0
2713,39522,WMPYVFkG1npps8BU0n5fJtN4LOF8N9L7,A3fsA9Zfv1X2fVEQhTw51lKENdNrEqT3,1,0,0,0,0,0,1,0,1,0.14285714285714285,1,0.0,0,0,0,0,0,0,0,1,0,0,1,1
2714,39523,U2HBhhMvJdYJzypYvAaM7auP4hEAIFmE,SpATywNh6bZuzm8s1ceuBUnMUAeoAHHw,33,45,24,29,9,13,21,3,144,20.571428571428573,7,0.0,9,24,27,9,36,13,2,21,3,69,75,0
2715,39528,UPv4XJg0qIN0z1e32NPBqipWdQJZCo5I,G8EPVSXsOYB5YQWZGiz1aVq5Pgr2GrQu,163,267,182,337,78,0,91,3,958,136.85714285714286,16,0.0,26,182,279,78,241,0,58,91,3,565,393,0
2716,39531,ZicPLcC85bFypm3Kcvbq59RwoYBxR8MH,A3fsA9Zfv1X2fVEQhTw51lKENdNrEqT3,52,37,17,130,2,2,30,3,221,31.571428571428573,9,0.0,8,17,115,2,29,2,15,30,3,142,79,1
2717,39532,cULoH8ZJIqrdeB8ADfKnnQ8THzmbMgQV,RXDvfPUBYFlVdlueBFbLW0mhhAyGEqpt,1,0,0,0,0,0,1,0,1,0.14285714285714285,1,0.0,0,0,0,0,0,0,0,1,0,0,1,1
2718,39542,rVLakh088SHEy7dbxY22je6HzyBvqGMw,A3fsA9Zfv1X2fVEQhTw51lKENdNrEqT3,5,2,1,0,1,0,2,0,6,0.8571428571428571,1,0.0,0,1,0,1,2,0,0,2,0,2,4,1
2719,39551,iwZaMWnVmB8vAWyB7qgI9UDj7NG1VyL9,G8EPVSXsOYB5YQWZGiz1aVq5Pgr2GrQu,17,36,14,14,4,1,1,0,70,10.0,3,0.0,3,14,12,4,33,1,2,1,0,33,37,1
2720,39566,Tgv3JnuulONnAU5nEHKsBYsIQCqMFPi1,SpATywNh6bZuzm8s1ceuBUnMUAeoAHHw,14,29,4,22,2,0,5,0,62,8.857142857142858,2,0.0,8,4,18,2,21,0,4,5,0,32,30,1
2721,39591,fqudw8MOLcF9t0i6q2XPWF2TIejKMZHF,SpATywNh6bZuzm8s1ceuBUnMUAeoAHHw,7,3,2,0,2,0,2,0,9,1.2857142857142858,1,0.0,0,2,0,2,3,0,0,2,0,4,5,1
2722,39602,il53m0D8iMReEupAF0qvTcyM0rInz34F,bWdj2GDclj5ofokWjzoa5jAwMkxCykd6,6,2,1,0,1,0,3,0,7,1.0,1,0.0,0,1,0,1,2,0,0,3,0,2,5,1
2723,39603,BYn6cWVQSMORsIVShYVRAnnkHpLyiUv8,A3fsA9Zfv1X2fVEQhTw51lKENdNrEqT3,14,11,8,0,4,0,5,0,28,4.0,3,0.0,0,8,0,4,11,0,0,5,0,12,16,1
2724,39610,5JJq364DIcWk9Vho0reVJETDCFza3l8p,SpATywNh6bZuzm8s1ceuBUnMUAeoAHHw,17,37,13,13,4,8,14,0,89,12.714285714285714,4,0.0,17,13,11,4,20,8,2,14,0,45,44,1
2725,39635,xcD6YWhnGA2xukGmX4eaYrm6VS9ffz1H,SpATywNh6bZuzm8s1ceuBUnMUAeoAHHw,51,99,50,45,17,11,26,0,248,35.42857142857143,8,0.0,29,50,40,17,70,11,5,26,0,136,112,0
2726,39643,IueU0b60sjtimOacIi9j88xjmyRWizli,G8EPVSXsOYB5YQWZGiz1aVq5Pgr2GrQu,15,16,9,12,3,4,16,8,68,9.714285714285714,3,0.0,0,9,10,3,16,4,2,16,8,22,46,0
2727,39650,6FzXe5nPWUHRxntREHsQRnp7x1pxuhUz,SpATywNh6bZuzm8s1ceuBUnMUAeoAHHw,41,98,43,23,19,0,20,0,203,29.0,10,0.0,24,43,23,19,74,0,0,20,0,109,94,0
2728,39665,XZfHeQwgEwa34fwsEe2zig6GAMNgCcPL,SpATywNh6bZuzm8s1ceuBUnMUAeoAHHw,16,48,19,5,9,4,20,1,106,15.142857142857142,3,0.0,11,19,4,9,37,4,1,20,1,43,63,1
2729,39667,eSr3zMoztxzII0MHEvdbKbrYmBK0ecDT,SpATywNh6bZuzm8s1ceuBUnMUAeoAHHw,9,13,6,0,3,2,4,0,28,4.0,2,0.0,0,6,0,3,13,2,0,4,0,9,19,1
2730,39692,s8yyjhcg4BVOip4HSP4txOTTHFJ4aWPU,bWdj2GDclj5ofokWjzoa5jAwMkxCykd6,1,0,0,0,0,0,4,0,4,0.5714285714285714,2,0.0,0,0,0,0,0,0,0,4,0,0,4,1
2731,39696,yvSkslbVS47eGhtXe3MSajZNXyqoO8P1,SpATywNh6bZuzm8s1ceuBUnMUAeoAHHw,16,14,9,12,4,3,9,0,51,7.285714285714286,1,0.0,2,9,11,4,12,3,1,9,0,26,25,1
2732,39708,eHl6vKLwTQcSxYHb6DIMnO9xh3WNvHJf,SpATywNh6bZuzm8s1ceuBUnMUAeoAHHw,37,38,24,25,19,4,8,0,118,16.857142857142858,4,0.0,12,24,25,19,26,4,0,8,0,80,38,0
2733,39712,wVfyl6WgFur5urtfx8TypP7osjiRs72N,SpATywNh6bZuzm8s1ceuBUnMUAeoAHHw,6,3,0,0,0,5,3,0,11,1.5714285714285714,1,0.0,1,0,0,0,2,5,0,3,0,1,10,1
2734,39737,qRawfA1fPOcB5hZkORgH0hm8Ghubmgi1,A3fsA9Zfv1X2fVEQhTw51lKENdNrEqT3,9,9,1,0,1,5,4,0,20,2.857142857142857,2,0.0,0,1,0,1,9,5,0,4,0,2,18,0
2735,39748,Y6PIDel0N3JB5RPAU8dzX7ZliiFlTqHS,SpATywNh6bZuzm8s1ceuBUnMUAeoAHHw,10,15,0,0,0,2,9,0,26,3.7142857142857144,3,0.0,0,0,0,0,15,2,0,9,0,0,26,1
2736,39750,g6zfMiS5ibUHTabfgiFKHajbGLSVfwvj,SpATywNh6bZuzm8s1ceuBUnMUAeoAHHw,22,33,19,12,5,15,16,1,101,14.428571428571429,4,0.0,6,19,10,5,27,15,2,16,1,40,61,1
2737,39758,wIj7H8utbODHp6xu3FxVq3czUnyCOoPI,A3fsA9Zfv1X2fVEQhTw51lKENdNrEqT3,40,23,13,100,7,2,8,1,154,22.0,1,0.0,6,13,84,7,17,2,16,8,1,110,44,1
2738,39766,Bq3dgySLNxUfP2DnFVHYyEWwaDcd9ALN,A3fsA9Zfv1X2fVEQhTw51lKENdNrEqT3,33,28,20,0,14,0,6,0,68,9.714285714285714,5,0.0,0,20,0,14,28,0,0,6,0,34,34,1
2739,39785,LIcmzVFUc9QeLs85yNk05hYWndHHL2L3,A3fsA9Zfv1X2fVEQhTw51lKENdNrEqT3,10,6,5,0,5,0,4,2,22,3.142857142857143,1,0.0,0,5,0,5,6,0,0,4,2,10,12,1
2740,39793,suOeipVROVXXPGj0VZHJUUTxQ7mEMHZk,A3fsA9Zfv1X2fVEQhTw51lKENdNrEqT3,10,5,4,0,3,0,2,0,14,2.0,1,0.0,0,4,0,3,5,0,0,2,0,7,7,1
2741,39795,ePUeHwknBJGR0K3G08IRIZccLLyuYW03,SpATywNh6bZuzm8s1ceuBUnMUAeoAHHw,6,5,1,0,0,0,3,0,9,1.2857142857142858,2,0.0,0,1,0,0,5,0,0,3,0,1,8,1
2742,39803,VdNVtOVHu3uq36SFu7mu40diveL7bnVd,A3fsA9Zfv1X2fVEQhTw51lKENdNrEqT3,11,11,8,0,6,0,5,0,30,4.285714285714286,3,0.0,0,8,0,6,11,0,0,5,0,14,16,1
2743,39804,KSzd6DMLdMMhFe5tf0DcSjOsxB002C2u,SpATywNh6bZuzm8s1ceuBUnMUAeoAHHw,9,10,4,0,2,1,15,2,34,4.857142857142857,1,0.0,0,4,0,2,10,1,0,15,2,6,28,1
2744,39840,eTm1NthBlqTXH0yqAhllYK6AeYLcvZS4,SpATywNh6bZuzm8s1ceuBUnMUAeoAHHw,28,29,16,31,8,2,5,0,91,13.0,5,0.0,7,16,27,8,22,2,4,5,0,58,33,1
2745,39841,9BRoND09uAkQha4X7ED5IFkfUaItyWWP,SpATywNh6bZuzm8s1ceuBUnMUAeoAHHw,9,8,2,0,2,0,3,0,15,2.142857142857143,2,0.0,2,2,0,2,6,0,0,3,0,6,9,1
2746,39845,xwqLmgu4yZxUsX04FDtQMDL3awvB0E5w,SpATywNh6bZuzm8s1ceuBUnMUAeoAHHw,38,57,26,34,12,0,17,0,146,20.857142857142858,8,0.0,17,26,28,12,40,0,6,17,0,83,63,0
2747,39859,bgVZEKpin3FcOsrwuoniLCnRgCNbZTOm,G8EPVSXsOYB5YQWZGiz1aVq5Pgr2GrQu,17,21,16,30,8,0,4,0,79,11.285714285714286,3,0.0,0,16,24,8,21,0,6,4,0,48,31,1
2748,39878,pLB7K8hva7hpUpPIa0JWEXpoyBHIkbAO,SpATywNh6bZuzm8s1ceuBUnMUAeoAHHw,47,61,33,47,13,8,18,2,182,26.0,4,0.0,19,33,40,13,42,8,7,18,2,105,77,1
2749,39908,Ubjq3ZPvBATiaU1sX2JibbPoyNs9VBpQ,SpATywNh6bZuzm8s1ceuBUnMUAeoAHHw,1,0,0,0,0,0,1,0,1,0.14285714285714285,1,0.0,0,0,0,0,0,0,0,1,0,0,1,1
2750,39917,ElXKVW194Vk4gMqfG0BJNLqGRaVlSemx,bWdj2GDclj5ofokWjzoa5jAwMkxCykd6,1,0,0,0,0,0,1,0,1,0.14285714285714285,1,0.0,0,0,0,0,0,0,0,1,0,0,1,1
2751,39922,2GATpIfDBYFyTgYmFkr0bda9mVfNXuAl,SpATywNh6bZuzm8s1ceuBUnMUAeoAHHw,43,81,13,34,8,36,20,1,193,27.571428571428573,12,0.0,7,13,34,8,74,36,0,20,1,62,131,0
2752,39939,AVWcvCCDqAG8PgmRAI5YyxSBbxSiVsy5,SpATywNh6bZuzm8s1ceuBUnMUAeoAHHw,4,2,1,0,1,0,1,0,5,0.7142857142857143,1,0.0,0,1,0,1,2,0,0,1,0,2,3,1
2753,39942,ddMTOiTV5HSxEMNnjSDeiKLzuF1YmYcT,SpATywNh6bZuzm8s1ceuBUnMUAeoAHHw,4,3,2,0,0,0,1,0,6,0.8571428571428571,1,0.0,0,2,0,0,3,0,0,1,0,2,4,1
2754,39946,CkKaHAvtocTb1rem1r8BN1SLAQUDW1pY,bWdj2GDclj5ofokWjzoa5jAwMkxCykd6,6,1,1,0,1,1,4,0,8,1.1428571428571428,1,0.0,0,1,0,1,1,1,0,4,0,2,6,1
2755,39958,Peb8kjmFqGQvYDTvo4JTH8WhAEOnPF2h,SpATywNh6bZuzm8s1ceuBUnMUAeoAHHw,15,18,6,9,4,2,5,0,44,6.285714285714286,3,0.0,10,6,8,4,8,2,1,5,0,28,16,1
2756,39962,p3Cz4BAZGaZT08I2Dwew8OwWDC6PUWgc,SpATywNh6bZuzm8s1ceuBUnMUAeoAHHw,43,42,22,28,12,2,8,0,114,16.285714285714285,7,0.0,14,22,26,12,28,2,2,8,0,74,40,1
2757,39979,a3HtyjZsIXy0rlfdz7IVbfqFoPB13M3i,G8EPVSXsOYB5YQWZGiz1aVq5Pgr2GrQu,9,28,2,4,2,0,1,0,37,5.285714285714286,4,0.0,6,2,3,2,22,0,1,1,0,13,24,1
2758,39994,CFP5BToaLlKEM1IV3uFEyj5nP0RKpJGG,A3fsA9Zfv1X2fVEQhTw51lKENdNrEqT3,1,0,0,0,0,0,1,0,1,0.14285714285714285,1,0.0,0,0,0,0,0,0,0,1,0,0,1,1
2759,40026,JlRuZgjmv2hzO83ouspiZFc9FxGockFl,RXDvfPUBYFlVdlueBFbLW0mhhAyGEqpt,16,20,9,0,3,0,5,0,37,5.285714285714286,5,0.0,0,9,0,3,20,0,0,5,0,12,25,1
2760,40036,vUH5NhW2dOJJ7pGM4nFysRqnPlXzFZdY,SpATywNh6bZuzm8s1ceuBUnMUAeoAHHw,33,44,5,48,3,0,6,0,106,15.142857142857142,5,0.0,6,5,41,3,38,0,7,6,0,55,51,0
2761,40067,p2NSaI2ihMq1kpyPoZO7VVEhFNMs1UZl,G8EPVSXsOYB5YQWZGiz1aVq5Pgr2GrQu,62,57,1,354,2,8,20,1,443,63.285714285714285,3,0.0,21,1,294,2,36,8,60,20,1,318,125,0
2762,40073,gT1aUgmAT0anYSW9us4nwhFYETF9WL3j,bWdj2GDclj5ofokWjzoa5jAwMkxCykd6,5,3,1,0,1,0,3,0,8,1.1428571428571428,2,0.0,1,1,0,1,2,0,0,3,0,3,5,1
2763,40085,QWkN0K04zy6ocvNBygFS9V3b4yJPON6O,A3fsA9Zfv1X2fVEQhTw51lKENdNrEqT3,5,2,1,0,1,0,2,0,6,0.8571428571428571,2,0.0,0,1,0,1,2,0,0,2,0,2,4,1
2764,40097,Rf6xXor9EmVmU5Nrbaea2KpXMtqjkHJb,SpATywNh6bZuzm8s1ceuBUnMUAeoAHHw,24,32,15,22,9,4,4,0,86,12.285714285714286,2,0.0,5,15,18,9,27,4,4,4,0,47,39,0
2765,40105,D2f4XnvAFD8ZIkDvhpGbd6yCstJua9ut,G8EPVSXsOYB5YQWZGiz1aVq5Pgr2GrQu,1,0,0,0,0,0,1,0,1,0.14285714285714285,1,0.0,0,0,0,0,0,0,0,1,0,0,1,1
2766,40112,09EE7Mkw9FE0hqOEryjnyXTu6FbIkdRQ,SpATywNh6bZuzm8s1ceuBUnMUAeoAHHw,7,4,3,0,3,0,2,0,12,1.7142857142857142,2,0.0,0,3,0,3,4,0,0,2,0,6,6,1
2767,40123,KjOosnYqFuW1JYNSfMjuIU0UyjDNXuGi,SpATywNh6bZuzm8s1ceuBUnMUAeoAHHw,7,5,2,0,1,0,3,0,11,1.5714285714285714,2,0.0,1,2,0,1,4,0,0,3,0,4,7,1
2768,40125,znkDmOOvUgN8z7Q2bDidRTpqlGavufFM,SpATywNh6bZuzm8s1ceuBUnMUAeoAHHw,46,108,39,35,16,1,38,6,243,34.714285714285715,12,0.0,25,39,34,16,83,1,1,38,6,114,129,0
2769,40141,ysFko0fUHMpyKjTDsgomHFNCaIAr5cN9,A3fsA9Zfv1X2fVEQhTw51lKENdNrEqT3,1,0,0,0,0,0,1,0,1,0.14285714285714285,1,0.0,0,0,0,0,0,0,0,1,0,0,1,1
2770,40143,OZ02Yntpt8Hg8thsFgejT4NSsPYtVPPm,bWdj2GDclj5ofokWjzoa5jAwMkxCykd6,11,8,3,42,1,5,8,1,68,9.714285714285714,4,0.0,1,3,40,1,7,5,2,8,1,45,23,1
2771,40165,Vcn2Ncl6KVYaVVug7iW4LScBfpTMatic,RXDvfPUBYFlVdlueBFbLW0mhhAyGEqpt,13,27,1,0,1,4,16,1,50,7.142857142857143,4,0.0,5,1,0,1,22,4,0,16,1,7,43,1
2772,40178,JhXfd0Tlc69bJyZdJPZXaAHtjoBDG89W,A3fsA9Zfv1X2fVEQhTw51lKENdNrEqT3,33,88,6,14,4,1,32,1,146,20.857142857142858,9,0.0,5,6,10,4,83,1,4,32,1,25,121,0
2773,40185,abA1IbdNqvgGPTwvaYtddvUoLjzJEWlN,A3fsA9Zfv1X2fVEQhTw51lKENdNrEqT3,36,23,0,52,0,5,14,2,96,13.714285714285714,1,0.0,3,0,49,0,20,5,3,14,2,52,44,1
2774,40192,plUweHzNEQ6tYmm8ypkjZ9ZgEhzpu5iN,SpATywNh6bZuzm8s1ceuBUnMUAeoAHHw,14,14,7,12,3,0,4,0,40,5.714285714285714,2,0.0,2,7,9,3,12,0,3,4,0,21,19,1
2775,40195,8auKgQ1pXJtaAwUgQOq3AnlP8yJ8xKs8,SpATywNh6bZuzm8s1ceuBUnMUAeoAHHw,5,10,1,0,0,0,2,0,13,1.8571428571428572,2,0.0,0,1,0,0,10,0,0,2,0,1,12,1
2776,40206,5HnJOsNDqfUbmuHMu8iG6iEtOPev7Xxw,SpATywNh6bZuzm8s1ceuBUnMUAeoAHHw,6,3,1,0,1,0,3,0,8,1.1428571428571428,2,0.0,0,1,0,1,3,0,0,3,0,2,6,1
2777,40207,mVPS8qtXmBYw6oQCHhHlXYGOl1msXZRm,SpATywNh6bZuzm8s1ceuBUnMUAeoAHHw,27,35,15,30,6,0,9,0,95,13.571428571428571,3,0.0,7,15,27,6,28,0,3,9,0,55,40,1
2778,40208,5X4lGySxqBLFYnW7eAhu5WWLC7wvzcF3,A3fsA9Zfv1X2fVEQhTw51lKENdNrEqT3,39,33,15,72,11,0,1,0,132,18.857142857142858,1,0.0,1,15,63,11,32,0,9,1,0,90,42,1
2779,40223,cuLVLzIr2y459RDZRcVR3FYe8DHl8ZjT,SpATywNh6bZuzm8s1ceuBUnMUAeoAHHw,1,0,0,0,0,0,1,0,1,0.14285714285714285,1,0.0,0,0,0,0,0,0,0,1,0,0,1,1
2780,40224,sV3jtFrXfncSgh7Xsq4nWcxj42E0NrUb,SpATywNh6bZuzm8s1ceuBUnMUAeoAHHw,27,43,13,0,15,0,31,0,102,14.571428571428571,10,0.0,0,13,0,15,43,0,0,31,0,28,74,0
2781,40233,tBcWnrptNiGaZgy4k51BltzcKki801j1,bWdj2GDclj5ofokWjzoa5jAwMkxCykd6,1,0,0,0,0,0,1,0,1,0.14285714285714285,1,0.0,0,0,0,0,0,0,0,1,0,0,1,1
2782,40237,tBcWnrptNiGaZgy4k51BltzcKki801j1,A3fsA9Zfv1X2fVEQhTw51lKENdNrEqT3,1,0,0,0,0,0,2,0,2,0.2857142857142857,2,0.0,0,0,0,0,0,0,0,2,0,0,2,1
2783,40243,3LBUjm1FFFdQL8moOjwGZJaqcxdpVPTx,SpATywNh6bZuzm8s1ceuBUnMUAeoAHHw,12,19,2,0,2,4,10,0,37,5.285714285714286,3,0.0,6,2,0,2,13,4,0,10,0,10,27,1
2784,40258,vosTvFxoRyJk1cDtxUw2GTYeGEnrXcMJ,G8EPVSXsOYB5YQWZGiz1aVq5Pgr2GrQu,8,6,2,0,2,0,2,0,12,1.7142857142857142,1,0.0,0,2,0,2,6,0,0,2,0,4,8,0
2785,40272,FWTxDnNzcugqXGOfXWOseyRKl3gd7tL9,SpATywNh6bZuzm8s1ceuBUnMUAeoAHHw,13,21,3,0,2,0,4,0,30,4.285714285714286,2,0.0,0,3,0,2,21,0,0,4,0,5,25,0
2786,40287,O1a4fHzT6b5r4IWUDa3zddRbshvfRlE4,A3fsA9Zfv1X2fVEQhTw51lKENdNrEqT3,36,30,22,62,5,0,9,0,128,18.285714285714285,5,0.0,2,22,53,5,28,0,9,9,0,82,46,1
2787,40310,qp5IXQZrLJFd9bS1JJL98d9ZDAq70kXN,SpATywNh6bZuzm8s1ceuBUnMUAeoAHHw,15,25,7,29,4,0,2,0,67,9.571428571428571,1,0.0,14,7,23,4,11,0,6,2,0,48,19,1
2788,40317,5FLIDnIga6PY7pJGfcQdTEADTcQg0s9O,G8EPVSXsOYB5YQWZGiz1aVq5Pgr2GrQu,4,2,1,0,0,0,3,0,6,0.8571428571428571,1,0.0,0,1,0,0,2,0,0,3,0,1,5,1
2789,40326,0JjJbtKs8dmrQQZXRwO3ezBCv1FqT0mM,SpATywNh6bZuzm8s1ceuBUnMUAeoAHHw,5,2,1,0,1,0,2,0,6,0.8571428571428571,1,0.0,0,1,0,1,2,0,0,2,0,2,4,1
2790,40330,e8tjBT4TkBUZGDf1oULgV0xlcUpSchNd,SpATywNh6bZuzm8s1ceuBUnMUAeoAHHw,27,93,44,14,21,0,25,2,199,28.428571428571427,6,0.0,26,44,13,21,67,0,1,25,2,104,95,0
2791,40335,xLE9ZE3BmJvIiYogSmZ2Qwy8Pm6jvutZ,SpATywNh6bZuzm8s1ceuBUnMUAeoAHHw,26,60,3,41,1,10,34,1,150,21.428571428571427,8,0.0,22,3,34,1,38,10,7,34,1,60,90,0
2792,40338,xoJqrbCgOTk6mALoHnYupKuyUFnXAEAL,SpATywNh6bZuzm8s1ceuBUnMUAeoAHHw,13,19,1,28,0,1,4,0,53,7.571428571428571,1,0.0,13,1,20,0,6,1,8,4,0,34,19,1
2793,40347,cC2qlM5WjvVF4gXhZ3ctfElOjyJIEAhi,SpATywNh6bZuzm8s1ceuBUnMUAeoAHHw,19,32,14,15,6,17,17,1,102,14.571428571428571,6,0.0,12,14,12,6,20,17,3,17,1,44,58,1
2794,40370,wD600Vm6nYpRlm6dPdneFPtwC1POqb2E,A3fsA9Zfv1X2fVEQhTw51lKENdNrEqT3,1,0,0,0,0,0,1,0,1,0.14285714285714285,1,0.0,0,0,0,0,0,0,0,1,0,0,1,1
2795,40385,uuGoGterx4QfmHoDE6WqQfMDG8gm4WOd,SpATywNh6bZuzm8s1ceuBUnMUAeoAHHw,14,16,10,0,5,1,4,0,36,5.142857142857143,3,0.0,4,10,0,5,12,1,0,4,0,19,17,1
2796,40388,ZuoiR8ZSgQ4EIp0UPK1kvYAuneCl6lTF,G8EPVSXsOYB5YQWZGiz1aVq5Pgr2GrQu,18,23,4,24,4,0,1,0,56,8.0,1,0.0,18,4,13,4,5,0,11,1,0,39,17,1
2797,40392,zT5Abo7SNHsAkCFKMvhJJJDWNu2sl4mh,SpATywNh6bZuzm8s1ceuBUnMUAeoAHHw,25,57,16,26,4,3,36,1,143,20.428571428571427,9,0.0,14,16,24,4,43,3,2,36,1,58,85,0
2798,40395,55BMoXCnWKUmNoRDU7bcdmqWNuK9JpZ6,bWdj2GDclj5ofokWjzoa5jAwMkxCykd6,10,12,0,20,1,7,9,2,51,7.285714285714286,3,0.0,4,0,20,1,8,7,0,9,2,25,26,1
2799,40403,Anr82PPgHyVjFu2RaZRNpr3IKYwAUnAW,SpATywNh6bZuzm8s1ceuBUnMUAeoAHHw,8,18,10,0,4,0,5,0,37,5.285714285714286,3,0.0,0,10,0,4,18,0,0,5,0,14,23,1
2800,40410,lkFGShqBa18inWINppsv8Kl48gyf85dR,bWdj2GDclj5ofokWjzoa5jAwMkxCykd6,12,23,10,40,8,7,2,0,90,12.857142857142858,1,0.0,9,10,37,8,14,7,3,2,0,64,26,1
2801,40416,0Cx8S0i9vAPm7jZ8jXLUkrYp9xGpIHIS,bWdj2GDclj5ofokWjzoa5jAwMkxCykd6,4,6,3,0,0,3,4,0,16,2.2857142857142856,3,0.0,0,3,0,0,6,3,0,4,0,3,13,1
2802,40422,D35qeoxZpbN67fSLA7wfpVWpoAtTKXOD,SpATywNh6bZuzm8s1ceuBUnMUAeoAHHw,13,12,8,5,5,3,3,0,36,5.142857142857143,1,0.0,2,8,5,5,10,3,0,3,0,20,16,1
2803,40425,JuFQ1S3Curjho2OVO8cP3KLv8ROaeaOy,G8EPVSXsOYB5YQWZGiz1aVq5Pgr2GrQu,18,12,7,20,5,0,1,0,45,6.428571428571429,1,0.0,4,7,20,5,8,0,0,1,0,36,9,1
2804,40428,RSvPQSF8RarDsP4aI3ftScWWjvINqjc5,A3fsA9Zfv1X2fVEQhTw51lKENdNrEqT3,10,16,10,0,9,0,1,0,36,5.142857142857143,8,0.0,0,10,0,9,16,0,0,1,0,19,17,1
2805,40433,fVDgOkqeY2Y5uks1gBAvSdrqz781Wr7g,SpATywNh6bZuzm8s1ceuBUnMUAeoAHHw,7,8,4,0,3,0,4,0,19,2.7142857142857144,1,0.0,1,4,0,3,7,0,0,4,0,8,11,1
2806,40441,b11C6Y0UpRSFGpKvHTlz5TF2Rt9ScBoX,SpATywNh6bZuzm8s1ceuBUnMUAeoAHHw,13,18,7,20,1,0,21,3,70,10.0,6,0.0,9,7,16,1,9,0,4,21,3,33,37,0
2807,40462,9hqCAq1z2NOCYAE7PjnGwKxGA9KHvl0W,A3fsA9Zfv1X2fVEQhTw51lKENdNrEqT3,11,7,0,0,0,2,8,1,18,2.5714285714285716,2,0.0,0,0,0,0,7,2,0,8,1,0,18,1
2808,40502,PzBfPYmnOZYwUEXwnCaNraevSYiEicsw,G8EPVSXsOYB5YQWZGiz1aVq5Pgr2GrQu,16,25,6,18,1,5,19,4,78,11.142857142857142,2,0.0,7,6,13,1,18,5,5,19,4,27,51,1
2809,40509,Hz1gD3xapoX9NB1k77xvttI5SLCsWFqX,A3fsA9Zfv1X2fVEQhTw51lKENdNrEqT3,5,3,1,0,0,1,3,0,8,1.1428571428571428,1,0.0,0,1,0,0,3,1,0,3,0,1,7,1
2810,40537,KUjjznPFpWdBg0GS5p0fa4zyp2j0nULG,A3fsA9Zfv1X2fVEQhTw51lKENdNrEqT3,5,2,1,0,1,0,2,0,6,0.8571428571428571,1,0.0,0,1,0,1,2,0,0,2,0,2,4,1
2811,40584,mC2fzvwPaO34Kq32ibCwzrJ2EjHwbRrb,RXDvfPUBYFlVdlueBFbLW0mhhAyGEqpt,21,42,24,19,8,0,5,0,98,14.0,3,0.0,10,24,17,8,32,0,2,5,0,59,39,1
2812,40602,TxbcY6S66ftou9eniDMFpBcA0Q86cCVI,SpATywNh6bZuzm8s1ceuBUnMUAeoAHHw,1,0,0,0,0,0,1,0,1,0.14285714285714285,1,0.0,0,0,0,0,0,0,0,1,0,0,1,1
2813,40605,MiPYsLH8kYorLuTY5qJyDrWlYhyksO0w,bWdj2GDclj5ofokWjzoa5jAwMkxCykd6,1,0,0,0,0,0,1,0,1,0.14285714285714285,1,0.0,0,0,0,0,0,0,0,1,0,0,1,1
2814,40607,MiPYsLH8kYorLuTY5qJyDrWlYhyksO0w,A3fsA9Zfv1X2fVEQhTw51lKENdNrEqT3,15,21,1,2,1,0,13,0,38,5.428571428571429,2,0.0,0,1,2,1,21,0,0,13,0,4,34,1
2815,40643,4hVUUGEGYiw6Bdgp8UlEBQC8ko8eVYqV,SpATywNh6bZuzm8s1ceuBUnMUAeoAHHw,6,3,1,0,1,0,2,0,7,1.0,1,0.0,0,1,0,1,3,0,0,2,0,2,5,1
2816,40648,zUbaOnwFf34fsU2q7dIMt7fpEzRZebx6,SpATywNh6bZuzm8s1ceuBUnMUAeoAHHw,20,53,28,18,18,1,7,0,125,17.857142857142858,3,0.0,17,28,15,18,36,1,3,7,0,78,47,1
2817,40662,C1sQeK9WfNApOsknFeDtbZSozuem8vKZ,A3fsA9Zfv1X2fVEQhTw51lKENdNrEqT3,5,2,1,0,1,0,3,0,7,1.0,1,0.0,0,1,0,1,2,0,0,3,0,2,5,1
2818,40664,oGGlzK2ht4ljgfC5PRL55MAob4FKnRhp,bWdj2GDclj5ofokWjzoa5jAwMkxCykd6,2,0,0,0,0,0,2,0,2,0.2857142857142857,1,0.0,0,0,0,0,0,0,0,2,0,0,2,1
2819,40667,oGGlzK2ht4ljgfC5PRL55MAob4FKnRhp,A3fsA9Zfv1X2fVEQhTw51lKENdNrEqT3,2,0,0,0,0,0,2,0,2,0.2857142857142857,1,0.0,0,0,0,0,0,0,0,2,0,0,2,1
2820,40702,eulwUG3HQzG3rg0A6GIWynY1beyNKKbn,SpATywNh6bZuzm8s1ceuBUnMUAeoAHHw,13,23,9,13,6,0,4,0,55,7.857142857142857,3,0.0,3,9,11,6,20,0,2,4,0,29,26,1
2821,40704,qmYTrueiQKfoQnGxjqfwlMlw7HOR9CKj,bWdj2GDclj5ofokWjzoa5jAwMkxCykd6,8,19,7,0,0,13,29,2,70,10.0,8,0.0,0,7,0,0,19,13,0,29,2,7,63,0
2822,40726,Y4FZdizgCfP48VyOuflC2D2a2JpAW4dz,G8EPVSXsOYB5YQWZGiz1aVq5Pgr2GrQu,6,2,1,0,1,0,3,0,7,1.0,1,0.0,0,1,0,1,2,0,0,3,0,2,5,1
2823,40737,G9SE33A9SwXRkrAwDpEWoUsFMADETyBJ,SpATywNh6bZuzm8s1ceuBUnMUAeoAHHw,2,0,0,0,0,0,3,0,3,0.42857142857142855,1,0.0,0,0,0,0,0,0,0,3,0,0,3,1
2824,40746,l7T8dOWG1cEtOxAxVcD5zNV6vn1g4oYM,bWdj2GDclj5ofokWjzoa5jAwMkxCykd6,2,0,0,0,0,0,4,0,4,0.5714285714285714,2,0.0,0,0,0,0,0,0,0,4,0,0,4,1
2825,40749,1UUWIp3PiN0CT0O96IXxrt6TRVFJmFUz,A3fsA9Zfv1X2fVEQhTw51lKENdNrEqT3,7,1,0,0,0,2,9,2,14,2.0,1,0.0,0,0,0,0,1,2,0,9,2,0,14,1
2826,40761,1Pk7jZ6bfmKYXcNnRyEd7kPSZWAEJN0N,A3fsA9Zfv1X2fVEQhTw51lKENdNrEqT3,1,0,0,0,0,0,1,0,1,0.14285714285714285,1,0.0,0,0,0,0,0,0,0,1,0,0,1,1
2827,40768,NlHO5hXiy7TmVTHiRgExH6y7p9gJG1YF,SpATywNh6bZuzm8s1ceuBUnMUAeoAHHw,19,18,9,23,5,0,4,0,59,8.428571428571429,3,0.0,5,9,19,5,13,0,4,4,0,38,21,1
2828,40780,EO0fRulUc32LbMOOGfwwNWyNgnF8pKY9,RXDvfPUBYFlVdlueBFbLW0mhhAyGEqpt,39,50,30,51,16,3,20,5,175,25.0,5,0.0,12,30,43,16,38,3,8,20,5,101,74,1
2829,40782,eEl2lnEvtyQyZa1YqA2JcBHBfdkh8SHK,SpATywNh6bZuzm8s1ceuBUnMUAeoAHHw,11,22,4,0,2,0,9,0,37,5.285714285714286,5,0.0,1,4,0,2,21,0,0,9,0,7,30,1
2830,40802,DFKzgJXlXxnZVHESIM4fYC543XX9ZfDV,SpATywNh6bZuzm8s1ceuBUnMUAeoAHHw,12,12,8,0,4,0,7,0,31,4.428571428571429,5,0.0,0,8,0,4,12,0,0,7,0,12,19,1
2831,40823,BXn2aG9clWntQARvXpqDawWoxN1Iz4WO,A3fsA9Zfv1X2fVEQhTw51lKENdNrEqT3,20,27,13,0,8,0,7,0,55,7.857142857142857,4,0.0,0,13,0,8,27,0,0,7,0,21,34,1
2832,40824,0NGZq9HZW5KOrSfzSGGipuN20pCRDMWu,A3fsA9Zfv1X2fVEQhTw51lKENdNrEqT3,9,8,1,0,1,0,2,0,12,1.7142857142857142,1,0.0,0,1,0,1,8,0,0,2,0,2,10,1
2833,40835,pwTSmyT1ONwSAvUKrgRYh4Mr4sMKfCZD,SpATywNh6bZuzm8s1ceuBUnMUAeoAHHw,1,0,0,0,0,0,1,0,1,0.14285714285714285,1,0.0,0,0,0,0,0,0,0,1,0,0,1,1
2834,40857,9VkUnpQ2wwfpxrKU7ACzLosNtkitvYWk,bWdj2GDclj5ofokWjzoa5jAwMkxCykd6,9,14,0,62,0,3,2,0,81,11.571428571428571,3,0.0,3,0,58,0,11,3,4,2,0,61,20,1
2835,40867,rV9ZZTHmhxb84QCeG9gPkzE5xk42RTz0,SpATywNh6bZuzm8s1ceuBUnMUAeoAHHw,14,16,1,15,0,1,7,1,41,5.857142857142857,2,0.0,6,1,13,0,10,1,2,7,1,20,21,1
2836,40869,8gfCGxZ6lFjZr89RwPF8oXZs1Qn6Pq6X,A3fsA9Zfv1X2fVEQhTw51lKENdNrEqT3,27,5,4,78,0,0,12,0,99,14.142857142857142,5,0.0,1,4,69,0,4,0,9,12,0,74,25,1
2837,40896,o4j0NDzLh6XqpDKcvRg8Lx9N4HUYeTuP,RXDvfPUBYFlVdlueBFbLW0mhhAyGEqpt,1,0,0,0,0,0,1,0,1,0.14285714285714285,1,0.0,0,0,0,0,0,0,0,1,0,0,1,1
2838,40900,f6iCNPPMIJtA2FTvaT2H53upAxoDRLhb,SpATywNh6bZuzm8s1ceuBUnMUAeoAHHw,10,28,10,0,1,1,13,1,54,7.714285714285714,3,0.0,5,10,0,1,23,1,0,13,1,16,38,1
2839,40938,DJeWlgB4cP1RQ3JZLa1wZwd4zgAbYOxv,A3fsA9Zfv1X2fVEQhTw51lKENdNrEqT3,1,0,0,0,0,0,1,0,1,0.14285714285714285,1,0.0,0,0,0,0,0,0,0,1,0,0,1,1
2840,40940,qMeUlyVNhm3N1xROQ1pyK2NlohyIqF1x,G8EPVSXsOYB5YQWZGiz1aVq5Pgr2GrQu,1,0,0,0,0,0,1,0,1,0.14285714285714285,1,0.0,0,0,0,0,0,0,0,1,0,0,1,1
2841,40951,ah2KXEU3IJN3pCxNzFybzDR3Qrtpz7ty,SpATywNh6bZuzm8s1ceuBUnMUAeoAHHw,1,0,0,0,0,0,1,0,1,0.14285714285714285,1,0.0,0,0,0,0,0,0,0,1,0,0,1,1
2842,40964,gnxZfu6FrSp4wr4QPorHabuGoagxpXKv,SpATywNh6bZuzm8s1ceuBUnMUAeoAHHw,1,0,0,0,0,0,1,0,1,0.14285714285714285,1,0.0,0,0,0,0,0,0,0,1,0,0,1,1
2843,40966,xHfGdYj0sYZXXCzkQp0eF5wBXW7C2C6R,A3fsA9Zfv1X2fVEQhTw51lKENdNrEqT3,6,5,2,0,2,0,4,0,13,1.8571428571428572,2,0.0,0,2,0,2,5,0,0,4,0,4,9,1
2844,40973,BasnDhJkjNSRVUOCCIoBniAgNajwACiL,SpATywNh6bZuzm8s1ceuBUnMUAeoAHHw,43,78,4,56,1,0,26,0,165,23.571428571428573,8,0.0,22,4,53,1,56,0,3,26,0,80,85,0
2845,40979,zeUi2UnQZPPF6bRQXw2s8LZ41ZOdqRAa,G8EPVSXsOYB5YQWZGiz1aVq5Pgr2GrQu,8,9,6,0,2,1,3,0,21,3.0,2,0.0,0,6,0,2,9,1,0,3,0,8,13,1
2846,40982,4IpWwTUOGPzGOpKLy9nKXcEDTyxApVd3,G8EPVSXsOYB5YQWZGiz1aVq5Pgr2GrQu,1,0,0,0,0,0,1,0,1,0.14285714285714285,1,0.0,0,0,0,0,0,0,0,1,0,0,1,1
2847,40984,xvXNoM4EBB4fcdWfVRuECibdILksVZE5,SpATywNh6bZuzm8s1ceuBUnMUAeoAHHw,4,2,0,0,0,0,3,0,5,0.7142857142857143,1,0.0,0,0,0,0,2,0,0,3,0,0,5,1
2848,40986,ikVmCxeXCKQtR8OPUUdHoGQCjATpEVdj,SpATywNh6bZuzm8s1ceuBUnMUAeoAHHw,14,17,9,15,5,0,2,0,48,6.857142857142857,3,0.0,7,9,13,5,10,0,2,2,0,34,14,1
2849,40991,WPAkKut2lu615mRXcePqeHjf7ZV10lWd,SpATywNh6bZuzm8s1ceuBUnMUAeoAHHw,13,14,9,10,4,0,2,0,39,5.571428571428571,3,0.0,2,9,9,4,12,0,1,2,0,24,15,1
2850,41010,uOFQjpYGMV24K1kl5khOKpWKqO5hcEHE,7GRhBDsirIGkRZBtSMEzNTyDr2JQm4xx,7,8,2,0,2,0,2,0,14,2.0,1,0.0,0,2,0,2,8,0,0,2,0,4,10,1
2851,41045,1YzM2x4RT6wZpTpcb29oadjFh2hfD86U,5X6FeZozNMgE2VRi3MJYjkkFK8SETtu2,1,0,0,0,0,0,1,0,1,0.14285714285714285,1,0.0,0,0,0,0,0,0,0,1,0,0,1,1
2852,41098,luetGJM4RCCEdMBc9OfxVqFFziudg0s4,7GRhBDsirIGkRZBtSMEzNTyDr2JQm4xx,2,0,0,0,0,0,3,0,3,0.42857142857142855,1,0.0,0,0,0,0,0,0,0,3,0,0,3,1
2853,41120,XpdeGVr67ypvPB6NlvDXEjF8wDCu5FS9,7GRhBDsirIGkRZBtSMEzNTyDr2JQm4xx,1,0,0,0,0,0,2,0,2,0.2857142857142857,2,0.0,0,0,0,0,0,0,0,2,0,0,2,1
2854,41126,XDK8k8ZxjLQNRum2tucg5KMs9y8pIx4l,5X6FeZozNMgE2VRi3MJYjkkFK8SETtu2,4,3,1,0,0,0,2,0,6,0.8571428571428571,1,0.0,0,1,0,0,3,0,0,2,0,1,5,1
2855,41133,sIrvXnSy3oMgG36f8e8UxJCnsTfr739w,7GRhBDsirIGkRZBtSMEzNTyDr2JQm4xx,17,24,1,0,1,2,10,0,38,5.428571428571429,3,0.0,3,1,0,1,21,2,0,10,0,5,33,1
2856,41151,CpJFUzNBBad8gxGQfFWcVCTdakqtlRdi,5X6FeZozNMgE2VRi3MJYjkkFK8SETtu2,1,0,0,0,0,0,1,0,1,0.14285714285714285,1,0.0,0,0,0,0,0,0,0,1,0,0,1,1
2857,41208,ttoFK5oOPrxtfVxJpGPFCiEs8J6AbuAg,7GRhBDsirIGkRZBtSMEzNTyDr2JQm4xx,2,0,0,0,0,0,3,0,3,0.42857142857142855,2,0.0,0,0,0,0,0,0,0,3,0,0,3,1
2858,41295,UyrB62TC80PvjIx5mHAqyBQJHo9hnImU,5X6FeZozNMgE2VRi3MJYjkkFK8SETtu2,9,7,3,0,1,2,5,1,19,2.7142857142857144,1,0.0,0,3,0,1,7,2,0,5,1,4,15,1
2859,41313,muzVsCrsBxqiBPr2RsB5pEdOhDGWWCl3,7GRhBDsirIGkRZBtSMEzNTyDr2JQm4xx,4,3,1,0,1,0,1,0,6,0.8571428571428571,1,0.0,1,1,0,1,2,0,0,1,0,3,3,1
2860,41347,qXJ6UuggRRYAIHwmdSldGzLBmAnY5Oc1,5X6FeZozNMgE2VRi3MJYjkkFK8SETtu2,12,9,6,0,4,0,4,0,23,3.2857142857142856,1,0.0,0,6,0,4,9,0,0,4,0,10,13,1
2861,41408,xbPbNw5WluotpcGvfodgid2Z7Rc8OfQr,7GRhBDsirIGkRZBtSMEzNTyDr2JQm4xx,1,0,0,0,0,0,1,0,1,0.14285714285714285,1,0.0,0,0,0,0,0,0,0,1,0,0,1,1
2862,41418,eTCGzxAsblGqwnuTAWtbbANcNVoq2Yog,5X6FeZozNMgE2VRi3MJYjkkFK8SETtu2,1,0,0,0,0,0,1,0,1,0.14285714285714285,1,0.0,0,0,0,0,0,0,0,1,0,0,1,1
2863,41424,Gn1QSm7WrSyhbej7tThohiyBKeBu1xtD,7GRhBDsirIGkRZBtSMEzNTyDr2JQm4xx,124,156,68,221,52,2,25,1,525,75.0,12,0.0,65,68,188,52,91,2,33,25,1,373,152,0
2864,41434,eFbaGNJkrGgLy9I6zgZvwaIK40Fpk2dV,5X6FeZozNMgE2VRi3MJYjkkFK8SETtu2,1,0,0,0,0,0,2,0,2,0.2857142857142857,1,0.0,0,0,0,0,0,0,0,2,0,0,2,1
2865,41448,we9tWnySpl1G7k7FqyXPj8wmC2gUYK0W,7GRhBDsirIGkRZBtSMEzNTyDr2JQm4xx,1,0,0,0,0,0,1,0,1,0.14285714285714285,1,0.0,0,0,0,0,0,0,0,1,0,0,1,1
2866,41454,zWECTl7pig27m6EXN2th2ITKXEX5E7bm,5X6FeZozNMgE2VRi3MJYjkkFK8SETtu2,40,115,26,45,39,5,13,1,244,34.857142857142854,4,0.0,78,26,34,39,37,5,11,13,1,177,67,1
2867,41455,emCY4aIQuto3vHDbWyLccdGfPM1ClSuh,7GRhBDsirIGkRZBtSMEzNTyDr2JQm4xx,4,1,0,0,0,0,3,0,4,0.5714285714285714,1,0.0,0,0,0,0,1,0,0,3,0,0,4,1
2868,41543,mEZvWvBBGXXfy0WF2DjKoOVWnqlpKunY,5X6FeZozNMgE2VRi3MJYjkkFK8SETtu2,5,2,1,0,1,0,2,0,6,0.8571428571428571,1,0.0,0,1,0,1,2,0,0,2,0,2,4,1
2869,41576,096xYyhB9kL7G6lT7J9rVrXyGNwUToLF,5X6FeZozNMgE2VRi3MJYjkkFK8SETtu2,11,28,9,0,1,0,7,0,45,6.428571428571429,4,0.0,17,9,0,1,11,0,0,7,0,27,18,0
2870,41589,JXidMLGzH1hCHEXJsiJMrwBekkp4L4vD,7GRhBDsirIGkRZBtSMEzNTyDr2JQm4xx,34,52,24,41,10,3,8,0,138,19.714285714285715,6,0.0,22,24,34,10,30,3,7,8,0,90,48,1
2871,41700,qGFsPZahffV69lg1cIg3IHQ7WbMNcFwi,5X6FeZozNMgE2VRi3MJYjkkFK8SETtu2,1,0,0,0,0,0,1,0,1,0.14285714285714285,1,0.0,0,0,0,0,0,0,0,1,0,0,1,1
2872,41732,b5exMMDqGOTUdj3bRJOK1OHepqmGIGuy,5X6FeZozNMgE2VRi3MJYjkkFK8SETtu2,7,3,2,0,2,0,2,0,9,1.2857142857142858,1,0.0,0,2,0,2,3,0,0,2,0,4,5,1
2873,41740,blaKT90TeOTAa2RsAkTxWQqeLxEi93Qu,7GRhBDsirIGkRZBtSMEzNTyDr2JQm4xx,1,0,0,0,0,0,2,0,2,0.2857142857142857,2,0.0,0,0,0,0,0,0,0,2,0,0,2,1
2874,41796,vpQq8XFeke8cuyYAJhpFzjSzZZBP51AP,7GRhBDsirIGkRZBtSMEzNTyDr2JQm4xx,1,0,0,0,0,0,1,0,1,0.14285714285714285,1,0.0,0,0,0,0,0,0,0,1,0,0,1,1
2875,41799,Qqy3TZdyBKfhf7zgHIRI72ZJ5QbTtpkb,7GRhBDsirIGkRZBtSMEzNTyDr2JQm4xx,11,12,4,0,3,0,3,0,22,3.142857142857143,1,0.0,0,4,0,3,12,0,0,3,0,7,15,1
2876,41805,kuZwBvEdgeUtKZ495C2FptBbxEtLtmVH,7GRhBDsirIGkRZBtSMEzNTyDr2JQm4xx,7,11,3,0,2,0,2,0,18,2.5714285714285716,2,0.0,3,3,0,2,8,0,0,2,0,8,10,1
2877,41808,Qqy3TZdyBKfhf7zgHIRI72ZJ5QbTtpkb,5X6FeZozNMgE2VRi3MJYjkkFK8SETtu2,4,0,0,0,0,1,4,1,6,0.8571428571428571,1,0.0,0,0,0,0,0,1,0,4,1,0,6,1
2878,41852,7d4b3SNxdjjzi8g8AEaVqA0FYKHzinDf,5Gyp41oLVo7Gg7vF4vpmggWP5MU70QO6,4,2,1,0,1,0,1,0,5,0.7142857142857143,1,0.0,0,1,0,1,2,0,0,1,0,2,3,1
2879,41872,mFpiELMd2y5tbkdxs4m8pKS7gXHb7bIO,5Gyp41oLVo7Gg7vF4vpmggWP5MU70QO6,21,25,17,19,8,6,3,0,78,11.142857142857142,2,0.0,5,17,16,8,20,6,3,3,0,46,32,1
2880,41901,xtF1xbFnW4uDdF6Vg0b6lAnaZxcIz0Ve,5Gyp41oLVo7Gg7vF4vpmggWP5MU70QO6,28,61,45,12,23,0,14,0,155,22.142857142857142,4,0.0,3,45,9,23,58,0,3,14,0,80,75,1
2881,41914,v1AqHfMoNhUox9GyIOrxftKibIp07zrt,5Gyp41oLVo7Gg7vF4vpmggWP5MU70QO6,1,0,0,0,0,0,1,0,1,0.14285714285714285,1,0.0,0,0,0,0,0,0,0,1,0,0,1,1
2882,41919,6h7iIssCCu9aON4ETl9Y3uiCltL5Vdbt,5Gyp41oLVo7Gg7vF4vpmggWP5MU70QO6,5,2,1,0,0,0,3,0,6,0.8571428571428571,1,0.0,0,1,0,0,2,0,0,3,0,1,5,1
2883,41937,ZECsrQDWNf4nPUfo4HpZsLiXc2swEQ6q,5Gyp41oLVo7Gg7vF4vpmggWP5MU70QO6,12,16,8,0,4,2,6,1,37,5.285714285714286,3,0.0,5,8,0,4,11,2,0,6,1,17,20,1
2884,41941,yq5rHqpCTagxs6XCaAXxmCSySzn2U3u8,5Gyp41oLVo7Gg7vF4vpmggWP5MU70QO6,48,108,57,65,1,4,44,0,279,39.857142857142854,13,0.0,30,57,53,1,78,4,12,44,0,141,138,0
2885,41943,fd2e5NJVnyVwHFHuiTOOM639ZY1uThtn,5Gyp41oLVo7Gg7vF4vpmggWP5MU70QO6,49,118,53,39,21,93,29,4,357,51.0,9,0.0,37,53,30,21,81,93,9,29,4,141,216,0
2886,41961,f0sVZyDIDK6aEjBJcynnEa0a1FRP4E3Q,5Gyp41oLVo7Gg7vF4vpmggWP5MU70QO6,62,450,178,46,111,29,54,3,871,124.42857142857143,17,0.0,210,178,30,111,240,29,16,54,3,529,342,0
2887,41982,9bv4TssyKs6woXSaEFvigyhEyIkdO1mQ,5Gyp41oLVo7Gg7vF4vpmggWP5MU70QO6,32,97,50,18,20,56,35,8,284,40.57142857142857,11,0.0,19,50,13,20,78,56,5,35,8,102,182,1
2888,41990,QCeQLHdKBbgocZCY3ZvshdQQP5rGGQRl,5Gyp41oLVo7Gg7vF4vpmggWP5MU70QO6,1,0,0,0,0,0,1,0,1,0.14285714285714285,1,0.0,0,0,0,0,0,0,0,1,0,0,1,1
2889,41996,BJDnbFOtylN7pvasNOrTjNGeFmTJRbJY,5Gyp41oLVo7Gg7vF4vpmggWP5MU70QO6,32,87,35,21,20,168,27,2,360,51.42857142857143,10,0.0,24,35,14,20,63,168,7,27,2,93,267,0
2890,42034,W6MGFBQ1Tov9lOeRQ8QlzHUMCDNEGRDq,5Gyp41oLVo7Gg7vF4vpmggWP5MU70QO6,49,129,37,66,12,0,20,0,264,37.714285714285715,6,0.0,18,37,59,12,111,0,7,20,0,126,138,1
2891,42045,lx4ZbPAl8lgZM7WAQwN5AzxQuHINUnnn,5Gyp41oLVo7Gg7vF4vpmggWP5MU70QO6,1,0,0,0,0,0,1,0,1,0.14285714285714285,1,0.0,0,0,0,0,0,0,0,1,0,0,1,1
2892,42050,L4oP8uZsX378RlX4CoGsRHdcJ2TspQbn,5Gyp41oLVo7Gg7vF4vpmggWP5MU70QO6,13,17,8,4,4,0,10,0,43,6.142857142857143,3,0.0,5,8,2,4,12,0,2,10,0,19,24,1
2893,42051,xh6Z87zHYO5TmTHmULL6ExXhMxQxPAzM,5Gyp41oLVo7Gg7vF4vpmggWP5MU70QO6,6,2,1,0,1,0,4,1,9,1.2857142857142858,1,0.0,0,1,0,1,2,0,0,4,1,2,7,1
2894,42054,DTdnrUWYQy6SZeB3v1jpsLGbeokB7hvq,5Gyp41oLVo7Gg7vF4vpmggWP5MU70QO6,14,7,6,6,4,3,6,1,33,4.714285714285714,1,0.0,1,6,3,4,6,3,3,6,1,14,19,1
2895,42059,fECdKG9engCN4PBWVnIUSeu4ChydnH9z,5Gyp41oLVo7Gg7vF4vpmggWP5MU70QO6,1,0,0,0,0,0,1,0,1,0.14285714285714285,1,0.0,0,0,0,0,0,0,0,1,0,0,1,1
2896,42096,HLBGWKgO3KQzLSRnEwchUSbXffZaQqeI,5Gyp41oLVo7Gg7vF4vpmggWP5MU70QO6,10,12,5,0,3,1,8,0,29,4.142857142857143,3,0.0,1,5,0,3,11,1,0,8,0,9,20,1
2897,42114,92weGHcUONTaSKRvvp9KGrCydTp17laF,5Gyp41oLVo7Gg7vF4vpmggWP5MU70QO6,1,0,0,0,0,0,1,0,1,0.14285714285714285,1,0.0,0,0,0,0,0,0,0,1,0,0,1,1
2898,42116,QM2QMYgltxQbwQVbv1JDjhjnw8gL0lR3,5Gyp41oLVo7Gg7vF4vpmggWP5MU70QO6,1,0,0,0,0,0,1,0,1,0.14285714285714285,1,0.0,0,0,0,0,0,0,0,1,0,0,1,1
2899,42149,p97VEQO2qWZmGa3xI7ijdv1FZbQKFwFm,5Gyp41oLVo7Gg7vF4vpmggWP5MU70QO6,5,3,1,0,1,0,1,0,6,0.8571428571428571,1,0.0,0,1,0,1,3,0,0,1,0,2,4,1
2900,42177,FbFzxcgOenGEHKMXxCSjDnrIiqrr6PFf,5Gyp41oLVo7Gg7vF4vpmggWP5MU70QO6,12,8,6,0,3,0,3,0,20,2.857142857142857,2,0.0,0,6,0,3,8,0,0,3,0,9,11,1
2901,42183,cRBP8bFCVMf6rvRdef3FrHPLSFuaFxMf,5Gyp41oLVo7Gg7vF4vpmggWP5MU70QO6,8,8,5,0,3,0,2,0,18,2.5714285714285716,2,0.0,1,5,0,3,7,0,0,2,0,9,9,1
2902,42274,pT3VeIuIzx4VMyEDCdSdiiTQryYF6ywz,5Gyp41oLVo7Gg7vF4vpmggWP5MU70QO6,6,4,2,0,1,0,4,0,11,1.5714285714285714,1,0.0,0,2,0,1,4,0,0,4,0,3,8,1
2903,42283,coeWNI3IAD901oWcF5eFxb3gewasuU9G,5Gyp41oLVo7Gg7vF4vpmggWP5MU70QO6,37,148,38,0,52,0,9,0,247,35.285714285714285,3,0.0,44,38,0,52,104,0,0,9,0,134,113,1
2904,42292,fo11APiMDJF2DjuYtDFoBE2X6zRUvD0O,5Gyp41oLVo7Gg7vF4vpmggWP5MU70QO6,24,78,40,34,1,0,26,0,179,25.571428571428573,7,0.0,21,40,26,1,57,0,8,26,0,88,91,0
2905,42351,Ov4skeGBwbiO8tM202AvGyzidAgLuRFD,5Gyp41oLVo7Gg7vF4vpmggWP5MU70QO6,1,0,0,0,0,0,2,0,2,0.2857142857142857,2,0.0,0,0,0,0,0,0,0,2,0,0,2,1
2906,42372,voXfmBYgeQMvGbDBGbeoknkDIyLOK6Zz,5Gyp41oLVo7Gg7vF4vpmggWP5MU70QO6,33,70,35,30,4,4,12,1,156,22.285714285714285,5,0.0,33,35,15,4,37,4,15,12,1,87,69,1
2907,42443,95wnVruHwJbQJ8XTksUIsLyn3QwBy0na,5Gyp41oLVo7Gg7vF4vpmggWP5MU70QO6,10,12,6,0,2,2,4,1,27,3.857142857142857,1,0.0,2,6,0,2,10,2,0,4,1,10,17,1
2908,42492,F5WXvUA8z1Vfdvlva1pujweut7tGE04r,5Gyp41oLVo7Gg7vF4vpmggWP5MU70QO6,5,1,1,0,1,0,7,0,10,1.4285714285714286,3,0.0,0,1,0,1,1,0,0,7,0,2,8,0
2909,42517,1fleh7lPd7aghMITlPRITTq0TKiljgoj,5Gyp41oLVo7Gg7vF4vpmggWP5MU70QO6,6,1,1,0,1,0,3,0,6,0.8571428571428571,1,0.0,0,1,0,1,1,0,0,3,0,2,4,0
2910,42545,16IaVArf7HDzubrwCdp5gqSN8A4lsrys,5Gyp41oLVo7Gg7vF4vpmggWP5MU70QO6,1,0,0,0,0,0,1,0,1,0.14285714285714285,1,0.0,0,0,0,0,0,0,0,1,0,0,1,1
2911,42548,1nSBEgn3dOnqesibXizOKGsR7hL9hjON,5Gyp41oLVo7Gg7vF4vpmggWP5MU70QO6,1,0,0,0,0,0,1,0,1,0.14285714285714285,1,0.0,0,0,0,0,0,0,0,1,0,0,1,1
2912,42604,VN7mIYOy9t6d92ozIKhBx0dLnBa4IRt3,5Gyp41oLVo7Gg7vF4vpmggWP5MU70QO6,16,38,21,3,7,1,16,0,86,12.285714285714286,6,0.0,9,21,1,7,29,1,2,16,0,38,48,0
2913,42641,EJ32Am2qz9sXqSHBy8iFLimLcPtCtc2g,5Gyp41oLVo7Gg7vF4vpmggWP5MU70QO6,11,16,7,0,4,0,8,0,35,5.0,3,0.0,0,7,0,4,16,0,0,8,0,11,24,1
2914,42663,MqQtReyruUVIU2LCfa5IIMpo9Hk5W0pq,5Gyp41oLVo7Gg7vF4vpmggWP5MU70QO6,3,0,0,0,0,0,3,0,3,0.42857142857142855,1,0.0,0,0,0,0,0,0,0,3,0,0,3,1
2915,42695,gKCfVXJeSOrE1xgSflOmwDFTFpuPrSlq,5Gyp41oLVo7Gg7vF4vpmggWP5MU70QO6,3,0,0,0,0,0,8,0,8,1.1428571428571428,3,0.0,0,0,0,0,0,0,0,8,0,0,8,1
2916,42759,RiuaU3j9glvJbW4ph026KXgBcE6tugPM,5Gyp41oLVo7Gg7vF4vpmggWP5MU70QO6,26,67,1,2,0,15,11,1,97,13.857142857142858,8,0.0,3,1,2,0,64,15,0,11,1,6,91,0
2917,42778,AQEdyfxMIDbf98PU42NTmTHCLAkjalfX,5Gyp41oLVo7Gg7vF4vpmggWP5MU70QO6,30,73,33,35,31,0,28,2,202,28.857142857142858,8,0.0,16,33,27,31,57,0,8,28,2,107,95,1
2918,42804,RFxR0SFPPvCWJDegU9vXnrDZ6RWwU07I,5Gyp41oLVo7Gg7vF4vpmggWP5MU70QO6,12,6,5,0,4,0,2,0,17,2.4285714285714284,1,0.0,0,5,0,4,6,0,0,2,0,9,8,1
2919,42847,sMynuMhoZTpmWI7JIgM7Zcgv9Nw77yWq,5Gyp41oLVo7Gg7vF4vpmggWP5MU70QO6,15,26,8,0,12,4,3,0,53,7.571428571428571,3,0.0,15,8,0,12,11,4,0,3,0,35,18,1
2920,42849,QBJjc55FhlsfcHHPW6AJvjfSIeMCCMEA,5Gyp41oLVo7Gg7vF4vpmggWP5MU70QO6,47,207,107,14,55,55,100,16,554,79.14285714285714,6,0.0,55,107,7,55,152,55,7,100,16,224,330,0
2921,42879,G5JFEd58i47FiqQxatEMibk5NL9uoQb2,5Gyp41oLVo7Gg7vF4vpmggWP5MU70QO6,5,32,25,0,1,0,2,0,60,8.571428571428571,10,0.0,0,25,0,1,32,0,0,2,0,26,34,1
2922,42886,YvjOOH17h0dXnr4Jwtv0jh1sSu9lkIZ7,5Gyp41oLVo7Gg7vF4vpmggWP5MU70QO6,7,3,2,0,2,0,2,0,9,1.2857142857142858,1,0.0,0,2,0,2,3,0,0,2,0,4,5,1
2923,42890,o6LWaGPsxwJxS9EHFcEz9dTihcviVEZr,5Gyp41oLVo7Gg7vF4vpmggWP5MU70QO6,29,19,16,0,10,0,12,1,58,8.285714285714286,2,0.0,2,16,0,10,17,0,0,12,1,28,30,0
2924,42910,kNaRHbDUPinoBQZENYvK7XkUGi7EGGIq,5Gyp41oLVo7Gg7vF4vpmggWP5MU70QO6,1,0,0,0,0,0,1,0,1,0.14285714285714285,1,0.0,0,0,0,0,0,0,0,1,0,0,1,1
2925,42937,r0Dep3QHNNWSPLkR08tICGVj5Fu7r77t,5Gyp41oLVo7Gg7vF4vpmggWP5MU70QO6,16,22,12,20,8,5,5,0,72,10.285714285714286,3,0.0,5,12,13,8,17,5,7,5,0,38,34,1
2926,42953,7SKW5Orp373hN42axMDs0xsTTPv4lnRr,5Gyp41oLVo7Gg7vF4vpmggWP5MU70QO6,5,3,0,0,1,0,2,0,6,0.8571428571428571,1,0.0,0,0,0,1,3,0,0,2,0,1,5,1
2927,43017,2uoMQOxqyRzmIYFGnyAflqy5t44QW2xE,5Gyp41oLVo7Gg7vF4vpmggWP5MU70QO6,16,16,9,0,6,0,11,1,43,6.142857142857143,4,0.0,1,9,0,6,15,0,0,11,1,16,27,1
2928,43048,a3dzyTdn4now8y79XAfczGTWvF7aosfb,5Gyp41oLVo7Gg7vF4vpmggWP5MU70QO6,8,11,3,0,3,1,7,0,25,3.5714285714285716,2,0.0,4,3,0,3,7,1,0,7,0,10,15,1
2929,43065,IYu26HWwnsP56tFrQgfK192g0xDPZe1A,5Gyp41oLVo7Gg7vF4vpmggWP5MU70QO6,10,22,13,0,9,2,18,0,64,9.142857142857142,5,0.0,1,13,0,9,21,2,0,18,0,23,41,1
2930,43141,9qWqwR5w0yLR2UZuxUx8CDb7A7u6scn0,5Gyp41oLVo7Gg7vF4vpmggWP5MU70QO6,52,130,53,33,26,0,17,0,259,37.0,9,0.0,47,53,31,26,83,0,2,17,0,157,102,0
2931,43205,DKfxzcRdq8FKoADcuGRfLXk0rRDap8VU,5Gyp41oLVo7Gg7vF4vpmggWP5MU70QO6,6,4,3,0,1,0,3,0,11,1.5714285714285714,1,0.0,0,3,0,1,4,0,0,3,0,4,7,1
2932,43264,Ox4dr3G3uxC6QxBwSIKQ4VzVwJeV3qcV,5Gyp41oLVo7Gg7vF4vpmggWP5MU70QO6,7,4,2,0,3,0,2,0,11,1.5714285714285714,1,0.0,1,2,0,3,3,0,0,2,0,6,5,1
2933,43320,ZNcLOAJ2r3H5DqhbGk1CiPtwI7ixaCeK,5Gyp41oLVo7Gg7vF4vpmggWP5MU70QO6,26,56,26,0,29,0,7,0,118,16.857142857142858,7,0.0,21,26,0,29,35,0,0,7,0,76,42,0
2934,43327,cN6OZq4ak5IqzN7Lw32XLOS12DhlWO8Q,5Gyp41oLVo7Gg7vF4vpmggWP5MU70QO6,50,205,106,78,59,142,36,20,646,92.28571428571429,8,0.0,73,106,52,59,132,142,26,36,20,290,356,0
2935,43337,T9uDhME1dGR0Q6Kbd7JPvChNdx9zfhaO,5Gyp41oLVo7Gg7vF4vpmggWP5MU70QO6,12,18,4,0,5,2,6,0,35,5.0,4,0.0,2,4,0,5,16,2,0,6,0,11,24,1
2936,43354,AXWWqNDiRDejTjo5V7yUaMbjtzXKhlP0,5Gyp41oLVo7Gg7vF4vpmggWP5MU70QO6,17,34,19,5,6,15,13,0,92,13.142857142857142,6,0.0,4,19,3,6,30,15,2,13,0,32,60,0
2937,43358,F2owRK2SDPW5FCDK4TxmBVHsTtJ44Nxq,5Gyp41oLVo7Gg7vF4vpmggWP5MU70QO6,10,18,6,0,2,0,7,0,33,4.714285714285714,4,0.0,0,6,0,2,18,0,0,7,0,8,25,0
2938,43393,OkJ0lKmMXuQ2MGftQ8Isfw1JciMpapRC,3VkHkmOtom3jM2wCu94xgzzu1d6Dn7or,5,4,1,0,1,0,2,0,8,1.1428571428571428,2,0.0,0,1,0,1,4,0,0,2,0,2,6,0
2939,43396,kg8jNAL6XWkd0183giUa3Jrg1KPQArtq,3VkHkmOtom3jM2wCu94xgzzu1d6Dn7or,1,0,0,0,0,0,1,0,1,0.14285714285714285,1,0.0,0,0,0,0,0,0,0,1,0,0,1,1
2940,43403,s6iksgptFmyh2vfiarKdJkiKnp6RLi3f,3VkHkmOtom3jM2wCu94xgzzu1d6Dn7or,23,51,17,2,10,123,65,3,271,38.714285714285715,15,0.0,6,17,2,10,45,123,0,65,3,35,236,1
2941,43421,zBnztQ47zRqd4YOqbZ7Bu4GeZ14n28YJ,3VkHkmOtom3jM2wCu94xgzzu1d6Dn7or,23,65,36,0,6,136,26,66,335,47.857142857142854,17,0.0,7,36,0,6,58,136,0,26,66,49,286,0
2942,43424,HRl1WtPVy480F3Uj29p44N7x6MhEkdO9,3VkHkmOtom3jM2wCu94xgzzu1d6Dn7or,7,5,3,0,0,3,7,0,18,2.5714285714285716,1,0.0,0,3,0,0,5,3,0,7,0,3,15,1
2943,43455,xePL2kxKaHs0bBt3C0iPKQ07cHzaWqkv,3VkHkmOtom3jM2wCu94xgzzu1d6Dn7or,1,0,0,0,0,0,1,0,1,0.14285714285714285,1,0.0,0,0,0,0,0,0,0,1,0,0,1,0
2944,43485,bHQY2mMklvQ96laeCvMnjAaOQZ9Z2fPl,5Gyp41oLVo7Gg7vF4vpmggWP5MU70QO6,1,0,0,0,0,0,1,0,1,0.14285714285714285,1,0.0,0,0,0,0,0,0,0,1,0,0,1,1
2945,43504,HafUKAP7RZbyh0jr3nHP7uNe6aFcE0ez,5Gyp41oLVo7Gg7vF4vpmggWP5MU70QO6,15,13,9,7,5,26,18,1,79,11.285714285714286,3,0.0,3,9,5,5,10,26,2,18,1,22,57,1
2946,43551,EIVlhBzHfz8g1ct2tpEW2E3ZS1tK3zYR,5Gyp41oLVo7Gg7vF4vpmggWP5MU70QO6,11,13,8,0,2,0,3,0,26,3.7142857142857144,3,0.0,0,8,0,2,13,0,0,3,0,10,16,1
2947,43565,6psynBJggS27dEPXlSIkWTKXOmBHQev3,5Gyp41oLVo7Gg7vF4vpmggWP5MU70QO6,1,0,0,0,0,0,1,0,1,0.14285714285714285,1,0.0,0,0,0,0,0,0,0,1,0,0,1,1
2948,43577,OZ02Yntpt8Hg8thsFgejT4NSsPYtVPPm,5Gyp41oLVo7Gg7vF4vpmggWP5MU70QO6,15,17,11,0,2,6,8,1,45,6.428571428571429,3,0.0,2,11,0,2,15,6,0,8,1,15,30,0
2949,43601,QRnkoghgCrSC0XTwYvvkCebLikYjnOiH,5Gyp41oLVo7Gg7vF4vpmggWP5MU70QO6,13,10,7,0,4,0,6,0,27,3.857142857142857,3,0.0,0,7,0,4,10,0,0,6,0,11,16,1
2950,43606,osZvJiYa9aDEaQ0aoDErqlo32Q2tqr88,5Gyp41oLVo7Gg7vF4vpmggWP5MU70QO6,7,3,2,0,2,0,3,0,10,1.4285714285714286,2,0.0,0,2,0,2,3,0,0,3,0,4,6,1
2951,43623,rc6SQY1f7UMU2z1RqzTVgOSasulrCJ3h,5Gyp41oLVo7Gg7vF4vpmggWP5MU70QO6,14,18,10,5,4,3,6,1,47,6.714285714285714,2,0.0,3,10,3,4,15,3,2,6,1,20,27,1
2952,43653,79QUI05RY9ZPkyZ2QTF4ldf0I0DmjbaG,7GRhBDsirIGkRZBtSMEzNTyDr2JQm4xx,25,77,44,0,8,13,26,0,168,24.0,7,0.0,9,44,0,8,68,13,0,26,0,61,107,1
2953,43659,TuM6W4EyKz1gShBWtvBuMmOw1xwF4xlS,7GRhBDsirIGkRZBtSMEzNTyDr2JQm4xx,6,8,4,0,4,2,3,0,21,3.0,2,0.0,2,4,0,4,6,2,0,3,0,10,11,0
2954,43667,YwEhgJrFq2w9QJl2yCPd9xaL0Uk6VujF,7GRhBDsirIGkRZBtSMEzNTyDr2JQm4xx,32,31,8,304,2,0,19,0,364,52.0,3,0.0,18,8,283,2,13,0,21,19,0,311,53,0
2955,43672,tCqgfXrL2rXAh5RJpLuMHSLSRwrclyuQ,7GRhBDsirIGkRZBtSMEzNTyDr2JQm4xx,78,354,100,233,55,38,27,0,807,115.28571428571429,14,0.0,121,100,198,55,233,38,35,27,0,474,333,0
2956,43674,zkqKiyV6OvwyKPkyCN37KC4hTRCpZYCH,7GRhBDsirIGkRZBtSMEzNTyDr2JQm4xx,17,23,12,10,11,0,3,0,59,8.428571428571429,3,0.0,8,12,9,11,15,0,1,3,0,40,19,0
2957,43685,Up0igPeMCPcrrFPZ1HsfM8Bq5rwAfYwv,7GRhBDsirIGkRZBtSMEzNTyDr2JQm4xx,57,78,25,72,27,22,8,0,232,33.142857142857146,6,0.0,44,25,60,27,34,22,12,8,0,156,76,0
2958,43689,E32xhKZZWx3RSJgehFSxMt99fqnIjiGq,7GRhBDsirIGkRZBtSMEzNTyDr2JQm4xx,17,25,1,12,1,0,1,0,40,5.714285714285714,1,0.0,11,1,6,1,14,0,6,1,0,19,21,1
2959,43697,ta4rrlwAs90RPkpFC9k1ckRd8n8Nkgxn,7GRhBDsirIGkRZBtSMEzNTyDr2JQm4xx,8,1,1,0,1,0,7,0,10,1.4285714285714286,2,0.0,0,1,0,1,1,0,0,7,0,2,8,1
2960,43700,z4NoXHrcgkhn7BypZflRO6Tgobh52UXj,7GRhBDsirIGkRZBtSMEzNTyDr2JQm4xx,52,95,31,74,18,11,17,0,246,35.142857142857146,6,0.0,44,31,54,18,51,11,20,17,0,147,99,0
2961,43709,3FE77xUt9GRriuZnel52RMR4IDPpAzkP,7GRhBDsirIGkRZBtSMEzNTyDr2JQm4xx,1,0,0,0,0,0,1,0,1,0.14285714285714285,1,0.0,0,0,0,0,0,0,0,1,0,0,1,1
2962,43713,KjugBA6V5bkEA5fAIbJoGnSUlDhZoaIH,7GRhBDsirIGkRZBtSMEzNTyDr2JQm4xx,80,185,45,152,25,4,29,2,442,63.142857142857146,7,0.0,73,45,133,25,112,4,19,29,2,276,166,0
2963,43719,PmDYoqv5aFPg9sMLkKbqOq2AMGxS1MTS,7GRhBDsirIGkRZBtSMEzNTyDr2JQm4xx,1,0,0,0,0,0,1,0,1,0.14285714285714285,1,0.0,0,0,0,0,0,0,0,1,0,0,1,1
2964,43726,kdSq236IYQMsCu2OjWxBROoAPTYOBg4Z,7GRhBDsirIGkRZBtSMEzNTyDr2JQm4xx,1,0,0,0,0,0,1,0,1,0.14285714285714285,1,0.0,0,0,0,0,0,0,0,1,0,0,1,1
2965,43732,0OpVcmwG6bVPxKzOCpgJ9F6MfBtuGolr,7GRhBDsirIGkRZBtSMEzNTyDr2JQm4xx,1,0,0,0,0,0,3,0,3,0.42857142857142855,2,0.0,0,0,0,0,0,0,0,3,0,0,3,1
2966,43739,U8C1raMgKT2mT8ZLyOUP6V5o8qd1qKWo,7GRhBDsirIGkRZBtSMEzNTyDr2JQm4xx,6,2,1,0,1,2,3,0,9,1.2857142857142858,1,0.0,0,1,0,1,2,2,0,3,0,2,7,1
2967,43740,e117XIPebSFWPuYXHTMQJ6xgFjjQ6u7z,7GRhBDsirIGkRZBtSMEzNTyDr2JQm4xx,7,2,1,0,1,0,8,0,12,1.7142857142857142,1,0.0,0,1,0,1,2,0,0,8,0,2,10,1
2968,43991,i936MfG3syIHVH4tehF88pJA63b8Vu78,fbPkOYLVPtPgIt0MxizjfFJov3JbHyAi,9,4,2,0,2,3,6,3,20,2.857142857142857,1,0.0,0,2,0,2,4,3,0,6,3,4,16,1
2969,43992,6UtqqjImjevYXkMdkukuwyWXLWcDEFFu,fbPkOYLVPtPgIt0MxizjfFJov3JbHyAi,11,29,11,6,9,5,13,2,75,10.714285714285714,2,0.0,4,11,4,9,25,5,2,13,2,28,47,1
2970,43998,e19ZEr9Yh5ILe0m8l9rWehMDuEWywMUJ,fbPkOYLVPtPgIt0MxizjfFJov3JbHyAi,1,0,0,0,0,0,1,0,1,0.14285714285714285,1,0.0,0,0,0,0,0,0,0,1,0,0,1,1
2971,44007,oPl0NnurlzpABskP5WrrITS0Jx7a7lgG,fbPkOYLVPtPgIt0MxizjfFJov3JbHyAi,9,15,8,0,7,0,6,1,37,5.285714285714286,2,0.0,4,8,0,7,11,0,0,6,1,19,18,1
2972,44008,uISGM4LqBUfXPHskRZuSs9XeQkD4VUeT,fbPkOYLVPtPgIt0MxizjfFJov3JbHyAi,27,60,31,16,15,43,18,1,184,26.285714285714285,5,0.0,18,31,14,15,42,43,2,18,1,78,106,1
2973,44009,inUZ2nCJKLY6kdHcpjk8OuyitRFog1f3,fbPkOYLVPtPgIt0MxizjfFJov3JbHyAi,3,2,0,0,0,0,2,0,4,0.5714285714285714,1,0.0,0,0,0,0,2,0,0,2,0,0,4,1
2974,44010,DQ9W5Vuawh3t7n6xTYzvjArLiUFtCoJH,fbPkOYLVPtPgIt0MxizjfFJov3JbHyAi,8,3,2,0,2,0,3,0,10,1.4285714285714286,1,0.0,0,2,0,2,3,0,0,3,0,4,6,1
2975,44012,3ovcvN6GJrfjQxnw4eUnC7Zf5NE35SVV,fbPkOYLVPtPgIt0MxizjfFJov3JbHyAi,4,2,0,0,0,2,6,0,10,1.4285714285714286,1,0.0,0,0,0,0,2,2,0,6,0,0,10,1
2976,44015,NHPpKvbnrSpxM8e1DORBWJbRCpmrxZw8,fbPkOYLVPtPgIt0MxizjfFJov3JbHyAi,16,21,12,0,8,46,11,0,98,14.0,5,0.0,4,12,0,8,17,46,0,11,0,24,74,1
2977,44017,axLHybd4Fc2iEZmnM9YqehKaeSBFTLUD,fbPkOYLVPtPgIt0MxizjfFJov3JbHyAi,2,0,0,0,0,0,2,0,2,0.2857142857142857,1,0.0,0,0,0,0,0,0,0,2,0,0,2,1
2978,44019,Oqf2KMc671oV8Cn8nfq2WN2xhEjMkCKi,fbPkOYLVPtPgIt0MxizjfFJov3JbHyAi,4,2,1,0,0,5,2,0,10,1.4285714285714286,1,0.0,0,1,0,0,2,5,0,2,0,1,9,1
2979,44021,9XnnqdyPvtBGS8L2kTzLO0S9Zq2a4kse,fbPkOYLVPtPgIt0MxizjfFJov3JbHyAi,4,5,0,0,0,0,1,0,6,0.8571428571428571,1,0.0,0,0,0,0,5,0,0,1,0,0,6,1
2980,44024,LeyaS1WvDVnHnV6ZSeQmCJao8bkVjN1j,fbPkOYLVPtPgIt0MxizjfFJov3JbHyAi,17,15,11,0,8,0,13,0,47,6.714285714285714,2,0.0,0,11,0,8,15,0,0,13,0,19,28,1
2981,44027,yfYI5syGDPun1q5rrD5IBdKLVoUhhItT,fbPkOYLVPtPgIt0MxizjfFJov3JbHyAi,11,5,4,0,4,0,4,0,17,2.4285714285714284,1,0.0,0,4,0,4,5,0,0,4,0,8,9,1
2982,44028,1brUgjk7oe1eohq9hpdKTnGa8wSkRKBL,fbPkOYLVPtPgIt0MxizjfFJov3JbHyAi,7,2,1,0,1,1,4,1,10,1.4285714285714286,1,0.0,0,1,0,1,2,1,0,4,1,2,8,1
2983,44032,g4BqtfArPu1P6dUgMW0j2r9GyrSqWjFl,fbPkOYLVPtPgIt0MxizjfFJov3JbHyAi,5,0,0,0,0,1,8,1,10,1.4285714285714286,1,0.0,0,0,0,0,0,1,0,8,1,0,10,1
2984,44034,qWEVgbmp31Yz7gV3k18he9mUiT0ZSaYx,fbPkOYLVPtPgIt0MxizjfFJov3JbHyAi,7,9,3,0,5,4,4,0,25,3.5714285714285716,1,0.0,4,3,0,5,5,4,0,4,0,12,13,1
2985,44036,jdE4Va4LkoFtXkdUlWOZzY1NPPK6qDDa,fbPkOYLVPtPgIt0MxizjfFJov3JbHyAi,9,3,2,0,2,1,8,1,17,2.4285714285714284,1,0.0,0,2,0,2,3,1,0,8,1,4,13,1
2986,44040,Rbjg9UrMjdBRLHwge6hMq2hF3DaLKFjG,fbPkOYLVPtPgIt0MxizjfFJov3JbHyAi,11,14,3,4,7,15,22,2,67,9.571428571428571,1,0.0,10,3,3,7,4,15,1,22,2,23,44,1
2987,44041,sg4VVv9cgk6nt80dZvUKhL5H7RMgLm0l,fbPkOYLVPtPgIt0MxizjfFJov3JbHyAi,9,9,6,0,3,8,3,0,29,4.142857142857143,2,0.0,1,6,0,3,8,8,0,3,0,10,19,1
2988,44044,h6WpsYrDbnnoeExgTZXkYo7GgIA3j8KF,fbPkOYLVPtPgIt0MxizjfFJov3JbHyAi,10,10,5,0,4,0,6,0,25,3.5714285714285716,1,0.0,3,5,0,4,7,0,0,6,0,12,13,1
2989,44046,76y1AbpXIG79W81ou4lYi6BwTmlPjyTW,fbPkOYLVPtPgIt0MxizjfFJov3JbHyAi,5,2,1,0,1,1,2,0,7,1.0,1,0.0,0,1,0,1,2,1,0,2,0,2,5,1
2990,44049,SnBsSMsyPBAPsHuU9YoDtuue1sZbKZBQ,fbPkOYLVPtPgIt0MxizjfFJov3JbHyAi,5,0,0,0,0,0,8,1,9,1.2857142857142858,2,0.0,0,0,0,0,0,0,0,8,1,0,9,1
2991,44052,BIBVHKjUSrjc5BHdvfhhLGTavi1WeSbD,fbPkOYLVPtPgIt0MxizjfFJov3JbHyAi,12,6,3,0,3,1,5,1,19,2.7142857142857144,1,0.0,1,3,0,3,5,1,0,5,1,7,12,1
2992,44054,nkBKSO0ZKz2Wst869GlQp6mO590hIJEZ,fbPkOYLVPtPgIt0MxizjfFJov3JbHyAi,1,0,0,0,0,0,1,0,1,0.14285714285714285,1,0.0,0,0,0,0,0,0,0,1,0,0,1,1
2993,44057,ZEbYOmWwQ4Xr4MxJtDQOJ8jnLIcd8Z5c,fbPkOYLVPtPgIt0MxizjfFJov3JbHyAi,8,9,6,0,4,0,4,0,23,3.2857142857142856,2,0.0,0,6,0,4,9,0,0,4,0,10,13,1
2994,44058,4ZVrwOJI0OZGv0iKNXpa2OrPWHTNPSKw,fbPkOYLVPtPgIt0MxizjfFJov3JbHyAi,7,5,3,0,2,3,2,0,15,2.142857142857143,1,0.0,0,3,0,2,5,3,0,2,0,5,10,1
2995,44060,HCuNeFLBULV55TbURLgBOnM01N7eaTIk,fbPkOYLVPtPgIt0MxizjfFJov3JbHyAi,8,19,10,0,8,5,24,0,66,9.428571428571429,2,0.0,0,10,0,8,19,5,0,24,0,18,48,1
2996,44062,eFC0KaZbDiJdIgbG1CR6r5jTa1z0727j,fbPkOYLVPtPgIt0MxizjfFJov3JbHyAi,11,18,11,10,9,0,5,0,53,7.571428571428571,2,0.0,3,11,7,9,15,0,3,5,0,30,23,0
2997,44063,l8chSgqUsX2ezoBZ8RO3OXA3HMPgq6Xo,fbPkOYLVPtPgIt0MxizjfFJov3JbHyAi,5,3,1,0,1,0,1,0,6,0.8571428571428571,1,0.0,0,1,0,1,3,0,0,1,0,2,4,1
2998,44069,sZ59BwHHS40O9b1LKGG4hE0LdlqpaIwv,fbPkOYLVPtPgIt0MxizjfFJov3JbHyAi,17,8,7,0,7,0,3,0,25,3.5714285714285716,1,0.0,0,7,0,7,8,0,0,3,0,14,11,1
2999,44070,eQaWyowDKjzkRJdrveWWiGAaGDkIAln1,fbPkOYLVPtPgIt0MxizjfFJov3JbHyAi,7,6,3,0,4,0,2,0,15,2.142857142857143,1,0.0,2,3,0,4,4,0,0,2,0,9,6,1
3000,44071,ZAJHLqPx7azIGtI8JwkpIz4DspMCXCFT,fbPkOYLVPtPgIt0MxizjfFJov3JbHyAi,1,0,0,0,0,0,1,0,1,0.14285714285714285,1,0.0,0,0,0,0,0,0,0,1,0,0,1,1
3001,44072,xCjpMcUUR38rFwI6LVi9moe3PuSjGvgc,fbPkOYLVPtPgIt0MxizjfFJov3JbHyAi,4,2,1,0,1,0,1,0,5,0.7142857142857143,1,0.0,0,1,0,1,2,0,0,1,0,2,3,1
3002,44076,R134yB2E94tOXCDag3zVHNWrBuFFRNfi,fbPkOYLVPtPgIt0MxizjfFJov3JbHyAi,6,3,2,0,2,0,1,0,8,1.1428571428571428,1,0.0,0,2,0,2,3,0,0,1,0,4,4,1
3003,44079,L5pA3H7m2qYFia4DHW15gmoKoflabQUC,fbPkOYLVPtPgIt0MxizjfFJov3JbHyAi,11,13,8,0,5,10,9,1,46,6.571428571428571,2,0.0,1,8,0,5,12,10,0,9,1,14,32,1
3004,44081,yRofSAhoibifpAqTO7qW5tQEYNWfWlsG,fbPkOYLVPtPgIt0MxizjfFJov3JbHyAi,10,19,4,0,3,0,10,1,37,5.285714285714286,2,0.0,13,4,0,3,6,0,0,10,1,20,17,1
3005,44083,KSfQPUyfWWfWDmmi6m3KXcKzxz89wkwt,fbPkOYLVPtPgIt0MxizjfFJov3JbHyAi,1,0,0,0,0,0,1,0,1,0.14285714285714285,1,0.0,0,0,0,0,0,0,0,1,0,0,1,1
3006,44084,kk72YEo7gxDpJjFfV60A1en59PCJ8Z09,fbPkOYLVPtPgIt0MxizjfFJov3JbHyAi,7,6,3,0,1,7,6,1,24,3.4285714285714284,1,0.0,0,3,0,1,6,7,0,6,1,4,20,1
3007,44093,9lvfANZJ7eXEtCdLExkxtGg3Vbd7Wyxt,fbPkOYLVPtPgIt0MxizjfFJov3JbHyAi,6,2,1,0,0,11,5,1,20,2.857142857142857,1,0.0,0,1,0,0,2,11,0,5,1,1,19,1
3008,44095,o61d02uP0OX8m0Pmj3Zu4on4UaOcYPIz,fbPkOYLVPtPgIt0MxizjfFJov3JbHyAi,13,8,5,3,3,3,5,2,29,4.142857142857143,2,0.0,1,5,2,3,7,3,1,5,2,11,18,0
3009,44097,2OnGZLO6PGk0y08tYvyYb6lXWyUABkGv,fbPkOYLVPtPgIt0MxizjfFJov3JbHyAi,9,8,4,0,3,0,6,2,23,3.2857142857142856,1,0.0,0,4,0,3,8,0,0,6,2,7,16,1
3010,44102,WpYtemwKZQxcuLGpndx0lQojfh6o5GOv,fbPkOYLVPtPgIt0MxizjfFJov3JbHyAi,4,4,0,0,0,0,1,0,5,0.7142857142857143,1,0.0,0,0,0,0,4,0,0,1,0,0,5,1
3011,44111,nWTDOg4ZYpkavWBGTPbOIHQSMseHgPvt,fbPkOYLVPtPgIt0MxizjfFJov3JbHyAi,8,4,2,0,2,0,3,0,11,1.5714285714285714,1,0.0,0,2,0,2,4,0,0,3,0,4,7,1
3012,44112,CKlck1NtRiTrxKTlx9u8mNsXnR4Cg2LR,fbPkOYLVPtPgIt0MxizjfFJov3JbHyAi,9,10,5,0,2,4,8,1,30,4.285714285714286,1,0.0,2,5,0,2,8,4,0,8,1,9,21,1
3013,44115,rQagJMIJxMWHybJu2qCbngkHoaC1bCF5,fbPkOYLVPtPgIt0MxizjfFJov3JbHyAi,2,0,0,0,0,0,2,0,2,0.2857142857142857,1,0.0,0,0,0,0,0,0,0,2,0,0,2,1
3014,44118,GmEmBf7c8vVD8NQKlYsc3CbTgcWxYLfx,fbPkOYLVPtPgIt0MxizjfFJov3JbHyAi,4,4,2,0,2,0,1,0,9,1.2857142857142858,1,0.0,0,2,0,2,4,0,0,1,0,4,5,1
3015,44119,hp1PeKFcESsUtrkTKF98ATmX1KKCPvia,fbPkOYLVPtPgIt0MxizjfFJov3JbHyAi,25,36,15,25,13,24,2,0,115,16.428571428571427,2,0.0,14,15,22,13,22,24,3,2,0,64,51,0
3016,44122,bYjPoNbc5ILh7K7s9YR8HLOMNJGN6Ums,fbPkOYLVPtPgIt0MxizjfFJov3JbHyAi,9,5,4,0,4,1,2,0,16,2.2857142857142856,1,0.0,0,4,0,4,5,1,0,2,0,8,8,1
3017,44123,xl4s40OnU4HrS2dTDEZu2keSj0YY1fmn,fbPkOYLVPtPgIt0MxizjfFJov3JbHyAi,11,25,16,0,8,17,7,1,74,10.571428571428571,3,0.0,0,16,0,8,25,17,0,7,1,24,50,1
3018,44131,dzaUNwKZy91BtYj96fOhuSgIlp9lXQDU,fbPkOYLVPtPgIt0MxizjfFJov3JbHyAi,81,119,63,43,35,59,31,0,350,50.0,11,0.0,31,63,40,35,88,59,3,31,0,169,181,0
3019,44133,0bPKxjIIw0GaiIYeAS2yIr8ZqMELBNL4,fbPkOYLVPtPgIt0MxizjfFJov3JbHyAi,6,11,4,0,0,0,1,0,16,2.2857142857142856,1,0.0,3,4,0,0,8,0,0,1,0,7,9,1
3020,44134,aTtRtpFY1HDjnosUur6O1bYAGBELKNkH,fbPkOYLVPtPgIt0MxizjfFJov3JbHyAi,1,0,0,0,0,0,1,0,1,0.14285714285714285,1,0.0,0,0,0,0,0,0,0,1,0,0,1,1
3021,44135,ZD66lyh6v0XhCV6q1X0pQAccOqFGi52W,fbPkOYLVPtPgIt0MxizjfFJov3JbHyAi,3,2,0,0,0,0,1,0,3,0.42857142857142855,1,0.0,0,0,0,0,2,0,0,1,0,0,3,1
3022,44139,9CGgLBDhAl2a4vPzbTBoeDjYbqCZREDz,fbPkOYLVPtPgIt0MxizjfFJov3JbHyAi,6,5,3,0,3,0,1,0,12,1.7142857142857142,1,0.0,0,3,0,3,5,0,0,1,0,6,6,1
3023,44141,MykUjAz2RHfOismfBj3t8dCwbOEsrgDq,fbPkOYLVPtPgIt0MxizjfFJov3JbHyAi,5,4,2,0,1,0,3,0,10,1.4285714285714286,1,0.0,0,2,0,1,4,0,0,3,0,3,7,1
3024,44144,8ZsouqUolTSghSnsdTjJFuPUeDFeagv6,fbPkOYLVPtPgIt0MxizjfFJov3JbHyAi,1,0,0,0,0,0,1,0,1,0.14285714285714285,1,0.0,0,0,0,0,0,0,0,1,0,0,1,1
3025,44148,hd8cWgeUYWb4NyjYBEC7ZVh5Gsq9Y3Ff,fbPkOYLVPtPgIt0MxizjfFJov3JbHyAi,18,13,11,0,9,0,10,0,43,6.142857142857143,1,0.0,0,11,0,9,13,0,0,10,0,20,23,1
3026,44151,WRW8ZNpfTVG6ItpEWtCFOCrLdAppQEhA,fbPkOYLVPtPgIt0MxizjfFJov3JbHyAi,11,11,4,0,5,0,5,0,25,3.5714285714285716,1,0.0,6,4,0,5,5,0,0,5,0,15,10,1
3027,44152,ckUgzG88eR58uy370LgSc7zPpsWm2L4O,fbPkOYLVPtPgIt0MxizjfFJov3JbHyAi,11,12,7,0,5,7,6,0,37,5.285714285714286,2,0.0,0,7,0,5,12,7,0,6,0,12,25,1
3028,44155,ufy4LHvMWo0whrRq15door8x99FGdY4J,fbPkOYLVPtPgIt0MxizjfFJov3JbHyAi,26,84,42,24,10,21,5,0,186,26.571428571428573,7,0.0,33,42,20,10,51,21,4,5,0,105,81,1
3029,44159,tfcOvcMIVTpughZ66Us0P1WhX9cxijTo,fbPkOYLVPtPgIt0MxizjfFJov3JbHyAi,7,5,3,0,2,3,3,0,16,2.2857142857142856,2,0.0,0,3,0,2,5,3,0,3,0,5,11,1
3030,44161,VmHFwT6SFcmG2hmz0LuDgYb6XJYcUUSp,fbPkOYLVPtPgIt0MxizjfFJov3JbHyAi,5,2,1,0,1,3,2,0,9,1.2857142857142858,1,0.0,0,1,0,1,2,3,0,2,0,2,7,1
3031,44163,QHPITLtk56ZUotelsryOYmh753HhRll9,fbPkOYLVPtPgIt0MxizjfFJov3JbHyAi,6,3,2,0,2,0,1,0,8,1.1428571428571428,1,0.0,0,2,0,2,3,0,0,1,0,4,4,1
3032,44165,VBgEdkbZzukrjHaMBzmoJMWNefIhR359,fbPkOYLVPtPgIt0MxizjfFJov3JbHyAi,6,4,2,0,1,0,2,0,9,1.2857142857142858,1,0.0,0,2,0,1,4,0,0,2,0,3,6,1
3033,44168,b6tYxnTOArtoyrdJ0MLgwMZ9LCbErJm6,fbPkOYLVPtPgIt0MxizjfFJov3JbHyAi,8,5,3,0,2,1,5,1,17,2.4285714285714284,1,0.0,0,3,0,2,5,1,0,5,1,5,12,1
3034,44169,gMeKwVdV7xHR9zrsQTTuP5xOz4aKMsCh,fbPkOYLVPtPgIt0MxizjfFJov3JbHyAi,9,6,5,0,4,4,6,0,25,3.5714285714285716,1,0.0,0,5,0,4,6,4,0,6,0,9,16,1
3035,44170,wfBPTMOVZ2z78mcsSkE5pUWw8ps1YZeD,fbPkOYLVPtPgIt0MxizjfFJov3JbHyAi,7,7,2,0,3,0,3,0,15,2.142857142857143,1,0.0,2,2,0,3,5,0,0,3,0,7,8,1
3036,44173,kNdT4Mob6J1VkdvqbhmS4aPzbDLqNeYP,fbPkOYLVPtPgIt0MxizjfFJov3JbHyAi,11,17,8,0,5,3,10,1,44,6.285714285714286,2,0.0,3,8,0,5,14,3,0,10,1,16,28,1
3037,44176,8TCCmIoVZzZAPAuNITv5aLi5oDEbcxb0,fbPkOYLVPtPgIt0MxizjfFJov3JbHyAi,7,5,3,0,2,0,8,1,19,2.7142857142857144,1,0.0,0,3,0,2,5,0,0,8,1,5,14,1
3038,44177,MikH0dwnUPgwm1pOxLfLikTx2rTYR4VE,fbPkOYLVPtPgIt0MxizjfFJov3JbHyAi,6,2,1,0,1,0,5,1,10,1.4285714285714286,1,0.0,0,1,0,1,2,0,0,5,1,2,8,1
3039,44180,1MF1O9UiGEPKiN9XxCO7tMvYDB1feEh9,fbPkOYLVPtPgIt0MxizjfFJov3JbHyAi,7,2,1,0,1,0,7,1,12,1.7142857142857142,1,0.0,0,1,0,1,2,0,0,7,1,2,10,1
3040,44183,xdClWt95AonMUbXmVncDz7pyQAF4u9BG,fbPkOYLVPtPgIt0MxizjfFJov3JbHyAi,5,2,1,0,1,0,3,0,7,1.0,1,0.0,0,1,0,1,2,0,0,3,0,2,5,1
3041,44189,1eQmYbeMjDeGW0fORE6JAUI81WibJPEv,fbPkOYLVPtPgIt0MxizjfFJov3JbHyAi,1,0,0,0,0,0,1,0,1,0.14285714285714285,1,0.0,0,0,0,0,0,0,0,1,0,0,1,1
3042,44190,RJAPKuvNhyLyzVhUoacg3kyQMrusLDCW,fbPkOYLVPtPgIt0MxizjfFJov3JbHyAi,20,41,23,0,9,0,10,2,85,12.142857142857142,2,0.0,13,23,0,9,28,0,0,10,2,45,40,1
3043,44191,MkhWkWrDBg7jFp3XklVC8uZQ46nAon3u,fbPkOYLVPtPgIt0MxizjfFJov3JbHyAi,17,36,14,0,6,3,6,2,67,9.571428571428571,1,0.0,6,14,0,6,30,3,0,6,2,26,41,1
3044,44192,c1zULVJb8UrzwaeCwQXbXVIx3xb2chrp,fbPkOYLVPtPgIt0MxizjfFJov3JbHyAi,6,4,3,0,1,0,11,0,19,2.7142857142857144,5,0.0,1,3,0,1,3,0,0,11,0,5,14,0
3045,44197,ZqSAxgvVLUFu6IOm5zNZalNXouYaP76y,fbPkOYLVPtPgIt0MxizjfFJov3JbHyAi,18,23,12,9,9,6,5,1,65,9.285714285714286,2,0.0,9,12,7,9,14,6,2,5,1,37,28,1
3046,44198,H1kvrsGGsPor5huYrdsnL3Isag4wSKlt,fbPkOYLVPtPgIt0MxizjfFJov3JbHyAi,22,16,7,11,8,0,1,0,43,6.142857142857143,1,0.0,8,7,11,8,8,0,0,1,0,34,9,1
3047,44199,K28hkwMS8Ua9nbLnLUJX6puRWq44TrF0,fbPkOYLVPtPgIt0MxizjfFJov3JbHyAi,4,2,1,0,1,0,1,0,5,0.7142857142857143,1,0.0,0,1,0,1,2,0,0,1,0,2,3,1
3048,44200,UeDs0IsM5JGu9WKbkZDo576REb7pnQUn,fbPkOYLVPtPgIt0MxizjfFJov3JbHyAi,1,0,0,0,0,0,1,0,1,0.14285714285714285,1,0.0,0,0,0,0,0,0,0,1,0,0,1,1
3049,44204,VndQ6jKo03PwXryVilJVgpCAmWUkBbqD,fbPkOYLVPtPgIt0MxizjfFJov3JbHyAi,8,3,2,0,2,0,5,0,12,1.7142857142857142,1,0.0,0,2,0,2,3,0,0,5,0,4,8,1
3050,44205,xeper6lTTTduQkRnWSDeRoAUobRsjfTO,fbPkOYLVPtPgIt0MxizjfFJov3JbHyAi,12,10,5,2,4,15,4,1,41,5.857142857142857,1,0.0,3,5,2,4,7,15,0,4,1,14,27,1
3051,44206,pmP1vo676Ls6u06kxeOxjGCjZN5T0bfn,fbPkOYLVPtPgIt0MxizjfFJov3JbHyAi,7,5,2,0,2,0,2,0,11,1.5714285714285714,1,0.0,0,2,0,2,5,0,0,2,0,4,7,1
3052,44207,jWewOVeTfMYYPxwOYqT1SGXzvovpIvz3,fbPkOYLVPtPgIt0MxizjfFJov3JbHyAi,5,2,1,0,1,0,5,0,9,1.2857142857142858,1,0.0,0,1,0,1,2,0,0,5,0,2,7,1
3053,44210,3tTsLPRBksgsW30Yifh6MWgLDquCQM2g,fbPkOYLVPtPgIt0MxizjfFJov3JbHyAi,8,3,2,0,2,0,3,2,12,1.7142857142857142,1,0.0,0,2,0,2,3,0,0,3,2,4,8,1
3054,44211,u1AyJHfZVkCbqmaTVxNT62X9SEOZHm4M,fbPkOYLVPtPgIt0MxizjfFJov3JbHyAi,7,4,2,0,1,0,4,0,11,1.5714285714285714,1,0.0,0,2,0,1,4,0,0,4,0,3,8,1
3055,44214,90af6u7O75fWjzbthnMq7awDtdd9TeI9,fbPkOYLVPtPgIt0MxizjfFJov3JbHyAi,7,6,3,0,2,3,1,0,15,2.142857142857143,1,0.0,0,3,0,2,6,3,0,1,0,5,10,1
3056,44218,hJGj3kQ93iSqrSQuFovt8Qk2BphLpPcg,fbPkOYLVPtPgIt0MxizjfFJov3JbHyAi,2,0,0,0,0,0,6,0,6,0.8571428571428571,1,0.0,0,0,0,0,0,0,0,6,0,0,6,1
3057,44220,hy5uxKEcxvtHS3tlaeM1vWwbo38Hj0n0,fbPkOYLVPtPgIt0MxizjfFJov3JbHyAi,11,19,9,0,6,18,7,0,59,8.428571428571429,2,0.0,3,9,0,6,16,18,0,7,0,18,41,0
3058,44221,JBImmJkUH6RU5EuKvs04Gb9Ih8CxmZjg,fbPkOYLVPtPgIt0MxizjfFJov3JbHyAi,2,0,0,0,0,0,10,0,10,1.4285714285714286,2,0.0,0,0,0,0,0,0,0,10,0,0,10,1
3059,44222,cztDDQRMLEL2fROQpw4ZlOpH3qNEy4bb,fbPkOYLVPtPgIt0MxizjfFJov3JbHyAi,1,0,0,0,0,0,1,0,1,0.14285714285714285,1,0.0,0,0,0,0,0,0,0,1,0,0,1,1
3060,44223,1RzKq1UsN4x78Mgw0Ly9Is8DkKOORlnQ,fbPkOYLVPtPgIt0MxizjfFJov3JbHyAi,2,0,0,0,0,0,7,0,7,1.0,1,0.0,0,0,0,0,0,0,0,7,0,0,7,1
3061,44224,zpieVPimuNuvyfb8XZsK7ZjTM6u74cRF,fbPkOYLVPtPgIt0MxizjfFJov3JbHyAi,6,2,1,0,1,0,2,0,6,0.8571428571428571,1,0.0,0,1,0,1,2,0,0,2,0,2,4,1
3062,44226,VYNucadxJwAl4oUfBMF6a5hY4ZvYaLjQ,fbPkOYLVPtPgIt0MxizjfFJov3JbHyAi,26,55,18,30,16,4,14,1,138,19.714285714285715,3,0.0,30,18,28,16,25,4,2,14,1,92,46,1
3063,44231,AQMZ0ecVv6yIj8PNV5GC8bjPJquyjuSz,fbPkOYLVPtPgIt0MxizjfFJov3JbHyAi,18,52,21,14,14,23,15,2,141,20.142857142857142,5,0.0,19,21,12,14,33,23,2,15,2,66,75,1
3064,44234,UDo4onvYbb2pCnzrdvVIV4SfsdccpEQm,fbPkOYLVPtPgIt0MxizjfFJov3JbHyAi,4,3,1,0,1,2,1,0,8,1.1428571428571428,1,0.0,0,1,0,1,3,2,0,1,0,2,6,1
3065,44235,NotCBcEqqDsUQXSDLm2TrhVN2AkQ1PWh,fbPkOYLVPtPgIt0MxizjfFJov3JbHyAi,2,0,0,0,0,0,5,0,5,0.7142857142857143,1,0.0,0,0,0,0,0,0,0,5,0,0,5,1
3066,44238,9qv2s3k2hG6Dn32V5Dxzc9l86R5tLy2Y,fbPkOYLVPtPgIt0MxizjfFJov3JbHyAi,8,12,6,0,4,0,3,0,25,3.5714285714285716,2,0.0,1,6,0,4,11,0,0,3,0,11,14,1
3067,44241,RlfgxVU45fTUQ2rrZmOGyzpDUuAkm82S,fbPkOYLVPtPgIt0MxizjfFJov3JbHyAi,8,8,0,0,1,2,11,1,23,3.2857142857142856,1,0.0,2,0,0,1,6,2,0,11,1,3,20,1
3068,44245,Qs9VQJkriDZBH3FlG0bgTumvMa49MEaO,fbPkOYLVPtPgIt0MxizjfFJov3JbHyAi,20,88,33,10,32,12,16,1,192,27.428571428571427,9,0.0,23,33,9,32,65,12,1,16,1,97,95,0
3069,44246,kf48MnOeHkW7v0hNxfQUaCVe32or0xVe,fbPkOYLVPtPgIt0MxizjfFJov3JbHyAi,8,4,3,0,2,0,3,0,12,1.7142857142857142,1,0.0,0,3,0,2,4,0,0,3,0,5,7,1
3070,44247,0zumY6pgP7xEn5eA1MMsT2riPT41hmwE,fbPkOYLVPtPgIt0MxizjfFJov3JbHyAi,11,9,5,0,4,0,2,0,20,2.857142857142857,2,0.0,1,5,0,4,8,0,0,2,0,10,10,1
3071,44249,d6iEuc9ggOjxGIdMWyLvfDI4lEqo5BAX,fbPkOYLVPtPgIt0MxizjfFJov3JbHyAi,8,10,6,0,4,1,3,0,24,3.4285714285714284,2,0.0,1,6,0,4,9,1,0,3,0,11,13,1
3072,44250,g1tIXPWfZhmnEZEG9z52U31YrMwRUSiT,fbPkOYLVPtPgIt0MxizjfFJov3JbHyAi,15,30,15,12,12,15,15,1,100,14.285714285714286,2,0.0,8,15,8,12,22,15,4,15,1,43,57,1
3073,44254,DxX4QPcfDwxjWtFJm5EFgLobXDWqAEqS,fbPkOYLVPtPgIt0MxizjfFJov3JbHyAi,7,7,5,0,4,6,3,0,25,3.5714285714285716,2,0.0,0,5,0,4,7,6,0,3,0,9,16,1
3074,44255,zVdtg8NVS1UKsR7hBTuXsHvQ0Y2M8ZjR,fbPkOYLVPtPgIt0MxizjfFJov3JbHyAi,6,3,2,0,2,0,2,0,9,1.2857142857142858,1,0.0,0,2,0,2,3,0,0,2,0,4,5,1
3075,44259,v5DL1tRN6AvAeQThFmEHNCo6sn5M6uIG,fbPkOYLVPtPgIt0MxizjfFJov3JbHyAi,9,26,13,3,6,8,14,0,70,10.0,4,0.0,7,13,3,6,19,8,0,14,0,29,41,1
3076,44261,JaD7mqaE0bkEF64A4nrAbGGFeYQR80Ys,fbPkOYLVPtPgIt0MxizjfFJov3JbHyAi,21,37,3,17,8,0,9,0,74,10.571428571428571,5,0.0,22,3,14,8,15,0,3,9,0,47,27,1
3077,44262,EWKyvUI6fjHJ7AQcKlSBWUO2bca5ubo6,fbPkOYLVPtPgIt0MxizjfFJov3JbHyAi,19,31,11,11,12,6,30,1,102,14.571428571428571,1,0.0,13,11,9,12,18,6,2,30,1,45,57,1
3078,44266,8LoJ3UkmcZEmQsx5Wwgf18vm50gv36wN,fbPkOYLVPtPgIt0MxizjfFJov3JbHyAi,37,47,24,19,15,52,17,1,175,25.0,4,0.0,16,24,18,15,31,52,1,17,1,73,102,1
3079,44268,Fm9D7fGEScpbD1TbGjzCqweaOK1CX2Mr,fbPkOYLVPtPgIt0MxizjfFJov3JbHyAi,5,3,1,0,1,0,9,0,14,2.0,1,0.0,0,1,0,1,3,0,0,9,0,2,12,1
3080,44269,uDkm2sS75pRjgqry4uezxxAPyhgOOrpN,fbPkOYLVPtPgIt0MxizjfFJov3JbHyAi,6,16,1,0,1,4,2,0,24,3.4285714285714284,1,0.0,2,1,0,1,14,4,0,2,0,4,20,1
3081,44271,1V3TxSEX8RFiuvxHNXCh1zQbhpFBX9Tf,fbPkOYLVPtPgIt0MxizjfFJov3JbHyAi,2,0,0,0,0,0,3,0,3,0.42857142857142855,1,0.0,0,0,0,0,0,0,0,3,0,0,3,1
3082,44273,v4VtiypZ3gKvKYOCZEjKIfSgOk6hH0T6,fbPkOYLVPtPgIt0MxizjfFJov3JbHyAi,18,18,9,16,8,0,6,0,57,8.142857142857142,2,0.0,5,9,12,8,13,0,4,6,0,34,23,1
3083,44276,oVGH1nEV79R6JEth0UtmMIUIu6BZjaDG,fbPkOYLVPtPgIt0MxizjfFJov3JbHyAi,7,11,3,0,2,9,7,0,32,4.571428571428571,1,0.0,0,3,0,2,11,9,0,7,0,5,27,1
3084,44278,0vLnRe5y9b9pBloxjGZQUFmqmEJONAkl,fbPkOYLVPtPgIt0MxizjfFJov3JbHyAi,6,4,2,0,2,0,1,0,9,1.2857142857142858,1,0.0,0,2,0,2,4,0,0,1,0,4,5,1
3085,44281,ocGAaC1x5z02wnoRsT01upUCTbjuENeN,fbPkOYLVPtPgIt0MxizjfFJov3JbHyAi,12,12,6,0,5,9,8,3,43,6.142857142857143,1,0.0,0,6,0,5,12,9,0,8,3,11,32,1
3086,44292,3ny9mc45r6qJQOOxmh4xg5QHGygeiHbu,fbPkOYLVPtPgIt0MxizjfFJov3JbHyAi,9,6,2,1,2,0,2,0,13,1.8571428571428572,1,0.0,1,2,1,2,5,0,0,2,0,6,7,1
3087,44293,XpTBA5oDkoJbl0jjlH57SraU2q4zBLWW,fbPkOYLVPtPgIt0MxizjfFJov3JbHyAi,5,0,0,0,0,3,4,1,8,1.1428571428571428,1,0.0,0,0,0,0,0,3,0,4,1,0,8,1
3088,44294,RTkGQ4UmTL2ed98p2vxbPQoTurdG2SAC,fbPkOYLVPtPgIt0MxizjfFJov3JbHyAi,17,19,12,0,8,2,5,0,46,6.571428571428571,3,0.0,0,12,0,8,19,2,0,5,0,20,26,1
3089,44298,ABJgMBFFKl294n68xTf25Os1AW439ijN,fbPkOYLVPtPgIt0MxizjfFJov3JbHyAi,1,0,0,0,0,0,1,0,1,0.14285714285714285,1,0.0,0,0,0,0,0,0,0,1,0,0,1,1
3090,44300,oO4ZerJgmfSMeyHkgVIxV4spEvg9yQJk,fbPkOYLVPtPgIt0MxizjfFJov3JbHyAi,6,3,2,0,2,0,1,0,8,1.1428571428571428,1,0.0,0,2,0,2,3,0,0,1,0,4,4,1
3091,44301,3zvHKS6M4U1m424fRhI52J9JeELqakS5,fbPkOYLVPtPgIt0MxizjfFJov3JbHyAi,4,5,1,0,0,0,3,0,9,1.2857142857142858,2,0.0,0,1,0,0,5,0,0,3,0,1,8,1
3092,44305,speERHm9QGPSObf8TcqRV8vukGx9NoGR,fbPkOYLVPtPgIt0MxizjfFJov3JbHyAi,4,3,2,0,0,0,5,0,10,1.4285714285714286,1,0.0,0,2,0,0,3,0,0,5,0,2,8,1
3093,44307,nxuexUreiYSzpSapqT3MF6tzgH9I1i5D,fbPkOYLVPtPgIt0MxizjfFJov3JbHyAi,5,2,1,0,1,0,3,0,7,1.0,1,0.0,0,1,0,1,2,0,0,3,0,2,5,1
3094,44309,LLsy8k18PLzqaAWgeu3HZsydISuZ18ow,fbPkOYLVPtPgIt0MxizjfFJov3JbHyAi,21,38,16,11,16,8,6,0,95,13.571428571428571,5,0.0,13,16,8,16,25,8,3,6,0,53,42,1
3095,45311,b28qvpjrNqMA0awJsB8hLMAyVGCoQbbk,G8EPVSXsOYB5YQWZGiz1aVq5Pgr2GrQu,7,6,1,0,2,0,5,0,14,2.0,2,0.0,4,1,0,2,2,0,0,5,0,7,7,1
3096,45351,YUDUYDMwNH7HxjxwbXkgNGbRIGFCEsrp,RXDvfPUBYFlVdlueBFbLW0mhhAyGEqpt,1,0,0,0,0,0,1,0,1,0.14285714285714285,1,0.0,0,0,0,0,0,0,0,1,0,0,1,1
3097,45360,n2Bw3Z0s4Gtstp5ZMzZilJIZC4rZeeNT,RXDvfPUBYFlVdlueBFbLW0mhhAyGEqpt,14,13,10,0,6,0,7,0,36,5.142857142857143,2,0.0,0,10,0,6,13,0,0,7,0,16,20,0
3098,45377,j1jdy8OF5VQw4rqSYOkbK2pQplvvvz37,RXDvfPUBYFlVdlueBFbLW0mhhAyGEqpt,1,0,0,0,0,0,3,0,3,0.42857142857142855,1,0.0,0,0,0,0,0,0,0,3,0,0,3,1
3099,45465,S2JQaGbkoCWVoXxNa4G5dVj0cKlAhzdj,G8EPVSXsOYB5YQWZGiz1aVq5Pgr2GrQu,1,0,0,0,0,0,1,0,1,0.14285714285714285,1,0.0,0,0,0,0,0,0,0,1,0,0,1,1
3100,45528,a6zSl0gjLWH0dh3jFMjFS9ulsRXPRoyp,G8EPVSXsOYB5YQWZGiz1aVq5Pgr2GrQu,12,12,6,12,1,1,8,1,41,5.857142857142857,2,0.0,3,6,10,1,9,1,2,8,1,20,21,1
3101,45530,BQi6o3YIDMuHZg7pBKL2EQvhTIhuaxJ1,RXDvfPUBYFlVdlueBFbLW0mhhAyGEqpt,22,27,3,0,2,0,11,0,43,6.142857142857143,5,0.0,0,3,0,2,27,0,0,11,0,5,38,1
3102,45577,JXWz1gOpRnT7ZzNBuPorM6sgihC1HCez,G8EPVSXsOYB5YQWZGiz1aVq5Pgr2GrQu,26,33,13,10,11,5,11,1,84,12.0,4,0.0,15,13,9,11,18,5,1,11,1,48,36,1
3103,45591,cANiCKhLAefO0FGisAnCzMrx1JIRd95C,G8EPVSXsOYB5YQWZGiz1aVq5Pgr2GrQu,15,10,0,20,0,0,9,0,39,5.571428571428571,2,0.0,0,0,16,0,10,0,4,9,0,16,23,1
3104,45614,aCMLJ0A5ki1G82R2CtOxjr8OrznWuiC4,RXDvfPUBYFlVdlueBFbLW0mhhAyGEqpt,17,24,3,2,2,1,8,1,41,5.857142857142857,4,0.0,3,3,2,2,21,1,0,8,1,10,31,0
3105,45699,K1CIuuqKM8wD54LStvCDz7Yn5t0CkHIq,RXDvfPUBYFlVdlueBFbLW0mhhAyGEqpt,2,0,0,0,0,0,2,0,2,0.2857142857142857,2,0.0,0,0,0,0,0,0,0,2,0,0,2,1
3106,45831,VmamyIiK1jSOxNtAs2j1qAN0wTVBPgfx,RXDvfPUBYFlVdlueBFbLW0mhhAyGEqpt,1,0,0,0,0,0,2,0,2,0.2857142857142857,1,0.0,0,0,0,0,0,0,0,2,0,0,2,1
3107,45843,0DHsJAElXb9hqHUPTXAQocHtOXvWXP78,G8EPVSXsOYB5YQWZGiz1aVq5Pgr2GrQu,1,0,0,0,0,0,1,0,1,0.14285714285714285,1,0.0,0,0,0,0,0,0,0,1,0,0,1,1
3108,45847,CpJFUzNBBad8gxGQfFWcVCTdakqtlRdi,G8EPVSXsOYB5YQWZGiz1aVq5Pgr2GrQu,1,0,0,0,0,0,1,0,1,0.14285714285714285,1,0.0,0,0,0,0,0,0,0,1,0,0,1,1
3109,45896,xTXd8tIpTtdrquABXzBf4mWdlBXfSN1C,RXDvfPUBYFlVdlueBFbLW0mhhAyGEqpt,1,0,0,0,0,0,1,0,1,0.14285714285714285,1,0.0,0,0,0,0,0,0,0,1,0,0,1,1
3110,45921,0Uvd29I2Jn8OHG2XWh0gsDCQWSV0omOU,G8EPVSXsOYB5YQWZGiz1aVq5Pgr2GrQu,13,12,2,6,2,0,3,0,25,3.5714285714285716,3,0.0,3,2,3,2,9,0,3,3,0,10,15,1
3111,46035,0Zq8B7S84C5PTvA0nNf1DjHNx9AarY36,G8EPVSXsOYB5YQWZGiz1aVq5Pgr2GrQu,6,4,1,0,2,8,6,1,22,3.142857142857143,2,0.0,2,1,0,2,2,8,0,6,1,5,17,1
3112,46037,OQeiYxdljaHZZUTeWOEaPzOq9rygakd3,RXDvfPUBYFlVdlueBFbLW0mhhAyGEqpt,21,33,25,23,15,0,7,0,103,14.714285714285714,3,0.0,2,25,20,15,31,0,3,7,0,62,41,1
3113,46053,gvkM0LsKRQYuvgC8Hpf4C14gSdMpspZj,RXDvfPUBYFlVdlueBFbLW0mhhAyGEqpt,15,17,4,21,8,0,3,0,53,7.571428571428571,2,0.0,13,4,18,8,4,0,3,3,0,43,10,1
3114,46068,H3iVkRV8UPZvsbvYrU1dnbX51IlHemsF,RXDvfPUBYFlVdlueBFbLW0mhhAyGEqpt,9,9,2,0,1,0,5,0,17,2.4285714285714284,5,0.0,0,2,0,1,9,0,0,5,0,3,14,0
3115,46092,98ZYW8gcU4Hxzep6tki6R3HQndcbamAh,RXDvfPUBYFlVdlueBFbLW0mhhAyGEqpt,1,0,0,0,0,0,1,0,1,0.14285714285714285,1,0.0,0,0,0,0,0,0,0,1,0,0,1,1
3116,46102,sGJu15oKkQx4W6qHl6Xom6U8DHxzhJdN,G8EPVSXsOYB5YQWZGiz1aVq5Pgr2GrQu,1,0,0,0,0,0,1,0,1,0.14285714285714285,1,0.0,0,0,0,0,0,0,0,1,0,0,1,1
3117,46115,TY20DTNTajpRAyDCw2XYDvuFZloaGUMy,RXDvfPUBYFlVdlueBFbLW0mhhAyGEqpt,11,19,9,0,0,5,10,1,44,6.285714285714286,2,0.0,9,9,0,0,10,5,0,10,1,18,26,1
3118,46215,MEUnkhrmqL9ON8PWbJJQFcg86E54kgxb,RXDvfPUBYFlVdlueBFbLW0mhhAyGEqpt,1,0,0,0,0,0,1,0,1,0.14285714285714285,1,0.0,0,0,0,0,0,0,0,1,0,0,1,1
3119,46249,khWVYmdWxnvqYtc79BZbIfd9BwoftBF7,RXDvfPUBYFlVdlueBFbLW0mhhAyGEqpt,1,0,0,0,0,0,1,0,1,0.14285714285714285,1,0.0,0,0,0,0,0,0,0,1,0,0,1,1
3120,46269,ciDlATwKIeO3pzuVf93RXkCmSkEbDZee,RXDvfPUBYFlVdlueBFbLW0mhhAyGEqpt,18,42,1,12,1,0,9,1,66,9.428571428571429,3,0.0,4,1,10,1,38,0,2,9,1,16,50,1
3121,46337,Rsrb1XM1aPdEAzSt1ydc7TbF7ep7aOyM,G8EPVSXsOYB5YQWZGiz1aVq5Pgr2GrQu,1,0,0,0,0,0,2,0,2,0.2857142857142857,1,0.0,0,0,0,0,0,0,0,2,0,0,2,1
3122,46359,6prInvUnT1ahW1Psrbr1FgolDYnjdXNy,RXDvfPUBYFlVdlueBFbLW0mhhAyGEqpt,1,0,0,0,0,0,1,0,1,0.14285714285714285,1,0.0,0,0,0,0,0,0,0,1,0,0,1,1
3123,46423,mufweOLZc5URTsjF5U8S2NwmI2DUiqcr,G8EPVSXsOYB5YQWZGiz1aVq5Pgr2GrQu,1,0,0,0,0,0,1,0,1,0.14285714285714285,1,0.0,0,0,0,0,0,0,0,1,0,0,1,1
3124,46437,TOrqBZDp9GjgXoTZI9iOS0r8wbO7CyB1,RXDvfPUBYFlVdlueBFbLW0mhhAyGEqpt,35,33,25,32,16,6,8,0,120,17.142857142857142,6,0.0,5,25,31,16,28,6,1,8,0,77,43,0
3125,46479,xSwC5YVwlqQI12zsRbCFcdEzFRC8jvLt,fbPkOYLVPtPgIt0MxizjfFJov3JbHyAi,50,228,13,48,9,118,33,2,451,64.42857142857143,9,0.0,95,13,44,9,133,118,4,33,2,161,290,1
3126,46480,MtDn5Hc2NrJY0NIN3hUo3bzbe51wyoG1,fbPkOYLVPtPgIt0MxizjfFJov3JbHyAi,6,2,1,0,1,0,4,0,8,1.1428571428571428,1,0.0,0,1,0,1,2,0,0,4,0,2,6,1
3127,46486,XYKEbaRABcMuBHmMB2I3YkBepzCp0swB,fbPkOYLVPtPgIt0MxizjfFJov3JbHyAi,34,79,3,31,13,75,17,1,219,31.285714285714285,6,0.0,37,3,23,13,42,75,8,17,1,76,143,1
3128,46488,5VcQW1dsZO9SFTtQE9ieV8dTnE3WZtAH,fbPkOYLVPtPgIt0MxizjfFJov3JbHyAi,42,95,26,39,16,1,14,4,195,27.857142857142858,3,0.0,24,26,33,16,71,1,6,14,4,99,96,1
3129,46490,GFOtGeWpej2vOEFvAlaIiOAxIuydKL8r,fbPkOYLVPtPgIt0MxizjfFJov3JbHyAi,1,0,0,0,0,0,1,0,1,0.14285714285714285,1,0.0,0,0,0,0,0,0,0,1,0,0,1,1
3130,46491,5DtI3jRGKF8MjArBAkeRlZ7S3llvU9hJ,fbPkOYLVPtPgIt0MxizjfFJov3JbHyAi,13,15,11,0,8,0,12,0,46,6.571428571428571,1,0.0,1,11,0,8,14,0,0,12,0,20,26,1
3131,46493,ZSamATIYC2PRfbcHh6ixkqUmlwzHYO9B,fbPkOYLVPtPgIt0MxizjfFJov3JbHyAi,7,2,1,0,1,4,4,2,14,2.0,1,0.0,0,1,0,1,2,4,0,4,2,2,12,1
3132,46495,kyoxb5V3l4e9xHjLzGcc4Zkj5x5jcbib,fbPkOYLVPtPgIt0MxizjfFJov3JbHyAi,27,30,16,29,14,11,5,1,106,15.142857142857142,2,0.0,12,16,21,14,18,11,8,5,1,63,43,1
3133,46497,S3wWlLKFbpoawwphxIy6q8DO9Rbo9Vr2,fbPkOYLVPtPgIt0MxizjfFJov3JbHyAi,2,0,0,0,0,0,2,0,2,0.2857142857142857,1,0.0,0,0,0,0,0,0,0,2,0,0,2,1
3134,46499,lRdsv9fYLnIcUL3TBjBQriZ2JWdvMb3q,fbPkOYLVPtPgIt0MxizjfFJov3JbHyAi,11,14,5,7,8,0,8,0,42,6.0,1,0.0,8,5,5,8,6,0,2,8,0,26,16,1
3135,46502,1jF4i27HOUbotwD2J9eQl8mWP4HNYpQb,fbPkOYLVPtPgIt0MxizjfFJov3JbHyAi,7,6,3,0,2,0,5,1,17,2.4285714285714284,1,0.0,1,3,0,2,5,0,0,5,1,6,11,1
3136,46506,zFt7rS5Ni4X3ECj04tcq3nH3EFoFZ84i,fbPkOYLVPtPgIt0MxizjfFJov3JbHyAi,6,5,2,0,2,0,2,0,11,1.5714285714285714,1,0.0,0,2,0,2,5,0,0,2,0,4,7,1
3137,46507,PCZm3QTx838vIR2ddmMUqYGr7hfCHZlX,fbPkOYLVPtPgIt0MxizjfFJov3JbHyAi,1,0,0,0,0,0,2,0,2,0.2857142857142857,1,0.0,0,0,0,0,0,0,0,2,0,0,2,1
3138,46508,sRnzromKdYo1GrGgSS37szKdSdhGa5G6,fbPkOYLVPtPgIt0MxizjfFJov3JbHyAi,18,10,9,0,8,0,2,0,29,4.142857142857143,1,0.0,0,9,0,8,10,0,0,2,0,17,12,1
3139,46509,wUS4QMZENKgcJOovrFGfoZniw3fDJWWg,fbPkOYLVPtPgIt0MxizjfFJov3JbHyAi,61,89,52,22,20,34,51,1,269,38.42857142857143,13,0.0,23,52,22,20,66,34,0,51,1,117,152,0
3140,46510,vCnaR7A3EMdV2eOQ4pBMh0byIjK5VwLE,fbPkOYLVPtPgIt0MxizjfFJov3JbHyAi,13,25,12,0,1,4,6,0,48,6.857142857142857,1,0.0,0,12,0,1,25,4,0,6,0,13,35,1
3141,46521,oSHVr2wJcX30QpIU9UqknqqlABAuhq3p,fbPkOYLVPtPgIt0MxizjfFJov3JbHyAi,8,4,3,0,2,0,7,0,16,2.2857142857142856,1,0.0,0,3,0,2,4,0,0,7,0,5,11,1
3142,46525,8leBy69GlSv8dJWktFbENy7QX7XuxXJV,fbPkOYLVPtPgIt0MxizjfFJov3JbHyAi,1,0,0,0,0,0,1,0,1,0.14285714285714285,1,0.0,0,0,0,0,0,0,0,1,0,0,1,1
3143,46528,0WR29JaRQtT4k6Qay1AHwZZo1wPFV6rM,fbPkOYLVPtPgIt0MxizjfFJov3JbHyAi,8,3,2,0,2,0,3,0,10,1.4285714285714286,1,0.0,0,2,0,2,3,0,0,3,0,4,6,1
3144,46532,iWEmpult7cdvgdjFW97TkROBvpRLqQNG,fbPkOYLVPtPgIt0MxizjfFJov3JbHyAi,1,0,0,0,0,0,1,0,1,0.14285714285714285,1,0.0,0,0,0,0,0,0,0,1,0,0,1,1
3145,46535,fdzq5tofwv4sAm3YqrsC6AMOnGl1oPA0,fbPkOYLVPtPgIt0MxizjfFJov3JbHyAi,26,48,1,18,9,13,21,2,112,16.0,4,0.0,25,1,15,9,23,13,3,21,2,50,62,1
3146,46537,TPC5VVSAcF8gFV38c4L30rHoJE6Gnwyt,fbPkOYLVPtPgIt0MxizjfFJov3JbHyAi,1,0,0,0,0,0,1,0,1,0.14285714285714285,1,0.0,0,0,0,0,0,0,0,1,0,0,1,1
3147,46538,PUFh3BsQaDVIJMDvwsFTqkrgAzvjO9ME,fbPkOYLVPtPgIt0MxizjfFJov3JbHyAi,5,4,2,0,1,0,1,0,8,1.1428571428571428,1,0.0,0,2,0,1,4,0,0,1,0,3,5,1
3148,46539,5lKHsIfbHqFuRTaXGCcOvuWTQPnbutQz,fbPkOYLVPtPgIt0MxizjfFJov3JbHyAi,14,16,4,4,8,5,13,1,51,7.285714285714286,1,0.0,10,4,3,8,6,5,1,13,1,25,26,1
3149,46542,pSw6NR4rsSse1CEq7lXuqdp47AxBAOW4,fbPkOYLVPtPgIt0MxizjfFJov3JbHyAi,12,8,5,6,4,0,6,0,29,4.142857142857143,2,0.0,1,5,5,4,7,0,1,6,0,15,14,1
3150,46545,z5vRcYNQa59xIDqKogHjXQX8tInd0ezN,fbPkOYLVPtPgIt0MxizjfFJov3JbHyAi,7,4,3,0,0,0,4,1,12,1.7142857142857142,1,0.0,0,3,0,0,4,0,0,4,1,3,9,1
3151,46546,RxVWvRN6nC74h4K2UUaoi1CZPrOsRdzT,fbPkOYLVPtPgIt0MxizjfFJov3JbHyAi,10,4,3,0,3,0,3,0,13,1.8571428571428572,1,0.0,0,3,0,3,4,0,0,3,0,6,7,1
3152,46548,85Gd0egbITBoZ0qf12CC4QmkR1r0ZNfP,fbPkOYLVPtPgIt0MxizjfFJov3JbHyAi,1,0,0,0,0,0,1,0,1,0.14285714285714285,1,0.0,0,0,0,0,0,0,0,1,0,0,1,1
3153,46551,kWet01DzGE5Z1z6FwJt5yEexIuvkBhsh,fbPkOYLVPtPgIt0MxizjfFJov3JbHyAi,7,21,3,0,4,16,5,0,49,7.0,3,0.0,8,3,0,4,13,16,0,5,0,15,34,0
3154,46553,3iTz6LNdmrAf4N1vHZusHFiE1Zs4S5Tp,fbPkOYLVPtPgIt0MxizjfFJov3JbHyAi,14,9,5,0,4,1,6,2,27,3.857142857142857,1,0.0,2,5,0,4,7,1,0,6,2,11,16,1
3155,46554,XDsU9hjOJ2JutIT7BD3Uu690qeQfLlzy,fbPkOYLVPtPgIt0MxizjfFJov3JbHyAi,8,9,6,0,4,0,7,0,26,3.7142857142857144,2,0.0,0,6,0,4,9,0,0,7,0,10,16,0
3156,46563,jeCWCRGTMsRbs6OIyOwUGbeuGaxOlgRf,fbPkOYLVPtPgIt0MxizjfFJov3JbHyAi,8,6,3,0,4,0,3,0,16,2.2857142857142856,2,0.0,2,3,0,4,4,0,0,3,0,9,7,1
3157,46572,ot3QeXNrfLK0N6qyT4MMuMtdNheYtJct,fbPkOYLVPtPgIt0MxizjfFJov3JbHyAi,8,2,1,0,1,2,6,1,13,1.8571428571428572,3,0.0,0,1,0,1,2,2,0,6,1,2,11,1
3158,46575,Qo1OAp8GglCOhKICbcJQhmG7Ih2RNYzD,fbPkOYLVPtPgIt0MxizjfFJov3JbHyAi,2,0,0,0,0,0,4,0,4,0.5714285714285714,1,0.0,0,0,0,0,0,0,0,4,0,0,4,1
3159,46583,oIYeGNswP9C35pzco2q8t5ZyALp7umIE,fbPkOYLVPtPgIt0MxizjfFJov3JbHyAi,1,0,0,0,0,0,1,0,1,0.14285714285714285,1,0.0,0,0,0,0,0,0,0,1,0,0,1,1
3160,46584,l6QkvTQevuUo95YVKmMOiOhmjs3kJ3PF,fbPkOYLVPtPgIt0MxizjfFJov3JbHyAi,1,0,0,0,0,0,1,0,1,0.14285714285714285,1,0.0,0,0,0,0,0,0,0,1,0,0,1,1
3161,46586,2sZGSeEPKMgpuspPc9ln3wAme2MWPynt,fbPkOYLVPtPgIt0MxizjfFJov3JbHyAi,1,0,0,0,0,0,1,0,1,0.14285714285714285,1,0.0,0,0,0,0,0,0,0,1,0,0,1,1
3162,46591,XQCUbONg6Qt5ssh0BzFokuANDDKZfnIv,fbPkOYLVPtPgIt0MxizjfFJov3JbHyAi,10,17,3,2,2,0,5,0,29,4.142857142857143,3,0.0,1,3,2,2,16,0,0,5,0,8,21,1
3163,46592,6EsKULTJVMq3E9IpeZllE0vOQuFiZwCm,fbPkOYLVPtPgIt0MxizjfFJov3JbHyAi,1,0,0,0,0,0,1,0,1,0.14285714285714285,1,0.0,0,0,0,0,0,0,0,1,0,0,1,1
3164,46594,43LGAyiQH2Nct9LoZlyA6wH2hSGoRMei,fbPkOYLVPtPgIt0MxizjfFJov3JbHyAi,1,0,0,0,0,0,1,0,1,0.14285714285714285,1,0.0,0,0,0,0,0,0,0,1,0,0,1,1
3165,46661,o7nB1nybhMcFgLy31X3R6RDOK94b1Iaa,5Gyp41oLVo7Gg7vF4vpmggWP5MU70QO6,8,9,3,0,2,0,5,0,19,2.7142857142857144,3,0.0,0,3,0,2,9,0,0,5,0,5,14,1
3166,46664,QUziVS4xrQYwYNmSVfW4Gr6JhKHA7cng,5Gyp41oLVo7Gg7vF4vpmggWP5MU70QO6,6,2,1,0,2,0,3,0,8,1.1428571428571428,1,0.0,1,1,0,2,1,0,0,3,0,4,4,1
3167,46698,6Gh3ATf3p6EBV7qTZIQP6wSoiBFYiazs,5Gyp41oLVo7Gg7vF4vpmggWP5MU70QO6,1,0,0,0,0,0,2,0,2,0.2857142857142857,2,0.0,0,0,0,0,0,0,0,2,0,0,2,1
3168,46737,6TxDc7fD2fI8AN5IlU88vTpwWW8nL4ZZ,5Gyp41oLVo7Gg7vF4vpmggWP5MU70QO6,12,28,11,0,4,0,9,0,52,7.428571428571429,2,0.0,0,11,0,4,28,0,0,9,0,15,37,1
3169,46765,htY6bwn9PbTbKM6i8WPOSsPcKrupS5Q1,5Gyp41oLVo7Gg7vF4vpmggWP5MU70QO6,1,0,0,0,0,0,1,0,1,0.14285714285714285,1,0.0,0,0,0,0,0,0,0,1,0,0,1,1
3170,46768,vpbGg04otyd7XcBF7UVpzyiov8ktcq0f,5Gyp41oLVo7Gg7vF4vpmggWP5MU70QO6,1,0,0,0,0,0,1,0,1,0.14285714285714285,1,0.0,0,0,0,0,0,0,0,1,0,0,1,1
3171,46794,ByDjTuY0oLVzrle7JgW0XGlu5bLAo5Uj,5Gyp41oLVo7Gg7vF4vpmggWP5MU70QO6,30,90,46,13,23,46,35,2,255,36.42857142857143,15,0.0,18,46,10,23,72,46,3,35,2,97,158,1
3172,46822,YFuusgPWJ2SCmrCsLMI6TFGMGcuGX75Z,5Gyp41oLVo7Gg7vF4vpmggWP5MU70QO6,1,0,0,0,0,0,2,0,2,0.2857142857142857,2,0.0,0,0,0,0,0,0,0,2,0,0,2,1
3173,46837,iX8db0h4bK73Weo8AP1BXtlfn6xSOf6w,5Gyp41oLVo7Gg7vF4vpmggWP5MU70QO6,15,28,11,12,7,40,10,0,108,15.428571428571429,2,0.0,12,11,6,7,16,40,6,10,0,36,72,0
3174,46847,6kTNzUuSYm6xoi9ZsoRODiZYLMX87MvV,5Gyp41oLVo7Gg7vF4vpmggWP5MU70QO6,1,0,0,0,0,0,1,0,1,0.14285714285714285,1,0.0,0,0,0,0,0,0,0,1,0,0,1,1
3175,46919,2uLHED4iY9VmLy5RW7Mfy2sLsR8ze3u7,5Gyp41oLVo7Gg7vF4vpmggWP5MU70QO6,8,8,1,0,1,0,6,0,16,2.2857142857142856,2,0.0,0,1,0,1,8,0,0,6,0,2,14,1
3176,46948,bUUHjOrv9lYLGdFvQvIJrOvIH31QCvbc,5Gyp41oLVo7Gg7vF4vpmggWP5MU70QO6,8,5,3,0,2,0,3,0,13,1.8571428571428572,2,0.0,0,3,0,2,5,0,0,3,0,5,8,0
3177,46961,4svUc6E37y245S00EaI9qAs0H0nzXOuh,5Gyp41oLVo7Gg7vF4vpmggWP5MU70QO6,8,18,6,0,1,7,7,0,39,5.571428571428571,4,0.0,0,6,0,1,18,7,0,7,0,7,32,1
3178,46964,aq6RzL3Xg5EYCsH3vPkd60PgfB0ApzuH,5Gyp41oLVo7Gg7vF4vpmggWP5MU70QO6,20,20,9,38,0,0,2,0,69,9.857142857142858,2,0.0,8,9,28,0,12,0,10,2,0,45,24,1
3179,46980,YGd4irzc5KMR1PH2KdOtbCkghLMZ2dPk,5Gyp41oLVo7Gg7vF4vpmggWP5MU70QO6,13,23,9,4,6,0,13,0,55,7.857142857142857,6,0.0,10,9,2,6,13,0,2,13,0,27,28,1
3180,46997,AzXEcnexrLYeOcX5AxPYhxZ1Dd0ERW2m,5Gyp41oLVo7Gg7vF4vpmggWP5MU70QO6,9,11,7,2,4,1,2,0,27,3.857142857142857,2,0.0,2,7,1,4,9,1,1,2,0,14,13,1
3181,47055,AtIH4YI3eYIPCQxtOLtZgwyhSnXOdn2e,5Gyp41oLVo7Gg7vF4vpmggWP5MU70QO6,15,19,11,0,7,0,11,1,49,7.0,2,0.0,1,11,0,7,18,0,0,11,1,19,30,0
3182,47087,VJF9Wd2OOsxD5fVkB2g1Pjv9fzWYEV2v,5Gyp41oLVo7Gg7vF4vpmggWP5MU70QO6,12,11,7,0,5,3,11,2,39,5.571428571428571,1,0.0,1,7,0,5,10,3,0,11,2,13,26,1
3183,47132,nC6UOgoIicf8pr79f2rdG7NgUQiopW9Q,5Gyp41oLVo7Gg7vF4vpmggWP5MU70QO6,11,13,7,0,5,0,6,0,31,4.428571428571429,5,0.0,0,7,0,5,13,0,0,6,0,12,19,1
3184,47179,0pGeUoaCZ47IZ5k3CgcpVvZsDT3jBkhR,5Gyp41oLVo7Gg7vF4vpmggWP5MU70QO6,1,0,0,0,0,0,1,0,1,0.14285714285714285,1,0.0,0,0,0,0,0,0,0,1,0,0,1,1
3185,47194,lKIuwUNGHfNRCFJGM4oJVNYNDuHHcNkj,5Gyp41oLVo7Gg7vF4vpmggWP5MU70QO6,1,0,0,0,0,0,1,0,1,0.14285714285714285,1,0.0,0,0,0,0,0,0,0,1,0,0,1,1
3186,47238,kC7JLQowN0BSKnzXXKRn5vuXi1nnM0dA,5Gyp41oLVo7Gg7vF4vpmggWP5MU70QO6,1,0,0,0,0,0,1,0,1,0.14285714285714285,1,0.0,0,0,0,0,0,0,0,1,0,0,1,1
3187,47273,oCCIMS9TsKBtXrDfjAHhMW7YOC3o0In0,5Gyp41oLVo7Gg7vF4vpmggWP5MU70QO6,8,7,3,0,4,1,3,0,18,2.5714285714285716,2,0.0,2,3,0,4,5,1,0,3,0,9,9,1
3188,47298,Xi5jJx0Z2MOBm1fPpYwlvuzwElYhyszd,5Gyp41oLVo7Gg7vF4vpmggWP5MU70QO6,8,9,2,2,0,0,6,0,19,2.7142857142857144,4,0.0,0,2,1,0,9,0,1,6,0,3,16,1
3189,47310,OX9vhsWD6JWYlhteOhuS18578YVCyA0P,5Gyp41oLVo7Gg7vF4vpmggWP5MU70QO6,8,5,2,6,1,0,3,0,17,2.4285714285714284,1,0.0,2,2,3,1,3,0,3,3,0,8,9,1
3190,47324,BLOM2xPWAdh8xbTkgox63v8VU5UwaQgE,5Gyp41oLVo7Gg7vF4vpmggWP5MU70QO6,29,85,36,7,11,26,22,4,191,27.285714285714285,9,0.0,18,36,5,11,67,26,2,22,4,70,121,0
3191,47327,tq5rSafpJQn5saVcMLWCPKYcu2G69rbK,5Gyp41oLVo7Gg7vF4vpmggWP5MU70QO6,1,0,0,0,0,0,1,0,1,0.14285714285714285,1,0.0,0,0,0,0,0,0,0,1,0,0,1,1
3192,47370,NHPpKvbnrSpxM8e1DORBWJbRCpmrxZw8,5Gyp41oLVo7Gg7vF4vpmggWP5MU70QO6,64,265,152,104,38,123,60,0,742,106.0,17,0.0,59,152,92,38,206,123,12,60,0,341,401,0
3193,47408,ZN49F0EHMnIHNnexZhXG9gL1H8w3Wds6,5Gyp41oLVo7Gg7vF4vpmggWP5MU70QO6,14,12,5,6,2,2,7,1,35,5.0,1,0.0,5,5,3,2,7,2,3,7,1,15,20,1
3194,47449,6pDumvu8BZSGMSLuGPFtyDgiupPPSlqU,5Gyp41oLVo7Gg7vF4vpmggWP5MU70QO6,2,0,0,0,0,0,2,0,2,0.2857142857142857,1,0.0,0,0,0,0,0,0,0,2,0,0,2,1
3195,47488,IaQmpIIrLIlpbhmM5T9fAOSrDWknoNOg,5Gyp41oLVo7Gg7vF4vpmggWP5MU70QO6,15,26,11,14,4,16,12,0,83,11.857142857142858,2,0.0,10,11,7,4,16,16,7,12,0,32,51,1
3196,47500,BAafvt8EkPI2TrQ9EWOz7Ripfor4zZf6,5Gyp41oLVo7Gg7vF4vpmggWP5MU70QO6,11,5,3,2,2,52,5,0,69,9.857142857142858,2,0.0,1,3,1,2,4,52,1,5,0,7,62,1
3197,47509,GulRMWFcPY5JE8HNbJPRyRdVqJqL2eEA,5Gyp41oLVo7Gg7vF4vpmggWP5MU70QO6,53,137,53,68,32,19,32,1,342,48.857142857142854,11,0.0,41,53,63,32,96,19,5,32,1,189,153,0
3198,47538,dQweEcdBCmNmUPOeO7X4TTmH8zuMq2aJ,5Gyp41oLVo7Gg7vF4vpmggWP5MU70QO6,3,2,1,0,0,0,1,0,4,0.5714285714285714,1,0.0,0,1,0,0,2,0,0,1,0,1,3,1
3199,47555,Z8nVRi3NcoaJdLoyeCeCpGK9mlRKkx1Z,5Gyp41oLVo7Gg7vF4vpmggWP5MU70QO6,1,0,0,0,0,0,1,0,1,0.14285714285714285,1,0.0,0,0,0,0,0,0,0,1,0,0,1,1
3200,47556,A5njsag2BUpIwHbVkBfhIH4eOQjUBmSJ,5Gyp41oLVo7Gg7vF4vpmggWP5MU70QO6,19,49,23,18,8,8,19,0,125,17.857142857142858,6,0.0,13,23,12,8,36,8,6,19,0,56,69,1
3201,47590,jcXoYFaI9QPcliotiwIgOLeObkrSUvNn,5Gyp41oLVo7Gg7vF4vpmggWP5MU70QO6,6,2,1,0,1,0,5,0,9,1.2857142857142858,1,0.0,0,1,0,1,2,0,0,5,0,2,7,1
3202,47596,EFMEoi5W4mceo8rjft5LKrYvvT3E2eat,5Gyp41oLVo7Gg7vF4vpmggWP5MU70QO6,17,19,11,0,11,20,4,0,65,9.285714285714286,2,0.0,4,11,0,11,15,20,0,4,0,26,39,1
3203,47671,3FnNr9vIYZumFxJHz1azU06JI7Pm6hh3,5Gyp41oLVo7Gg7vF4vpmggWP5MU70QO6,7,9,5,0,3,0,4,0,21,3.0,3,0.0,0,5,0,3,9,0,0,4,0,8,13,1
3204,47691,Onp8u1IlkiXCdEq7Tg9xltw0KEKQAxrs,7GRhBDsirIGkRZBtSMEzNTyDr2JQm4xx,2,0,0,0,0,0,2,0,2,0.2857142857142857,1,0.0,0,0,0,0,0,0,0,2,0,0,2,1
3205,47695,GK9sxY4922aacfUwQrGGaZo1AzrN2tZV,7GRhBDsirIGkRZBtSMEzNTyDr2JQm4xx,2,0,0,0,0,0,2,0,2,0.2857142857142857,1,0.0,0,0,0,0,0,0,0,2,0,0,2,1
3206,47706,P59zgxkiZZAY4L2oDvB0C7gvcL7QBtyx,7GRhBDsirIGkRZBtSMEzNTyDr2JQm4xx,47,68,14,138,6,0,4,0,230,32.857142857142854,4,0.0,31,14,124,6,37,0,14,4,0,175,55,0
3207,47708,Kx0yh1NYg9bLebA77hJUfctp68sztPRl,7GRhBDsirIGkRZBtSMEzNTyDr2JQm4xx,1,0,0,0,0,0,1,0,1,0.14285714285714285,1,0.0,0,0,0,0,0,0,0,1,0,0,1,1
3208,47711,GH3PC1SBnD0QirB2kfSpXzY7ZEDaORGK,7GRhBDsirIGkRZBtSMEzNTyDr2JQm4xx,8,13,4,0,2,1,1,0,21,3.0,1,0.0,4,4,0,2,9,1,0,1,0,10,11,1
3209,47712,ilWzYGLWBh9DSc1MV8g2C4Go5wDNgUHX,7GRhBDsirIGkRZBtSMEzNTyDr2JQm4xx,34,32,12,34,10,22,6,0,116,16.571428571428573,4,0.0,16,12,28,10,16,22,6,6,0,66,50,1
3210,47719,yG8wEEmCuC5YTy4CQDGA5I639Z9JzSu0,7GRhBDsirIGkRZBtSMEzNTyDr2JQm4xx,9,8,3,0,3,0,2,0,16,2.2857142857142856,2,0.0,0,3,0,3,8,0,0,2,0,6,10,1
3211,47732,Zi0zviSNJjQgRnDqltYXCKQ56bOQDRq9,7GRhBDsirIGkRZBtSMEzNTyDr2JQm4xx,1,0,0,0,0,0,1,0,1,0.14285714285714285,1,0.0,0,0,0,0,0,0,0,1,0,0,1,1
3212,47737,kqS8BwWN9R1093oeblGkvtCsQJ68Gh0G,7GRhBDsirIGkRZBtSMEzNTyDr2JQm4xx,7,8,4,2,1,0,4,0,19,2.7142857142857144,3,0.0,1,4,1,1,7,0,1,4,0,7,12,1
3213,47748,kBcjUv7wCsLl51XfcJpKl8Rz4VIbTmWw,fbPkOYLVPtPgIt0MxizjfFJov3JbHyAi,27,23,9,8,9,3,11,1,64,9.142857142857142,3,0.0,10,9,8,9,13,3,0,11,1,36,28,1
3214,47750,0qPh5PrlrJCeTfTUrI9BQO9zneoMXi60,fbPkOYLVPtPgIt0MxizjfFJov3JbHyAi,9,12,3,0,4,1,5,1,26,3.7142857142857144,1,0.0,7,3,0,4,5,1,0,5,1,14,12,1
3215,47752,sssMJa5iFnCjQwIkqzgCnBND3LRzFTaw,fbPkOYLVPtPgIt0MxizjfFJov3JbHyAi,1,0,0,0,0,0,1,0,1,0.14285714285714285,1,0.0,0,0,0,0,0,0,0,1,0,0,1,1
3216,47753,vAnQOM98uBV9N4zlyAfd54z2JCZnwUx8,fbPkOYLVPtPgIt0MxizjfFJov3JbHyAi,21,41,14,24,13,0,9,0,101,14.428571428571429,3,0.0,8,14,19,13,33,0,5,9,0,54,47,1
3217,47758,Br3boNa1GOtMS8whgjxC8vFojVZKIJ8q,fbPkOYLVPtPgIt0MxizjfFJov3JbHyAi,7,3,2,0,2,0,5,0,12,1.7142857142857142,1,0.0,0,2,0,2,3,0,0,5,0,4,8,1
3218,47760,jWh61XkRTjwdqASpqvrGaFWBIry4gjxu,fbPkOYLVPtPgIt0MxizjfFJov3JbHyAi,5,4,3,0,3,0,8,0,18,2.5714285714285716,4,0.0,0,3,0,3,4,0,0,8,0,6,12,1
3219,47764,3ekpb9qQNnBvDGQePlspHv7VLn9RhUhL,fbPkOYLVPtPgIt0MxizjfFJov3JbHyAi,1,0,0,0,0,0,1,0,1,0.14285714285714285,1,0.0,0,0,0,0,0,0,0,1,0,0,1,1
3220,47770,KO9zYaiac2CNagQLdx3aJ9c2fXXMgIJX,fbPkOYLVPtPgIt0MxizjfFJov3JbHyAi,22,56,17,4,10,6,17,2,112,16.0,7,0.0,3,17,3,10,53,6,1,17,2,33,79,0
3221,47772,mMS5utPEE0kau31EdquwgaN1e0nxF2V4,fbPkOYLVPtPgIt0MxizjfFJov3JbHyAi,7,5,3,0,2,0,2,0,12,1.7142857142857142,2,0.0,0,3,0,2,5,0,0,2,0,5,7,1
3222,47776,zHeujEYh5L6paRQ7acJHcEFwTj5egykX,fbPkOYLVPtPgIt0MxizjfFJov3JbHyAi,5,6,2,0,0,0,3,0,11,1.5714285714285714,3,0.0,0,2,0,0,6,0,0,3,0,2,9,1
3223,47777,H2nT05aeA6Q1zZKHa66kquyct5PT5SXn,fbPkOYLVPtPgIt0MxizjfFJov3JbHyAi,9,9,3,0,3,8,2,0,25,3.5714285714285716,1,0.0,2,3,0,3,7,8,0,2,0,8,17,1
3224,47779,rVswAzjMLz5uIPbCwAU1SliCQFpiAqey,fbPkOYLVPtPgIt0MxizjfFJov3JbHyAi,7,7,5,0,3,0,4,0,19,2.7142857142857144,2,0.0,0,5,0,3,7,0,0,4,0,8,11,1
3225,47780,bhGqExUGpWPVtLHOBczGOZtP5NSlb2iV,fbPkOYLVPtPgIt0MxizjfFJov3JbHyAi,5,2,1,0,1,0,2,0,6,0.8571428571428571,1,0.0,0,1,0,1,2,0,0,2,0,2,4,1
3226,47783,LnBIzyfbdwaIzv1AmzgfFWCAT33UKIqQ,fbPkOYLVPtPgIt0MxizjfFJov3JbHyAi,5,3,1,0,1,0,4,0,9,1.2857142857142858,1,0.0,1,1,0,1,2,0,0,4,0,3,6,1
3227,47787,W3kCxGrfIFukJWUU9IJiC14IoMB2PgEG,fbPkOYLVPtPgIt0MxizjfFJov3JbHyAi,7,7,5,0,0,15,5,0,32,4.571428571428571,1,0.0,0,5,0,0,7,15,0,5,0,5,27,1
3228,47789,2LJu3awzGTK6KEvbTKsHaTWm40Uc2FME,fbPkOYLVPtPgIt0MxizjfFJov3JbHyAi,5,2,1,0,1,0,2,0,6,0.8571428571428571,1,0.0,0,1,0,1,2,0,0,2,0,2,4,1
3229,47790,0ieVgiGrluCsPP0YL5BydyAhM42qWcB4,fbPkOYLVPtPgIt0MxizjfFJov3JbHyAi,7,3,2,0,2,0,3,0,10,1.4285714285714286,1,0.0,0,2,0,2,3,0,0,3,0,4,6,1
3230,47793,hllwiqbKGoyJt5Tb2KABSErcKGSjkpFC,fbPkOYLVPtPgIt0MxizjfFJov3JbHyAi,1,0,0,0,0,0,1,0,1,0.14285714285714285,1,0.0,0,0,0,0,0,0,0,1,0,0,1,1
3231,47794,lQ3NA8rIFeBdMYWA2lzeVtp3TG4uBQXU,fbPkOYLVPtPgIt0MxizjfFJov3JbHyAi,15,56,33,13,31,30,8,0,171,24.428571428571427,5,0.0,10,33,9,31,46,30,4,8,0,83,88,1
3232,47802,0QSMkT1dSojdga3gOUuLnnXcPZoPeqgp,fbPkOYLVPtPgIt0MxizjfFJov3JbHyAi,5,2,1,0,1,0,2,0,6,0.8571428571428571,1,0.0,0,1,0,1,2,0,0,2,0,2,4,0
3233,47805,C1NrIu2z9b7sPd2GgrgPvw1qImibSsqR,fbPkOYLVPtPgIt0MxizjfFJov3JbHyAi,1,0,0,0,0,0,1,0,1,0.14285714285714285,1,0.0,0,0,0,0,0,0,0,1,0,0,1,1
3234,47806,uXSmZuPz2xNXPk2qFBcPykAtedr98vP4,fbPkOYLVPtPgIt0MxizjfFJov3JbHyAi,14,11,7,2,5,0,3,0,28,4.0,2,0.0,1,7,2,5,10,0,0,3,0,15,13,1
3235,47809,LwiFBYAg8FxzttVYXUksrgMfJRvI4SFJ,fbPkOYLVPtPgIt0MxizjfFJov3JbHyAi,13,33,16,0,0,1,16,1,67,9.571428571428571,4,0.0,9,16,0,0,24,1,0,16,1,25,42,1
3236,47810,ZQszEDvefL66DoX1xrFttL5Z99UGUgJi,fbPkOYLVPtPgIt0MxizjfFJov3JbHyAi,14,25,17,1,7,58,15,2,125,17.857142857142858,5,0.0,1,17,1,7,24,58,0,15,2,26,99,0
3237,47812,FQ1LFgTnlxgM163pJYQ8F6cnOancinCK,fbPkOYLVPtPgIt0MxizjfFJov3JbHyAi,15,22,1,7,4,7,4,0,45,6.428571428571429,3,0.0,9,1,6,4,13,7,1,4,0,20,25,1
3238,47816,JyOwpTqxlZyOZXFXAlv3kcbVV4zSYrRf,fbPkOYLVPtPgIt0MxizjfFJov3JbHyAi,8,4,2,0,2,0,2,0,10,1.4285714285714286,1,0.0,0,2,0,2,4,0,0,2,0,4,6,1
3239,47817,5NX0UTrEG0Nosf3C8odmhhCWYxUKxKSk,fbPkOYLVPtPgIt0MxizjfFJov3JbHyAi,5,2,1,0,1,0,2,0,6,0.8571428571428571,1,0.0,0,1,0,1,2,0,0,2,0,2,4,1
3240,47818,4aUZNrEysB01BTDaMjEoJUWN7ca7RotB,fbPkOYLVPtPgIt0MxizjfFJov3JbHyAi,12,12,4,2,5,0,5,0,28,4.0,1,0.0,6,4,2,5,6,0,0,5,0,17,11,1
3241,47820,ZJVdccRSVGtL7lRrhASOIKDRLk41rGEl,fbPkOYLVPtPgIt0MxizjfFJov3JbHyAi,8,5,3,0,2,0,2,0,12,1.7142857142857142,1,0.0,0,3,0,2,5,0,0,2,0,5,7,1
3242,47822,T0bX8618p1zppaN2AzjlfD61pjXKKkDP,fbPkOYLVPtPgIt0MxizjfFJov3JbHyAi,2,0,0,0,0,0,2,0,2,0.2857142857142857,1,0.0,0,0,0,0,0,0,0,2,0,0,2,1
3243,47824,wwifhf2JKuRRsCekTCD33hbtOjxoHPnW,fbPkOYLVPtPgIt0MxizjfFJov3JbHyAi,44,82,37,33,25,45,12,0,234,33.42857142857143,7,0.0,36,37,27,25,46,45,6,12,0,125,109,1
3244,47826,6cy8BWaUGaMCAOjojQczbStvsRKYISdK,fbPkOYLVPtPgIt0MxizjfFJov3JbHyAi,12,20,13,9,10,0,8,0,60,8.571428571428571,5,0.0,3,13,6,10,17,0,3,8,0,32,28,1
3245,47828,W7e0QUNKaRKq7UxQ0gmzqrmRmeubAvn2,fbPkOYLVPtPgIt0MxizjfFJov3JbHyAi,5,2,1,0,1,0,2,0,6,0.8571428571428571,1,0.0,0,1,0,1,2,0,0,2,0,2,4,1
3246,47838,bJNzzdFbeXF3gRIHxGK6VlbnTQeUffyz,fbPkOYLVPtPgIt0MxizjfFJov3JbHyAi,12,13,3,4,5,3,11,1,40,5.714285714285714,3,0.0,7,3,3,5,6,3,1,11,1,18,22,1
3247,47839,ymWpwD3GRW9ut1JiVBQeAWpoDiatjwOa,fbPkOYLVPtPgIt0MxizjfFJov3JbHyAi,19,25,13,5,9,18,8,0,78,11.142857142857142,3,0.0,7,13,5,9,18,18,0,8,0,34,44,1
3248,47846,DUdBmTRQYTDfiJ48gpt3WzQELlnWqHAt,fbPkOYLVPtPgIt0MxizjfFJov3JbHyAi,29,38,24,15,17,43,17,1,155,22.142857142857142,6,0.0,8,24,12,17,30,43,3,17,1,61,94,1
3249,47848,bo0kzQtcVPpunN4Y9LfeiFpB6omq1iOi,fbPkOYLVPtPgIt0MxizjfFJov3JbHyAi,1,0,0,0,0,0,1,0,1,0.14285714285714285,1,0.0,0,0,0,0,0,0,0,1,0,0,1,1
3250,47850,EA93zC2FZSfWuUTy2fGF8qAEwUDl0X8s,fbPkOYLVPtPgIt0MxizjfFJov3JbHyAi,80,117,64,76,37,29,22,1,346,49.42857142857143,10,0.0,35,64,64,37,82,29,12,22,1,200,146,1
3251,47853,ZZRh21sVolimyM3CDUIIgG9cuzaZauji,fbPkOYLVPtPgIt0MxizjfFJov3JbHyAi,54,94,46,59,21,60,28,5,313,44.714285714285715,8,0.0,29,46,45,21,65,60,14,28,5,141,172,1
3252,47861,DIrQamaTjjU1PZti9ZjQXTxfEYtPLnQl,fbPkOYLVPtPgIt0MxizjfFJov3JbHyAi,33,53,29,19,15,3,14,1,134,19.142857142857142,4,0.0,12,29,15,15,41,3,4,14,1,71,63,1
3253,47894,Rz28tFT5qYZaEQ78Ly3OdJx8TpvsmLBy,bWdj2GDclj5ofokWjzoa5jAwMkxCykd6,21,31,10,70,1,14,17,0,143,20.428571428571427,6,0.0,2,10,66,1,29,14,4,17,0,79,64,0
3254,47900,t8SjYilFMTCG5Wi1o6mcbWFbM7fvPbYd,SpATywNh6bZuzm8s1ceuBUnMUAeoAHHw,56,81,45,19,30,23,11,1,210,30.0,7,0.0,26,45,19,30,55,23,0,11,1,120,90,0
3255,47911,rupuJPHZYcCjzgb5zuSbBK0ZcJQy8q7D,SpATywNh6bZuzm8s1ceuBUnMUAeoAHHw,1,0,0,0,0,0,1,0,1,0.14285714285714285,1,0.0,0,0,0,0,0,0,0,1,0,0,1,1
3256,47938,szUZ2QsyqJuXPgyS49q35y1kTVrrBlKT,SpATywNh6bZuzm8s1ceuBUnMUAeoAHHw,39,135,58,67,9,23,21,2,315,45.0,9,0.0,54,58,54,9,81,23,13,21,2,175,140,0
3257,48018,xecOK3aJ3hCti9mz2pAAcwSq9d1S8ATw,SpATywNh6bZuzm8s1ceuBUnMUAeoAHHw,34,97,13,73,7,1,23,1,215,30.714285714285715,6,0.0,37,13,71,7,60,1,2,23,1,128,87,0
3258,48041,SmONSyS4YgG4Afnv6ZxU81t7p4CQPV5P,bWdj2GDclj5ofokWjzoa5jAwMkxCykd6,6,9,4,0,2,1,4,0,20,2.857142857142857,2,0.0,0,4,0,2,9,1,0,4,0,6,14,1
3259,48045,O6XTfrmBXPHHKFN07CLCPWqyMP9NsQuf,A3fsA9Zfv1X2fVEQhTw51lKENdNrEqT3,7,3,2,0,2,0,3,0,10,1.4285714285714286,1,0.0,0,2,0,2,3,0,0,3,0,4,6,0
3260,48081,zCdZvanEH4w4mJiogg5VcFWhPxVyZDYs,RXDvfPUBYFlVdlueBFbLW0mhhAyGEqpt,66,69,20,162,15,6,7,0,279,39.857142857142854,4,0.0,16,20,158,15,53,6,4,7,0,209,70,0
3261,48093,23GFMJXBCJBMscnU5tVwAanleKYVql9b,SpATywNh6bZuzm8s1ceuBUnMUAeoAHHw,57,141,89,68,49,229,89,14,679,97.0,16,0.0,20,89,62,49,121,229,6,89,14,220,459,0
3262,48097,TsDe3YkshVWrWCP25fGXNXAufSbXrOSR,SpATywNh6bZuzm8s1ceuBUnMUAeoAHHw,6,2,1,0,1,1,4,0,9,1.2857142857142858,1,0.0,0,1,0,1,2,1,0,4,0,2,7,1
3263,48114,rzXoVvb6RM0hS48T1GDjFso4hKBDuhsd,bWdj2GDclj5ofokWjzoa5jAwMkxCykd6,39,51,34,61,17,0,11,0,174,24.857142857142858,5,0.0,7,34,54,17,44,0,7,11,0,112,62,0
3264,48121,aDXyYOZH6u3WRzJTxPdI3vxwfFxiKOmm,SpATywNh6bZuzm8s1ceuBUnMUAeoAHHw,25,50,20,18,11,0,9,0,108,15.428571428571429,3,0.0,5,20,15,11,45,0,3,9,0,51,57,1
3265,48188,ZuzQyeRHP6ylyX1kz2ZCSK5JTnFY7jgw,5X6FeZozNMgE2VRi3MJYjkkFK8SETtu2,5,3,1,0,1,0,2,0,7,1.0,1,0.0,0,1,0,1,3,0,0,2,0,2,5,1
3266,48204,pl9XUoy865SinWI51RNAlmhqaJHEhs94,SpATywNh6bZuzm8s1ceuBUnMUAeoAHHw,46,62,28,60,14,5,18,2,189,27.0,4,0.0,26,28,50,14,36,5,10,18,2,118,71,1
3267,48246,ieR2oDuOBOWrOSx08B7vLKsdvt41Kjgw,A3fsA9Zfv1X2fVEQhTw51lKENdNrEqT3,26,52,12,0,8,0,11,0,83,11.857142857142858,4,0.0,4,12,0,8,48,0,0,11,0,24,59,0
3268,48254,nazeZS8BdRMOGGuVriyb5M21Pn5Qng36,5X6FeZozNMgE2VRi3MJYjkkFK8SETtu2,4,5,2,0,0,0,2,0,9,1.2857142857142858,2,0.0,0,2,0,0,5,0,0,2,0,2,7,1
3269,48261,wi7Ze896VO17gMeNUgqgfOVbxlFbfvaK,SpATywNh6bZuzm8s1ceuBUnMUAeoAHHw,44,103,52,35,26,7,35,5,263,37.57142857142857,8,0.0,19,52,28,26,84,7,7,35,5,125,138,0
3270,48307,xqNT9GHVIeGkzMPTfiXtvyG6m6zaY6B9,A3fsA9Zfv1X2fVEQhTw51lKENdNrEqT3,5,2,0,0,0,0,7,0,9,1.2857142857142858,2,0.0,0,0,0,0,2,0,0,7,0,0,9,1
3271,48325,vkfHpP1V5bzhsiIUQc7ID6uM0xIbyM6G,bWdj2GDclj5ofokWjzoa5jAwMkxCykd6,6,5,2,0,3,0,2,0,12,1.7142857142857142,4,0.0,2,2,0,3,3,0,0,2,0,7,5,1
3272,48345,pnW8XX8zC0UKr9mm25Bt1RQ7xgXCstp3,A3fsA9Zfv1X2fVEQhTw51lKENdNrEqT3,2,0,0,0,0,0,4,0,4,0.5714285714285714,2,0.0,0,0,0,0,0,0,0,4,0,0,4,0
3273,48370,3HC1D1DG8BjKUNFZlgm7gcIQVOGrzi6J,SpATywNh6bZuzm8s1ceuBUnMUAeoAHHw,32,47,31,0,19,29,9,0,135,19.285714285714285,7,0.0,9,31,0,19,38,29,0,9,0,59,76,0
3274,48371,vPzTKxBGOgQvPyttxcPLEgk5w088HTzb,SpATywNh6bZuzm8s1ceuBUnMUAeoAHHw,28,25,19,0,12,1,9,1,67,9.571428571428571,3,0.0,0,19,0,12,25,1,0,9,1,31,36,1
3275,48372,WjTYaS8yfbxyQCBRfgx2LHwT0DLPXKM5,SpATywNh6bZuzm8s1ceuBUnMUAeoAHHw,8,7,6,0,0,0,9,10,32,4.571428571428571,2,0.0,0,6,0,0,7,0,0,9,10,6,26,1
3276,48386,5jz6qtmzJGoTjjzPCohz2U8oEp7qiszP,SpATywNh6bZuzm8s1ceuBUnMUAeoAHHw,59,95,38,66,19,25,25,3,271,38.714285714285715,10,0.0,25,38,57,19,70,25,9,25,3,139,132,0
3277,48436,aPM6Pkx8yXzDO1Wq6YMG1wXnFkTU2WLX,bWdj2GDclj5ofokWjzoa5jAwMkxCykd6,7,7,0,0,0,0,1,0,8,1.1428571428571428,1,0.0,0,0,0,0,7,0,0,1,0,0,8,1
3278,48446,QIQR6VwK3cpUKM5lDzadEKeQATM23w8z,A3fsA9Zfv1X2fVEQhTw51lKENdNrEqT3,55,57,1,132,0,0,9,0,199,28.428571428571427,7,0.0,4,1,120,0,53,0,12,9,0,125,74,1
3279,48454,g1ncrxE30iLPOXYuzSV4ccCqY3Ww9KwB,A3fsA9Zfv1X2fVEQhTw51lKENdNrEqT3,4,2,1,0,0,1,3,0,7,1.0,2,0.0,0,1,0,0,2,1,0,3,0,1,6,1
3280,48484,HsuSSkmNEe51pmwRC4MuavuxD1n89icY,SpATywNh6bZuzm8s1ceuBUnMUAeoAHHw,21,35,19,18,10,23,15,1,121,17.285714285714285,5,0.0,5,19,15,10,30,23,3,15,1,49,72,1
3281,48492,Av4RUzIKiBksZoh2Q0L0akgGSwn9yOvk,SpATywNh6bZuzm8s1ceuBUnMUAeoAHHw,51,49,41,23,24,16,5,0,158,22.571428571428573,4,0.0,4,41,21,24,45,16,2,5,0,90,68,0
3282,48505,wLHIcBw64LujKVlhQPCCWdqoNNExSslB,RXDvfPUBYFlVdlueBFbLW0mhhAyGEqpt,5,2,1,0,1,0,4,0,8,1.1428571428571428,2,0.0,0,1,0,1,2,0,0,4,0,2,6,1
3283,48529,hkwn5MNEUKXaOvo8i7hJxIoCohTDhE10,SpATywNh6bZuzm8s1ceuBUnMUAeoAHHw,45,76,45,56,28,0,8,2,215,30.714285714285715,6,0.0,21,45,51,28,55,0,5,8,2,145,70,0
3284,48545,chixnlC2a6qKHlbNdDwMmrvvgJUNDKKd,SpATywNh6bZuzm8s1ceuBUnMUAeoAHHw,1,0,0,0,0,0,1,0,1,0.14285714285714285,1,0.0,0,0,0,0,0,0,0,1,0,0,1,1
3285,48570,VTFDw2vJ6rzCiyEGWQUVkoldm7wzhtYa,SpATywNh6bZuzm8s1ceuBUnMUAeoAHHw,45,61,36,0,23,6,14,0,140,20.0,7,0.0,14,36,0,23,47,6,0,14,0,73,67,1
3286,48585,QIbN4GxDISz9UsvJoNIOWyqRfTxBq16y,SpATywNh6bZuzm8s1ceuBUnMUAeoAHHw,6,2,1,0,1,0,3,0,7,1.0,1,0.0,0,1,0,1,2,0,0,3,0,2,5,1
3287,48587,v6QLYqOum8NXSX8h0M5DMTP0vkr2qfHa,SpATywNh6bZuzm8s1ceuBUnMUAeoAHHw,62,126,69,59,36,162,68,1,521,74.42857142857143,15,0.0,32,69,57,36,94,162,2,68,1,194,327,0
3288,48597,iFAEvIlnSy7QTK0C8wy8Gm8EC4q4g73z,G8EPVSXsOYB5YQWZGiz1aVq5Pgr2GrQu,8,6,3,0,2,0,4,0,15,2.142857142857143,1,0.0,0,3,0,2,6,0,0,4,0,5,10,1
3289,48617,LSvU72CFq1TrHd9SCZOiKQ0qcV2oa2Ok,A3fsA9Zfv1X2fVEQhTw51lKENdNrEqT3,15,42,3,0,2,2,14,0,63,9.0,8,0.0,2,3,0,2,40,2,0,14,0,7,56,0
3290,48630,oymhnrhhZTojmhR9U4GGxnwHZLmXRmW8,SpATywNh6bZuzm8s1ceuBUnMUAeoAHHw,8,15,9,0,0,0,7,0,31,4.428571428571429,5,0.0,0,9,0,0,15,0,0,7,0,9,22,1
3291,48643,RCdcltNaQLfcoxT7YKTjQxAYUbCmzzKd,SpATywNh6bZuzm8s1ceuBUnMUAeoAHHw,60,79,47,59,24,40,23,1,273,39.0,12,0.0,18,47,56,24,61,40,3,23,1,145,128,0
3292,48684,ugIvWXr0VKdRfQslnLOrtvUMZY9HB5mg,A3fsA9Zfv1X2fVEQhTw51lKENdNrEqT3,1,0,0,0,0,0,1,0,1,0.14285714285714285,1,0.0,0,0,0,0,0,0,0,1,0,0,1,1
3293,48693,AnsnVs5AVUHmSDONSrxZt8MIRHsOXvcc,SpATywNh6bZuzm8s1ceuBUnMUAeoAHHw,43,36,23,31,14,21,12,4,141,20.142857142857142,6,0.0,7,23,29,14,29,21,2,12,4,73,68,0
3294,48701,z4snJqWxxByo4wMmQ2g1knGwZpMDrb1I,SpATywNh6bZuzm8s1ceuBUnMUAeoAHHw,30,84,51,20,44,9,8,0,216,30.857142857142858,12,0.0,6,51,17,44,78,9,3,8,0,118,98,0
3295,48702,ryiQYyVYMdwKFXJfIVJiBqI3D0XwNLw1,bWdj2GDclj5ofokWjzoa5jAwMkxCykd6,13,19,8,34,6,0,7,0,74,10.571428571428571,2,0.0,5,8,34,6,14,0,0,7,0,53,21,0
3296,48709,QQWLbKtU9foRAK01shKWj5BlhSa8NZ5K,5X6FeZozNMgE2VRi3MJYjkkFK8SETtu2,39,88,33,56,33,5,10,1,226,32.285714285714285,5,0.0,48,33,44,33,40,5,12,10,1,158,68,1
3297,48716,EJmjPRM04Uqau3e0OiUKVcHUyavQV9Hd,SpATywNh6bZuzm8s1ceuBUnMUAeoAHHw,22,27,5,8,4,0,6,0,50,7.142857142857143,6,0.0,0,5,7,4,27,0,1,6,0,16,34,0
3298,48717,Kkk2oty8lHBEgyFYDiZgsO24fUpD8pZQ,A3fsA9Zfv1X2fVEQhTw51lKENdNrEqT3,12,11,9,0,7,0,4,0,31,4.428571428571429,2,0.0,0,9,0,7,11,0,0,4,0,16,15,1
3299,48724,oxWNSOCXM5YtqWviH5bNOZtEWIiiD3Ad,SpATywNh6bZuzm8s1ceuBUnMUAeoAHHw,43,85,3,71,0,12,25,4,200,28.571428571428573,8,0.0,24,3,59,0,61,12,12,25,4,86,114,0
3300,48746,gVGj2LhiiokanFRHheozHOjuzmD8hKxS,G8EPVSXsOYB5YQWZGiz1aVq5Pgr2GrQu,10,9,5,0,4,0,3,0,21,3.0,2,0.0,1,5,0,4,8,0,0,3,0,10,11,1
3301,48768,PtsRHtEUtNnLmH8gts61dMI3tx9jCckb,SpATywNh6bZuzm8s1ceuBUnMUAeoAHHw,8,9,5,0,2,0,3,0,19,2.7142857142857144,1,0.0,2,5,0,2,7,0,0,3,0,9,10,1
3302,48821,ZjsIVK1LVT8DmeiV5guDcHEGev6AFTMV,SpATywNh6bZuzm8s1ceuBUnMUAeoAHHw,8,4,3,0,2,0,2,0,11,1.5714285714285714,1,0.0,0,3,0,2,4,0,0,2,0,5,6,1
3303,48840,aGUfx90yhbQwlGokMP50QqeVLCer1QZu,5X6FeZozNMgE2VRi3MJYjkkFK8SETtu2,9,13,0,11,5,6,5,0,40,5.714285714285714,1,0.0,9,0,9,5,4,6,2,5,0,23,17,1
3304,48851,U2YEyQJ6vRjLD9a41Fy3cKvRrxCg3qKu,SpATywNh6bZuzm8s1ceuBUnMUAeoAHHw,46,118,65,50,17,49,57,1,357,51.0,11,0.0,11,65,42,17,107,49,8,57,1,135,222,0
3305,48873,FgYPvBwLri7YiFI9og6clP9FuKJ08jX7,G8EPVSXsOYB5YQWZGiz1aVq5Pgr2GrQu,9,10,5,0,2,0,4,0,21,3.0,5,0.0,0,5,0,2,10,0,0,4,0,7,14,1
3306,48877,Ni0IPlzVi6gdiGgs6dhBnA0GIuFxEzjB,5X6FeZozNMgE2VRi3MJYjkkFK8SETtu2,1,0,0,0,0,0,1,0,1,0.14285714285714285,1,0.0,0,0,0,0,0,0,0,1,0,0,1,1
3307,48910,oORy78WPGzz21oydfrdMfNTEPAbNPQ4N,SpATywNh6bZuzm8s1ceuBUnMUAeoAHHw,31,29,17,13,11,0,16,0,86,12.285714285714286,5,0.0,4,17,11,11,25,0,2,16,0,43,43,0
3308,48912,Ke3m1XBYFaKY25GJE6kMuwQnyabdYG4B,bWdj2GDclj5ofokWjzoa5jAwMkxCykd6,1,0,0,0,0,0,2,0,2,0.2857142857142857,1,0.0,0,0,0,0,0,0,0,2,0,0,2,1
3309,48923,rJ7deFT9ohZCOevrsW5L4Px2yVgiatFT,A3fsA9Zfv1X2fVEQhTw51lKENdNrEqT3,27,31,23,0,14,0,5,0,73,10.428571428571429,2,0.0,2,23,0,14,29,0,0,5,0,39,34,1
3310,48934,PPMgD0y4ftWviyNbM56pMh7QBTyoyQi0,A3fsA9Zfv1X2fVEQhTw51lKENdNrEqT3,35,23,0,64,0,0,5,0,92,13.142857142857142,2,0.0,1,0,57,0,22,0,7,5,0,58,34,1
3311,48957,7xLRAUzJSfSBonILgUC8oEWPnbxwGYvj,RXDvfPUBYFlVdlueBFbLW0mhhAyGEqpt,32,55,5,21,3,1,6,1,92,13.142857142857142,5,0.0,0,5,18,3,55,1,3,6,1,26,66,1
3312,48958,CFwBanDE4eguHX9lcM62Yx5Bex6437kC,SpATywNh6bZuzm8s1ceuBUnMUAeoAHHw,7,6,4,0,1,3,7,0,21,3.0,4,0.0,0,4,0,1,6,3,0,7,0,5,16,0
3313,48968,3Y0bPm3E3Ch9XQ8h4cbV56DUaTL5U5qc,SpATywNh6bZuzm8s1ceuBUnMUAeoAHHw,42,131,44,56,7,113,37,4,392,56.0,17,0.0,33,44,46,7,98,113,10,37,4,130,262,0
3314,48974,Ze9kgklMuT1yRhjZzYqZ128xNCVJ9Ing,SpATywNh6bZuzm8s1ceuBUnMUAeoAHHw,14,15,6,13,5,0,2,0,41,5.857142857142857,2,0.0,2,6,11,5,13,0,2,2,0,24,17,0
3315,48988,n0HFF3TwqKuBMzzkdLCbvb8Mji5ZUnVX,bWdj2GDclj5ofokWjzoa5jAwMkxCykd6,20,28,4,0,3,0,7,0,42,6.0,5,0.0,0,4,0,3,28,0,0,7,0,7,35,0
3316,49040,tNcQJSYfIwP0RRLCMvpsyr5j06z8N8iO,SpATywNh6bZuzm8s1ceuBUnMUAeoAHHw,1,0,0,0,0,0,1,0,1,0.14285714285714285,1,0.0,0,0,0,0,0,0,0,1,0,0,1,1
3317,49055,VnqjPsNMop8FSxKaE0aFC1bL7RnYPDau,bWdj2GDclj5ofokWjzoa5jAwMkxCykd6,2,0,0,0,0,0,2,0,2,0.2857142857142857,1,0.0,0,0,0,0,0,0,0,2,0,0,2,1
3318,49074,xVBb6KTthksx7yA35KzlYaPb1gJ7b3SK,SpATywNh6bZuzm8s1ceuBUnMUAeoAHHw,6,5,1,0,1,0,2,0,9,1.2857142857142858,1,0.0,0,1,0,1,5,0,0,2,0,2,7,1
3319,49079,uqA5Smdw6BACOcL0f2tmxwTTxZXBpZpE,A3fsA9Zfv1X2fVEQhTw51lKENdNrEqT3,8,11,6,0,1,0,4,0,22,3.142857142857143,3,0.0,0,6,0,1,11,0,0,4,0,7,15,1
3320,49082,21PlIQxHvCIRuT4YC0IvZYCzvQ1GOkuQ,SpATywNh6bZuzm8s1ceuBUnMUAeoAHHw,25,33,5,33,4,3,8,1,87,12.428571428571429,6,0.0,7,5,28,4,26,3,5,8,1,44,43,1
3321,49086,G7CuAdMTwHj5eYhpu5z9RBNQZMziV4KR,SpATywNh6bZuzm8s1ceuBUnMUAeoAHHw,26,34,20,0,16,4,20,3,97,13.857142857142858,6,0.0,0,20,0,16,34,4,0,20,3,36,61,0
3322,49113,1uHLOYSfEFwzZFuLCsgyZIWEkaqBo7Qo,bWdj2GDclj5ofokWjzoa5jAwMkxCykd6,1,0,0,0,0,0,1,0,1,0.14285714285714285,1,0.0,0,0,0,0,0,0,0,1,0,0,1,1
3323,49123,hZuqApg1u2xIALq7aPkxAemxANyM5ZQO,SpATywNh6bZuzm8s1ceuBUnMUAeoAHHw,40,27,21,35,15,0,10,0,108,15.428571428571429,2,0.0,6,21,32,15,21,0,3,10,0,74,34,0
3324,49125,XOaJO8KF8vdUACh2JbMQ3VMKBQSpUCWY,5X6FeZozNMgE2VRi3MJYjkkFK8SETtu2,28,111,36,26,14,6,17,1,211,30.142857142857142,8,0.0,32,36,22,14,79,6,4,17,1,104,107,0
3325,49126,ODO6YJv7WKlywuU0ERlwS65mjmQLwAAN,G8EPVSXsOYB5YQWZGiz1aVq5Pgr2GrQu,13,8,6,0,6,0,2,0,22,3.142857142857143,1,0.0,0,6,0,6,8,0,0,2,0,12,10,1
3326,49136,q52eSaqWMZ3OyThwrFYZptxsSeXg1MmQ,5X6FeZozNMgE2VRi3MJYjkkFK8SETtu2,5,2,1,0,1,0,3,0,7,1.0,1,0.0,0,1,0,1,2,0,0,3,0,2,5,1
3327,49142,nlq4r6xc3rTUqTwcYhL6wudXdN6RIE52,5X6FeZozNMgE2VRi3MJYjkkFK8SETtu2,10,18,5,0,15,0,2,0,40,5.714285714285714,2,0.0,11,5,0,15,7,0,0,2,0,31,9,1
3328,49144,sLXZuSYSyseCIVyzHGWGjauvNb9Bdi86,SpATywNh6bZuzm8s1ceuBUnMUAeoAHHw,24,13,11,0,10,0,4,0,38,5.428571428571429,2,0.0,0,11,0,10,13,0,0,4,0,21,17,0
3329,49154,ahTQ6twHrEgeLAYHLb7pWZDspU6rrM6J,A3fsA9Zfv1X2fVEQhTw51lKENdNrEqT3,14,13,12,0,6,0,1,0,32,4.571428571428571,1,0.0,0,12,0,6,13,0,0,1,0,18,14,1
3330,49169,DiWBcd8PLPtmWnfb34O6eK5u6IIpJyne,bWdj2GDclj5ofokWjzoa5jAwMkxCykd6,6,2,1,0,1,0,3,0,7,1.0,1,0.0,0,1,0,1,2,0,0,3,0,2,5,1
3331,49173,1n5WyoQB7crKqtXBR0SIfThQpW2Y5gVs,SpATywNh6bZuzm8s1ceuBUnMUAeoAHHw,27,53,26,20,13,16,13,1,142,20.285714285714285,4,0.0,16,26,20,13,37,16,0,13,1,75,67,0
3332,49176,NPHytleW9ri0zHSbUOwP2d33PRO3w2MK,SpATywNh6bZuzm8s1ceuBUnMUAeoAHHw,17,23,9,31,1,23,13,0,100,14.285714285714286,6,0.0,8,9,29,1,15,23,2,13,0,47,53,0
3333,49181,XlmFJwnIeWSyzdPHIMvNTxkRpr6ZopMK,SpATywNh6bZuzm8s1ceuBUnMUAeoAHHw,16,31,16,21,7,4,6,0,85,12.142857142857142,5,0.0,8,16,17,7,23,4,4,6,0,48,37,1
3334,49183,TNa2CwMEhRRkLaiFBsLLeLu23oFHBijc,SpATywNh6bZuzm8s1ceuBUnMUAeoAHHw,23,41,1,27,1,16,18,2,106,15.142857142857142,7,0.0,12,1,23,1,29,16,4,18,2,37,69,0
3335,49202,l70wRZ2DS0s6LjbT7C4gRoGrF27x9p2H,A3fsA9Zfv1X2fVEQhTw51lKENdNrEqT3,48,45,0,92,0,16,30,0,183,26.142857142857142,8,0.0,5,0,88,0,40,16,4,30,0,93,90,1
3336,49210,vAuEkfFLmRAZzPWBMIHGpWEOUfjnGK8C,SpATywNh6bZuzm8s1ceuBUnMUAeoAHHw,8,10,2,0,2,0,2,0,16,2.2857142857142856,1,0.0,1,2,0,2,9,0,0,2,0,5,11,1
3337,49238,Zi3R72s2HAt1ldLoA4VSH4SbCoNpJ8zo,SpATywNh6bZuzm8s1ceuBUnMUAeoAHHw,7,3,2,0,2,0,3,0,10,1.4285714285714286,2,0.0,0,2,0,2,3,0,0,3,0,4,6,1
3338,49253,b1eRrhapWSjtM2Ih9Xn0eBEZAyjqmlvI,5X6FeZozNMgE2VRi3MJYjkkFK8SETtu2,15,26,12,10,10,0,5,0,63,9.0,4,0.0,9,12,10,10,17,0,0,5,0,41,22,1
3339,49254,Hw8jmGp4VI4tAz6cfKhHDOeLB2t7MJ9z,SpATywNh6bZuzm8s1ceuBUnMUAeoAHHw,12,13,7,6,0,20,6,0,52,7.428571428571429,5,0.0,4,7,6,0,9,20,0,6,0,17,35,1
3340,49271,L1EklyJfiTl8KTmYGUWKSBRLYXBLn3BW,SpATywNh6bZuzm8s1ceuBUnMUAeoAHHw,18,27,18,12,9,0,5,1,72,10.285714285714286,7,0.0,3,18,11,9,24,0,1,5,1,41,31,0
3341,49276,vrm9Sqb4UFaJQirEdRETMq8oV2HNeZJI,bWdj2GDclj5ofokWjzoa5jAwMkxCykd6,13,33,12,0,12,21,9,1,88,12.571428571428571,5,0.0,2,12,0,12,31,21,0,9,1,26,62,0
3342,49278,uYpCxSEThfkQLmmlnpb36cNb0AbKmnXu,bWdj2GDclj5ofokWjzoa5jAwMkxCykd6,12,5,2,0,4,1,7,1,20,2.857142857142857,1,0.0,2,2,0,4,3,1,0,7,1,8,12,1
3343,49279,SAT7bMoLoVZhaMB8v6lFFmYFR0NgSYce,A3fsA9Zfv1X2fVEQhTw51lKENdNrEqT3,9,2,1,0,1,2,8,1,15,2.142857142857143,1,0.0,0,1,0,1,2,2,0,8,1,2,13,1
3344,49280,CGjJFqZQSngbEn6BLTOwdJsdGHCnhvU8,SpATywNh6bZuzm8s1ceuBUnMUAeoAHHw,39,47,16,45,10,11,19,4,152,21.714285714285715,5,0.0,7,16,35,10,40,11,10,19,4,68,84,1
3345,49295,cQq1I450zzmO4zcHgKJLXcCXQBX0VHxW,SpATywNh6bZuzm8s1ceuBUnMUAeoAHHw,6,3,1,0,1,0,3,0,8,1.1428571428571428,1,0.0,0,1,0,1,3,0,0,3,0,2,6,1
3346,49302,3uU9hzp6POZeWb9TkpjJweQiyjZgKmLY,SpATywNh6bZuzm8s1ceuBUnMUAeoAHHw,47,77,46,44,24,7,16,3,217,31.0,9,0.0,17,46,39,24,60,7,5,16,3,126,91,0
3347,49316,SY8PjWAcViY3TAxvifjZF4drAUdDweaG,RXDvfPUBYFlVdlueBFbLW0mhhAyGEqpt,6,4,3,0,3,0,1,0,11,1.5714285714285714,1,0.0,0,3,0,3,4,0,0,1,0,6,5,1
3348,49340,YbDGggh5B2xVgz44wTEzgnuIROY324O4,RXDvfPUBYFlVdlueBFbLW0mhhAyGEqpt,1,0,0,0,0,0,2,0,2,0.2857142857142857,1,0.0,0,0,0,0,0,0,0,2,0,0,2,1
3349,49384,829nD15I0zFbxTlo9Kk4QZLCipO4Bdiu,RXDvfPUBYFlVdlueBFbLW0mhhAyGEqpt,2,0,0,0,0,0,3,0,3,0.42857142857142855,1,0.0,0,0,0,0,0,0,0,3,0,0,3,1
3350,49396,5gZxPym3HmEvBCZNbF2vxyjqjuAZOTpQ,5X6FeZozNMgE2VRi3MJYjkkFK8SETtu2,15,29,10,16,14,0,4,0,73,10.428571428571429,3,0.0,16,10,13,14,13,0,3,4,0,53,20,1
3351,49398,829nD15I0zFbxTlo9Kk4QZLCipO4Bdiu,A3fsA9Zfv1X2fVEQhTw51lKENdNrEqT3,2,0,0,0,0,0,2,0,2,0.2857142857142857,1,0.0,0,0,0,0,0,0,0,2,0,0,2,1
3352,49401,rb0bCeAP0PjUKM6QZmb5eDbdcmhSPRHl,5X6FeZozNMgE2VRi3MJYjkkFK8SETtu2,4,2,1,0,1,0,3,0,7,1.0,2,0.0,0,1,0,1,2,0,0,3,0,2,5,1
3353,49415,5gZxPym3HmEvBCZNbF2vxyjqjuAZOTpQ,bWdj2GDclj5ofokWjzoa5jAwMkxCykd6,8,15,8,0,4,0,7,0,34,4.857142857142857,3,0.0,0,8,0,4,15,0,0,7,0,12,22,1
3354,49423,S9Zsax2BYcPzUt4rHtigt6S1ZlRCRjuu,SpATywNh6bZuzm8s1ceuBUnMUAeoAHHw,50,101,46,26,17,9,30,1,230,32.857142857142854,12,0.0,12,46,26,17,89,9,0,30,1,101,129,0
3355,49432,omzzgaeT6ZY9tvDfseVuJqPQ1kKVGR2Z,SpATywNh6bZuzm8s1ceuBUnMUAeoAHHw,46,82,34,56,15,19,18,5,229,32.714285714285715,2,0.0,43,34,45,15,39,19,11,18,5,137,92,1
3356,49439,cKY5fIoDoYK1EL9DOwETOjepsO48aQ9E,bWdj2GDclj5ofokWjzoa5jAwMkxCykd6,9,9,6,0,6,0,3,0,24,3.4285714285714284,1,0.0,2,6,0,6,7,0,0,3,0,14,10,1
3357,49458,hJo1MgKiPZFXuH2ko6hqPTd9dbjMQKDO,5X6FeZozNMgE2VRi3MJYjkkFK8SETtu2,9,15,5,10,3,0,6,0,39,5.571428571428571,4,0.0,4,5,8,3,11,0,2,6,0,20,19,1
3358,49460,cvdLaf0MdwYwJIsGvs9mqC9xuvaOoxKF,A3fsA9Zfv1X2fVEQhTw51lKENdNrEqT3,24,47,12,0,9,0,9,1,78,11.142857142857142,4,0.0,0,12,0,9,47,0,0,9,1,21,57,1
3359,49483,T761UltC8HrAVgHTpcJuQFf7vNJ3Ud9J,5X6FeZozNMgE2VRi3MJYjkkFK8SETtu2,17,32,16,12,9,0,7,1,77,11.0,3,0.0,4,16,10,9,28,0,2,7,1,39,38,1
3360,49511,H1nbdkC904EOh8jWeVVcV5piaqMVBsli,SpATywNh6bZuzm8s1ceuBUnMUAeoAHHw,35,42,4,36,1,2,14,0,99,14.142857142857142,8,0.0,10,4,35,1,32,2,1,14,0,50,49,0
3361,49513,I15DoIEv5oOQwZnGe2Nztxp5iKM5K2pr,SpATywNh6bZuzm8s1ceuBUnMUAeoAHHw,28,56,2,22,5,6,14,0,105,15.0,3,0.0,5,2,18,5,51,6,4,14,0,30,75,0
3362,49541,NblSZLprYLuCPJABpiPhGyWCznOG5gpM,SpATywNh6bZuzm8s1ceuBUnMUAeoAHHw,20,24,15,0,8,0,2,0,49,7.0,3,0.0,0,15,0,8,24,0,0,2,0,23,26,1
3363,49543,0OsY8LWQHJyrf2iZ6AGYuDrpmW3bfvqO,SpATywNh6bZuzm8s1ceuBUnMUAeoAHHw,52,103,52,29,23,8,39,3,257,36.714285714285715,11,0.0,22,52,25,23,81,8,4,39,3,122,135,0
3364,49553,bFQZxr4iRVJaZh2fO7R9dida2Y7glw1T,SpATywNh6bZuzm8s1ceuBUnMUAeoAHHw,47,46,25,47,14,1,10,1,144,20.571428571428573,5,0.0,16,25,42,14,30,1,5,10,1,97,47,0
3365,49576,oynYdl2jV0AqFEflzqlk35JIgkfhOwM5,SpATywNh6bZuzm8s1ceuBUnMUAeoAHHw,1,0,0,0,0,0,1,0,1,0.14285714285714285,1,0.0,0,0,0,0,0,0,0,1,0,0,1,1
3366,49604,OXUkoQAJTqhVghuHGRHk1iSAl7CHffoQ,SpATywNh6bZuzm8s1ceuBUnMUAeoAHHw,7,4,1,0,1,0,3,0,9,1.2857142857142858,2,0.0,1,1,0,1,3,0,0,3,0,3,6,1
3367,49610,G43uBjhkBEsnK2sHC51NOglfCGNDkydQ,SpATywNh6bZuzm8s1ceuBUnMUAeoAHHw,31,46,23,20,13,2,15,0,119,17.0,5,0.0,19,23,19,13,27,2,1,15,0,74,45,1
3368,49611,00SOCgKq1H6iYExhbauCeUrQFSjIMetG,SpATywNh6bZuzm8s1ceuBUnMUAeoAHHw,9,9,6,0,3,1,8,1,28,4.0,2,0.0,0,6,0,3,9,1,0,8,1,9,19,0
3369,49620,twg5LqeyEPdLZyjl4T3Yb1man7ZRuOed,SpATywNh6bZuzm8s1ceuBUnMUAeoAHHw,50,140,22,35,11,2,35,2,247,35.285714285714285,12,0.0,30,22,34,11,110,2,1,35,2,97,150,0
3370,49626,LiONc59joHBCh6XOJp7hfXs4mjQEsGy4,SpATywNh6bZuzm8s1ceuBUnMUAeoAHHw,29,41,24,35,10,0,10,0,120,17.142857142857142,5,0.0,7,24,34,10,34,0,1,10,0,75,45,1
3371,49630,Nvud1QIhR4FBjW055r9HSxywupZk5GAR,SpATywNh6bZuzm8s1ceuBUnMUAeoAHHw,9,10,2,0,1,0,2,0,15,2.142857142857143,2,0.0,0,2,0,1,10,0,0,2,0,3,12,1
3372,49633,lcYZKeyU0m8T0hVxudGSh4HqQiun1Pb4,SpATywNh6bZuzm8s1ceuBUnMUAeoAHHw,14,14,0,4,0,0,6,0,24,3.4285714285714284,2,0.0,4,0,4,0,10,0,0,6,0,8,16,1
3373,49650,Y3zuofaAdrsNcwq0tuYyHFkAsBUWoV8a,SpATywNh6bZuzm8s1ceuBUnMUAeoAHHw,36,63,23,37,7,40,34,8,212,30.285714285714285,8,0.0,9,23,33,7,54,40,4,34,8,72,140,0
3374,49654,1bKMONcV6Mq58szdlIajPdFyqaw4BvrA,SpATywNh6bZuzm8s1ceuBUnMUAeoAHHw,7,7,1,0,1,0,4,0,13,1.8571428571428572,3,0.0,0,1,0,1,7,0,0,4,0,2,11,1
3375,49655,H1nbdkC904EOh8jWeVVcV5piaqMVBsli,G8EPVSXsOYB5YQWZGiz1aVq5Pgr2GrQu,124,175,10,391,8,5,47,1,637,91.0,12,0.0,69,10,332,8,106,5,59,47,1,419,218,0
3376,49656,BoK7CAUaCFqnLgmWLxeOHg8YkXUSeCtc,SpATywNh6bZuzm8s1ceuBUnMUAeoAHHw,12,38,18,8,10,0,10,0,84,12.0,5,0.0,2,18,6,10,36,0,2,10,0,36,48,0
3377,49667,FMXygMEgHnu3skJkjoCo0OvyQsjB0C7q,SpATywNh6bZuzm8s1ceuBUnMUAeoAHHw,9,11,1,0,1,0,14,1,28,4.0,1,0.0,0,1,0,1,11,0,0,14,1,2,26,1
3378,49679,GF5Rflu9cCcL8EFuacKpsHdGIeCCsr9m,SpATywNh6bZuzm8s1ceuBUnMUAeoAHHw,32,103,12,14,8,3,18,1,159,22.714285714285715,8,0.0,3,12,11,8,100,3,3,18,1,34,125,0
3379,49691,bVLtn3iBc4ibW8xWVzLLM3Hs9gCB0qb7,SpATywNh6bZuzm8s1ceuBUnMUAeoAHHw,30,29,0,30,0,0,10,0,69,9.857142857142858,3,0.0,7,0,26,0,22,0,4,10,0,33,36,0
3380,49694,cszgTMCcWdEja3BpEwPP5MtLXTMUMJXE,SpATywNh6bZuzm8s1ceuBUnMUAeoAHHw,24,16,11,12,8,0,2,0,49,7.0,2,0.0,2,11,12,8,14,0,0,2,0,33,16,0
3381,49705,Lce2TIYgGhTbahYzTHHK4e5KxnEianpx,G8EPVSXsOYB5YQWZGiz1aVq5Pgr2GrQu,6,4,2,0,1,0,4,0,11,1.5714285714285714,3,0.0,0,2,0,1,4,0,0,4,0,3,8,1
3382,49710,LzTBHDjLePaTqbybIwaptvUgkC0hWYCZ,SpATywNh6bZuzm8s1ceuBUnMUAeoAHHw,62,103,51,77,24,6,34,1,296,42.285714285714285,10,0.0,31,51,68,24,72,6,9,34,1,174,122,0
3383,49732,fiLsrcAU0ZFm61T8xhRUwb5p8PN605CT,G8EPVSXsOYB5YQWZGiz1aVq5Pgr2GrQu,1,0,0,0,0,0,1,0,1,0.14285714285714285,1,0.0,0,0,0,0,0,0,0,1,0,0,1,1
3384,49749,EwhKhClSv2Ps16I3uKtjdSj1YI7rGPIh,SpATywNh6bZuzm8s1ceuBUnMUAeoAHHw,25,42,24,37,11,0,18,0,132,18.857142857142858,7,0.0,5,24,32,11,37,0,5,18,0,72,60,0
3385,49759,k9PbwipCcCjE65bhyUr029mHfI0NwL1R,A3fsA9Zfv1X2fVEQhTw51lKENdNrEqT3,5,2,1,0,1,0,2,0,6,0.8571428571428571,1,0.0,0,1,0,1,2,0,0,2,0,2,4,1
3386,49766,Lce2TIYgGhTbahYzTHHK4e5KxnEianpx,SpATywNh6bZuzm8s1ceuBUnMUAeoAHHw,7,12,5,0,2,0,6,0,25,3.5714285714285716,4,0.0,0,5,0,2,12,0,0,6,0,7,18,1
3387,49803,3FwKlBDtKGlNAYyQNzHL1qfkuXpNOPVW,A3fsA9Zfv1X2fVEQhTw51lKENdNrEqT3,52,34,26,80,14,5,23,1,183,26.142857142857142,5,0.0,1,26,66,14,33,5,14,23,1,107,76,0
3388,49836,0vUwtohBIGCms6pa9p1s0k5cJHWURa4P,SpATywNh6bZuzm8s1ceuBUnMUAeoAHHw,34,42,1,46,0,4,8,1,102,14.571428571428571,3,0.0,14,1,40,0,28,4,6,8,1,55,47,0
3389,49863,rVswAzjMLz5uIPbCwAU1SliCQFpiAqey,SpATywNh6bZuzm8s1ceuBUnMUAeoAHHw,37,30,21,15,14,0,7,0,87,12.428571428571429,5,0.0,4,21,14,14,26,0,1,7,0,53,34,0
3390,49871,8Z72cXdX2QzZC5Cee7T0dly3YHU3SU43,SpATywNh6bZuzm8s1ceuBUnMUAeoAHHw,4,2,1,0,1,0,3,0,7,1.0,2,0.0,0,1,0,1,2,0,0,3,0,2,5,1
3391,49876,SvdoxHaqv4If8vTEQE4Ye6pIzdBuUEi9,SpATywNh6bZuzm8s1ceuBUnMUAeoAHHw,5,2,0,0,1,0,2,0,5,0.7142857142857143,1,0.0,0,0,0,1,2,0,0,2,0,1,4,1
3392,49883,m5Ev3sP4lHJ0ibeJ0LosEcT9fpQ7nqsa,SpATywNh6bZuzm8s1ceuBUnMUAeoAHHw,41,64,2,41,1,0,21,4,133,19.0,9,0.0,9,2,37,1,55,0,4,21,4,49,84,0
3393,49896,PrE64zhEuNh83grWL2cXaZZPY2nI1xUf,RXDvfPUBYFlVdlueBFbLW0mhhAyGEqpt,1,0,0,0,0,0,1,0,1,0.14285714285714285,1,0.0,0,0,0,0,0,0,0,1,0,0,1,1
3394,49918,ydYJlUXOoM7xCFpD6o4c1fr3yZVc0YKb,SpATywNh6bZuzm8s1ceuBUnMUAeoAHHw,20,31,13,14,7,0,6,5,76,10.857142857142858,2,0.0,16,13,12,7,15,0,2,6,5,48,28,0
3395,49937,S1lONT2J4pj3m6ZnKfCaXABaqydhFYAZ,RXDvfPUBYFlVdlueBFbLW0mhhAyGEqpt,1,0,0,0,0,0,1,0,1,0.14285714285714285,1,0.0,0,0,0,0,0,0,0,1,0,0,1,1
3396,49946,LNdimqsJkOxQDP9dT4IGwewg9YvH7zfV,G8EPVSXsOYB5YQWZGiz1aVq5Pgr2GrQu,119,135,59,184,34,3,17,0,432,61.714285714285715,9,0.0,56,59,145,34,79,3,39,17,0,294,138,0
3397,49949,8kmVwd95niwmuvSIAWJVA4Pqx2tMb8kH,A3fsA9Zfv1X2fVEQhTw51lKENdNrEqT3,21,24,11,0,8,0,4,0,47,6.714285714285714,2,0.0,1,11,0,8,23,0,0,4,0,20,27,1
3398,49954,wUH86mMJYdGCZbgyy3OXf5PGskcw9ISy,RXDvfPUBYFlVdlueBFbLW0mhhAyGEqpt,17,18,2,15,2,6,9,1,53,7.571428571428571,3,0.0,2,2,12,2,16,6,3,9,1,18,35,1
3399,49967,7tmNprOSiahGzByaY8XiUnCFEIQfWwuf,bWdj2GDclj5ofokWjzoa5jAwMkxCykd6,10,27,11,0,0,1,13,1,53,7.571428571428571,8,0.0,3,11,0,0,24,1,0,13,1,14,39,0
3400,49971,2rGTh1SgxK2LtCqPtAjekJLf0W67MrW9,SpATywNh6bZuzm8s1ceuBUnMUAeoAHHw,7,11,2,10,0,0,1,0,24,3.4285714285714284,1,0.0,8,2,9,0,3,0,1,1,0,19,5,1
3401,49987,ctfOhdlbQGiOVF89Y090EmsAqQEvSWmz,SpATywNh6bZuzm8s1ceuBUnMUAeoAHHw,25,52,1,34,0,2,22,1,112,16.0,10,0.0,17,1,29,0,35,2,5,22,1,47,65,0
3402,49989,5fAHYcqH6noZyKsfWFiBARbB61J6LxWy,SpATywNh6bZuzm8s1ceuBUnMUAeoAHHw,16,35,1,0,2,0,4,0,42,6.0,3,0.0,0,1,0,2,35,0,0,4,0,3,39,0
3403,49990,uG5tavnQGh6e9leaVUY69Y8QlorpIOvo,SpATywNh6bZuzm8s1ceuBUnMUAeoAHHw,17,17,13,0,9,0,5,0,44,6.285714285714286,3,0.0,0,13,0,9,17,0,0,5,0,22,22,0
3404,49999,46mPOafwambmi8gI5RDfSSG6CkqbcJr8,SpATywNh6bZuzm8s1ceuBUnMUAeoAHHw,25,36,23,33,2,0,9,0,103,14.714285714285714,3,0.0,7,23,26,2,29,0,7,9,0,58,45,0
3405,50013,hEuZWxjCrAC3cKN1nvhR1u2fd2M80LCS,5X6FeZozNMgE2VRi3MJYjkkFK8SETtu2,9,23,2,11,4,0,2,0,42,6.0,1,0.0,11,2,9,4,12,0,2,2,0,26,16,1
3406,50039,Ib4hBLihYWrsRQnVhSZKjb9Z8z0NZ4FI,SpATywNh6bZuzm8s1ceuBUnMUAeoAHHw,38,94,3,46,2,13,18,3,179,25.571428571428573,10,0.0,29,3,37,2,65,13,9,18,3,71,108,1
3407,50046,Pot71eWzAwlFIQ6WGEu1vr9IkLdwRub9,SpATywNh6bZuzm8s1ceuBUnMUAeoAHHw,26,43,26,28,9,23,16,0,145,20.714285714285715,7,0.0,4,26,26,9,39,23,2,16,0,65,80,0
3408,50047,gUDPkL7pRDCcGo7yRjnN9pFohqG3UESN,G8EPVSXsOYB5YQWZGiz1aVq5Pgr2GrQu,12,15,2,6,4,0,6,0,33,4.714285714285714,1,0.0,8,2,3,4,7,0,3,6,0,17,16,1
3409,50067,nYSFDE8RCbcZhD46fRSvPHUvA1ahfupi,bWdj2GDclj5ofokWjzoa5jAwMkxCykd6,21,28,3,0,3,77,19,1,131,18.714285714285715,5,0.0,0,3,0,3,28,77,0,19,1,6,125,1
3410,50077,HNEdRWA988TWNlPkPkScnQdIH5zRazOo,SpATywNh6bZuzm8s1ceuBUnMUAeoAHHw,30,57,26,22,11,39,9,1,165,23.571428571428573,9,0.0,16,26,21,11,41,39,1,9,1,74,91,0
3411,50083,0lcODMnOtMqKwcOQQi0MUEWuUnIKYPe1,A3fsA9Zfv1X2fVEQhTw51lKENdNrEqT3,60,55,2,160,2,0,15,0,234,33.42857142857143,5,0.0,6,2,140,2,49,0,20,15,0,150,84,1
3412,50092,rPKaOWNl9cYkLvtQk035CJPYGwPAMUtv,SpATywNh6bZuzm8s1ceuBUnMUAeoAHHw,31,59,24,40,5,2,14,1,145,20.714285714285715,10,0.0,13,24,37,5,46,2,3,14,1,79,66,0
3413,50099,sDoPeRFIl4sblcl7cpIozq9zgLVwKPZK,SpATywNh6bZuzm8s1ceuBUnMUAeoAHHw,11,9,2,2,0,0,4,0,17,2.4285714285714284,2,0.0,0,2,2,0,9,0,0,4,0,4,13,0
3414,50100,5u5MqcjfkyBtFhEFfICuuKJJdSbQMwNN,SpATywNh6bZuzm8s1ceuBUnMUAeoAHHw,22,43,22,21,11,0,7,0,104,14.857142857142858,3,0.0,13,22,17,11,30,0,4,7,0,63,41,1
3415,50131,6k0P72adqZC6N7qhsceaS6tnkuUG2bub,SpATywNh6bZuzm8s1ceuBUnMUAeoAHHw,16,24,10,30,3,5,11,0,83,11.857142857142858,3,0.0,7,10,25,3,17,5,5,11,0,45,38,0
3416,50143,kmn6CGih1FILZybV8MrApq46D7xH5npO,SpATywNh6bZuzm8s1ceuBUnMUAeoAHHw,29,35,10,1,8,11,21,1,87,12.428571428571429,6,0.0,1,10,1,8,34,11,0,21,1,20,67,0
3417,50148,KlVBCKeUNzJiPeVUbSEa3YQZCx8yfOft,SpATywNh6bZuzm8s1ceuBUnMUAeoAHHw,16,13,7,2,3,0,5,0,30,4.285714285714286,2,0.0,1,7,2,3,12,0,0,5,0,13,17,0
3418,50158,PPK7S6McpqG1xker7o77HjrFULvz49Xg,SpATywNh6bZuzm8s1ceuBUnMUAeoAHHw,11,11,0,34,0,0,2,0,47,6.714285714285714,1,0.0,4,0,32,0,7,0,2,2,0,36,11,1
3419,50175,CfX84b3AnOREjEgHXp5gQV78osBjxVJV,RXDvfPUBYFlVdlueBFbLW0mhhAyGEqpt,50,90,0,149,2,14,23,3,281,40.142857142857146,8,0.0,25,0,136,2,65,14,13,23,3,163,118,0
3420,50176,CU5xrwbVWBzQZTDEzCWYaPDOJwNXjtq2,A3fsA9Zfv1X2fVEQhTw51lKENdNrEqT3,15,22,3,0,3,7,2,0,37,5.285714285714286,5,0.0,0,3,0,3,22,7,0,2,0,6,31,0
3421,50181,abmp6NHOG5DtC0bkxrbMKfrj8pBrMR65,SpATywNh6bZuzm8s1ceuBUnMUAeoAHHw,5,2,1,0,1,0,2,0,6,0.8571428571428571,1,0.0,0,1,0,1,2,0,0,2,0,2,4,1
3422,50193,FakQTw0mcCCNaYTf0r7ShnVJd2c9Q8vo,SpATywNh6bZuzm8s1ceuBUnMUAeoAHHw,10,5,4,0,4,0,1,0,14,2.0,1,0.0,0,4,0,4,5,0,0,1,0,8,6,1
3423,50254,rf43ZHojMqXQ775bmX3nnHgQ62d9XvGK,A3fsA9Zfv1X2fVEQhTw51lKENdNrEqT3,27,34,19,0,9,4,14,1,81,11.571428571428571,5,0.0,0,19,0,9,34,4,0,14,1,28,53,1
3424,50271,Gur5FuhE9EyV9K1F0qLPk7AenhoY8PBS,5X6FeZozNMgE2VRi3MJYjkkFK8SETtu2,16,50,10,0,18,0,16,0,94,13.428571428571429,6,0.0,18,10,0,18,32,0,0,16,0,46,48,1
3425,50280,8kmVwd95niwmuvSIAWJVA4Pqx2tMb8kH,bWdj2GDclj5ofokWjzoa5jAwMkxCykd6,4,3,0,0,0,0,2,0,5,0.7142857142857143,2,0.0,1,0,0,0,2,0,0,2,0,1,4,1
3426,50283,cxmD5n6LDACjvuY8YvfXaGJ22S8l6lkc,5X6FeZozNMgE2VRi3MJYjkkFK8SETtu2,4,6,3,0,0,0,4,0,13,1.8571428571428572,4,0.0,0,3,0,0,6,0,0,4,0,3,10,1
3427,50315,1D9YAtx0zyELGBYY8fk5ML3KqjBc5hJQ,bWdj2GDclj5ofokWjzoa5jAwMkxCykd6,1,0,0,0,0,0,2,0,2,0.2857142857142857,2,0.0,0,0,0,0,0,0,0,2,0,0,2,1
3428,50318,nrol5VxiNERghlxTlRYzcM0aTVUVOtUp,SpATywNh6bZuzm8s1ceuBUnMUAeoAHHw,33,103,57,54,25,5,23,1,268,38.285714285714285,4,0.0,33,57,42,25,70,5,12,23,1,157,111,0
3429,50319,7eLlsseV075nalpvk2K7Ka9Wx9qMiOW4,SpATywNh6bZuzm8s1ceuBUnMUAeoAHHw,14,35,30,0,19,4,19,3,110,15.714285714285714,10,0.0,2,30,0,19,33,4,0,19,3,51,59,0
3430,50324,OIups6Cq9XY2CbwOPuI31XrOSt1FeD7G,SpATywNh6bZuzm8s1ceuBUnMUAeoAHHw,34,48,1,49,1,0,6,0,105,15.0,6,0.0,8,1,42,1,40,0,7,6,0,52,53,0
3431,50348,4clLK6Y8CprtsnOm6pLtpUpbGTeCufAu,SpATywNh6bZuzm8s1ceuBUnMUAeoAHHw,38,66,33,21,20,0,6,0,146,20.857142857142858,6,0.0,11,33,20,20,55,0,1,6,0,84,62,0
3432,50355,0ALNyWoY1JWb8XE08BRj6HWmYvNPawi2,G8EPVSXsOYB5YQWZGiz1aVq5Pgr2GrQu,28,30,11,52,8,0,3,0,104,14.857142857142858,1,0.0,17,11,35,8,13,0,17,3,0,71,33,1
3433,50357,wXFfHtwd9smrvhh9NQW7SmEEo1001LDW,bWdj2GDclj5ofokWjzoa5jAwMkxCykd6,20,22,11,48,5,21,10,2,119,17.0,4,0.0,5,11,44,5,17,21,4,10,2,65,54,0
3434,50364,aielGp4BBBM8UMDsf9Gagm7MaWHEZpD2,SpATywNh6bZuzm8s1ceuBUnMUAeoAHHw,5,3,1,0,1,0,1,0,6,0.8571428571428571,1,0.0,0,1,0,1,3,0,0,1,0,2,4,1
3435,50365,daRNgrfSmtLtouStkwCortm8nv14xS31,SpATywNh6bZuzm8s1ceuBUnMUAeoAHHw,10,14,11,2,0,0,1,0,28,4.0,3,0.0,1,11,2,0,13,0,0,1,0,14,14,1
3436,50374,hAzZgxrFOBoGWYS4hUaB1UgnpeWilVGC,SpATywNh6bZuzm8s1ceuBUnMUAeoAHHw,37,45,24,33,13,0,12,0,127,18.142857142857142,4,0.0,5,24,28,13,40,0,5,12,0,70,57,1
3437,50407,6EQbt9V437dKT6gP8U14lbyP7vlX0oqM,RXDvfPUBYFlVdlueBFbLW0mhhAyGEqpt,1,0,0,0,0,0,1,0,1,0.14285714285714285,1,0.0,0,0,0,0,0,0,0,1,0,0,1,1
3438,50410,dy5U2Hr6hWmpYZri5b9XY0EijWuyuZjO,A3fsA9Zfv1X2fVEQhTw51lKENdNrEqT3,2,0,0,0,0,0,2,0,2,0.2857142857142857,1,0.0,0,0,0,0,0,0,0,2,0,0,2,1
3439,50414,x29OOChdmJGXK62DnUpwKbwJurqULmnD,A3fsA9Zfv1X2fVEQhTw51lKENdNrEqT3,2,0,0,0,0,0,2,0,2,0.2857142857142857,1,0.0,0,0,0,0,0,0,0,2,0,0,2,1
3440,50416,Xdag5jOmE7uWC3FmBvgPc5F7lO3QNcPW,SpATywNh6bZuzm8s1ceuBUnMUAeoAHHw,35,61,30,36,8,38,18,4,195,27.857142857142858,8,0.0,7,30,32,8,54,38,4,18,4,77,118,0
3441,50439,uZmZE9etGnvk5b9puVa5txx5eNz1U4Ni,5X6FeZozNMgE2VRi3MJYjkkFK8SETtu2,4,2,1,0,1,0,1,0,5,0.7142857142857143,1,0.0,0,1,0,1,2,0,0,1,0,2,3,1
3442,50453,oeAE2ju0pElvnhTP1w6Sla895xthJTKj,A3fsA9Zfv1X2fVEQhTw51lKENdNrEqT3,1,0,0,0,0,0,1,0,1,0.14285714285714285,1,0.0,0,0,0,0,0,0,0,1,0,0,1,1
3443,50461,Mk1WltctY1vlvTjvcoOEN36uI9KP8emp,SpATywNh6bZuzm8s1ceuBUnMUAeoAHHw,34,132,64,5,24,0,28,0,253,36.142857142857146,13,0.0,3,64,4,24,129,0,1,28,0,95,158,0
3444,50489,oN94SUDmQJB7NjOsdtFUBlHSFjNSal96,G8EPVSXsOYB5YQWZGiz1aVq5Pgr2GrQu,1,0,0,0,0,0,1,0,1,0.14285714285714285,1,0.0,0,0,0,0,0,0,0,1,0,0,1,1
3445,50496,Crsle3QdAPcjxEbhDM61m0114QeooRDa,5X6FeZozNMgE2VRi3MJYjkkFK8SETtu2,4,2,1,0,0,0,2,0,5,0.7142857142857143,1,0.0,0,1,0,0,2,0,0,2,0,1,4,1
3446,50497,4en36s6M5dWiGXaOz7Ao485PkasQppcC,RXDvfPUBYFlVdlueBFbLW0mhhAyGEqpt,24,22,9,32,11,24,8,0,106,15.142857142857142,1,0.0,12,9,30,11,10,24,2,8,0,62,44,0
3447,50500,RwMUq7SCIYrULeTtIYQzgTGTjkIjUHL3,SpATywNh6bZuzm8s1ceuBUnMUAeoAHHw,54,76,24,44,16,3,22,7,192,27.428571428571427,8,0.0,11,24,36,16,65,3,8,22,7,87,105,0
3448,50501,E7wBgQCkgD4tkfXLdP9URnDZqb2ubvF0,SpATywNh6bZuzm8s1ceuBUnMUAeoAHHw,32,55,4,35,3,0,7,0,104,14.857142857142858,5,0.0,6,4,31,3,49,0,4,7,0,44,60,0
3449,50508,9VvuC4slhZy3KdxqSDDnJl1JHYWZF5th,A3fsA9Zfv1X2fVEQhTw51lKENdNrEqT3,21,30,17,0,7,20,32,2,108,15.428571428571429,5,0.0,2,17,0,7,28,20,0,32,2,26,82,1
3450,50513,W0kdPH6yQ2qysuOIkIgCmrFyFZhFfIKL,SpATywNh6bZuzm8s1ceuBUnMUAeoAHHw,32,46,24,11,5,17,9,2,114,16.285714285714285,3,0.0,15,24,11,5,31,17,0,9,2,55,59,0
3451,50528,faeF4I5p3gAJMB1p4LfYVeCLQZKervYV,A3fsA9Zfv1X2fVEQhTw51lKENdNrEqT3,41,52,3,66,1,0,8,0,130,18.571428571428573,6,0.0,2,3,59,1,50,0,7,8,0,65,65,1
3452,50537,faeF4I5p3gAJMB1p4LfYVeCLQZKervYV,5X6FeZozNMgE2VRi3MJYjkkFK8SETtu2,5,2,1,0,1,0,2,0,6,0.8571428571428571,2,0.0,0,1,0,1,2,0,0,2,0,2,4,1
3453,50540,RS564zscXajJOiW9woDtEu4M9LDaNEPd,SpATywNh6bZuzm8s1ceuBUnMUAeoAHHw,14,15,7,0,6,0,3,0,31,4.428571428571429,2,0.0,0,7,0,6,15,0,0,3,0,13,18,1
3454,50546,8rXJHeqrLpho5nIQgbDcpBTvBrVnGged,A3fsA9Zfv1X2fVEQhTw51lKENdNrEqT3,31,12,6,54,3,0,25,0,100,14.285714285714286,4,0.0,1,6,50,3,11,0,4,25,0,60,40,1
3455,50573,8ksQz9dz4s7ijHzYWnxMOGz2bplP7OAs,SpATywNh6bZuzm8s1ceuBUnMUAeoAHHw,10,22,3,19,0,0,3,0,47,6.714285714285714,3,0.0,10,3,16,0,12,0,3,3,0,29,18,1
3456,50583,RDYqKiZt9A6fUXvjmZNUfSbfEZdDLqXa,A3fsA9Zfv1X2fVEQhTw51lKENdNrEqT3,8,3,2,0,2,0,3,0,10,1.4285714285714286,1,0.0,0,2,0,2,3,0,0,3,0,4,6,1
3457,50595,y1ePxH9bhUBdav1d6VZPfHfp0HugcSgX,A3fsA9Zfv1X2fVEQhTw51lKENdNrEqT3,7,3,2,0,2,0,2,0,9,1.2857142857142858,1,0.0,0,2,0,2,3,0,0,2,0,4,5,1
3458,50611,RgxmGDfKcBuOKimrAda6q6r1m3kTwJWg,A3fsA9Zfv1X2fVEQhTw51lKENdNrEqT3,5,2,1,0,1,0,2,0,6,0.8571428571428571,2,0.0,0,1,0,1,2,0,0,2,0,2,4,1
3459,50627,JhEVXqMF0fvMmfagf4Ea7erW2ArgVAj9,SpATywNh6bZuzm8s1ceuBUnMUAeoAHHw,12,27,8,14,0,7,4,0,60,8.571428571428571,3,0.0,3,8,14,0,24,7,0,4,0,25,35,1
3460,50660,6jPw8ZwEXjLpnrxZT6HkwOQ20NkEyvU7,SpATywNh6bZuzm8s1ceuBUnMUAeoAHHw,45,99,18,49,14,360,40,1,581,83.0,13,0.0,21,18,41,14,78,360,8,40,1,94,487,0
3461,50677,cgc8DGkd3Jwqn7jWLS8pFiVfUMBb7Shb,5X6FeZozNMgE2VRi3MJYjkkFK8SETtu2,9,34,4,0,1,3,10,0,52,7.428571428571429,3,0.0,11,4,0,1,23,3,0,10,0,16,36,1
3462,50679,tqvOTiQbipkIXQL7CIR5dckxV83rng9S,G8EPVSXsOYB5YQWZGiz1aVq5Pgr2GrQu,48,56,39,82,16,32,26,1,252,36.0,8,0.0,1,39,73,16,55,32,9,26,1,129,123,0
3463,50683,iVwNFnYcHwv8JroRNWkaHfHv9TTNdn1b,G8EPVSXsOYB5YQWZGiz1aVq5Pgr2GrQu,11,6,2,0,1,0,17,1,27,3.857142857142857,1,0.0,0,2,0,1,6,0,0,17,1,3,24,1
3464,50707,Aa2R9ra7UkMT71HsVEpaQpVn5z60q5tc,G8EPVSXsOYB5YQWZGiz1aVq5Pgr2GrQu,19,23,17,0,9,8,17,1,75,10.714285714285714,4,0.0,0,17,0,9,23,8,0,17,1,26,49,1
3465,50723,85CdJb1zpoAUDtR6sIsTNXjrVvfGwx1A,SpATywNh6bZuzm8s1ceuBUnMUAeoAHHw,47,100,41,42,13,20,20,1,237,33.857142857142854,6,0.0,42,41,38,13,58,20,4,20,1,134,103,0
3466,50754,FJxbzfYvIetXhjzEILF0NWt1RCss96LW,A3fsA9Zfv1X2fVEQhTw51lKENdNrEqT3,39,39,25,0,23,0,14,2,103,14.714285714285714,7,0.0,0,25,0,23,39,0,0,14,2,48,55,0
3467,50765,oVaUms2Ssh1VCspWlUtFJRhg5TUrapsx,SpATywNh6bZuzm8s1ceuBUnMUAeoAHHw,1,0,0,0,0,0,1,0,1,0.14285714285714285,1,0.0,0,0,0,0,0,0,0,1,0,0,1,1
3468,50782,spcUWaGtojfez6ZdF6aqlTnU3zU2dqpy,A3fsA9Zfv1X2fVEQhTw51lKENdNrEqT3,70,81,39,122,23,10,30,2,307,43.857142857142854,3,0.0,5,39,102,23,76,10,20,30,2,169,138,0
3469,50832,KH1qoBE3q99uPmQbxyBhuyXhrxNuFdJJ,5X6FeZozNMgE2VRi3MJYjkkFK8SETtu2,1,0,0,0,0,0,1,0,1,0.14285714285714285,1,0.0,0,0,0,0,0,0,0,1,0,0,1,1
3470,50833,KH1qoBE3q99uPmQbxyBhuyXhrxNuFdJJ,bWdj2GDclj5ofokWjzoa5jAwMkxCykd6,1,0,0,0,0,0,1,0,1,0.14285714285714285,1,0.0,0,0,0,0,0,0,0,1,0,0,1,1
3471,50884,4msuvQN1KfMGlp99mEfZpxIIpoD4IGXo,5Gyp41oLVo7Gg7vF4vpmggWP5MU70QO6,6,1,1,0,1,0,3,0,6,0.8571428571428571,1,0.0,0,1,0,1,1,0,0,3,0,2,4,1
3472,50891,oDr5oRs7FIygz2lqxkuhCjkxvDWb5L6G,5Gyp41oLVo7Gg7vF4vpmggWP5MU70QO6,13,21,8,10,6,0,3,0,48,6.857142857142857,3,0.0,6,8,5,6,15,0,5,3,0,25,23,1
3473,50894,1U7cDhSu4UGlxuwxcjk5lRzaNoaFm88d,5Gyp41oLVo7Gg7vF4vpmggWP5MU70QO6,7,1,1,0,1,3,4,1,11,1.5714285714285714,1,0.0,0,1,0,1,1,3,0,4,1,2,9,1
3474,50909,kyUPY0MEVeZNvkmrQxOn0CHNXLZiD03b,5Gyp41oLVo7Gg7vF4vpmggWP5MU70QO6,13,17,9,0,3,0,15,1,45,6.428571428571429,4,0.0,0,9,0,3,17,0,0,15,1,12,33,0
3475,50919,MwsjD881hF2KUCEG3rXUPSq3GKMfMo2d,5Gyp41oLVo7Gg7vF4vpmggWP5MU70QO6,7,10,6,0,1,0,3,0,20,2.857142857142857,3,0.0,1,6,0,1,9,0,0,3,0,8,12,1
3476,50933,irhRnOsJYuxpNg5XBOqsIO4PAoGU2IoY,5Gyp41oLVo7Gg7vF4vpmggWP5MU70QO6,1,0,0,0,0,0,1,0,1,0.14285714285714285,1,0.0,0,0,0,0,0,0,0,1,0,0,1,1
3477,50950,U04y5vFf0AfyJVGIOJHlryTyRQEOm5pT,5Gyp41oLVo7Gg7vF4vpmggWP5MU70QO6,5,8,3,0,0,0,5,0,16,2.2857142857142856,3,0.0,0,3,0,0,8,0,0,5,0,3,13,0
3478,50994,eNQdUjKgDpXjtgshKzAH2kpRxsIu20wI,5Gyp41oLVo7Gg7vF4vpmggWP5MU70QO6,1,0,0,0,0,0,1,0,1,0.14285714285714285,1,0.0,0,0,0,0,0,0,0,1,0,0,1,1
3479,51046,K1pykS4XBq4CMEnRPAkBRQ0KuHn2G2FR,5Gyp41oLVo7Gg7vF4vpmggWP5MU70QO6,5,2,1,0,1,0,2,0,6,0.8571428571428571,1,0.0,0,1,0,1,2,0,0,2,0,2,4,1
3480,51052,0ElvyB1MiVzz5klxXQkmAKR1rTFeqHn9,5Gyp41oLVo7Gg7vF4vpmggWP5MU70QO6,11,15,7,8,3,0,4,0,37,5.285714285714286,4,0.0,4,7,6,3,11,0,2,4,0,20,17,0
3481,51055,6A60zadtj8FKi84VaMeYcSvKWRtVJvs6,5Gyp41oLVo7Gg7vF4vpmggWP5MU70QO6,41,139,34,34,34,353,48,3,645,92.14285714285714,15,0.0,18,34,25,34,121,353,9,48,3,111,534,1
3482,51056,sfsOsmVwJBxu6Zuz5Ndm1WMj56nnjiUs,5Gyp41oLVo7Gg7vF4vpmggWP5MU70QO6,9,8,0,6,0,0,3,0,17,2.4285714285714284,2,0.0,2,0,6,0,6,0,0,3,0,8,9,1
3483,51059,vSL0kRsKOWBMpC6pqEAxri0eLNug5E20,5Gyp41oLVo7Gg7vF4vpmggWP5MU70QO6,1,0,0,0,0,0,2,0,2,0.2857142857142857,1,0.0,0,0,0,0,0,0,0,2,0,0,2,1
3484,51136,NYceLerQzC2X1tSR9IDfk2VrbeTPT1db,5Gyp41oLVo7Gg7vF4vpmggWP5MU70QO6,18,32,11,12,13,0,4,0,72,10.285714285714286,2,0.0,15,11,6,13,17,0,6,4,0,45,27,1
3485,51150,bsTh1xFON0PPXlEOexejfdceRZ4CC8Hx,5Gyp41oLVo7Gg7vF4vpmggWP5MU70QO6,12,16,7,16,2,0,6,0,47,6.714285714285714,4,0.0,6,7,13,2,10,0,3,6,0,28,19,1
3486,51176,x14nioYZXOgcIkIJTp88ZtYltIrxA4Dy,5Gyp41oLVo7Gg7vF4vpmggWP5MU70QO6,1,0,0,0,0,0,2,0,2,0.2857142857142857,1,0.0,0,0,0,0,0,0,0,2,0,0,2,1
3487,51187,3eKiIXhRJU4AcaSK2OGxb5hm0pCKaHgd,5Gyp41oLVo7Gg7vF4vpmggWP5MU70QO6,9,3,2,0,2,0,6,1,14,2.0,1,0.0,0,2,0,2,3,0,0,6,1,4,10,1
3488,51215,HNZ8UVJXOjsBf9vs7pgIklpz5V5PnTac,5Gyp41oLVo7Gg7vF4vpmggWP5MU70QO6,5,3,1,0,1,0,1,0,6,0.8571428571428571,1,0.0,0,1,0,1,3,0,0,1,0,2,4,1
3489,51233,FbmJNri4rSwVM6BXSopSVdPwLJqrwwJ5,5Gyp41oLVo7Gg7vF4vpmggWP5MU70QO6,5,6,0,0,0,0,5,0,11,1.5714285714285714,4,0.0,0,0,0,0,6,0,0,5,0,0,11,1
3490,51242,lVwgv61cg8fkhW9rg5b1PIPnuUWxb0Vk,5Gyp41oLVo7Gg7vF4vpmggWP5MU70QO6,9,3,3,0,3,13,8,4,34,4.857142857142857,2,0.0,0,3,0,3,3,13,0,8,4,6,28,1
3491,51306,JxLtKAnMek98G5fWpyeTaKlh0zheuNnU,5Gyp41oLVo7Gg7vF4vpmggWP5MU70QO6,12,11,5,4,4,0,3,0,27,3.857142857142857,2,0.0,2,5,2,4,9,0,2,3,0,13,14,1
3492,51338,mTt9TVaQ6qcDrpUsX6Vyc0IYv4BlJlMi,5Gyp41oLVo7Gg7vF4vpmggWP5MU70QO6,1,0,0,0,0,0,1,0,1,0.14285714285714285,1,0.0,0,0,0,0,0,0,0,1,0,0,1,1
3493,51345,R3GQusqS3T8BBP6hUdls7DaRD06v0PCL,5Gyp41oLVo7Gg7vF4vpmggWP5MU70QO6,1,0,0,0,0,0,1,0,1,0.14285714285714285,1,0.0,0,0,0,0,0,0,0,1,0,0,1,1
3494,51384,ueh8Q0J414FE7Xmjqeh6AbzlK27RwSRw,5Gyp41oLVo7Gg7vF4vpmggWP5MU70QO6,1,0,0,0,0,0,1,0,1,0.14285714285714285,1,0.0,0,0,0,0,0,0,0,1,0,0,1,1
3495,51422,umh1eDwHp9o5woAgDLq7irEaHM3qlWx2,5Gyp41oLVo7Gg7vF4vpmggWP5MU70QO6,40,60,37,26,19,6,12,1,161,23.0,3,0.0,18,37,17,19,42,6,9,12,1,91,70,0
3496,51426,acXed7EOVLnzsuab64PTBE3RVCDYaMyv,5Gyp41oLVo7Gg7vF4vpmggWP5MU70QO6,7,7,2,0,2,0,5,0,16,2.2857142857142856,1,0.0,0,2,0,2,7,0,0,5,0,4,12,1
3497,51477,aZ9nebrSuYWjxv43atpyEZvrYwCfGfkB,5Gyp41oLVo7Gg7vF4vpmggWP5MU70QO6,7,4,3,0,1,0,2,0,10,1.4285714285714286,1,0.0,0,3,0,1,4,0,0,2,0,4,6,1
3498,51478,2HoTvbB5XhoxXrJjJBwk94t2kQYx0MlB,5Gyp41oLVo7Gg7vF4vpmggWP5MU70QO6,8,7,3,0,2,0,2,0,14,2.0,2,0.0,0,3,0,2,7,0,0,2,0,5,9,1
3499,51487,mU2fAUtLp5jLgHGiFf5pygTKY9O9K5i4,5Gyp41oLVo7Gg7vF4vpmggWP5MU70QO6,7,3,2,0,2,0,3,0,10,1.4285714285714286,1,0.0,0,2,0,2,3,0,0,3,0,4,6,1
3500,51495,yXQSmgRTBARynLVxQn0bjGRHaQjsMjoL,5Gyp41oLVo7Gg7vF4vpmggWP5MU70QO6,8,3,2,0,2,0,3,0,10,1.4285714285714286,1,0.0,0,2,0,2,3,0,0,3,0,4,6,1
3501,51511,wZxGcsfZmDyO3eZaMEp8V4Qxwmu1n6lt,5Gyp41oLVo7Gg7vF4vpmggWP5MU70QO6,56,112,47,66,43,11,20,4,303,43.285714285714285,8,0.0,44,47,54,43,68,11,12,20,4,188,115,0
3502,51517,Q4toQWMz5O0YPhQzU0icjhFgXM41EKSX,5Gyp41oLVo7Gg7vF4vpmggWP5MU70QO6,28,69,32,15,10,2,17,0,145,20.714285714285715,7,0.0,9,32,14,10,60,2,1,17,0,65,80,0
3503,51529,WhgcVmTFWo1dBarNNCAJnFUhFulnMlzP,5Gyp41oLVo7Gg7vF4vpmggWP5MU70QO6,1,0,0,0,0,0,1,0,1,0.14285714285714285,1,0.0,0,0,0,0,0,0,0,1,0,0,1,1
3504,51534,VZInThaP5bjFkTwTO2BoGxMGNvXGtUPg,5Gyp41oLVo7Gg7vF4vpmggWP5MU70QO6,7,4,3,0,2,0,2,0,11,1.5714285714285714,1,0.0,0,3,0,2,4,0,0,2,0,5,6,1
3505,51548,SH3THvT9ATqMny80GD63EuK5GGnf8XMU,5Gyp41oLVo7Gg7vF4vpmggWP5MU70QO6,5,9,0,0,0,1,8,0,18,2.5714285714285716,3,0.0,0,0,0,0,9,1,0,8,0,0,18,0
3506,51558,L39ZdOzVu52b5Nu8u3TuFdomCuDfGlbZ,5Gyp41oLVo7Gg7vF4vpmggWP5MU70QO6,21,21,16,2,9,0,5,0,53,7.571428571428571,2,0.0,1,16,1,9,20,0,1,5,0,27,26,1
3507,51574,A2TslyZ8TwcXRoKLLIx5H8X0qnPIGM93,5Gyp41oLVo7Gg7vF4vpmggWP5MU70QO6,4,3,0,0,0,0,2,0,5,0.7142857142857143,1,0.0,0,0,0,0,3,0,0,2,0,0,5,1
3508,51584,O1qqAub9LnJtRCJpB6uaaoNbBqZAzzPH,5Gyp41oLVo7Gg7vF4vpmggWP5MU70QO6,1,0,0,0,0,0,1,0,1,0.14285714285714285,1,0.0,0,0,0,0,0,0,0,1,0,0,1,1
3509,51602,AMvvVmOhJFXdorQhUjG7zbr0lpdmWFD7,5Gyp41oLVo7Gg7vF4vpmggWP5MU70QO6,13,10,7,0,4,0,6,0,27,3.857142857142857,2,0.0,0,7,0,4,10,0,0,6,0,11,16,1
3510,51607,dELrNUPf0LYnYKGiwZPbUyeEFznLuQat,5Gyp41oLVo7Gg7vF4vpmggWP5MU70QO6,5,2,1,0,1,0,2,0,6,0.8571428571428571,1,0.0,0,1,0,1,2,0,0,2,0,2,4,1
3511,51638,M6bmfgIp9dYLX3Zc75Ti7JeaGAhKkIIV,5Gyp41oLVo7Gg7vF4vpmggWP5MU70QO6,1,0,0,0,0,0,1,0,1,0.14285714285714285,1,0.0,0,0,0,0,0,0,0,1,0,0,1,1
3512,51689,wWbWyhQVaGyU5DEhZSbsADk6ecdZdZP3,5Gyp41oLVo7Gg7vF4vpmggWP5MU70QO6,1,0,0,0,0,0,1,0,1,0.14285714285714285,1,0.0,0,0,0,0,0,0,0,1,0,0,1,1
3513,51702,MDlXnb9rsG8JWVZUQtg4346WwlX7yiGH,5Gyp41oLVo7Gg7vF4vpmggWP5MU70QO6,6,2,1,0,2,0,3,0,8,1.1428571428571428,1,0.0,1,1,0,2,1,0,0,3,0,4,4,1
3514,51747,R6mWJ0ZeHkZWWi0xlkZZqK7iozuGXemG,5Gyp41oLVo7Gg7vF4vpmggWP5MU70QO6,9,4,3,0,3,0,19,0,29,4.142857142857143,3,0.0,1,3,0,3,3,0,0,19,0,7,22,1
3515,51800,SPVEPDWe7wKH8038B3lBhW6PSWSX6ArY,5Gyp41oLVo7Gg7vF4vpmggWP5MU70QO6,6,2,0,0,0,0,5,0,7,1.0,1,0.0,0,0,0,0,2,0,0,5,0,0,7,1
3516,51804,sfdgnQL9ZJy8iQoJsTh6pz33V1sjsZlD,5Gyp41oLVo7Gg7vF4vpmggWP5MU70QO6,11,29,14,0,0,25,14,1,83,11.857142857142858,2,0.0,3,14,0,0,26,25,0,14,1,17,66,1
3517,51816,YeRXVpkXvCF1S4W69VvqHCshoTfoJYx1,5Gyp41oLVo7Gg7vF4vpmggWP5MU70QO6,13,42,17,10,11,0,7,0,87,12.428571428571429,3,0.0,18,17,5,11,24,0,5,7,0,51,36,1
3518,51856,BHFxB9WSZUNA3bSbhXGfFvM0uldWsWSG,5Gyp41oLVo7Gg7vF4vpmggWP5MU70QO6,5,2,1,0,1,0,3,0,7,1.0,2,0.0,0,1,0,1,2,0,0,3,0,2,5,0
3519,51868,24686CbCuct6ibY6FEwXzhohAw2vtXBO,5Gyp41oLVo7Gg7vF4vpmggWP5MU70QO6,21,30,16,4,6,0,12,0,68,9.714285714285714,8,0.0,4,16,3,6,26,0,1,12,0,29,39,0
3520,51895,NzIOG5NJMUxeeqfkFuzJNfvgPL3Ojtwv,5Gyp41oLVo7Gg7vF4vpmggWP5MU70QO6,13,15,6,2,3,5,7,0,38,5.428571428571429,2,0.0,2,6,1,3,13,5,1,7,0,12,26,1
3521,51911,Ci9FGx4bWbxBIrvlwmLcaPnUTvif70a3,5Gyp41oLVo7Gg7vF4vpmggWP5MU70QO6,29,95,35,18,16,0,12,0,176,25.142857142857142,6,0.0,19,35,13,16,76,0,5,12,0,83,93,0
3522,51969,TZKmI0qv9Bws9wg22BGw0ShlF2CcTiea,5Gyp41oLVo7Gg7vF4vpmggWP5MU70QO6,11,10,4,8,2,2,12,1,39,5.571428571428571,1,0.0,6,4,4,2,4,2,4,12,1,16,23,1
3523,51976,IFxa36yYyTY0IScgqpr2YDZw1IrRnsiL,5Gyp41oLVo7Gg7vF4vpmggWP5MU70QO6,1,0,0,0,0,0,1,0,1,0.14285714285714285,1,0.0,0,0,0,0,0,0,0,1,0,0,1,1
3524,52001,rigObVsPw012mTLP7Xer1eLUaWsRqL0B,5Gyp41oLVo7Gg7vF4vpmggWP5MU70QO6,6,3,1,0,1,0,3,0,8,1.1428571428571428,1,0.0,0,1,0,1,3,0,0,3,0,2,6,1
3525,52012,1h7W4wzmG1Na13n5PFihFy3BFCvI9aUF,5Gyp41oLVo7Gg7vF4vpmggWP5MU70QO6,1,0,0,0,0,0,1,0,1,0.14285714285714285,1,0.0,0,0,0,0,0,0,0,1,0,0,1,1
3526,52013,UZj9qZ6lkWkIz7HEEFyBh5LFRNaz4SI2,5Gyp41oLVo7Gg7vF4vpmggWP5MU70QO6,5,2,1,0,1,0,3,0,7,1.0,1,0.0,0,1,0,1,2,0,0,3,0,2,5,1
3527,52015,o2EBQAVUG9zZ1N0mYC2wQkN5KDw2JsF9,5Gyp41oLVo7Gg7vF4vpmggWP5MU70QO6,1,0,0,0,0,0,1,0,1,0.14285714285714285,1,0.0,0,0,0,0,0,0,0,1,0,0,1,1
3528,52045,wL2WUNjeovd8v5fP8dkNYd0gn970jWmX,5Gyp41oLVo7Gg7vF4vpmggWP5MU70QO6,2,0,0,0,0,0,3,0,3,0.42857142857142855,1,0.0,0,0,0,0,0,0,0,3,0,0,3,1
3529,52073,SkqVAXXmBdrKaGu9COTBqlBrc4qsyWY0,5Gyp41oLVo7Gg7vF4vpmggWP5MU70QO6,11,9,3,2,2,1,8,0,25,3.5714285714285716,1,0.0,1,3,1,2,8,1,1,8,0,7,18,1
3530,52085,HuABcLMtHr6Y0RrPlzNhzgc87JaxJbDJ,5Gyp41oLVo7Gg7vF4vpmggWP5MU70QO6,5,2,1,0,1,0,2,0,6,0.8571428571428571,1,0.0,0,1,0,1,2,0,0,2,0,2,4,1
3531,52087,KZZhGQ4nBwlSXt2YkCYPVvuv8CEYCuv3,5Gyp41oLVo7Gg7vF4vpmggWP5MU70QO6,4,3,0,0,0,0,3,0,6,0.8571428571428571,1,0.0,0,0,0,0,3,0,0,3,0,0,6,1
3532,52096,5U79KRZxDDBIetuxjK0KXphUhzbxTzjr,5Gyp41oLVo7Gg7vF4vpmggWP5MU70QO6,10,15,7,0,2,0,3,0,27,3.857142857142857,2,0.0,3,7,0,2,12,0,0,3,0,12,15,1
3533,52097,TFz5IhIRCPFI3OwAYAZbVriTl2Kets7l,5Gyp41oLVo7Gg7vF4vpmggWP5MU70QO6,5,2,1,0,1,0,2,0,6,0.8571428571428571,1,0.0,0,1,0,1,2,0,0,2,0,2,4,1
3534,52126,MQvE5A8L0POnIFXzu10gx5cCAfVoSlB2,5Gyp41oLVo7Gg7vF4vpmggWP5MU70QO6,1,0,0,0,0,0,1,0,1,0.14285714285714285,1,0.0,0,0,0,0,0,0,0,1,0,0,1,1
3535,52128,CVNZnTiRds77aV88t7oO5JnyjLjE4gZ5,5Gyp41oLVo7Gg7vF4vpmggWP5MU70QO6,8,7,3,0,3,0,8,1,22,3.142857142857143,3,0.0,1,3,0,3,6,0,0,8,1,7,15,0
3536,52158,jtsBBwr9OFgAX0CtUxYKA8zuhME346wi,5Gyp41oLVo7Gg7vF4vpmggWP5MU70QO6,2,0,0,0,0,0,2,0,2,0.2857142857142857,1,0.0,0,0,0,0,0,0,0,2,0,0,2,0
3537,52180,xDcaASSFJhBnk43vPD1Z15YLfQOMVMNF,5Gyp41oLVo7Gg7vF4vpmggWP5MU70QO6,4,2,1,0,0,0,2,0,5,0.7142857142857143,1,0.0,0,1,0,0,2,0,0,2,0,1,4,1
3538,52183,k0RJg96Fpv2wERmrbwPIzHi2sDkVUGP1,5Gyp41oLVo7Gg7vF4vpmggWP5MU70QO6,31,87,48,26,18,26,23,1,229,32.714285714285715,10,0.0,22,48,24,18,65,26,2,23,1,112,117,1
3539,52199,sBOxdNnpJUq7xjCMDQDk623huheAshBl,5Gyp41oLVo7Gg7vF4vpmggWP5MU70QO6,11,13,6,0,3,0,5,1,28,4.0,2,0.0,0,6,0,3,13,0,0,5,1,9,19,1
3540,52208,5xBdESmY1nBvhCHUEPjhjxgP4SUV3nyi,5Gyp41oLVo7Gg7vF4vpmggWP5MU70QO6,1,0,0,0,0,0,1,0,1,0.14285714285714285,1,0.0,0,0,0,0,0,0,0,1,0,0,1,1
3541,52225,ZOdzp19tU4985pZGAlB8kRKe52hHtzEJ,5Gyp41oLVo7Gg7vF4vpmggWP5MU70QO6,2,0,0,0,0,0,2,0,2,0.2857142857142857,1,0.0,0,0,0,0,0,0,0,2,0,0,2,1
3542,52235,6r9w9XrCXpAInFHxfDIxOD9m18cX5jcd,5Gyp41oLVo7Gg7vF4vpmggWP5MU70QO6,1,0,0,0,0,0,1,0,1,0.14285714285714285,1,0.0,0,0,0,0,0,0,0,1,0,0,1,1
3543,52243,BwaZCJgJk3McTWZaifCsx9alpiilOhBE,5Gyp41oLVo7Gg7vF4vpmggWP5MU70QO6,10,21,11,0,1,34,17,1,85,12.142857142857142,5,0.0,4,11,0,1,17,34,0,17,1,16,69,1
3544,52247,KqGR4psq39mn0SAoxpJqPFEQt3ilwYa8,5Gyp41oLVo7Gg7vF4vpmggWP5MU70QO6,5,3,1,0,1,0,2,0,7,1.0,1,0.0,0,1,0,1,3,0,0,2,0,2,5,1
3545,52274,ChLYb6LYBFg2XNE33gE0X7v4FlbTtzEZ,5Gyp41oLVo7Gg7vF4vpmggWP5MU70QO6,1,0,0,0,0,0,1,0,1,0.14285714285714285,1,0.0,0,0,0,0,0,0,0,1,0,0,1,1
3546,52320,6QJrVrU15RwYswqP91jLfBByHdY6ePwM,5Gyp41oLVo7Gg7vF4vpmggWP5MU70QO6,9,7,3,0,3,4,6,0,23,3.2857142857142856,2,0.0,1,3,0,3,6,4,0,6,0,7,16,1
3547,52329,0M1738scr3UPDiDGNVEZtY01qtS2Scga,5Gyp41oLVo7Gg7vF4vpmggWP5MU70QO6,8,3,2,0,2,0,3,0,10,1.4285714285714286,1,0.0,0,2,0,2,3,0,0,3,0,4,6,1
3548,52332,ECIKY7UVyqdc5rfdBpc5OKQ4L4XJnBZ3,5Gyp41oLVo7Gg7vF4vpmggWP5MU70QO6,7,2,1,0,1,0,8,1,13,1.8571428571428572,1,0.0,0,1,0,1,2,0,0,8,1,2,11,1
3549,52359,0t3Bc6GJdFKSDrPfrCWxDJ33tvFzV4Gw,5Gyp41oLVo7Gg7vF4vpmggWP5MU70QO6,5,6,0,0,0,0,5,0,11,1.5714285714285714,1,0.0,0,0,0,0,6,0,0,5,0,0,11,1
3550,52451,EcvMrbxqb9Hu5or0mXUSfB1IsR9KbRvG,5X6FeZozNMgE2VRi3MJYjkkFK8SETtu2,5,5,1,0,1,0,2,0,9,1.2857142857142858,1,0.0,3,1,0,1,2,0,0,2,0,5,4,1
3551,52454,quFRN0nuO6SCdHOgmUhTlayoumtzVI29,7GRhBDsirIGkRZBtSMEzNTyDr2JQm4xx,50,65,3,125,16,0,2,0,211,30.142857142857142,3,0.0,37,3,109,16,28,0,16,2,0,165,46,1
3552,52495,knUloC1tBi2LXsmD9KzPebmyzGJ327i5,5X6FeZozNMgE2VRi3MJYjkkFK8SETtu2,5,16,11,0,4,0,2,0,33,4.714285714285714,5,0.0,0,11,0,4,16,0,0,2,0,15,18,1
3553,52504,dTE2gkSy9lx7HiJblz4dkkDKbW2NyCb8,5X6FeZozNMgE2VRi3MJYjkkFK8SETtu2,34,49,9,79,18,0,3,0,158,22.571428571428573,3,0.0,36,9,58,18,13,0,21,3,0,121,37,1
3554,52511,YTuPtoiiUgMUEO0EcQhHENEgNCcauWbW,5X6FeZozNMgE2VRi3MJYjkkFK8SETtu2,3,2,1,0,0,0,1,0,4,0.5714285714285714,1,0.0,0,1,0,0,2,0,0,1,0,1,3,1
3555,52537,Jm6sJTkF2CzUeH5fDnA3ZYS6v322ABBN,7GRhBDsirIGkRZBtSMEzNTyDr2JQm4xx,5,2,1,0,1,0,2,0,6,0.8571428571428571,1,0.0,0,1,0,1,2,0,0,2,0,2,4,1
3556,52546,dNx7yBBYuWpRM4BeMNLD1yOnUwcueGfB,7GRhBDsirIGkRZBtSMEzNTyDr2JQm4xx,8,12,7,4,3,0,4,0,30,4.285714285714286,2,0.0,1,7,2,3,11,0,2,4,0,13,17,1
3557,52622,lRuRgYuxlfG4wGoaGOQqJl3BAifyNcHA,5X6FeZozNMgE2VRi3MJYjkkFK8SETtu2,1,0,0,0,0,0,1,0,1,0.14285714285714285,1,0.0,0,0,0,0,0,0,0,1,0,0,1,1
3558,52630,up9RsivyokQDdIY9XjceWgPIaWSXiHeb,5X6FeZozNMgE2VRi3MJYjkkFK8SETtu2,15,16,2,12,5,0,2,0,37,5.285714285714286,2,0.0,7,2,12,5,9,0,0,2,0,26,11,1
3559,52669,Q8hb0j5K90GRKBQLUtk9egje9fPULAJD,7GRhBDsirIGkRZBtSMEzNTyDr2JQm4xx,2,0,0,0,0,0,3,0,3,0.42857142857142855,2,0.0,0,0,0,0,0,0,0,3,0,0,3,0
3560,52789,OO7beVHPObBfPwHA9jIrdvSr48hMom1m,7GRhBDsirIGkRZBtSMEzNTyDr2JQm4xx,32,65,23,56,23,3,2,0,172,24.571428571428573,12,0.0,25,23,48,23,40,3,8,2,0,119,53,0
3561,52835,ESHOHiiFNOO5h5pqzByY0J6PmNipWo8U,7GRhBDsirIGkRZBtSMEzNTyDr2JQm4xx,1,0,0,0,0,0,1,0,1,0.14285714285714285,1,0.0,0,0,0,0,0,0,0,1,0,0,1,1
3562,52935,VQQV4EfxxGcWfIRpLvaTXUUXZHA1kehZ,7GRhBDsirIGkRZBtSMEzNTyDr2JQm4xx,1,0,0,0,0,0,1,0,1,0.14285714285714285,1,0.0,0,0,0,0,0,0,0,1,0,0,1,1
3563,52964,AOjqu8OTCPaKqT40dsKKHuXenHhl1lM6,5X6FeZozNMgE2VRi3MJYjkkFK8SETtu2,1,0,0,0,0,0,1,0,1,0.14285714285714285,1,0.0,0,0,0,0,0,0,0,1,0,0,1,1
3564,53000,CGPCZptxVu9ER3GGm9DUJ9SpSOShg1OZ,7GRhBDsirIGkRZBtSMEzNTyDr2JQm4xx,37,53,14,60,12,3,1,0,143,20.428571428571427,1,0.0,25,14,52,12,28,3,8,1,0,103,40,1
3565,53020,Z4kedXjIF6f3uubwtldCvvLQcT4vIEro,7GRhBDsirIGkRZBtSMEzNTyDr2JQm4xx,5,8,2,0,0,0,2,0,12,1.7142857142857142,2,0.0,3,2,0,0,5,0,0,2,0,5,7,1
3566,53046,t8qBiDTvOvYmrxcVIErRuEOf38tywm6t,bWdj2GDclj5ofokWjzoa5jAwMkxCykd6,35,88,60,100,13,44,30,1,336,48.0,8,0.0,9,60,93,13,79,44,7,30,1,175,161,1
3567,53048,8gk5kBMYT20pCB4wpUHe3xKwSYDbtvzS,SpATywNh6bZuzm8s1ceuBUnMUAeoAHHw,23,32,15,15,5,21,11,2,101,14.428571428571429,5,0.0,5,15,14,5,27,21,1,11,2,39,62,1
3568,53049,8cVIhj7cvR0q9dzupEColmwPbOHZ624c,SpATywNh6bZuzm8s1ceuBUnMUAeoAHHw,46,48,27,45,15,24,18,3,180,25.714285714285715,5,0.0,10,27,40,15,38,24,5,18,3,92,88,0
3569,53063,LbpzBfhp2Wgcn9ayrU6jOBjfquY2961S,SpATywNh6bZuzm8s1ceuBUnMUAeoAHHw,7,3,2,0,2,0,2,0,9,1.2857142857142858,1,0.0,0,2,0,2,3,0,0,2,0,4,5,1
3570,53070,3Ph0mVs6YY4X7VkfoALrDqpzMeDhFoCj,A3fsA9Zfv1X2fVEQhTw51lKENdNrEqT3,36,49,24,42,12,0,11,0,138,19.714285714285715,5,0.0,0,24,39,12,49,0,3,11,0,75,63,1
3571,53118,5bplw4NcU21nNTIEcExDZZHISObWtI7D,SpATywNh6bZuzm8s1ceuBUnMUAeoAHHw,2,0,0,0,0,0,2,0,2,0.2857142857142857,1,0.0,0,0,0,0,0,0,0,2,0,0,2,1
3572,53119,AwKhkfPOqEnTXG1Cn8Gmf8HHhYnwnTgu,SpATywNh6bZuzm8s1ceuBUnMUAeoAHHw,25,44,14,24,6,36,12,0,136,19.428571428571427,5,0.0,11,14,20,6,33,36,4,12,0,51,85,1
3573,53124,1mZ7vCkgdZSC0cu4gxvMxxm9xwGvwvAR,SpATywNh6bZuzm8s1ceuBUnMUAeoAHHw,12,7,0,8,0,0,4,1,20,2.857142857142857,1,0.0,1,0,7,0,6,0,1,4,1,8,12,1
3574,53139,nNXdLwc4WRmQjF7qTMoDc98hNmIFSp8j,SpATywNh6bZuzm8s1ceuBUnMUAeoAHHw,8,9,5,0,1,0,5,0,20,2.857142857142857,4,0.0,1,5,0,1,8,0,0,5,0,7,13,1
3575,53140,Jf77UYIvUtofHBGpvQMQ0qUfMZBh9rRJ,A3fsA9Zfv1X2fVEQhTw51lKENdNrEqT3,58,43,26,78,16,0,7,1,171,24.428571428571427,4,0.0,6,26,73,16,37,0,5,7,1,121,50,1
3576,53155,PPZEwof9f8rZx0lcTpURHpbkLB2YY5hH,bWdj2GDclj5ofokWjzoa5jAwMkxCykd6,1,0,0,0,0,0,1,0,1,0.14285714285714285,1,0.0,0,0,0,0,0,0,0,1,0,0,1,1
3577,53161,oS1Vf0Ayi2kmK9AxKSgJ38BEbMfbnGmy,SpATywNh6bZuzm8s1ceuBUnMUAeoAHHw,19,33,2,12,1,17,5,1,71,10.142857142857142,3,0.0,14,2,10,1,19,17,2,5,1,27,44,1
3578,53163,MxIyDpIx03wSGr0H52jiRE3GZR3Xt5iM,SpATywNh6bZuzm8s1ceuBUnMUAeoAHHw,29,61,31,44,16,1,8,0,161,23.0,4,0.0,21,31,38,16,40,1,6,8,0,106,55,1
3579,53170,BBcMLJIRqEjAV0Iy0PZLL6aDRdsecvdG,G8EPVSXsOYB5YQWZGiz1aVq5Pgr2GrQu,32,55,3,38,5,1,17,0,119,17.0,3,0.0,11,3,33,5,44,1,5,17,0,52,67,1
3580,53194,5y4YA2mbDcwuEjNHeStgjLfqN1rsKZgP,SpATywNh6bZuzm8s1ceuBUnMUAeoAHHw,37,130,6,64,2,2,28,1,233,33.285714285714285,9,0.0,67,6,53,2,63,2,11,28,1,128,105,0
3581,53198,TVNQBfVHiiSK1QlXMueUvqhShIHov5rx,A3fsA9Zfv1X2fVEQhTw51lKENdNrEqT3,4,0,0,0,0,0,8,0,8,1.1428571428571428,1,0.0,0,0,0,0,0,0,0,8,0,0,8,1
3582,53209,GOcyurvQpr52NaTeXKp3vF6yg377GcU5,SpATywNh6bZuzm8s1ceuBUnMUAeoAHHw,25,52,6,49,1,22,27,5,162,23.142857142857142,8,0.0,9,6,49,1,43,22,0,27,5,65,97,0
3583,53219,igvNYxEcQQQ9zsQs0eESBN7rFelE1Oyt,SpATywNh6bZuzm8s1ceuBUnMUAeoAHHw,6,4,1,0,1,0,2,0,8,1.1428571428571428,1,0.0,1,1,0,1,3,0,0,2,0,3,5,1
3584,53223,xv3zPM1UCM9DtQrJ8sbmGYaRlj8FtrlB,SpATywNh6bZuzm8s1ceuBUnMUAeoAHHw,25,45,3,16,1,8,12,1,86,12.285714285714286,4,0.0,14,3,16,1,31,8,0,12,1,34,52,1
3585,53247,tHPSGx00vsFzhzr0zwBlWWarqJT4wPHF,A3fsA9Zfv1X2fVEQhTw51lKENdNrEqT3,38,14,11,56,8,0,5,0,94,13.428571428571429,3,0.0,1,11,51,8,13,0,5,5,0,71,23,1
3586,53255,mOyYFNs2t1Eh1aA09x8EHu6wqp81MSvv,bWdj2GDclj5ofokWjzoa5jAwMkxCykd6,3,2,1,0,0,0,1,0,4,0.5714285714285714,1,0.0,0,1,0,0,2,0,0,1,0,1,3,1
3587,53275,tixHTdVBfyAX1gHufSYbGyCBT9OKYh0u,SpATywNh6bZuzm8s1ceuBUnMUAeoAHHw,10,8,4,0,3,0,2,0,17,2.4285714285714284,1,0.0,3,4,0,3,5,0,0,2,0,10,7,1
3588,53280,N7f90nGBEKO2Wy697fsY7gOd7p4hRhpZ,SpATywNh6bZuzm8s1ceuBUnMUAeoAHHw,8,4,2,0,1,7,4,1,19,2.7142857142857144,1,0.0,0,2,0,1,4,7,0,4,1,3,16,1
3589,53281,1R6B3xPo1MU8MeIr72077lkCH6LzghZG,SpATywNh6bZuzm8s1ceuBUnMUAeoAHHw,18,15,9,16,5,0,6,0,51,7.285714285714286,1,0.0,2,9,13,5,13,0,3,6,0,29,22,1
3590,53295,yo1PAd1hBwimD9OOoxvyi6mwQC5bfK9g,bWdj2GDclj5ofokWjzoa5jAwMkxCykd6,6,11,6,0,2,0,7,0,26,3.7142857142857144,3,0.0,0,6,0,2,11,0,0,7,0,8,18,1
3591,53312,uQjl8NGtIQkRfoe9edBiMgtYYmdkzVXR,SpATywNh6bZuzm8s1ceuBUnMUAeoAHHw,1,0,0,0,0,0,1,0,1,0.14285714285714285,1,0.0,0,0,0,0,0,0,0,1,0,0,1,0
3592,53336,5naaONANTJUheGV6edn51qgkV97IPNdM,SpATywNh6bZuzm8s1ceuBUnMUAeoAHHw,1,0,0,0,0,0,1,0,1,0.14285714285714285,1,0.0,0,0,0,0,0,0,0,1,0,0,1,1
3593,53346,oNcOLZOgRKuqVCWgf9VQFQ2ph82THXaV,RXDvfPUBYFlVdlueBFbLW0mhhAyGEqpt,1,0,0,0,0,0,1,0,1,0.14285714285714285,1,0.0,0,0,0,0,0,0,0,1,0,0,1,0
3594,53360,boitIxZvCZ9przAKAQqxtWTvavMJkqzn,SpATywNh6bZuzm8s1ceuBUnMUAeoAHHw,59,56,38,32,21,2,11,0,160,22.857142857142858,9,0.0,9,38,31,21,47,2,1,11,0,99,61,0
3595,53368,mf00J2vS5aNSPGjL8Bq3W8G35vnnAtUS,SpATywNh6bZuzm8s1ceuBUnMUAeoAHHw,28,40,8,32,4,2,16,2,104,14.857142857142858,4,0.0,14,8,28,4,26,2,4,16,2,54,50,1
3596,53374,rSB9ieAhUU6VlZTakIYbk4lUm5NlM8Bf,SpATywNh6bZuzm8s1ceuBUnMUAeoAHHw,2,0,0,0,0,0,2,0,2,0.2857142857142857,1,0.0,0,0,0,0,0,0,0,2,0,0,2,1
3597,53381,hJ48EYDAUcnIubJFw4NRxQxCK6ApJIxf,SpATywNh6bZuzm8s1ceuBUnMUAeoAHHw,20,25,2,35,0,6,10,0,78,11.142857142857142,4,0.0,10,2,33,0,15,6,2,10,0,45,33,1
3598,53396,0qQG1Nylz3pu9h7MazaVuzCwo13YkYej,SpATywNh6bZuzm8s1ceuBUnMUAeoAHHw,10,12,5,0,3,0,3,0,23,3.2857142857142856,2,0.0,0,5,0,3,12,0,0,3,0,8,15,1
3599,53418,0uULbxMYxykuellS4DES6XbGTfaCngOW,A3fsA9Zfv1X2fVEQhTw51lKENdNrEqT3,8,10,0,0,0,0,4,0,14,2.0,1,0.0,0,0,0,0,10,0,0,4,0,0,14,1
3600,53421,oyKGOSyMOi0AM9nt7p8h8Y1cF1HEnPtq,SpATywNh6bZuzm8s1ceuBUnMUAeoAHHw,4,2,1,0,1,0,2,0,6,0.8571428571428571,2,0.0,0,1,0,1,2,0,0,2,0,2,4,1
3601,53423,26YZUhjQbxCihl3CNnlwudlVL638MFZI,SpATywNh6bZuzm8s1ceuBUnMUAeoAHHw,7,9,0,0,0,1,8,0,18,2.5714285714285716,1,0.0,0,0,0,0,9,1,0,8,0,0,18,1
3602,53453,A4vEkOAwhpQEgLFKtjOc7tdIxawwQcIi,SpATywNh6bZuzm8s1ceuBUnMUAeoAHHw,33,75,41,20,19,3,22,0,180,25.714285714285715,7,0.0,15,41,16,19,60,3,4,22,0,91,89,1
3603,53456,WFLWEfQrQsuFMQB4h1DfinKxHOxaJgRw,RXDvfPUBYFlVdlueBFbLW0mhhAyGEqpt,2,0,0,0,0,0,2,0,2,0.2857142857142857,2,0.0,0,0,0,0,0,0,0,2,0,0,2,1
3604,53462,9rLNySnV0yxkzZA7V8enLIbzXZCrF6IJ,RXDvfPUBYFlVdlueBFbLW0mhhAyGEqpt,63,87,51,84,27,10,27,14,300,42.857142857142854,8,0.0,9,51,80,27,78,10,4,27,14,167,133,0
3605,53483,t20VhGjJQwmwXV8X5LeBQDucO3YuiMru,SpATywNh6bZuzm8s1ceuBUnMUAeoAHHw,21,33,4,41,1,56,16,3,154,22.0,5,0.0,10,4,34,1,23,56,7,16,3,49,105,0
3606,53484,WyWFczdn2Y2i2D9wUJkB93D49zn2CheK,SpATywNh6bZuzm8s1ceuBUnMUAeoAHHw,1,0,0,0,0,0,5,0,5,0.7142857142857143,4,0.0,0,0,0,0,0,0,0,5,0,0,5,0
3607,53501,5vi4PfMqn3pILscFmPde7WIp5OpFzjzt,SpATywNh6bZuzm8s1ceuBUnMUAeoAHHw,21,20,9,42,2,3,5,0,81,11.571428571428571,3,0.0,6,9,38,2,14,3,4,5,0,55,26,0
3608,53505,nG7nzscbe2QtoUFUlgTpRDhBo6dlFgWT,SpATywNh6bZuzm8s1ceuBUnMUAeoAHHw,1,0,0,0,0,0,1,0,1,0.14285714285714285,1,0.0,0,0,0,0,0,0,0,1,0,0,1,1
3609,53507,sqZsZQq9LcjzbfCPmehLyMMrK3ClcYAT,A3fsA9Zfv1X2fVEQhTw51lKENdNrEqT3,7,3,2,0,2,0,4,0,11,1.5714285714285714,2,0.0,0,2,0,2,3,0,0,4,0,4,7,1
3610,53526,4XbWtzoFwF5LOOV7fIRFhXr7S6ATs5RB,SpATywNh6bZuzm8s1ceuBUnMUAeoAHHw,9,6,1,0,1,9,4,1,22,3.142857142857143,1,0.0,0,1,0,1,6,9,0,4,1,2,20,1
3611,53534,ssMidTFfcaAGjWiJzMk3J73LCswwO4yV,A3fsA9Zfv1X2fVEQhTw51lKENdNrEqT3,7,0,0,0,0,2,6,1,9,1.2857142857142858,1,0.0,0,0,0,0,0,2,0,6,1,0,9,1
3612,53565,0HsU2yFVHR5yKm9Hke3oyrM0twIu2eg3,bWdj2GDclj5ofokWjzoa5jAwMkxCykd6,8,12,1,58,2,0,6,0,79,11.285714285714286,2,0.0,8,1,57,2,4,0,1,6,0,68,11,1
3613,53587,VDscv2ylkQ5hVjxSl7FzkFmJDmBcIaMr,A3fsA9Zfv1X2fVEQhTw51lKENdNrEqT3,30,14,7,76,4,0,4,0,105,15.0,2,0.0,5,7,72,4,9,0,4,4,0,88,17,1
3614,53596,fHnWrc914HQUCHZRKa2nPteHkVOkvlJI,SpATywNh6bZuzm8s1ceuBUnMUAeoAHHw,23,44,4,30,1,8,18,1,106,15.142857142857142,5,0.0,16,4,27,1,28,8,3,18,1,48,58,0
3615,53630,w7s7CbDlE2P2RGY2w8kEYH9keSavEsec,SpATywNh6bZuzm8s1ceuBUnMUAeoAHHw,7,5,2,0,1,0,6,0,14,2.0,1,0.0,0,2,0,1,5,0,0,6,0,3,11,1
3616,53649,dtP0jNvfsrthiSc4EbxmbNOv0Ufz6AhB,RXDvfPUBYFlVdlueBFbLW0mhhAyGEqpt,7,4,3,0,3,0,4,0,14,2.0,2,0.0,0,3,0,3,4,0,0,4,0,6,8,1
3617,53666,uxWS9amhXxmjOvqXmZExJSg0LcMFBAvq,RXDvfPUBYFlVdlueBFbLW0mhhAyGEqpt,20,20,16,0,9,1,39,3,88,12.571428571428571,5,0.0,2,16,0,9,18,1,0,39,3,27,61,1
3618,53669,j79CPp6e09l3A1MeqgSV5ajYlxbk9Ixy,A3fsA9Zfv1X2fVEQhTw51lKENdNrEqT3,38,21,7,72,5,0,6,0,111,15.857142857142858,3,0.0,2,7,67,5,19,0,5,6,0,81,30,1
3619,53694,dXgGUXhGtPdqA3aOz733dBgKiaq7cvX6,SpATywNh6bZuzm8s1ceuBUnMUAeoAHHw,13,21,2,0,2,0,15,0,40,5.714285714285714,4,0.0,0,2,0,2,21,0,0,15,0,4,36,1
3620,53718,Ar22lkOE5FvesxoMKtYhm8Cbv4MUQUYF,SpATywNh6bZuzm8s1ceuBUnMUAeoAHHw,7,1,1,0,1,0,5,0,8,1.1428571428571428,2,0.0,0,1,0,1,1,0,0,5,0,2,6,1
3621,53721,lSVRjk6dkgEmIe9I21hvsRF98Lf2IKdM,SpATywNh6bZuzm8s1ceuBUnMUAeoAHHw,41,58,30,29,15,3,13,0,148,21.142857142857142,3,0.0,10,30,29,15,48,3,0,13,0,84,64,1
3622,53740,oUC5J8T9mINNExS4753FcPxbWA9dWDjN,SpATywNh6bZuzm8s1ceuBUnMUAeoAHHw,17,17,10,5,4,1,7,1,45,6.428571428571429,1,0.0,3,10,4,4,14,1,1,7,1,21,24,1
3623,53741,CV8kQrzk7Ma4h2GmuCAW4YCocO4w4WSf,bWdj2GDclj5ofokWjzoa5jAwMkxCykd6,4,4,1,0,2,0,2,0,9,1.2857142857142858,2,0.0,2,1,0,2,2,0,0,2,0,5,4,1
3624,53755,FOAFoPTPHDIp8ur1T09KgTEj3KeABYBf,SpATywNh6bZuzm8s1ceuBUnMUAeoAHHw,2,0,0,0,0,0,2,0,2,0.2857142857142857,1,0.0,0,0,0,0,0,0,0,2,0,0,2,1
3625,53760,KGXFn1n0h5LwrdyZxyMenRRVTJ2x6Rjd,RXDvfPUBYFlVdlueBFbLW0mhhAyGEqpt,4,3,2,0,2,0,1,0,8,1.1428571428571428,1,0.0,0,2,0,2,3,0,0,1,0,4,4,1
3626,53766,KIPXc8MOqmnlmMqnIzIeaBqliIw9pS44,SpATywNh6bZuzm8s1ceuBUnMUAeoAHHw,32,44,23,16,11,9,18,4,125,17.857142857142858,4,0.0,10,23,16,11,34,9,0,18,4,60,65,1
3627,53786,L5GEhRbHdd9onnNJ8EJkvOQW3HytY3G8,SpATywNh6bZuzm8s1ceuBUnMUAeoAHHw,13,10,5,0,5,0,5,0,25,3.5714285714285716,2,0.0,2,5,0,5,8,0,0,5,0,12,13,1
3628,53792,p62iTg6ZpvzODJCBLH2d7SVfdoSWuy8j,RXDvfPUBYFlVdlueBFbLW0mhhAyGEqpt,107,151,93,150,46,1,17,2,460,65.71428571428571,8,0.0,31,93,144,46,120,1,6,17,2,314,146,0
3629,53796,10a3aPUuiEikOQBzdtiLA8dXlMBNaCqq,A3fsA9Zfv1X2fVEQhTw51lKENdNrEqT3,1,0,0,0,0,0,1,0,1,0.14285714285714285,1,0.0,0,0,0,0,0,0,0,1,0,0,1,1
3630,53805,sytW49I21SJ70ElOkXGU5SHeeHl1E3fL,A3fsA9Zfv1X2fVEQhTw51lKENdNrEqT3,24,24,17,0,11,0,13,0,65,9.285714285714286,6,0.0,2,17,0,11,22,0,0,13,0,30,35,1
3631,53818,mBrhN2Nrf27UQ54otia4OdwjR0gGrIS1,SpATywNh6bZuzm8s1ceuBUnMUAeoAHHw,8,6,1,0,0,1,8,0,16,2.2857142857142856,1,0.0,0,1,0,0,6,1,0,8,0,1,15,1
3632,53835,8rXJHeqrLpho5nIQgbDcpBTvBrVnGged,bWdj2GDclj5ofokWjzoa5jAwMkxCykd6,14,27,5,38,1,10,10,1,92,13.142857142857142,2,0.0,6,5,34,1,21,10,4,10,1,46,46,1
3633,53856,4jDSfVr3FM2ZrR7U3LMbeRYrZXGv5CAV,SpATywNh6bZuzm8s1ceuBUnMUAeoAHHw,17,29,9,20,4,1,3,1,67,9.571428571428571,2,0.0,17,9,17,4,12,1,3,3,1,47,20,1
3634,53865,jKfEyfk0HFbzE5vAszOX5qLRWBhzLYt2,A3fsA9Zfv1X2fVEQhTw51lKENdNrEqT3,1,0,0,0,0,0,2,0,2,0.2857142857142857,2,0.0,0,0,0,0,0,0,0,2,0,0,2,1
3635,53872,jKfEyfk0HFbzE5vAszOX5qLRWBhzLYt2,bWdj2GDclj5ofokWjzoa5jAwMkxCykd6,1,0,0,0,0,0,1,0,1,0.14285714285714285,1,0.0,0,0,0,0,0,0,0,1,0,0,1,1
3636,53893,8C3Ev7v016DKmnVXW2AvnqT9jJXWxsa8,SpATywNh6bZuzm8s1ceuBUnMUAeoAHHw,7,3,2,0,2,0,2,0,9,1.2857142857142858,1,0.0,0,2,0,2,3,0,0,2,0,4,5,1
3637,53903,4XxIEPI2UOvU2fn3nQAeJ4R1qsxwKTmu,SpATywNh6bZuzm8s1ceuBUnMUAeoAHHw,21,29,15,0,11,0,11,0,66,9.428571428571429,1,0.0,4,15,0,11,25,0,0,11,0,30,36,0
3638,53916,BsBj37bM37sYKQjSXV07xFL8gbIptVn8,bWdj2GDclj5ofokWjzoa5jAwMkxCykd6,5,2,0,0,0,0,4,0,6,0.8571428571428571,2,0.0,0,0,0,0,2,0,0,4,0,0,6,1
3639,53920,Oiq6C4nL7ZnZProqskptBCeXrYJ4FTge,A3fsA9Zfv1X2fVEQhTw51lKENdNrEqT3,1,0,0,0,0,0,2,0,2,0.2857142857142857,1,0.0,0,0,0,0,0,0,0,2,0,0,2,1
3640,53930,IARcq51sP2SqR9JLBLqyXGL88k6Z1aOe,SpATywNh6bZuzm8s1ceuBUnMUAeoAHHw,1,0,0,0,0,0,1,0,1,0.14285714285714285,1,0.0,0,0,0,0,0,0,0,1,0,0,1,1
3641,53970,mopAEhc4oYbNGgdB14MDU4Z5IjNO4SXn,SpATywNh6bZuzm8s1ceuBUnMUAeoAHHw,22,25,2,34,0,0,5,0,66,9.428571428571429,1,0.0,6,2,28,0,19,0,6,5,0,36,30,1
3642,53984,QYVRHTpooyTkzSbIywJ7ri5o4t73Xwty,SpATywNh6bZuzm8s1ceuBUnMUAeoAHHw,7,15,5,0,3,0,3,0,26,3.7142857142857144,1,0.0,0,5,0,3,15,0,0,3,0,8,18,1
3643,53986,z9sj5HIJml1DMOMfRKKBQ7IvS2IoE424,bWdj2GDclj5ofokWjzoa5jAwMkxCykd6,21,102,51,24,11,33,34,0,255,36.42857142857143,5,0.0,9,51,22,11,93,33,2,34,0,93,162,1
3644,53989,1kEIJj7vLRBM7EdRHp9VWjLFIqNPjA0F,SpATywNh6bZuzm8s1ceuBUnMUAeoAHHw,5,2,1,0,1,0,3,0,7,1.0,1,0.0,0,1,0,1,2,0,0,3,0,2,5,1
3645,54035,6UfIu5SKHPYfwZxBxJpGSqhLHKhbdsl0,SpATywNh6bZuzm8s1ceuBUnMUAeoAHHw,14,15,12,2,7,0,7,0,43,6.142857142857143,3,0.0,0,12,2,7,15,0,0,7,0,21,22,0
3646,54045,A9hKsxxgL4q5b7FGmUZTmhhYJ9IUDrBm,SpATywNh6bZuzm8s1ceuBUnMUAeoAHHw,18,42,21,0,14,2,11,0,90,12.857142857142858,6,0.0,6,21,0,14,36,2,0,11,0,41,49,0
3647,54054,W3FcEvxr2cIwq2NIdATNIqtjoGLetLLn,bWdj2GDclj5ofokWjzoa5jAwMkxCykd6,10,13,2,20,1,8,7,2,53,7.571428571428571,2,0.0,1,2,18,1,12,8,2,7,2,22,31,1
3648,54072,Y9YzwTET1OUYhHsLt97DLY5Tl5O9atqy,SpATywNh6bZuzm8s1ceuBUnMUAeoAHHw,12,21,10,0,10,0,1,0,42,6.0,2,0.0,0,10,0,10,21,0,0,1,0,20,22,1
3649,54086,uIIavYxNuEJ6NG2Ex383dBZvdILceLZJ,SpATywNh6bZuzm8s1ceuBUnMUAeoAHHw,24,45,19,17,10,0,12,1,104,14.857142857142858,6,0.0,13,19,16,10,32,0,1,12,1,58,46,0
3650,54090,IwRf58Af79ziuqQX85M6J2Lo8D4N0Ygn,A3fsA9Zfv1X2fVEQhTw51lKENdNrEqT3,8,5,3,0,3,0,2,0,13,1.8571428571428572,1,0.0,0,3,0,3,5,0,0,2,0,6,7,1
3651,54093,1rAHmNrxrqnzHEQFMlydmQ968LsZW0oG,RXDvfPUBYFlVdlueBFbLW0mhhAyGEqpt,15,8,5,10,2,7,8,3,43,6.142857142857143,3,0.0,1,5,9,2,7,7,1,8,3,17,26,1
3652,54095,mANHObgCOxed01sMVUE2CCh0Yy4sWlCz,bWdj2GDclj5ofokWjzoa5jAwMkxCykd6,4,2,0,0,0,0,3,0,5,0.7142857142857143,1,0.0,0,0,0,0,2,0,0,3,0,0,5,1
3653,54100,ULxriJOFgcYW8OKrxzYPWeTN4MYJZpRj,SpATywNh6bZuzm8s1ceuBUnMUAeoAHHw,16,51,5,6,4,0,12,0,78,11.142857142857142,7,0.0,3,5,6,4,48,0,0,12,0,18,60,1
3654,54105,On4dVQn2MRHkwqRorWIyGST4bzaBJgjb,SpATywNh6bZuzm8s1ceuBUnMUAeoAHHw,7,7,4,0,3,0,2,0,16,2.2857142857142856,2,0.0,0,4,0,3,7,0,0,2,0,7,9,1
3655,54107,puAOKUG4MdJZvu6TGCieg6bgD5WGJ0qf,bWdj2GDclj5ofokWjzoa5jAwMkxCykd6,16,15,9,68,0,40,15,3,150,21.428571428571427,2,0.0,3,9,65,0,12,40,3,15,3,77,73,1
3656,54112,GASbwPXxwryodKV3AqYKdU5jEaEhIE7r,SpATywNh6bZuzm8s1ceuBUnMUAeoAHHw,33,39,4,14,2,0,27,3,89,12.714285714285714,8,0.0,3,4,12,2,36,0,2,27,3,21,68,0
3657,54120,S9bleRJbl0xJFa4yPXuTgULWJ67nbMqi,SpATywNh6bZuzm8s1ceuBUnMUAeoAHHw,28,51,30,20,18,0,10,0,129,18.428571428571427,8,0.0,5,30,18,18,46,0,2,10,0,71,58,0
3658,54127,puAOKUG4MdJZvu6TGCieg6bgD5WGJ0qf,A3fsA9Zfv1X2fVEQhTw51lKENdNrEqT3,1,0,0,0,0,0,1,0,1,0.14285714285714285,1,0.0,0,0,0,0,0,0,0,1,0,0,1,1
3659,54142,oEOiBLMr97GK8O9ympHG9NMLQODJ0Xam,A3fsA9Zfv1X2fVEQhTw51lKENdNrEqT3,1,0,0,0,0,0,1,0,1,0.14285714285714285,1,0.0,0,0,0,0,0,0,0,1,0,0,1,1
3660,54151,6f80AuCxgLhEz4q3r0Z7Tne4jeBhxVpZ,SpATywNh6bZuzm8s1ceuBUnMUAeoAHHw,43,116,40,61,18,23,45,6,309,44.142857142857146,4,0.0,31,40,51,18,85,23,10,45,6,140,169,0
3661,54156,QYaJtD7z5M6YcGNpdHV2JTsxqV4tXm9a,SpATywNh6bZuzm8s1ceuBUnMUAeoAHHw,34,52,31,30,0,19,12,0,144,20.571428571428573,7,0.0,13,31,28,0,39,19,2,12,0,72,72,0
3662,54174,qsAhBackOo3cL2WuRLzyR4ErX4nTraFk,bWdj2GDclj5ofokWjzoa5jAwMkxCykd6,8,9,2,2,5,0,2,0,20,2.857142857142857,1,0.0,6,2,2,5,3,0,0,2,0,15,5,1
3663,54189,cN6OZq4ak5IqzN7Lw32XLOS12DhlWO8Q,A3fsA9Zfv1X2fVEQhTw51lKENdNrEqT3,99,108,58,242,24,28,19,1,480,68.57142857142857,5,0.0,10,58,189,24,98,28,53,19,1,281,199,0
3664,54190,U6zvwzZFC3hs6bhxG6asVA50snx1s2RU,SpATywNh6bZuzm8s1ceuBUnMUAeoAHHw,4,2,1,0,1,0,1,0,5,0.7142857142857143,1,0.0,0,1,0,1,2,0,0,1,0,2,3,1
3665,54191,Io3VzTK6sP3a0ZVRKkRhFNz8A2ULjris,G8EPVSXsOYB5YQWZGiz1aVq5Pgr2GrQu,2,0,0,0,0,0,3,0,3,0.42857142857142855,1,0.0,0,0,0,0,0,0,0,3,0,0,3,1
3666,54193,smg4SHkT0uQ59GP6Camalxkw6c32vtzM,SpATywNh6bZuzm8s1ceuBUnMUAeoAHHw,42,69,8,42,6,1,20,0,146,20.857142857142858,7,0.0,12,8,36,6,57,1,6,20,0,62,84,0
3667,54196,4mLn5YrkZbnxPXEuAYTSn9TKZyVmWQjo,SpATywNh6bZuzm8s1ceuBUnMUAeoAHHw,19,38,2,0,2,0,7,0,49,7.0,5,0.0,0,2,0,2,38,0,0,7,0,4,45,0
3668,54209,ke8J6J68PMmqZ8rK8FCDUgXlLZQpLLZW,bWdj2GDclj5ofokWjzoa5jAwMkxCykd6,20,43,14,100,9,7,12,1,186,26.571428571428573,7,0.0,7,14,93,9,36,7,7,12,1,123,63,1
3669,54215,ZbaPpC6DlaDgy5Ic6oj7YX9qkm2j3Pmr,A3fsA9Zfv1X2fVEQhTw51lKENdNrEqT3,1,0,0,0,0,0,1,0,1,0.14285714285714285,1,0.0,0,0,0,0,0,0,0,1,0,0,1,1
3670,54230,RJ1FVW8gXQIpK321uzh2Sh69ojlsqnvg,A3fsA9Zfv1X2fVEQhTw51lKENdNrEqT3,16,11,8,0,6,2,13,2,42,6.0,2,0.0,0,8,0,6,11,2,0,13,2,14,28,0
3671,54245,DauUa5EOQjYVJ9IOEZ6MNnCJpVrdodep,SpATywNh6bZuzm8s1ceuBUnMUAeoAHHw,5,2,1,0,1,0,2,0,6,0.8571428571428571,1,0.0,0,1,0,1,2,0,0,2,0,2,4,1
3672,54248,4rM5k15XYnxmy5xR9L5EVWP9CatXJ8wI,SpATywNh6bZuzm8s1ceuBUnMUAeoAHHw,4,2,0,0,0,0,3,0,5,0.7142857142857143,1,0.0,0,0,0,0,2,0,0,3,0,0,5,1
3673,54256,wtEiMTsSGyqVYmzAUWtaJeXU5b3t5li0,SpATywNh6bZuzm8s1ceuBUnMUAeoAHHw,16,23,7,26,1,0,4,0,61,8.714285714285714,3,0.0,14,7,20,1,9,0,6,4,0,42,19,0
3674,54263,haOx3D2RVOqd6ga1rw8OsvbEHoupYgpz,SpATywNh6bZuzm8s1ceuBUnMUAeoAHHw,14,9,4,12,3,3,3,0,34,4.857142857142857,1,0.0,2,4,9,3,7,3,3,3,0,18,16,1
3675,54267,o4j0NDzLh6XqpDKcvRg8Lx9N4HUYeTuP,A3fsA9Zfv1X2fVEQhTw51lKENdNrEqT3,1,0,0,0,0,0,1,0,1,0.14285714285714285,1,0.0,0,0,0,0,0,0,0,1,0,0,1,1
3676,54269,7EEqnuI1QuwYA0sZvgr9zLDxbRgASZvg,A3fsA9Zfv1X2fVEQhTw51lKENdNrEqT3,1,0,0,0,0,0,1,0,1,0.14285714285714285,1,0.0,0,0,0,0,0,0,0,1,0,0,1,1
3677,54286,NCyQ1ytdiWvqyE3iylDLFJzABxi8HOfD,SpATywNh6bZuzm8s1ceuBUnMUAeoAHHw,3,0,0,0,0,0,5,0,5,0.7142857142857143,1,0.0,0,0,0,0,0,0,0,5,0,0,5,1
3678,54307,Io3VzTK6sP3a0ZVRKkRhFNz8A2ULjris,A3fsA9Zfv1X2fVEQhTw51lKENdNrEqT3,2,0,0,0,0,0,2,0,2,0.2857142857142857,1,0.0,0,0,0,0,0,0,0,2,0,0,2,1
3679,54317,uKEv904ylJe7cpj2OP28yUTrESfvx6LR,SpATywNh6bZuzm8s1ceuBUnMUAeoAHHw,5,3,2,0,1,0,2,0,8,1.1428571428571428,1,0.0,0,2,0,1,3,0,0,2,0,3,5,1
3680,54326,Fq6XRhpyARqo3e2KmYQqUPcebNvG6D8A,SpATywNh6bZuzm8s1ceuBUnMUAeoAHHw,9,7,0,1,0,0,5,0,13,1.8571428571428572,2,0.0,0,0,1,0,7,0,0,5,0,1,12,1
3681,54347,u4dhcCVujoYC7k1ILiJ5SLaS1NfapC9a,SpATywNh6bZuzm8s1ceuBUnMUAeoAHHw,4,2,1,0,1,0,1,0,5,0.7142857142857143,1,0.0,0,1,0,1,2,0,0,1,0,2,3,1
3682,54354,1GwCcPnawuwjaFyAi38hoJxQ9NHTHcHa,SpATywNh6bZuzm8s1ceuBUnMUAeoAHHw,17,37,14,35,3,0,7,1,97,13.857142857142858,4,0.0,17,14,32,3,20,0,3,7,1,66,31,1
3683,54400,hMJOWQDhTMJkvOumtHtoyaiAzs72Ex16,A3fsA9Zfv1X2fVEQhTw51lKENdNrEqT3,1,0,0,0,0,0,2,0,2,0.2857142857142857,1,0.0,0,0,0,0,0,0,0,2,0,0,2,1
3684,54403,IiprEhfBJUF3Volv4Wt8hDKs67azhw4N,SpATywNh6bZuzm8s1ceuBUnMUAeoAHHw,42,70,5,51,3,79,30,4,242,34.57142857142857,13,0.0,18,5,43,3,52,79,8,30,4,69,173,0
3685,54406,WK8aAMlHaWKAnJlGkt1oHqYhwnCNU9kd,SpATywNh6bZuzm8s1ceuBUnMUAeoAHHw,13,10,8,0,6,4,6,0,34,4.857142857142857,3,0.0,0,8,0,6,10,4,0,6,0,14,20,1
3686,54424,iU4BkerxkC85turiATAPlGLqWWQBW3EA,SpATywNh6bZuzm8s1ceuBUnMUAeoAHHw,6,4,2,0,2,0,2,0,10,1.4285714285714286,1,0.0,0,2,0,2,4,0,0,2,0,4,6,0
3687,54428,fvcf8Mss4D9M5Dkk5Dn5T9NiTapwZ9dB,bWdj2GDclj5ofokWjzoa5jAwMkxCykd6,13,6,5,0,5,0,7,0,23,3.2857142857142856,3,0.0,0,5,0,5,6,0,0,7,0,10,13,1
3688,54433,0LlQk6hYRlvSzomDUaPkEEBmqmYnYmBf,A3fsA9Zfv1X2fVEQhTw51lKENdNrEqT3,8,9,3,0,3,0,3,0,18,2.5714285714285716,1,0.0,0,3,0,3,9,0,0,3,0,6,12,1
3689,54441,jWzOKFReJZdfMoypRkZGX0AJ4yOxVurG,SpATywNh6bZuzm8s1ceuBUnMUAeoAHHw,18,56,15,29,3,13,26,1,143,20.428571428571427,6,0.0,32,15,22,3,24,13,7,26,1,72,71,1
3690,54454,xPyi5tVWLdzwESKbVSwWQTZrKjlUSal4,A3fsA9Zfv1X2fVEQhTw51lKENdNrEqT3,11,6,1,0,1,0,12,2,22,3.142857142857143,3,0.0,0,1,0,1,6,0,0,12,2,2,20,1
3691,54456,9y3oRyXROykl3sBJ7TIi1TtD7SPjZS8A,RXDvfPUBYFlVdlueBFbLW0mhhAyGEqpt,1,0,0,0,0,0,1,0,1,0.14285714285714285,1,0.0,0,0,0,0,0,0,0,1,0,0,1,1
3692,54466,X0qRVbMFwtmOOuQv50UvryYfYmnstiNp,RXDvfPUBYFlVdlueBFbLW0mhhAyGEqpt,10,15,1,0,0,0,5,0,21,3.0,5,0.0,0,1,0,0,15,0,0,5,0,1,20,1
3693,54474,2cQfWhwRUGUv48S47s2aDWYzSM5LRy6r,SpATywNh6bZuzm8s1ceuBUnMUAeoAHHw,24,39,3,34,1,0,15,1,93,13.285714285714286,7,0.0,8,3,29,1,31,0,5,15,1,41,52,1
3694,54513,wD600Vm6nYpRlm6dPdneFPtwC1POqb2E,SpATywNh6bZuzm8s1ceuBUnMUAeoAHHw,19,41,18,20,7,0,11,0,97,13.857142857142858,4,0.0,10,18,16,7,31,0,4,11,0,51,46,1
3695,54539,obFplu8p0J5bdsesTSoaj6Bc4UGbTB6M,A3fsA9Zfv1X2fVEQhTw51lKENdNrEqT3,3,2,0,0,0,0,4,0,6,0.8571428571428571,3,0.0,0,0,0,0,2,0,0,4,0,0,6,1
3696,54560,PuyGNo8qc6xk0x7N225chheH1U0jpEmh,SpATywNh6bZuzm8s1ceuBUnMUAeoAHHw,16,23,9,14,0,0,9,0,55,7.857142857142857,2,0.0,8,9,11,0,15,0,3,9,0,28,27,0
3697,54562,FjbDR3UaxcNBkb6IH3GDQCUcWtWdh8Qq,RXDvfPUBYFlVdlueBFbLW0mhhAyGEqpt,34,22,12,36,10,0,3,0,83,11.857142857142858,1,0.0,7,12,34,10,15,0,2,3,0,63,20,1
3698,54579,UTQBVZwwRuN7bMqGkwJeqpNJF2PPrsFV,bWdj2GDclj5ofokWjzoa5jAwMkxCykd6,5,4,2,0,1,0,2,0,9,1.2857142857142858,2,0.0,0,2,0,1,4,0,0,2,0,3,6,1
3699,54583,CQQHZVTg11Q29ZpbkjEKlKziDTQM27vd,SpATywNh6bZuzm8s1ceuBUnMUAeoAHHw,2,0,0,0,0,0,2,0,2,0.2857142857142857,1,0.0,0,0,0,0,0,0,0,2,0,0,2,1
3700,54589,TFbXWoitMnOMl2WspWQeF8K8fD3FgeDB,fbPkOYLVPtPgIt0MxizjfFJov3JbHyAi,1,0,0,0,0,0,1,0,1,0.14285714285714285,1,0.0,0,0,0,0,0,0,0,1,0,0,1,1
3701,54594,5U0rvr3pqkKVd5Jhr1Idago4kekvZ7Qd,fbPkOYLVPtPgIt0MxizjfFJov3JbHyAi,1,0,0,0,0,0,1,0,1,0.14285714285714285,1,0.0,0,0,0,0,0,0,0,1,0,0,1,1
3702,54599,36RjzRPygGsRdCxzhcBfbwPaas6Hv1AB,fbPkOYLVPtPgIt0MxizjfFJov3JbHyAi,10,18,0,7,1,1,4,1,32,4.571428571428571,1,0.0,5,0,5,1,13,1,2,4,1,11,21,1
3703,54601,U7Pbnvw6ous6eMpEApyMcKGIm8NhiIVb,fbPkOYLVPtPgIt0MxizjfFJov3JbHyAi,1,0,0,0,0,0,1,0,1,0.14285714285714285,1,0.0,0,0,0,0,0,0,0,1,0,0,1,1
3704,54609,zqJYLp2Za4wDRWdLkC6hOzbgm2qW4Dc0,fbPkOYLVPtPgIt0MxizjfFJov3JbHyAi,6,3,2,0,2,0,3,0,10,1.4285714285714286,2,0.0,0,2,0,2,3,0,0,3,0,4,6,1
3705,54611,w50jSI5RjqfAgmbAtDpAViImkLRNEU1B,fbPkOYLVPtPgIt0MxizjfFJov3JbHyAi,2,0,0,0,0,0,2,0,2,0.2857142857142857,1,0.0,0,0,0,0,0,0,0,2,0,0,2,1
3706,54612,3AcdZj2eRws1eHnIlNRTeIlmDqR0IPnY,fbPkOYLVPtPgIt0MxizjfFJov3JbHyAi,1,0,0,0,0,0,1,0,1,0.14285714285714285,1,0.0,0,0,0,0,0,0,0,1,0,0,1,1
3707,54613,KHpSQIE01XQJLtU5vhXvwADIT0s4ocMd,fbPkOYLVPtPgIt0MxizjfFJov3JbHyAi,2,0,0,0,0,0,4,0,4,0.5714285714285714,1,0.0,0,0,0,0,0,0,0,4,0,0,4,1
3708,54623,LDoffeIzXBaEA3EoYd9Gp4Kl36LUuUJD,fbPkOYLVPtPgIt0MxizjfFJov3JbHyAi,11,9,6,5,4,0,7,0,31,4.428571428571429,1,0.0,1,6,3,4,8,0,2,7,0,14,17,1
3709,54626,qowpjfcpUK1iU9rrtJ9U3WvarOVtt4V0,fbPkOYLVPtPgIt0MxizjfFJov3JbHyAi,1,0,0,0,0,0,2,0,2,0.2857142857142857,1,0.0,0,0,0,0,0,0,0,2,0,0,2,1
3710,54631,cZaJE9WXhMzWTnSMxu0NdfVeWxOkn7lj,fbPkOYLVPtPgIt0MxizjfFJov3JbHyAi,7,3,1,0,1,0,4,0,9,1.2857142857142858,2,0.0,0,1,0,1,3,0,0,4,0,2,7,1
3711,54632,WYnjjnMJs3hcSus3wsuOF4Oq6comfAXw,fbPkOYLVPtPgIt0MxizjfFJov3JbHyAi,35,33,23,0,13,0,7,0,76,10.857142857142858,1,0.0,0,23,0,13,33,0,0,7,0,36,40,1
3712,54633,dTyQ7W3SS3T02L83rAdjVWHrGRV4tFve,fbPkOYLVPtPgIt0MxizjfFJov3JbHyAi,9,4,2,0,3,0,3,0,12,1.7142857142857142,2,0.0,0,2,0,3,4,0,0,3,0,5,7,1
3713,54638,Mdfw3Q8oYP333LBMIERuMcnF8vYJNJ5b,fbPkOYLVPtPgIt0MxizjfFJov3JbHyAi,11,6,5,0,5,0,4,0,20,2.857142857142857,1,0.0,0,5,0,5,6,0,0,4,0,10,10,1
3714,54640,DVOHqEW2vUL1QpZynG6huVjAWwl1vI6M,fbPkOYLVPtPgIt0MxizjfFJov3JbHyAi,3,2,0,0,0,0,1,0,3,0.42857142857142855,1,0.0,0,0,0,0,2,0,0,1,0,0,3,1
3715,54642,1SXEIjzcoG8fdGB2rpSblj2HngER2yeu,fbPkOYLVPtPgIt0MxizjfFJov3JbHyAi,2,0,0,0,0,0,4,0,4,0.5714285714285714,2,0.0,0,0,0,0,0,0,0,4,0,0,4,1
3716,54644,X8FsaAv2Du3OE8bDKmARRecRJlZv4Av6,fbPkOYLVPtPgIt0MxizjfFJov3JbHyAi,2,0,0,0,0,0,4,0,4,0.5714285714285714,1,0.0,0,0,0,0,0,0,0,4,0,0,4,1
3717,54647,iNOoAvHUSfXxnF08qxfzfj0WmtUTTaRF,fbPkOYLVPtPgIt0MxizjfFJov3JbHyAi,11,8,6,0,5,0,9,1,29,4.142857142857143,2,0.0,1,6,0,5,7,0,0,9,1,12,17,1
3718,54649,MOIvgRd1Za1CsX2aG6XCAFZF5Iim3dN2,fbPkOYLVPtPgIt0MxizjfFJov3JbHyAi,1,0,0,0,0,0,1,0,1,0.14285714285714285,1,0.0,0,0,0,0,0,0,0,1,0,0,1,1
3719,54650,HvF4MJdW9mM4Uba858ulPV9LRY45bMal,fbPkOYLVPtPgIt0MxizjfFJov3JbHyAi,7,5,1,0,1,0,2,0,9,1.2857142857142858,1,0.0,0,1,0,1,5,0,0,2,0,2,7,1
3720,54651,i2JNGTgmf1lOGK2KnwkVCH8cCTETzhrF,fbPkOYLVPtPgIt0MxizjfFJov3JbHyAi,2,0,0,0,0,0,2,0,2,0.2857142857142857,1,0.0,0,0,0,0,0,0,0,2,0,0,2,1
3721,54653,N3bEDA47IlbzAbjhdudWg0K3fl1rro1B,fbPkOYLVPtPgIt0MxizjfFJov3JbHyAi,2,0,0,0,0,0,2,0,2,0.2857142857142857,1,0.0,0,0,0,0,0,0,0,2,0,0,2,1
3722,54655,LAwGJ37pqq1lJyt65gGidYJTzcBCIYfb,fbPkOYLVPtPgIt0MxizjfFJov3JbHyAi,6,2,1,0,1,0,3,0,7,1.0,1,0.0,0,1,0,1,2,0,0,3,0,2,5,1
3723,54656,vGZ3iFC7cl51KRfkdZMl5JdMbTFw6ygX,fbPkOYLVPtPgIt0MxizjfFJov3JbHyAi,5,4,0,0,0,0,2,0,6,0.8571428571428571,1,0.0,0,0,0,0,4,0,0,2,0,0,6,1
3724,54658,68Dxo5Uz0aGDvHTFGMu5vw31QRJ7GnRc,fbPkOYLVPtPgIt0MxizjfFJov3JbHyAi,8,6,4,0,4,0,1,0,15,2.142857142857143,1,0.0,0,4,0,4,6,0,0,1,0,8,7,1
3725,54662,2oTvbzieHn2y5oozeOgSnruqE6N0BtR5,fbPkOYLVPtPgIt0MxizjfFJov3JbHyAi,8,10,7,0,0,11,4,0,32,4.571428571428571,2,0.0,0,7,0,0,10,11,0,4,0,7,25,1
3726,54669,bYjPoNbc5ILh7K7s9YR8HLOMNJGN6Ums,SpATywNh6bZuzm8s1ceuBUnMUAeoAHHw,30,40,35,0,30,0,2,0,107,15.285714285714286,1,0.0,1,35,0,30,39,0,0,2,0,66,41,0
3727,54691,goA9z819kccFvSfjnBmFLW5zxeJMJD6F,A3fsA9Zfv1X2fVEQhTw51lKENdNrEqT3,1,0,0,0,0,0,1,0,1,0.14285714285714285,1,0.0,0,0,0,0,0,0,0,1,0,0,1,1
3728,54713,GtuEelYfNaXxzKOllxbFfafnobOPHIGx,bWdj2GDclj5ofokWjzoa5jAwMkxCykd6,6,2,1,0,1,0,3,0,7,1.0,1,0.0,0,1,0,1,2,0,0,3,0,2,5,0
3729,54714,GtuEelYfNaXxzKOllxbFfafnobOPHIGx,A3fsA9Zfv1X2fVEQhTw51lKENdNrEqT3,7,7,2,0,0,8,5,0,22,3.142857142857143,3,0.0,0,2,0,0,7,8,0,5,0,2,20,1
3730,54747,s2cJROUkYxvmOCaBfdTAC4ldoFLwdJSw,A3fsA9Zfv1X2fVEQhTw51lKENdNrEqT3,5,2,1,0,1,0,4,0,8,1.1428571428571428,2,0.0,0,1,0,1,2,0,0,4,0,2,6,1
3731,54753,8XalsjWgV9vFGi86xQSXkMYKuQx0bDjR,SpATywNh6bZuzm8s1ceuBUnMUAeoAHHw,2,0,0,0,0,0,2,0,2,0.2857142857142857,1,0.0,0,0,0,0,0,0,0,2,0,0,2,1
3732,54772,YfpBRnRxCpR1TK7m0C7otuwPOThrM107,A3fsA9Zfv1X2fVEQhTw51lKENdNrEqT3,8,2,2,0,2,0,3,0,9,1.2857142857142858,1,0.0,0,2,0,2,2,0,0,3,0,4,5,1
3733,54784,KQPXidcwG060yQGJPDlINxK2yFVflTSt,SpATywNh6bZuzm8s1ceuBUnMUAeoAHHw,1,0,0,0,0,0,1,0,1,0.14285714285714285,1,0.0,0,0,0,0,0,0,0,1,0,0,1,1
3734,54786,MgEz8Kh24CoQLmplPmrXNZfiSa5njivf,bWdj2GDclj5ofokWjzoa5jAwMkxCykd6,13,27,3,74,4,2,6,0,116,16.571428571428573,2,0.0,16,3,72,4,11,2,2,6,0,95,21,1
3735,54802,CyhW9ceUO9NYz6xFgPeXoLjeNitx4OvW,7GRhBDsirIGkRZBtSMEzNTyDr2JQm4xx,1,0,0,0,0,0,1,0,1,0.14285714285714285,1,0.0,0,0,0,0,0,0,0,1,0,0,1,1
3736,54806,CyhW9ceUO9NYz6xFgPeXoLjeNitx4OvW,5X6FeZozNMgE2VRi3MJYjkkFK8SETtu2,1,0,0,0,0,0,1,0,1,0.14285714285714285,1,0.0,0,0,0,0,0,0,0,1,0,0,1,1
3737,54831,oMY23DevzUsmhDrGNgzC3AgbyiZkq9X2,bWdj2GDclj5ofokWjzoa5jAwMkxCykd6,18,11,1,0,1,0,8,1,22,3.142857142857143,1,0.0,0,1,0,1,11,0,0,8,1,2,20,0
3738,54832,XTByA0ecuKljeTXiSoi3vawyiYSNo5Ez,SpATywNh6bZuzm8s1ceuBUnMUAeoAHHw,38,156,79,23,35,21,20,0,334,47.714285714285715,4,0.0,63,79,22,35,93,21,1,20,0,199,135,0
3739,54836,pVK8kwJmTtFRhseEFXqi0Vcn8D0v4GEA,bWdj2GDclj5ofokWjzoa5jAwMkxCykd6,50,32,18,178,7,7,4,1,247,35.285714285714285,2,0.0,12,18,174,7,20,7,4,4,1,211,36,1
3740,54850,nEzidwd1f4tZP3mnFNbL1NYH0VtiIG9o,SpATywNh6bZuzm8s1ceuBUnMUAeoAHHw,1,0,0,0,0,0,1,0,1,0.14285714285714285,1,0.0,0,0,0,0,0,0,0,1,0,0,1,1
3741,54867,5PKcR4qIlFoFDgQbZBaaE6PaBQr3UBHF,A3fsA9Zfv1X2fVEQhTw51lKENdNrEqT3,33,22,13,56,8,1,20,0,120,17.142857142857142,1,0.0,2,13,51,8,20,1,5,20,0,74,46,1
3742,54874,zmKR9B5NLIRfAmSKdCbaIDXMZT9PoZip,7GRhBDsirIGkRZBtSMEzNTyDr2JQm4xx,1,0,0,0,0,0,1,0,1,0.14285714285714285,1,0.0,0,0,0,0,0,0,0,1,0,0,1,1
3743,54893,MZomFQTbHAKaDGd0B9fv7KQ9MRsZJ7m6,7GRhBDsirIGkRZBtSMEzNTyDr2JQm4xx,6,3,2,0,2,1,3,0,11,1.5714285714285714,2,0.0,0,2,0,2,3,1,0,3,0,4,7,1
3744,54931,x89YyfX1v9jrCXDDiy9HsPZFNZWRlfiG,SpATywNh6bZuzm8s1ceuBUnMUAeoAHHw,15,11,1,8,0,0,3,0,23,3.2857142857142856,2,0.0,0,1,8,0,11,0,0,3,0,9,14,0
3745,54936,BY9YLSZcQDQQEQ3MNU6DAt6np51iLH0O,A3fsA9Zfv1X2fVEQhTw51lKENdNrEqT3,7,5,1,0,1,0,1,0,8,1.1428571428571428,1,0.0,0,1,0,1,5,0,0,1,0,2,6,1
3746,54970,YbQfcgwKrjskWW3wyOzQUUJYzdeHmY82,A3fsA9Zfv1X2fVEQhTw51lKENdNrEqT3,70,69,31,138,15,4,26,0,283,40.42857142857143,8,0.0,7,31,124,15,62,4,14,26,0,177,106,0
3747,54981,Zyf4Fx2Q4VGwgsd2tRc1f9GIxHAqsh1E,SpATywNh6bZuzm8s1ceuBUnMUAeoAHHw,4,3,0,0,0,0,2,0,5,0.7142857142857143,1,0.0,0,0,0,0,3,0,0,2,0,0,5,1
3748,54983,9TfZcuW9XFphtEgwQrccxCFHKScgn5mj,SpATywNh6bZuzm8s1ceuBUnMUAeoAHHw,2,0,0,0,0,0,2,0,2,0.2857142857142857,1,0.0,0,0,0,0,0,0,0,2,0,0,2,1
3749,54997,IJWUl0dWQiuiW9w5y2FbSbROivrhPUri,G8EPVSXsOYB5YQWZGiz1aVq5Pgr2GrQu,25,28,13,16,5,3,11,1,77,11.0,3,0.0,10,13,8,5,18,3,8,11,1,36,41,0
3750,55002,crL8XlHfgGxCO2yU3loQgEUYoD6TDz3m,SpATywNh6bZuzm8s1ceuBUnMUAeoAHHw,2,0,0,0,0,0,2,0,2,0.2857142857142857,1,0.0,0,0,0,0,0,0,0,2,0,0,2,1
3751,55003,PnDN2WssnANedhxbDqo06cZR8VfXOHcf,SpATywNh6bZuzm8s1ceuBUnMUAeoAHHw,33,95,33,77,1,119,25,2,352,50.285714285714285,9,0.0,46,33,66,1,49,119,11,25,2,146,206,0
3752,55008,D4QPb866p0LB9x0Ul2B3bay8zRlCxMSN,SpATywNh6bZuzm8s1ceuBUnMUAeoAHHw,1,0,0,0,0,0,1,0,1,0.14285714285714285,1,0.0,0,0,0,0,0,0,0,1,0,0,1,1
3753,55011,44NSfhUNLUI5lCBFMkEs9Un2s2Oz0cz0,SpATywNh6bZuzm8s1ceuBUnMUAeoAHHw,12,19,0,15,0,2,7,1,44,6.285714285714286,1,0.0,12,0,13,0,7,2,2,7,1,25,19,1
3754,55032,VT9jjElVjpMsf2zIziMAJWphCCTuBSUt,A3fsA9Zfv1X2fVEQhTw51lKENdNrEqT3,39,13,9,62,8,0,10,0,102,14.571428571428571,1,0.0,4,9,55,8,9,0,7,10,0,76,26,1
3755,55046,OsjipUObm67JsyJjOy7xHoa32L8CSYg5,7GRhBDsirIGkRZBtSMEzNTyDr2JQm4xx,95,123,7,125,14,1,17,0,287,41.0,9,0.0,62,7,123,14,61,1,2,17,0,206,81,1
3756,55055,p7kSnjO0uUcIRggHewx0HDSWkZbQpZMf,A3fsA9Zfv1X2fVEQhTw51lKENdNrEqT3,1,0,0,0,0,0,1,0,1,0.14285714285714285,1,0.0,0,0,0,0,0,0,0,1,0,0,1,1
3757,55057,95rBh3nA5ryqebDyyAi8HuMMGjJOTX7y,SpATywNh6bZuzm8s1ceuBUnMUAeoAHHw,34,32,24,12,21,9,7,0,105,15.0,2,0.0,7,24,12,21,25,9,0,7,0,64,41,0
3758,55068,gKSJfTKRpPRCZVoRPeT84zeHU3dzpwjK,SpATywNh6bZuzm8s1ceuBUnMUAeoAHHw,1,0,0,0,0,0,1,0,1,0.14285714285714285,1,0.0,0,0,0,0,0,0,0,1,0,0,1,1
3759,55073,5bLca2NVfaOvMosrC3znHH0bACGNInJI,SpATywNh6bZuzm8s1ceuBUnMUAeoAHHw,14,21,7,19,5,1,2,0,55,7.857142857142857,1,0.0,13,7,18,5,8,1,1,2,0,43,12,0
3760,55086,PfTpx7WgTJY6IpNokJ2POml34GMs7LTI,A3fsA9Zfv1X2fVEQhTw51lKENdNrEqT3,114,40,30,244,19,0,9,0,342,48.857142857142854,6,0.0,3,30,236,19,37,0,8,9,0,288,54,0
3761,55096,UvQMiNijSBGXihS0IyD8hVQt9aLPd6yp,SpATywNh6bZuzm8s1ceuBUnMUAeoAHHw,6,1,1,0,1,0,3,0,6,0.8571428571428571,1,0.0,0,1,0,1,1,0,0,3,0,2,4,1
3762,55102,tC06tDcyfiakkQ82nvNuQ9hOr0id1lp4,A3fsA9Zfv1X2fVEQhTw51lKENdNrEqT3,25,12,10,0,9,19,10,2,62,8.857142857142858,3,0.0,0,10,0,9,12,19,0,10,2,19,43,1
3763,55108,oASR1hbK6DD6OJfTJCDKLW9l2vPgw7kR,SpATywNh6bZuzm8s1ceuBUnMUAeoAHHw,21,33,19,10,10,0,6,0,78,11.142857142857142,4,0.0,6,19,10,10,27,0,0,6,0,45,33,0
3764,55118,o32R7MADzv6ZJXN2A9yz9F4MgrJJw9Qs,G8EPVSXsOYB5YQWZGiz1aVq5Pgr2GrQu,1,0,0,0,0,0,1,0,1,0.14285714285714285,1,0.0,0,0,0,0,0,0,0,1,0,0,1,1
3765,55150,YEb4IhQ2RxrCQodPIxBL4Z2QiEDyCZuY,SpATywNh6bZuzm8s1ceuBUnMUAeoAHHw,5,2,1,0,1,0,2,0,6,0.8571428571428571,1,0.0,0,1,0,1,2,0,0,2,0,2,4,0
3766,55157,yUIi2GUBxhysS9d9StVXyKUpISr6ANil,bWdj2GDclj5ofokWjzoa5jAwMkxCykd6,20,22,13,18,7,0,14,0,74,10.571428571428571,1,0.0,6,13,18,7,16,0,0,14,0,44,30,0
3767,55162,gKSJfTKRpPRCZVoRPeT84zeHU3dzpwjK,7GRhBDsirIGkRZBtSMEzNTyDr2JQm4xx,1,0,0,0,0,0,1,0,1,0.14285714285714285,1,0.0,0,0,0,0,0,0,0,1,0,0,1,1
3768,55167,gKSJfTKRpPRCZVoRPeT84zeHU3dzpwjK,A3fsA9Zfv1X2fVEQhTw51lKENdNrEqT3,1,0,0,0,0,0,1,0,1,0.14285714285714285,1,0.0,0,0,0,0,0,0,0,1,0,0,1,1
3769,55184,oVT1DSRDmSOI9P6Fvaw4mU7McCnHmOfz,bWdj2GDclj5ofokWjzoa5jAwMkxCykd6,5,2,1,0,1,0,5,0,9,1.2857142857142858,2,0.0,0,1,0,1,2,0,0,5,0,2,7,1
3770,55218,9DhjEr6688N0pGcvfzUDBy2Ch8BrzD6G,SpATywNh6bZuzm8s1ceuBUnMUAeoAHHw,31,104,4,40,0,14,39,5,206,29.428571428571427,7,0.0,47,4,35,0,57,14,5,39,5,86,120,0
3771,55222,sl5gnvWQxJCaKuNiDBTD8Gtex2riuepC,7GRhBDsirIGkRZBtSMEzNTyDr2JQm4xx,12,17,1,3,1,0,2,0,24,3.4285714285714284,1,0.0,3,1,3,1,14,0,0,2,0,8,16,1
3772,55224,fUiHjsgVTGx2gqPb2ZvmjVRjbdS9ZqmA,SpATywNh6bZuzm8s1ceuBUnMUAeoAHHw,45,58,21,43,11,23,8,2,166,23.714285714285715,2,0.0,19,21,41,11,39,23,2,8,2,92,74,0
3773,55249,RvNTpDpHJXpHBPiVPs0LJQO0QVfwQmLZ,RXDvfPUBYFlVdlueBFbLW0mhhAyGEqpt,6,1,1,0,1,0,4,0,7,1.0,1,0.0,0,1,0,1,1,0,0,4,0,2,5,1
3774,55259,YJeMkd3jz6x14dPiy98P6Q1CUjEPbHyt,bWdj2GDclj5ofokWjzoa5jAwMkxCykd6,2,0,0,0,0,0,2,0,2,0.2857142857142857,1,0.0,0,0,0,0,0,0,0,2,0,0,2,1
3775,55263,M1VrwOWjiMnBueo7ci4JBR246P3AJPFN,bWdj2GDclj5ofokWjzoa5jAwMkxCykd6,1,0,0,0,0,0,1,0,1,0.14285714285714285,1,0.0,0,0,0,0,0,0,0,1,0,0,1,1
3776,55268,yRP1A8CWHIiqi7L2SKgryjvGOEaUovOk,SpATywNh6bZuzm8s1ceuBUnMUAeoAHHw,31,69,6,53,2,1,14,2,147,21.0,4,0.0,22,6,46,2,47,1,7,14,2,76,71,0
3777,55279,pt3wm9HtultYr0UCBIWH5P5prgTkt7m0,G8EPVSXsOYB5YQWZGiz1aVq5Pgr2GrQu,59,80,6,239,4,18,15,2,364,52.0,4,0.0,14,6,210,4,66,18,29,15,2,234,130,0
3778,55291,cPtFlYsoyEEkZNxOdkt9K062078YOujz,SpATywNh6bZuzm8s1ceuBUnMUAeoAHHw,1,0,0,0,0,0,1,0,1,0.14285714285714285,1,0.0,0,0,0,0,0,0,0,1,0,0,1,1
3779,55302,6IS7EPvZH5qwgjP7B7wKKNHDapbUNZzo,A3fsA9Zfv1X2fVEQhTw51lKENdNrEqT3,3,3,1,0,0,0,2,0,6,0.8571428571428571,1,0.0,0,1,0,0,3,0,0,2,0,1,5,1
3780,55311,9WckfdNtlzlT2DpQl1LIa5W8ikOsv83Y,bWdj2GDclj5ofokWjzoa5jAwMkxCykd6,5,2,1,0,1,0,3,0,7,1.0,1,0.0,0,1,0,1,2,0,0,3,0,2,5,1
3781,55314,pzjrdD7q4o4JUPPOqQkw5fcoOUkIlkAh,5X6FeZozNMgE2VRi3MJYjkkFK8SETtu2,41,193,58,5,53,0,28,1,338,48.285714285714285,9,0.0,53,58,4,53,140,0,1,28,1,168,170,1
3782,55315,C3empNgjHCzi0FFc7gzcI9FqKZfB0kwl,A3fsA9Zfv1X2fVEQhTw51lKENdNrEqT3,2,0,0,0,0,0,2,0,2,0.2857142857142857,1,0.0,0,0,0,0,0,0,0,2,0,0,2,1
3783,55324,b9PnER5aWf7HLwZ7RJ62h9NvkqSBL8ua,7GRhBDsirIGkRZBtSMEzNTyDr2JQm4xx,1,0,0,0,0,0,1,0,1,0.14285714285714285,1,0.0,0,0,0,0,0,0,0,1,0,0,1,1
3784,55335,YPEupTuOqSGieSSneZcv3AcUcSBCtbGY,RXDvfPUBYFlVdlueBFbLW0mhhAyGEqpt,47,66,3,75,6,15,19,1,185,26.428571428571427,5,0.0,15,3,71,6,51,15,4,19,1,95,90,1
3785,55338,CJvQb9Hij1vi5CpddEhAGwqZhdqybXGg,RXDvfPUBYFlVdlueBFbLW0mhhAyGEqpt,1,0,0,0,0,0,1,0,1,0.14285714285714285,1,0.0,0,0,0,0,0,0,0,1,0,0,1,1
3786,55341,rF503HYO0yfDhY1PybydCUAwDRRpCv4q,RXDvfPUBYFlVdlueBFbLW0mhhAyGEqpt,26,26,0,0,0,0,2,0,28,4.0,1,0.0,0,0,0,0,26,0,0,2,0,0,28,0
3787,55354,Gi2X0hiarDyo35MZ1XLA1tAuH6cjnWrV,SpATywNh6bZuzm8s1ceuBUnMUAeoAHHw,1,0,0,0,0,0,1,0,1,0.14285714285714285,1,0.0,0,0,0,0,0,0,0,1,0,0,1,1
3788,55355,4F0UQjd75R1TirjycGkNWhHj6ZRjyPGA,bWdj2GDclj5ofokWjzoa5jAwMkxCykd6,1,0,0,0,0,0,1,0,1,0.14285714285714285,1,0.0,0,0,0,0,0,0,0,1,0,0,1,1
3789,55362,xkt3K6JWpnfeixDBdwkLXaHgXuuGt35v,7GRhBDsirIGkRZBtSMEzNTyDr2JQm4xx,37,74,31,55,21,0,12,0,193,27.571428571428573,7,0.0,25,31,48,21,49,0,7,12,0,125,68,1
3790,55392,zJYvwWT1PjHkUzbH163Gl1FetfzZr9EA,RXDvfPUBYFlVdlueBFbLW0mhhAyGEqpt,1,0,0,0,0,0,1,0,1,0.14285714285714285,1,0.0,0,0,0,0,0,0,0,1,0,0,1,1
3791,55394,4mCA51pF01hkyB9Dsn8cU0qpfh1iqOVS,7GRhBDsirIGkRZBtSMEzNTyDr2JQm4xx,5,2,0,0,1,0,2,0,5,0.7142857142857143,1,0.0,0,0,0,1,2,0,0,2,0,1,4,1
3792,55398,46OTr627jSWtC8wrPe4BZiyNeqDxFeE3,SpATywNh6bZuzm8s1ceuBUnMUAeoAHHw,14,29,7,24,2,0,7,0,69,9.857142857142858,4,0.0,7,7,19,2,22,0,5,7,0,35,34,0
3793,55410,RTJrnitsd8G1VoV2K19FA0I93mo0ia0Z,5X6FeZozNMgE2VRi3MJYjkkFK8SETtu2,5,2,1,0,1,0,2,0,6,0.8571428571428571,1,0.0,0,1,0,1,2,0,0,2,0,2,4,1
3794,55431,y1WcAm64t9lQRNAylqHIQuubzMG9DVdt,SpATywNh6bZuzm8s1ceuBUnMUAeoAHHw,29,17,14,0,13,0,3,0,47,6.714285714285714,2,0.0,0,14,0,13,17,0,0,3,0,27,20,1
3795,55454,rhsZYk7m5LBkn7LVFx16rCH37SmeAW9R,SpATywNh6bZuzm8s1ceuBUnMUAeoAHHw,14,10,5,13,3,0,2,0,33,4.714285714285714,1,0.0,4,5,12,3,6,0,1,2,0,24,9,1
3796,55459,M9P4K0uKZv2JIzPAa6CKLB4Oc6qrAVQc,bWdj2GDclj5ofokWjzoa5jAwMkxCykd6,5,2,1,0,1,0,2,0,6,0.8571428571428571,1,0.0,0,1,0,1,2,0,0,2,0,2,4,1
3797,55482,87SYGQjFYUtEWda0pG12bcNker0JGBy3,SpATywNh6bZuzm8s1ceuBUnMUAeoAHHw,16,39,1,12,0,11,10,1,74,10.571428571428571,5,0.0,6,1,12,0,33,11,0,10,1,19,55,1
3798,55496,1TS44EjfaevEY3Ojw6rE7X5JCr9Of15y,SpATywNh6bZuzm8s1ceuBUnMUAeoAHHw,9,12,8,0,4,0,10,0,34,4.857142857142857,1,0.0,0,8,0,4,12,0,0,10,0,12,22,1
3799,55507,lIve9zf9D7vTMXQs5hH3jAEjrPNCSDld,SpATywNh6bZuzm8s1ceuBUnMUAeoAHHw,23,25,0,12,0,2,1,0,40,5.714285714285714,1,0.0,3,0,12,0,22,2,0,1,0,15,25,1
3800,55509,bOjQp32RFEV06sLvBam0q4cSgCEI9Fx6,A3fsA9Zfv1X2fVEQhTw51lKENdNrEqT3,1,0,0,0,0,0,9,0,9,1.2857142857142858,1,0.0,0,0,0,0,0,0,0,9,0,0,9,1
3801,55510,kXQxyYCkkJ6U8ORD8v5rCtwPvreatPKB,SpATywNh6bZuzm8s1ceuBUnMUAeoAHHw,25,28,17,9,11,2,10,0,77,11.0,4,0.0,7,17,7,11,21,2,2,10,0,42,35,1
3802,55543,pUCIPJW1P8mn7ehxRb7s9lkHivSStKgb,7GRhBDsirIGkRZBtSMEzNTyDr2JQm4xx,12,13,2,0,2,0,5,0,22,3.142857142857143,2,0.0,0,2,0,2,13,0,0,5,0,4,18,1
3803,55554,iN5LRJ62Fzny0HSOI77UB3W5oJ1HoHwK,7GRhBDsirIGkRZBtSMEzNTyDr2JQm4xx,2,0,0,0,0,0,3,0,3,0.42857142857142855,1,0.0,0,0,0,0,0,0,0,3,0,0,3,1
3804,55555,3GUakKniS7rRi1Az7W70DqXmiHk3dI25,SpATywNh6bZuzm8s1ceuBUnMUAeoAHHw,7,9,4,0,2,0,4,0,19,2.7142857142857144,1,0.0,0,4,0,2,9,0,0,4,0,6,13,1
3805,55574,kUTtwBKG3vzyymERNLukoy5hQ6c4zXj6,A3fsA9Zfv1X2fVEQhTw51lKENdNrEqT3,19,16,12,6,4,0,6,0,44,6.285714285714286,1,0.0,3,12,6,4,13,0,0,6,0,25,19,1
3806,55581,TctDXxVWte7oscV8OqkwV5s6zf8UI8b3,SpATywNh6bZuzm8s1ceuBUnMUAeoAHHw,17,9,5,19,3,1,5,1,43,6.142857142857143,1,0.0,3,5,16,3,6,1,3,5,1,27,16,1
3807,55587,dNMg8HqASFn9pIW9ZR7BiQy6ZwZupOce,A3fsA9Zfv1X2fVEQhTw51lKENdNrEqT3,7,11,4,0,3,0,12,0,30,4.285714285714286,4,0.0,0,4,0,3,11,0,0,12,0,7,23,1
3808,55589,dNMg8HqASFn9pIW9ZR7BiQy6ZwZupOce,bWdj2GDclj5ofokWjzoa5jAwMkxCykd6,7,7,2,0,2,0,7,0,18,2.5714285714285716,3,0.0,0,2,0,2,7,0,0,7,0,4,14,0
3809,55606,QuPJMxHrI2abilMygWFCmLFsgGUQO9Wm,bWdj2GDclj5ofokWjzoa5jAwMkxCykd6,17,34,21,22,11,17,12,1,118,16.857142857142858,5,0.0,4,21,17,11,30,17,5,12,1,53,65,1
3810,55628,qIt5jgUMiC2NqsdfOpbvC5VZ3HQC5sYb,SpATywNh6bZuzm8s1ceuBUnMUAeoAHHw,12,15,7,18,6,0,2,0,48,6.857142857142857,1,0.0,6,7,16,6,9,0,2,2,0,35,13,0
3811,55634,j38sS48yyjSQUQ4EfqmBmZ0QyWUgAHfx,bWdj2GDclj5ofokWjzoa5jAwMkxCykd6,9,6,4,18,3,0,2,0,33,4.714285714285714,1,0.0,1,4,17,3,5,0,1,2,0,25,8,1
3812,55643,PerDvJFeT0tH6oOxg5UEB9YO1At9Z54E,SpATywNh6bZuzm8s1ceuBUnMUAeoAHHw,6,3,0,0,0,0,3,0,6,0.8571428571428571,1,0.0,0,0,0,0,3,0,0,3,0,0,6,1
3813,55676,0KWLX80Me9j0YMYrLboMuYM0mrVWxRud,7GRhBDsirIGkRZBtSMEzNTyDr2JQm4xx,32,50,24,42,5,40,18,2,181,25.857142857142858,1,0.0,18,24,36,5,32,40,6,18,2,83,98,0
3814,55679,xpqgjZbEokW0MRLke1FZWztUWsQSbcB5,A3fsA9Zfv1X2fVEQhTw51lKENdNrEqT3,11,8,2,0,2,0,7,0,19,2.7142857142857144,2,0.0,0,2,0,2,8,0,0,7,0,4,15,1
3815,55681,8YnnXA8oYVyEbPN7gW2C6PhP9To3oGEn,SpATywNh6bZuzm8s1ceuBUnMUAeoAHHw,10,9,5,0,2,1,7,1,25,3.5714285714285716,2,0.0,0,5,0,2,9,1,0,7,1,7,18,1
3816,55714,ycZVLmNiTgP7M4zqov9Nx3hYhdN2qhKF,A3fsA9Zfv1X2fVEQhTw51lKENdNrEqT3,33,42,33,0,26,0,10,0,111,15.857142857142858,7,0.0,0,33,0,26,42,0,0,10,0,59,52,1
3817,55724,GPhUvJI07T5gQ3usvfVqtaObLXCifN5e,SpATywNh6bZuzm8s1ceuBUnMUAeoAHHw,13,14,9,0,2,0,8,0,33,4.714285714285714,1,0.0,0,9,0,2,14,0,0,8,0,11,22,1
3818,55731,ybcsmPlarjax7Mq4kzteIAIZbYqmFvSY,G8EPVSXsOYB5YQWZGiz1aVq5Pgr2GrQu,30,29,16,128,0,2,9,0,184,26.285714285714285,6,0.0,2,16,120,0,27,2,8,9,0,138,46,0
3819,55733,zVX5LPwTGC1SEitxSfv31cubNXKJSEc2,G8EPVSXsOYB5YQWZGiz1aVq5Pgr2GrQu,29,16,13,170,1,0,18,3,221,31.571428571428573,4,0.0,0,13,163,1,16,0,7,18,3,177,44,0
3820,55794,H7LXKFyDxiZHnveNgHWLN7esK08pjn2X,SpATywNh6bZuzm8s1ceuBUnMUAeoAHHw,10,9,4,0,2,0,5,0,20,2.857142857142857,1,0.0,0,4,0,2,9,0,0,5,0,6,14,1
3821,55804,lP9Twn179TKTpTDJYyTSHNE9ichblI6t,SpATywNh6bZuzm8s1ceuBUnMUAeoAHHw,5,3,0,0,0,1,2,1,7,1.0,1,0.0,0,0,0,0,3,1,0,2,1,0,7,1
3822,55813,gykRbA7iJUFygOkXv9mNdsHLTYvvd4jI,bWdj2GDclj5ofokWjzoa5jAwMkxCykd6,11,22,1,78,1,35,23,7,167,23.857142857142858,2,0.0,5,1,77,1,17,35,1,23,7,84,83,1
3823,55814,BomMRlBByw8amFeVspHb5AR3og0R9z55,A3fsA9Zfv1X2fVEQhTw51lKENdNrEqT3,11,6,5,0,5,0,2,0,18,2.5714285714285716,2,0.0,0,5,0,5,6,0,0,2,0,10,8,0
3824,55818,EQ7wf57Maxtqueh0jcALSwDsSR4NE6Fa,7GRhBDsirIGkRZBtSMEzNTyDr2JQm4xx,1,0,0,0,0,0,1,0,1,0.14285714285714285,1,0.0,0,0,0,0,0,0,0,1,0,0,1,1
3825,55823,EQ7wf57Maxtqueh0jcALSwDsSR4NE6Fa,SpATywNh6bZuzm8s1ceuBUnMUAeoAHHw,1,0,0,0,0,0,3,0,3,0.42857142857142855,2,0.0,0,0,0,0,0,0,0,3,0,0,3,1
3826,55828,bXhvLL1DQzEIjyGvSUCfqx2LTtxg4cK2,7GRhBDsirIGkRZBtSMEzNTyDr2JQm4xx,40,64,28,40,19,61,19,1,232,33.142857142857146,5,0.0,28,28,32,19,36,61,8,19,1,107,125,1
3827,55832,K6KJIQIABvxIIjAmEcXXN0HZbm0ejZ38,5X6FeZozNMgE2VRi3MJYjkkFK8SETtu2,1,0,0,0,0,0,1,0,1,0.14285714285714285,1,0.0,0,0,0,0,0,0,0,1,0,0,1,1
3828,55833,Oucq99GMqVclKZUxDVtfJKcfgITW3NjA,A3fsA9Zfv1X2fVEQhTw51lKENdNrEqT3,2,0,0,0,0,0,4,0,4,0.5714285714285714,1,0.0,0,0,0,0,0,0,0,4,0,0,4,1
3829,55852,zC2jRq3r9EI7fiKmdxBaoujmdY4A8FN5,G8EPVSXsOYB5YQWZGiz1aVq5Pgr2GrQu,53,57,4,97,8,24,15,3,208,29.714285714285715,6,0.0,17,4,84,8,40,24,13,15,3,113,95,0
3830,55860,PmH4XgxtQe1CNb3l16TlTY5tyEhuC40E,SpATywNh6bZuzm8s1ceuBUnMUAeoAHHw,47,99,48,59,25,23,24,1,279,39.857142857142854,7,0.0,22,48,49,25,77,23,10,24,1,144,135,0
3831,55878,eCmkxWG61kjkyysYDawv54wjgppgcySc,SpATywNh6bZuzm8s1ceuBUnMUAeoAHHw,1,0,0,0,0,0,1,0,1,0.14285714285714285,1,0.0,0,0,0,0,0,0,0,1,0,0,1,0
3832,55888,Td90IqNnmmKtRdkISxoRwDL7f9FPwSv2,SpATywNh6bZuzm8s1ceuBUnMUAeoAHHw,5,2,0,0,0,0,3,0,5,0.7142857142857143,1,0.0,0,0,0,0,2,0,0,3,0,0,5,1
3833,55895,4fvgkYf9yGvIrlkwVwtH59EjCP57A9bP,5X6FeZozNMgE2VRi3MJYjkkFK8SETtu2,4,0,0,0,0,0,3,1,4,0.5714285714285714,1,0.0,0,0,0,0,0,0,0,3,1,0,4,1
3834,55918,JOqHNkiAQMopMtNnxSpHdAOKSp68V43j,A3fsA9Zfv1X2fVEQhTw51lKENdNrEqT3,77,32,18,214,5,16,18,0,303,43.285714285714285,7,0.0,6,18,179,5,26,16,35,18,0,208,95,1
3835,55919,3gDYjjrgNInoS1KtNVg2GeRehkqftCKB,A3fsA9Zfv1X2fVEQhTw51lKENdNrEqT3,1,0,0,0,0,0,1,0,1,0.14285714285714285,1,0.0,0,0,0,0,0,0,0,1,0,0,1,1
3836,55928,ar4cwuAwjqKFHUFshoX4Vj4edt6iUva1,bWdj2GDclj5ofokWjzoa5jAwMkxCykd6,13,28,16,0,8,0,14,1,67,9.571428571428571,6,0.0,0,16,0,8,28,0,0,14,1,24,43,0
3837,55933,sNbuAEBvvCL9s1FspvGXLJVjQkFzxwpw,SpATywNh6bZuzm8s1ceuBUnMUAeoAHHw,2,0,0,0,0,0,2,0,2,0.2857142857142857,1,0.0,0,0,0,0,0,0,0,2,0,0,2,1
3838,55939,eraZwBr2l3pA9iqFftNgMFAP4UbJfK86,SpATywNh6bZuzm8s1ceuBUnMUAeoAHHw,4,2,0,0,0,0,2,0,4,0.5714285714285714,1,0.0,0,0,0,0,2,0,0,2,0,0,4,1
3839,55943,3tuGhYafSc9w18aR98dZeFrIlLzhyEje,A3fsA9Zfv1X2fVEQhTw51lKENdNrEqT3,7,3,2,0,2,0,2,0,9,1.2857142857142858,1,0.0,0,2,0,2,3,0,0,2,0,4,5,1
3840,55967,EK7Y6jLbcTIHEzN8KJHD55mY3w7SjZfJ,SpATywNh6bZuzm8s1ceuBUnMUAeoAHHw,39,96,10,32,6,55,14,0,213,30.428571428571427,3,0.0,40,10,30,6,56,55,2,14,0,86,127,1
3841,55977,PHqZ7C2u7hY0lcq8mwdcP007MajzouMM,RXDvfPUBYFlVdlueBFbLW0mhhAyGEqpt,2,0,0,0,0,0,2,0,2,0.2857142857142857,1,0.0,0,0,0,0,0,0,0,2,0,0,2,1
3842,55978,JVRk883TChkd8D0ZSH6CEb3OUHD06lXQ,SpATywNh6bZuzm8s1ceuBUnMUAeoAHHw,47,71,35,40,18,7,21,3,195,27.857142857142858,7,0.0,19,35,36,18,52,7,4,21,3,108,87,0
3843,55979,P7MRSD3CXumEAUVQkOjfu7iyOA6WzwhX,7GRhBDsirIGkRZBtSMEzNTyDr2JQm4xx,7,8,3,4,3,0,1,0,19,2.7142857142857144,1,0.0,1,3,4,3,7,0,0,1,0,11,8,0
3844,55991,7tM0glf5iOjFrrOx11jEjeXPWGg1qnPf,RXDvfPUBYFlVdlueBFbLW0mhhAyGEqpt,1,0,0,0,0,0,1,0,1,0.14285714285714285,1,0.0,0,0,0,0,0,0,0,1,0,0,1,1
3845,56003,UqClTQDqKMNYDPHUpaTnYqiluGgaVwby,7GRhBDsirIGkRZBtSMEzNTyDr2JQm4xx,27,34,17,25,9,7,6,0,98,14.0,4,0.0,13,17,20,9,21,7,5,6,0,59,39,1
3846,56004,o9m1fMq17KjyGUhfLHLXFO5hoKQ5jU6O,A3fsA9Zfv1X2fVEQhTw51lKENdNrEqT3,6,5,1,0,0,0,4,0,10,1.4285714285714286,3,0.0,0,1,0,0,5,0,0,4,0,1,9,1
3847,56013,D6ad06f016ECiyDyXUNBTRBzQthq5sAJ,SpATywNh6bZuzm8s1ceuBUnMUAeoAHHw,1,0,0,0,0,0,1,0,1,0.14285714285714285,1,0.0,0,0,0,0,0,0,0,1,0,0,1,1
3848,56015,LAEQbw9BPtGnPbKTCBR9cl7L97VwZuUc,RXDvfPUBYFlVdlueBFbLW0mhhAyGEqpt,5,2,1,0,1,0,2,0,6,0.8571428571428571,1,0.0,0,1,0,1,2,0,0,2,0,2,4,0
3849,56019,e7lf1Tkn34jQw0oCMzBHIbD6A6hPfd7D,bWdj2GDclj5ofokWjzoa5jAwMkxCykd6,4,2,1,0,1,0,2,0,6,0.8571428571428571,1,0.0,0,1,0,1,2,0,0,2,0,2,4,1
3850,56031,QOTn8ztUNlHS3hl3hqCv4ofIiB3cOmPL,SpATywNh6bZuzm8s1ceuBUnMUAeoAHHw,15,13,7,0,3,3,8,0,34,4.857142857142857,2,0.0,2,7,0,3,11,3,0,8,0,12,22,0
3851,56058,c162xBeHQ1ehzoWsokUc8kKEtu9gLIte,SpATywNh6bZuzm8s1ceuBUnMUAeoAHHw,36,48,24,24,13,1,11,1,122,17.428571428571427,3,0.0,20,24,21,13,28,1,3,11,1,78,44,0
3852,56062,pKCzqYDvJAlWQNOnHiIQZJLfMk8J7wCX,G8EPVSXsOYB5YQWZGiz1aVq5Pgr2GrQu,23,27,8,58,6,11,16,8,134,19.142857142857142,2,0.0,14,8,50,6,13,11,8,16,8,78,56,0
3853,56068,x2PUZGLlLCFDK8N0W0vdLLE67kNzX1k4,SpATywNh6bZuzm8s1ceuBUnMUAeoAHHw,6,5,2,0,1,0,3,0,11,1.5714285714285714,1,0.0,2,2,0,1,3,0,0,3,0,5,6,1
3854,56078,kKj1FlDO03hIJs4qO2fYyQxEzv7HbwXh,SpATywNh6bZuzm8s1ceuBUnMUAeoAHHw,23,50,11,10,6,0,9,0,86,12.285714285714286,6,0.0,11,11,9,6,39,0,1,9,0,37,49,1
3855,56081,Ybi3cFvDqy1VWHiDJ2n2dPI1NwP5ZaHo,7GRhBDsirIGkRZBtSMEzNTyDr2JQm4xx,1,0,0,0,0,0,1,0,1,0.14285714285714285,1,0.0,0,0,0,0,0,0,0,1,0,0,1,1
3856,56090,CXsZzvE3iylo5KzyiPoa1X1kRLwsS4Km,7GRhBDsirIGkRZBtSMEzNTyDr2JQm4xx,2,0,0,0,0,0,2,0,2,0.2857142857142857,1,0.0,0,0,0,0,0,0,0,2,0,0,2,1
3857,56094,ZjIWRRmDJF0oSBD8UTF25mPP93G9gAQR,SpATywNh6bZuzm8s1ceuBUnMUAeoAHHw,10,9,3,0,3,0,2,0,17,2.4285714285714284,1,0.0,0,3,0,3,9,0,0,2,0,6,11,1
3858,56095,CXsZzvE3iylo5KzyiPoa1X1kRLwsS4Km,bWdj2GDclj5ofokWjzoa5jAwMkxCykd6,1,0,0,0,0,0,1,0,1,0.14285714285714285,1,0.0,0,0,0,0,0,0,0,1,0,0,1,1
3859,56098,CXsZzvE3iylo5KzyiPoa1X1kRLwsS4Km,A3fsA9Zfv1X2fVEQhTw51lKENdNrEqT3,1,0,0,0,0,0,1,0,1,0.14285714285714285,1,0.0,0,0,0,0,0,0,0,1,0,0,1,1
3860,56104,WZLkW7B5dsHccBcGjqVOiLakE0tHruAV,SpATywNh6bZuzm8s1ceuBUnMUAeoAHHw,9,23,1,0,1,0,4,0,29,4.142857142857143,3,0.0,0,1,0,1,23,0,0,4,0,2,27,1
3861,56114,PmaZVK1XohXhK9MuIDoeUlsnQ3xunZ0o,SpATywNh6bZuzm8s1ceuBUnMUAeoAHHw,6,9,1,0,1,0,8,0,19,2.7142857142857144,4,0.0,0,1,0,1,9,0,0,8,0,2,17,1
3862,56137,XpVd5uEcP2Yxg4lfroDNkVY0jgpcLPLq,SpATywNh6bZuzm8s1ceuBUnMUAeoAHHw,18,14,6,10,4,0,3,0,37,5.285714285714286,1,0.0,2,6,10,4,12,0,0,3,0,22,15,0
3863,56138,0K6JPqiivQzicxY4EV4nqMLCL3a08A97,7GRhBDsirIGkRZBtSMEzNTyDr2JQm4xx,20,29,17,22,13,3,11,0,95,13.571428571428571,4,0.0,11,17,19,13,18,3,3,11,0,60,35,1
3864,56153,YgnjU1hWSGf8038ZkUT6S1YfeICauUtf,SpATywNh6bZuzm8s1ceuBUnMUAeoAHHw,39,48,24,22,15,2,3,0,114,16.285714285714285,3,0.0,14,24,21,15,34,2,1,3,0,74,40,0
3865,56154,hcrd0JfkIltpZTYyzvBezmjxNHV3TQ2P,7GRhBDsirIGkRZBtSMEzNTyDr2JQm4xx,31,53,16,51,22,16,6,0,164,23.428571428571427,2,0.0,33,16,46,22,20,16,5,6,0,117,47,1
3866,56157,TExe4YVB8RdIX9n7bjL5aFk2EIxQvn6S,SpATywNh6bZuzm8s1ceuBUnMUAeoAHHw,12,19,6,20,0,0,6,1,52,7.428571428571429,1,0.0,12,6,18,0,7,0,2,6,1,36,16,1
3867,56160,e3Xx0LWeS8euUOsFo80XF3J80EQ2D87p,SpATywNh6bZuzm8s1ceuBUnMUAeoAHHw,24,46,3,22,3,0,9,1,84,12.0,4,0.0,8,3,18,3,38,0,4,9,1,32,52,0
3868,56169,TNAUZUlDZyGbJQN7wls2QRBe2Cw7eeSK,bWdj2GDclj5ofokWjzoa5jAwMkxCykd6,20,23,1,54,0,15,9,0,102,14.571428571428571,4,0.0,15,1,48,0,8,15,6,9,0,64,38,0
3869,56189,sMMDk03UePJILkRIn5YDW5tA5us6h51J,SpATywNh6bZuzm8s1ceuBUnMUAeoAHHw,32,47,26,33,9,4,19,1,139,19.857142857142858,6,0.0,7,26,29,9,40,4,4,19,1,71,68,1
3870,56190,i4SeHiwnbIIoq9LoP3weAeDXl7e5RBtg,5X6FeZozNMgE2VRi3MJYjkkFK8SETtu2,16,17,4,10,4,1,12,0,48,6.857142857142857,3,0.0,11,4,10,4,6,1,0,12,0,29,19,1
3871,56204,xbYSqp0T7Uu69VoCNyfTCvQcS3HV3UeU,5X6FeZozNMgE2VRi3MJYjkkFK8SETtu2,8,7,3,0,1,2,11,1,25,3.5714285714285716,3,0.0,0,3,0,1,7,2,0,11,1,4,21,1
3872,56216,UGrzFFoMUY8lyETY7WUVQiSf705Madpt,SpATywNh6bZuzm8s1ceuBUnMUAeoAHHw,28,32,23,8,19,0,6,0,88,12.571428571428571,4,0.0,2,23,8,19,30,0,0,6,0,52,36,0
3873,56221,mxDmiNiZbTWbG5eX6cuqeU6lZnYbJUhB,SpATywNh6bZuzm8s1ceuBUnMUAeoAHHw,15,47,14,0,2,6,33,2,104,14.857142857142858,7,0.0,13,14,0,2,34,6,0,33,2,29,75,0
3874,56234,qYhoMsNGFfjRIDh2DmSOTAEOExxbLNsi,7GRhBDsirIGkRZBtSMEzNTyDr2JQm4xx,8,8,4,0,1,1,5,0,19,2.7142857142857144,1,0.0,1,4,0,1,7,1,0,5,0,6,13,1
3875,56237,PlHOy9sO4wpd56kVnMDoRd2P9dW85wrW,A3fsA9Zfv1X2fVEQhTw51lKENdNrEqT3,11,10,4,0,3,0,13,0,30,4.285714285714286,2,0.0,0,4,0,3,10,0,0,13,0,7,23,1
3876,56242,aJc8aUAetxPPGWFRPX4YOEm2nyZUaAWd,7GRhBDsirIGkRZBtSMEzNTyDr2JQm4xx,8,12,6,4,5,0,4,0,31,4.428571428571429,1,0.0,2,6,3,5,10,0,1,4,0,16,15,1
3877,56249,I7F56XqyQ8b5GpiGlOus1XQv70VVeUq9,bWdj2GDclj5ofokWjzoa5jAwMkxCykd6,1,0,0,0,0,0,1,0,1,0.14285714285714285,1,0.0,0,0,0,0,0,0,0,1,0,0,1,1
3878,56250,bTuE0djIq5F990AHAk85k9A06v19Matb,5X6FeZozNMgE2VRi3MJYjkkFK8SETtu2,4,2,0,0,0,0,2,0,4,0.5714285714285714,2,0.0,0,0,0,0,2,0,0,2,0,0,4,1
3879,56260,GLN4A8S1FfCje62RkokqBLEULjMYf2Jo,SpATywNh6bZuzm8s1ceuBUnMUAeoAHHw,19,17,2,8,2,0,13,1,43,6.142857142857143,4,0.0,0,2,6,2,17,0,2,13,1,10,33,0
3880,56273,ZHGiV2heRgfndFJprqNP0m9NCX5puCJj,G8EPVSXsOYB5YQWZGiz1aVq5Pgr2GrQu,14,10,8,0,7,0,2,1,28,4.0,1,0.0,0,8,0,7,10,0,0,2,1,15,13,1
3881,56274,aJc8aUAetxPPGWFRPX4YOEm2nyZUaAWd,A3fsA9Zfv1X2fVEQhTw51lKENdNrEqT3,11,10,8,0,7,0,3,0,28,4.0,1,0.0,0,8,0,7,10,0,0,3,0,15,13,1
3882,56283,eCJEYxlte8R6sbqh66Nohv34rvkne1DG,SpATywNh6bZuzm8s1ceuBUnMUAeoAHHw,45,47,24,19,14,10,9,0,123,17.571428571428573,3,0.0,17,24,19,14,30,10,0,9,0,74,49,1
3883,56328,lyFNL8kV6VicGW73AnKGdsGcS116jdQS,bWdj2GDclj5ofokWjzoa5jAwMkxCykd6,1,0,0,0,0,0,1,0,1,0.14285714285714285,1,0.0,0,0,0,0,0,0,0,1,0,0,1,1
3884,56334,6A5mn3Pn8IBDZpMvNejUh5y2X9g7rQUJ,SpATywNh6bZuzm8s1ceuBUnMUAeoAHHw,31,43,3,61,1,0,13,0,121,17.285714285714285,4,0.0,10,3,57,1,33,0,4,13,0,71,50,0
3885,56349,iHZWk8DNCHWjtlySjApOGtqjEWRSrx2m,RXDvfPUBYFlVdlueBFbLW0mhhAyGEqpt,7,5,0,0,0,0,5,0,10,1.4285714285714286,1,0.0,0,0,0,0,5,0,0,5,0,0,10,1
3886,56351,9EUUO7h64xEMsIYSdMrVOb4PBS93f8Du,SpATywNh6bZuzm8s1ceuBUnMUAeoAHHw,10,7,4,0,3,0,3,0,17,2.4285714285714284,2,0.0,0,4,0,3,7,0,0,3,0,7,10,1
3887,56356,3R3Nczg72kfMEiApN4orlcWVqV3FRVsF,bWdj2GDclj5ofokWjzoa5jAwMkxCykd6,1,0,0,0,0,0,1,0,1,0.14285714285714285,1,0.0,0,0,0,0,0,0,0,1,0,0,1,1
3888,56363,JLoCQORXjvwdLxTSzHD1j5idBdhZN6jK,7GRhBDsirIGkRZBtSMEzNTyDr2JQm4xx,5,0,0,0,0,2,7,0,9,1.2857142857142858,1,0.0,0,0,0,0,0,2,0,7,0,0,9,1
3889,56380,4GCUZawdASarA3TMg6HAfW2kyE7xYxA6,7GRhBDsirIGkRZBtSMEzNTyDr2JQm4xx,2,0,0,0,0,0,2,0,2,0.2857142857142857,1,0.0,0,0,0,0,0,0,0,2,0,0,2,1
3890,56397,1KCmpfcoDnRnd9ITYAgYi4eQPwc5jiJz,SpATywNh6bZuzm8s1ceuBUnMUAeoAHHw,16,24,1,6,0,0,8,0,39,5.571428571428571,6,0.0,2,1,6,0,22,0,0,8,0,9,30,1
3891,56410,m7ppZFqoqxq4drq32V7wzPII9oNFXP01,SpATywNh6bZuzm8s1ceuBUnMUAeoAHHw,44,70,43,27,18,6,15,0,179,25.571428571428573,6,0.0,14,43,25,18,56,6,2,15,0,100,79,0
3892,56417,cUqw8BeU1kIPdLrPk0kldw6H3haT1GKW,A3fsA9Zfv1X2fVEQhTw51lKENdNrEqT3,7,11,2,0,2,0,1,0,16,2.2857142857142856,1,0.0,0,2,0,2,11,0,0,1,0,4,12,1
3893,56428,x6upZ5zLvcOLWKUXPUe1AXIpYEyiR7aS,SpATywNh6bZuzm8s1ceuBUnMUAeoAHHw,1,0,0,0,0,0,1,0,1,0.14285714285714285,1,0.0,0,0,0,0,0,0,0,1,0,0,1,1
3894,56436,2B1Sa19tBbYgocD2xlB5fX7K09dmclmZ,SpATywNh6bZuzm8s1ceuBUnMUAeoAHHw,30,57,13,35,6,2,15,2,130,18.571428571428573,7,0.0,5,13,31,6,52,2,4,15,2,55,75,1
3895,56455,RcsMEES0IQ1NHP2Ss1VxXk92ez6mhLug,SpATywNh6bZuzm8s1ceuBUnMUAeoAHHw,8,8,5,6,0,0,3,0,22,3.142857142857143,2,0.0,0,5,5,0,8,0,1,3,0,10,12,0
3896,56464,mUGiOApqSIPNJJAxx9ku1Ubhn4j7vYNp,SpATywNh6bZuzm8s1ceuBUnMUAeoAHHw,40,76,14,29,8,32,15,0,174,24.857142857142858,5,0.0,22,14,28,8,54,32,1,15,0,72,102,0
3897,56482,OlI6IKs7zmyB25QZ2wZTzJXcjSSlBlit,RXDvfPUBYFlVdlueBFbLW0mhhAyGEqpt,7,2,0,0,0,1,7,1,11,1.5714285714285714,1,0.0,0,0,0,0,2,1,0,7,1,0,11,1
3898,56502,YAaB5kbzMpno3yyQhEjSC43PC6r4FUut,A3fsA9Zfv1X2fVEQhTw51lKENdNrEqT3,2,0,0,0,0,0,2,0,2,0.2857142857142857,2,0.0,0,0,0,0,0,0,0,2,0,0,2,1
3899,56505,K9sZStDxVlzslbizXAYcyYp63PWAyvJs,bWdj2GDclj5ofokWjzoa5jAwMkxCykd6,10,25,11,26,9,27,10,0,108,15.428571428571429,3,0.0,7,11,23,9,18,27,3,10,0,50,58,1
3900,56507,yh14zaFitCUTgvBPqRXiaZ6cUijtktL4,7GRhBDsirIGkRZBtSMEzNTyDr2JQm4xx,5,7,0,2,0,0,1,0,10,1.4285714285714286,1,0.0,1,0,2,0,6,0,0,1,0,3,7,1
3901,56511,KI8HKTaed6ftbRs8hxS2QLp9yDQHigXN,bWdj2GDclj5ofokWjzoa5jAwMkxCykd6,6,3,1,0,1,10,7,0,22,3.142857142857143,3,0.0,0,1,0,1,3,10,0,7,0,2,20,0
3902,56516,yreSFZev8w2vccLGmUPWniYPFTHUVYuW,SpATywNh6bZuzm8s1ceuBUnMUAeoAHHw,26,31,5,41,4,10,8,1,100,14.285714285714286,2,0.0,19,5,37,4,12,10,4,8,1,65,35,1
3903,56517,Rz28tFT5qYZaEQ78Ly3OdJx8TpvsmLBy,A3fsA9Zfv1X2fVEQhTw51lKENdNrEqT3,10,15,6,0,1,0,28,0,50,7.142857142857143,5,0.0,0,6,0,1,15,0,0,28,0,7,43,0
3904,56533,1quHb10fObuEEg4CZXYAqSIkbHHSbI1d,5X6FeZozNMgE2VRi3MJYjkkFK8SETtu2,13,25,1,2,4,1,9,0,42,6.0,5,0.0,10,1,2,4,15,1,0,9,0,17,25,1
3905,56539,BRyXI2jlP9arzZoLjKD1qwawYxBWQDfb,A3fsA9Zfv1X2fVEQhTw51lKENdNrEqT3,6,4,2,0,2,0,2,0,10,1.4285714285714286,1,0.0,0,2,0,2,4,0,0,2,0,4,6,1
3906,56551,SRtsJqUL9xISAo9TMC6eKPCvdTaj4XO3,SpATywNh6bZuzm8s1ceuBUnMUAeoAHHw,10,9,4,8,0,0,3,0,24,3.4285714285714284,2,0.0,0,4,8,0,9,0,0,3,0,12,12,0
3907,56552,C5GTwEweg1bPhFzl7GnQQbIddyn0y9WS,RXDvfPUBYFlVdlueBFbLW0mhhAyGEqpt,5,23,14,0,9,0,0,0,46,6.571428571428571,1,0.0,2,14,0,9,21,0,0,0,0,25,21,1
3908,56557,HFlkUxGHWB77t9TiRXSaNCP8d3isxGAz,SpATywNh6bZuzm8s1ceuBUnMUAeoAHHw,1,0,0,0,0,0,1,0,1,0.14285714285714285,1,0.0,0,0,0,0,0,0,0,1,0,0,1,1
3909,56562,dtFae9PjMozKIdBzv7AdkzVzJFKFs05y,RXDvfPUBYFlVdlueBFbLW0mhhAyGEqpt,12,21,7,0,5,0,2,0,35,5.0,1,0.0,6,7,0,5,15,0,0,2,0,18,17,1
3910,56564,WFaX2lVFQ02ZdYk8UYpSsb64zjahxJD4,SpATywNh6bZuzm8s1ceuBUnMUAeoAHHw,5,3,0,0,0,0,3,0,6,0.8571428571428571,1,0.0,0,0,0,0,3,0,0,3,0,0,6,1
3911,56566,6qgQAmX6y5wh5nEPRINOiKrZNoTl5yfT,G8EPVSXsOYB5YQWZGiz1aVq5Pgr2GrQu,182,264,114,244,83,48,28,3,784,112.0,13,0.0,121,114,167,83,143,48,77,28,3,485,299,0
3912,56569,2HbabEHSEnqM0bBaiJs30PG9549v5yOk,5X6FeZozNMgE2VRi3MJYjkkFK8SETtu2,1,0,0,0,0,0,1,0,1,0.14285714285714285,1,0.0,0,0,0,0,0,0,0,1,0,0,1,1
3913,56570,LSVa2jpU1dF8RnC5rzovm0tv2cSNIe8I,SpATywNh6bZuzm8s1ceuBUnMUAeoAHHw,31,97,48,0,33,0,18,0,196,28.0,5,0.0,0,48,0,33,97,0,0,18,0,81,115,1
3914,56579,XkKS323fFxBVezQ5JyIgzxHDxEKEwwEf,SpATywNh6bZuzm8s1ceuBUnMUAeoAHHw,9,8,3,2,2,0,4,2,21,3.0,1,0.0,2,3,2,2,6,0,0,4,2,9,12,1
3915,56585,1ek5QqaGzN6P33dWOwYmxFbMxKwWe19o,SpATywNh6bZuzm8s1ceuBUnMUAeoAHHw,1,0,0,0,0,0,1,0,1,0.14285714285714285,1,0.0,0,0,0,0,0,0,0,1,0,0,1,1
3916,56593,5Gu4g9dtF1zjfzBwHRDyoDsx2MPMINMH,A3fsA9Zfv1X2fVEQhTw51lKENdNrEqT3,82,14,6,258,2,0,1,0,281,40.142857142857146,1,0.0,6,6,253,2,8,0,5,1,0,267,14,0
3917,56603,LmbFtDSfLFeyNU7nFqQJsMI7iXLM51md,SpATywNh6bZuzm8s1ceuBUnMUAeoAHHw,1,0,0,0,0,0,1,0,1,0.14285714285714285,1,0.0,0,0,0,0,0,0,0,1,0,0,1,0
3918,56617,hhlID9e9RXNsuOHzHvfjbzrkpQmbpeir,SpATywNh6bZuzm8s1ceuBUnMUAeoAHHw,29,40,27,20,10,9,13,1,120,17.142857142857142,10,0.0,6,27,18,10,34,9,2,13,1,61,59,1
3919,56624,7g1Vw1VTMIZv2SNnFwKfmXrRUvuPdRJF,SpATywNh6bZuzm8s1ceuBUnMUAeoAHHw,4,10,0,0,0,0,1,0,11,1.5714285714285714,3,0.0,0,0,0,0,10,0,0,1,0,0,11,1
3920,56628,nx5QFDeL3HGj8P6Q50AF1WAJHhbCqdYM,7GRhBDsirIGkRZBtSMEzNTyDr2JQm4xx,1,0,0,0,0,0,1,0,1,0.14285714285714285,1,0.0,0,0,0,0,0,0,0,1,0,0,1,1
3921,56630,v05YX233WSCgECpF2N4rdvc18pCg2iqt,SpATywNh6bZuzm8s1ceuBUnMUAeoAHHw,14,9,5,16,3,0,3,0,36,5.142857142857143,2,0.0,3,5,14,3,6,0,2,3,0,25,11,0
3922,56636,PdrdE0IIRUHKPZyUMDrlUIJ0Ny8UuZco,A3fsA9Zfv1X2fVEQhTw51lKENdNrEqT3,44,37,20,76,8,1,22,1,165,23.571428571428573,5,0.0,4,20,71,8,33,1,5,22,1,103,62,1
3923,56642,7ttzq6sOsWQ5eEpZriKP7OLuIb0DcSbF,SpATywNh6bZuzm8s1ceuBUnMUAeoAHHw,46,49,26,53,13,5,9,1,156,22.285714285714285,4,0.0,18,26,44,13,31,5,9,9,1,101,55,0
3924,56652,uHeTIz8GkglZUts3zio1tGR2aBoYwiQE,bWdj2GDclj5ofokWjzoa5jAwMkxCykd6,44,71,39,145,18,53,11,1,338,48.285714285714285,5,0.0,15,39,137,18,56,53,8,11,1,209,129,1
3925,56653,A0M3i5nfjroJ4PM9wmVXYOoLY3tY0fag,SpATywNh6bZuzm8s1ceuBUnMUAeoAHHw,14,58,3,19,1,1,1,0,83,11.857142857142858,6,0.0,17,3,17,1,41,1,2,1,0,38,45,0
3926,56657,QjRqlcg02MPH1ssCHCoMGSYCtFlPbtU9,A3fsA9Zfv1X2fVEQhTw51lKENdNrEqT3,5,4,2,0,1,0,5,0,12,1.7142857142857142,4,0.0,0,2,0,1,4,0,0,5,0,3,9,1
3927,56678,GHx2mQF50a1TJotiqGtGfhTS2ssF34QK,A3fsA9Zfv1X2fVEQhTw51lKENdNrEqT3,5,2,1,0,1,0,2,0,6,0.8571428571428571,1,0.0,0,1,0,1,2,0,0,2,0,2,4,1
3928,56721,SK7IxqKpOFb3vAlYnYjFjD4PVuXVBlrm,SpATywNh6bZuzm8s1ceuBUnMUAeoAHHw,38,116,9,54,5,19,24,2,229,32.714285714285715,5,0.0,27,9,46,5,89,19,8,24,2,87,142,0
3929,56732,csg0yBjjrshmLGGyq6UVgiiqMZP9T0vI,bWdj2GDclj5ofokWjzoa5jAwMkxCykd6,9,7,5,0,4,0,7,1,24,3.4285714285714284,3,0.0,0,5,0,4,7,0,0,7,1,9,15,1
3930,56733,i9CWvduTcskommMHOeHEvsItP05JGHxW,SpATywNh6bZuzm8s1ceuBUnMUAeoAHHw,44,63,24,33,13,0,5,0,138,19.714285714285715,5,0.0,14,24,28,13,49,0,5,5,0,79,59,0
3931,56741,GXi0JiFESUZlctzkqcyy8vfaIeTzKOhp,SpATywNh6bZuzm8s1ceuBUnMUAeoAHHw,31,29,18,0,13,0,7,0,67,9.571428571428571,4,0.0,6,18,0,13,23,0,0,7,0,37,30,1
3932,56758,3X0JLX6UvJnnRb5GkwbFJgAokE5g69D0,A3fsA9Zfv1X2fVEQhTw51lKENdNrEqT3,49,38,20,162,2,0,6,0,228,32.57142857142857,3,0.0,5,20,145,2,33,0,17,6,0,172,56,1
3933,56782,Kh53GURdm4wzt7JTpZoCCzo0wL64E4IV,SpATywNh6bZuzm8s1ceuBUnMUAeoAHHw,1,0,0,0,0,0,1,0,1,0.14285714285714285,1,0.0,0,0,0,0,0,0,0,1,0,0,1,1
3934,56787,73lhhrOcE2srJj5BkIzSweWSnQRZBT2o,bWdj2GDclj5ofokWjzoa5jAwMkxCykd6,59,127,79,198,0,0,21,0,425,60.714285714285715,11,0.0,25,79,165,0,102,0,33,21,0,269,156,1
3935,56824,1NMKAl678ZBpdBkhXfYTAgEyYygMZz0x,SpATywNh6bZuzm8s1ceuBUnMUAeoAHHw,23,45,4,0,4,1,8,0,62,8.857142857142858,4,0.0,6,4,0,4,39,1,0,8,0,14,48,1
3936,56826,ilWzYGLWBh9DSc1MV8g2C4Go5wDNgUHX,A3fsA9Zfv1X2fVEQhTw51lKENdNrEqT3,140,76,58,294,40,62,28,1,559,79.85714285714286,6,0.0,10,58,237,40,66,62,57,28,1,345,214,0
3937,56865,y64BqR5f4fJBfwxF4aLt14ViHkvnjGLs,5X6FeZozNMgE2VRi3MJYjkkFK8SETtu2,23,23,11,42,2,0,5,0,83,11.857142857142858,2,0.0,5,11,36,2,18,0,6,5,0,54,29,1
3938,56867,qDignCY8ZSbFAHDmfGr6um90qnmxvInL,bWdj2GDclj5ofokWjzoa5jAwMkxCykd6,39,56,31,74,14,22,16,2,215,30.714285714285715,4,0.0,10,31,60,14,46,22,14,16,2,115,100,1
3939,56869,F1uYmg9j3YwgNnk0aXzCliVPelaqL3Ra,G8EPVSXsOYB5YQWZGiz1aVq5Pgr2GrQu,2,0,0,0,0,0,2,0,2,0.2857142857142857,1,0.0,0,0,0,0,0,0,0,2,0,0,2,1
3940,56879,7bo2b6hOKJdeJMUZPegC3OXRiqnOBuKu,SpATywNh6bZuzm8s1ceuBUnMUAeoAHHw,1,0,0,0,0,0,2,0,2,0.2857142857142857,1,0.0,0,0,0,0,0,0,0,2,0,0,2,1
3941,56886,PJRBo6fo8GkTYEZAj3yApWIU4z2xQiJ3,SpATywNh6bZuzm8s1ceuBUnMUAeoAHHw,12,26,9,0,9,0,3,0,47,6.714285714285714,1,0.0,0,9,0,9,26,0,0,3,0,18,29,1
3942,56891,afVQ7OP9Yg7nQrenfRDF9heWvtL5syxt,SpATywNh6bZuzm8s1ceuBUnMUAeoAHHw,1,0,0,0,0,0,2,0,2,0.2857142857142857,1,0.0,0,0,0,0,0,0,0,2,0,0,2,1
3943,56898,i0LHbVo0MUWeo1slrPpQRlCoWzknlhLR,5X6FeZozNMgE2VRi3MJYjkkFK8SETtu2,1,0,0,0,0,0,1,0,1,0.14285714285714285,1,0.0,0,0,0,0,0,0,0,1,0,0,1,1
3944,56952,H7pGBNaBrGHYeUmvNiEOm731zZ0Xqtux,RXDvfPUBYFlVdlueBFbLW0mhhAyGEqpt,14,20,6,0,6,2,8,1,43,6.142857142857143,2,0.0,2,6,0,6,18,2,0,8,1,14,29,1
3945,56959,qZhmmNUvkNXdf3u04DTUQOFEBxxO10p4,A3fsA9Zfv1X2fVEQhTw51lKENdNrEqT3,12,9,5,0,3,0,7,0,24,3.4285714285714284,5,0.0,0,5,0,3,9,0,0,7,0,8,16,1
3946,56993,CMLvVcsPjeGzJkj3tZzcZ06brb5LMupf,5X6FeZozNMgE2VRi3MJYjkkFK8SETtu2,1,0,0,0,0,0,1,0,1,0.14285714285714285,1,0.0,0,0,0,0,0,0,0,1,0,0,1,1
3947,56994,7W8jjJVFEvdsz605K0BoRU3E0G6E9Kji,G8EPVSXsOYB5YQWZGiz1aVq5Pgr2GrQu,1,0,0,0,0,0,1,0,1,0.14285714285714285,1,0.0,0,0,0,0,0,0,0,1,0,0,1,1
3948,56999,vbTgITzq6jZRj0oUV5gFotgOlwSXnjML,G8EPVSXsOYB5YQWZGiz1aVq5Pgr2GrQu,144,179,67,465,20,12,27,0,770,110.0,7,0.0,68,67,378,20,111,12,87,27,0,533,237,0
3949,57006,dJ2h8ddhmpweKKIE5BpE7xXimjPVsm52,G8EPVSXsOYB5YQWZGiz1aVq5Pgr2GrQu,1,0,0,0,0,0,1,0,1,0.14285714285714285,1,0.0,0,0,0,0,0,0,0,1,0,0,1,0
3950,57008,ZtLnEkCqeRnvyqFQdbYPmQSGK8YkXNE8,SpATywNh6bZuzm8s1ceuBUnMUAeoAHHw,17,18,2,15,2,0,8,2,47,6.714285714285714,3,0.0,4,2,15,2,14,0,0,8,2,23,24,0
3951,57029,I7IIrHAh1LzzCf8lcvI92o8deFulzAh8,SpATywNh6bZuzm8s1ceuBUnMUAeoAHHw,2,0,0,0,0,0,3,0,3,0.42857142857142855,2,0.0,0,0,0,0,0,0,0,3,0,0,3,1
3952,57044,I7IIrHAh1LzzCf8lcvI92o8deFulzAh8,bWdj2GDclj5ofokWjzoa5jAwMkxCykd6,1,0,0,0,0,0,4,0,4,0.5714285714285714,3,0.0,0,0,0,0,0,0,0,4,0,0,4,1
3953,57046,AKrswbnpGlIzlwfZKfo5lwKhJzNpXmb1,SpATywNh6bZuzm8s1ceuBUnMUAeoAHHw,13,35,1,17,0,0,3,0,56,8.0,1,0.0,18,1,15,0,17,0,2,3,0,34,22,0
3954,57056,uMWcv4ZmW7X4PBv6egGkJZliUjuRluME,RXDvfPUBYFlVdlueBFbLW0mhhAyGEqpt,1,0,0,0,0,0,1,0,1,0.14285714285714285,1,0.0,0,0,0,0,0,0,0,1,0,0,1,1
3955,57059,cYibpCaMUGq0WjgUWfTv0iIvJ7QbFj5E,A3fsA9Zfv1X2fVEQhTw51lKENdNrEqT3,18,8,8,0,8,0,14,0,38,5.428571428571429,4,0.0,0,8,0,8,8,0,0,14,0,16,22,1
3956,57064,vAq6n4okEOzm4Q7527tzA1bof68awv28,G8EPVSXsOYB5YQWZGiz1aVq5Pgr2GrQu,11,10,1,0,1,0,6,0,18,2.5714285714285716,2,0.0,0,1,0,1,10,0,0,6,0,2,16,1
3957,57065,nxmaEvO6WAl9UO0RB8OmpscRPO1Nbssm,A3fsA9Zfv1X2fVEQhTw51lKENdNrEqT3,6,4,1,0,1,0,1,0,7,1.0,1,0.0,0,1,0,1,4,0,0,1,0,2,5,1
3958,57070,uMWcv4ZmW7X4PBv6egGkJZliUjuRluME,G8EPVSXsOYB5YQWZGiz1aVq5Pgr2GrQu,5,5,0,0,0,0,2,0,7,1.0,1,0.0,0,0,0,0,5,0,0,2,0,0,7,1
3959,57196,9hgjLw4OD5u1XjZx0s9EMRnEguVXBlYy,A3fsA9Zfv1X2fVEQhTw51lKENdNrEqT3,23,17,12,0,10,0,3,0,42,6.0,2,0.0,0,12,0,10,17,0,0,3,0,22,20,1
3960,57250,3Jq0rhguTOZ7fja70sOOKUPAPqu7fQyT,SpATywNh6bZuzm8s1ceuBUnMUAeoAHHw,29,54,33,19,16,51,20,0,193,27.571428571428573,7,0.0,11,33,17,16,43,51,2,20,0,77,116,0
3961,57265,NFGYUC7dcOkWJh2BiZLJheVSucAvXvpt,bWdj2GDclj5ofokWjzoa5jAwMkxCykd6,19,28,3,47,1,20,15,2,116,16.571428571428573,8,0.0,1,3,43,1,27,20,4,15,2,48,68,0
3962,57277,bt7h6JIDcUKzJSKeXMoVM1LEqwbXUCBJ,SpATywNh6bZuzm8s1ceuBUnMUAeoAHHw,21,80,4,32,0,1,23,0,140,20.0,6,0.0,13,4,27,0,67,1,5,23,0,44,96,0
3963,57321,mSToVMacc08MhsUyEFn562K69bpANB3P,A3fsA9Zfv1X2fVEQhTw51lKENdNrEqT3,76,25,21,74,18,0,3,0,141,20.142857142857142,1,0.0,3,21,74,18,22,0,0,3,0,116,25,1
3964,57323,xayicpjClPkwcfGTr3r84hb5pfZk0nB8,RXDvfPUBYFlVdlueBFbLW0mhhAyGEqpt,39,37,27,8,21,10,12,4,119,17.0,3,0.0,4,27,8,21,33,10,0,12,4,60,59,1
3965,57327,RdOaDfHEeBBslFA96Ipf8QaGmA7wq7Rz,SpATywNh6bZuzm8s1ceuBUnMUAeoAHHw,27,61,20,28,5,1,22,0,137,19.571428571428573,8,0.0,13,20,22,5,48,1,6,22,0,60,77,0
3966,57329,XyoP35cBUiKk44G72mbtEXCBjk8FmHfo,bWdj2GDclj5ofokWjzoa5jAwMkxCykd6,38,71,41,51,16,1,32,0,212,30.285714285714285,6,0.0,12,41,41,16,59,1,10,32,0,110,102,1
3967,57345,SmBAgHRNeYWZKP2SpqpKXwVR3YhUZnjq,SpATywNh6bZuzm8s1ceuBUnMUAeoAHHw,43,60,0,64,0,23,22,0,169,24.142857142857142,6,0.0,22,0,55,0,38,23,9,22,0,77,92,0
3968,57353,3SNPt0tgFaFs22ZCc56rWyLmizBS9I72,SpATywNh6bZuzm8s1ceuBUnMUAeoAHHw,1,0,0,0,0,0,1,0,1,0.14285714285714285,1,0.0,0,0,0,0,0,0,0,1,0,0,1,1
3969,57423,MJQDYgQSk0Dles3B2EOjCe8Rc6SLp0Te,SpATywNh6bZuzm8s1ceuBUnMUAeoAHHw,1,0,0,0,0,0,1,0,1,0.14285714285714285,1,0.0,0,0,0,0,0,0,0,1,0,0,1,1
3970,57424,ITiFsDuHkhq2oCixW0Woe4mx6l3FjxPc,SpATywNh6bZuzm8s1ceuBUnMUAeoAHHw,7,5,2,0,2,0,2,0,11,1.5714285714285714,1,0.0,0,2,0,2,5,0,0,2,0,4,7,1
3971,57453,1ITGuQ2R8DpLVa12S7xW3GeCStKCoFln,SpATywNh6bZuzm8s1ceuBUnMUAeoAHHw,6,5,1,12,0,0,4,0,22,3.142857142857143,1,0.0,1,1,10,0,4,0,2,4,0,12,10,1
3972,57522,FCOtK161WkcVOQohkw4NuKVb2dJLDsJS,A3fsA9Zfv1X2fVEQhTw51lKENdNrEqT3,1,0,0,0,0,0,1,0,1,0.14285714285714285,1,0.0,0,0,0,0,0,0,0,1,0,0,1,1
3973,57525,OLSxCkluLildKVrVnzRIsj47tt9tVHj9,bWdj2GDclj5ofokWjzoa5jAwMkxCykd6,5,2,1,0,1,0,5,0,9,1.2857142857142858,2,0.0,0,1,0,1,2,0,0,5,0,2,7,1
3974,57544,rwwtkpIIPQWlSN0q7WUWaQBBUS2Mm6IT,SpATywNh6bZuzm8s1ceuBUnMUAeoAHHw,1,0,0,0,0,0,1,0,1,0.14285714285714285,1,0.0,0,0,0,0,0,0,0,1,0,0,1,1
3975,57550,mN3Kbbx6eP7NH0lwyK6LVlERNttoP58u,SpATywNh6bZuzm8s1ceuBUnMUAeoAHHw,2,0,0,0,0,0,3,0,3,0.42857142857142855,1,0.0,0,0,0,0,0,0,0,3,0,0,3,1
3976,57552,JjC5gQBcEdEGxqUfdmNRpoNHaHUkhFr3,SpATywNh6bZuzm8s1ceuBUnMUAeoAHHw,18,15,5,11,3,0,5,1,40,5.714285714285714,1,0.0,4,5,10,3,11,0,1,5,1,22,18,1
3977,57576,uA7r7QkkxMOoLmO6n5eQTQ4mcfRiz1sY,SpATywNh6bZuzm8s1ceuBUnMUAeoAHHw,7,1,1,0,1,0,5,0,8,1.1428571428571428,1,0.0,0,1,0,1,1,0,0,5,0,2,6,1
3978,57639,D5gDQ8hFb4klemeBiodWmMPe9KIvqw9O,5X6FeZozNMgE2VRi3MJYjkkFK8SETtu2,6,4,1,0,1,0,1,0,7,1.0,1,0.0,0,1,0,1,4,0,0,1,0,2,5,1
3979,57641,C2kNfLlJQRAYF9jyyvOY33F0K0B7w85s,bWdj2GDclj5ofokWjzoa5jAwMkxCykd6,6,4,2,0,2,0,1,0,9,1.2857142857142858,1,0.0,0,2,0,2,4,0,0,1,0,4,5,1
3980,57657,r4CghvxKbP3R549p5B3LTdvr7lbYRqXF,G8EPVSXsOYB5YQWZGiz1aVq5Pgr2GrQu,60,86,39,104,21,25,17,2,294,42.0,3,0.0,37,39,69,21,49,25,35,17,2,166,128,0
3981,57679,f3dcnqPelEIMHduho80ktIjNJSihd3u6,SpATywNh6bZuzm8s1ceuBUnMUAeoAHHw,8,6,3,0,1,0,8,1,19,2.7142857142857144,2,0.0,0,3,0,1,6,0,0,8,1,4,15,1
3982,57684,uq4F79CzLXcUWikv4BbYmEqP6niBgdHB,SpATywNh6bZuzm8s1ceuBUnMUAeoAHHw,6,3,2,0,2,0,1,0,8,1.1428571428571428,1,0.0,0,2,0,2,3,0,0,1,0,4,4,1
3983,57687,pRBbSmiVEBaGz4jkeqwSc7HR4j4zPAwQ,RXDvfPUBYFlVdlueBFbLW0mhhAyGEqpt,5,0,0,0,0,1,4,1,6,0.8571428571428571,1,0.0,0,0,0,0,0,1,0,4,1,0,6,1
3984,57710,pp3MkpuoWvkyzXCuYr4td0R2Hp9mxMXr,RXDvfPUBYFlVdlueBFbLW0mhhAyGEqpt,11,13,7,0,2,1,7,0,30,4.285714285714286,2,0.0,0,7,0,2,13,1,0,7,0,9,21,1
3985,57716,oDMwcP97XCFhatRKDALyEk29j0A66Zee,SpATywNh6bZuzm8s1ceuBUnMUAeoAHHw,7,3,2,0,2,0,7,0,14,2.0,3,0.0,0,2,0,2,3,0,0,7,0,4,10,1
3986,57761,tS5yd0InBPlA0CVUCBIjrGWKHeeeibf9,A3fsA9Zfv1X2fVEQhTw51lKENdNrEqT3,33,39,20,48,4,6,16,0,133,19.0,5,0.0,6,20,45,4,33,6,3,16,0,75,58,0
3987,57789,xayicpjClPkwcfGTr3r84hb5pfZk0nB8,5X6FeZozNMgE2VRi3MJYjkkFK8SETtu2,10,14,6,0,10,0,2,0,32,4.571428571428571,2,0.0,6,6,0,10,8,0,0,2,0,22,10,1
3988,57796,oieeinmRIRZuvg1KZp8yYpFAojV2pQvR,SpATywNh6bZuzm8s1ceuBUnMUAeoAHHw,9,8,5,0,3,1,7,0,24,3.4285714285714284,2,0.0,0,5,0,3,8,1,0,7,0,8,16,1
3989,57817,bZSiNUbAIuydDBd77IMAJ15Hy6k2A1kT,5X6FeZozNMgE2VRi3MJYjkkFK8SETtu2,5,2,1,0,1,0,2,0,6,0.8571428571428571,2,0.0,0,1,0,1,2,0,0,2,0,2,4,1
3990,57841,7J9JIWVCQG1g6yXh3uTVbrSu3pa18Ezn,bWdj2GDclj5ofokWjzoa5jAwMkxCykd6,10,14,6,6,3,1,3,0,33,4.714285714285714,2,0.0,4,6,6,3,10,1,0,3,0,19,14,1
3991,57843,23LSJ7PS8hJRx4MiulnRK0RfIKtQHqFP,SpATywNh6bZuzm8s1ceuBUnMUAeoAHHw,1,0,0,0,0,0,1,0,1,0.14285714285714285,1,0.0,0,0,0,0,0,0,0,1,0,0,1,1
3992,57857,4dPv5sV5dbfclN0Y8IwI4Ic117ct14yS,SpATywNh6bZuzm8s1ceuBUnMUAeoAHHw,5,3,0,0,0,0,3,0,6,0.8571428571428571,2,0.0,0,0,0,0,3,0,0,3,0,0,6,1
3993,57876,ftjlnmyEYFbgOc72QgwdUJYu6fgVXYpz,A3fsA9Zfv1X2fVEQhTw51lKENdNrEqT3,7,3,2,0,2,0,3,0,10,1.4285714285714286,1,0.0,0,2,0,2,3,0,0,3,0,4,6,1
3994,57907,4lfVtIfwsnJZLFeonBqOpKEgIshst3Yq,SpATywNh6bZuzm8s1ceuBUnMUAeoAHHw,10,27,14,5,9,0,12,0,67,9.571428571428571,3,0.0,6,14,4,9,21,0,1,12,0,33,34,0
3995,57910,se9ZVl8DNkiCW8i2nP0p3krrUcQqYC47,A3fsA9Zfv1X2fVEQhTw51lKENdNrEqT3,22,17,12,10,7,2,14,0,62,8.857142857142858,4,0.0,0,12,10,7,17,2,0,14,0,29,33,0
3996,57952,Axw4HBt3l6GD2DONFf7w1tmix5Mk5VUT,A3fsA9Zfv1X2fVEQhTw51lKENdNrEqT3,13,13,6,0,2,5,11,2,39,5.571428571428571,2,0.0,0,6,0,2,13,5,0,11,2,8,31,1
3997,57987,sqasMoGc0IU5lpNZsO5KtcLYxSWllMxq,RXDvfPUBYFlVdlueBFbLW0mhhAyGEqpt,52,76,21,80,21,24,32,17,271,38.714285714285715,4,0.0,22,21,74,21,54,24,6,32,17,138,133,0
3998,57989,ncKGr6xR4Vhs3wPeU0aqO1sSEow8LN64,5X6FeZozNMgE2VRi3MJYjkkFK8SETtu2,1,0,0,0,0,0,1,0,1,0.14285714285714285,1,0.0,0,0,0,0,0,0,0,1,0,0,1,1
3999,58013,Bf025FfgNrlcqN8gYGnmBAhjBy0v5Xmo,bWdj2GDclj5ofokWjzoa5jAwMkxCykd6,14,53,34,0,14,1,19,0,121,17.285714285714285,5,0.0,7,34,0,14,46,1,0,19,0,55,66,1
4000,58025,SJPM6RlM27WGlBQJlWcTA7fvsKmlPxUf,SpATywNh6bZuzm8s1ceuBUnMUAeoAHHw,7,2,1,0,1,0,6,0,10,1.4285714285714286,1,0.0,0,1,0,1,2,0,0,6,0,2,8,1
4001,58062,rGJvvNRNeS4weXphC4pxwlmBwDQi7NXo,SpATywNh6bZuzm8s1ceuBUnMUAeoAHHw,19,29,13,8,9,1,11,2,73,10.428571428571429,2,0.0,12,13,7,9,17,1,1,11,2,41,32,0
4002,58069,nWDRtsdyQI6TNTQknsvrXkgOEaTh8I0k,SpATywNh6bZuzm8s1ceuBUnMUAeoAHHw,25,26,15,16,8,5,5,0,75,10.714285714285714,2,0.0,8,15,16,8,18,5,0,5,0,47,28,0
4003,58142,G2OV1K6QAb8ZlrDRCrLDF7tfA5J7JUDN,SpATywNh6bZuzm8s1ceuBUnMUAeoAHHw,16,25,10,22,4,2,5,0,68,9.714285714285714,2,0.0,8,10,19,4,17,2,3,5,0,41,27,1
4004,58147,GHWD27wG643ibd6OSLThLJ3MzX9fgfxx,A3fsA9Zfv1X2fVEQhTw51lKENdNrEqT3,30,25,16,0,13,0,7,0,61,8.714285714285714,3,0.0,0,16,0,13,25,0,0,7,0,29,32,1
4005,58148,yvxDmdTtwak3ePh9ZZvgT2yHbtqhLJuU,SpATywNh6bZuzm8s1ceuBUnMUAeoAHHw,5,2,1,0,1,0,2,0,6,0.8571428571428571,1,0.0,0,1,0,1,2,0,0,2,0,2,4,1
4006,58156,wXw48gUOB5BEkScgUyQMzs63eq0ygNDQ,RXDvfPUBYFlVdlueBFbLW0mhhAyGEqpt,2,0,0,0,0,0,5,0,5,0.7142857142857143,2,0.0,0,0,0,0,0,0,0,5,0,0,5,1
4007,58162,g2crr0D1YRZspeg3aG0QVrkBBPBltTjz,RXDvfPUBYFlVdlueBFbLW0mhhAyGEqpt,6,4,1,0,0,0,2,0,7,1.0,1,0.0,0,1,0,0,4,0,0,2,0,1,6,0
4008,58172,I4jcIexarcejSCh8gI54DZO3U7SFfRnT,A3fsA9Zfv1X2fVEQhTw51lKENdNrEqT3,3,0,0,0,0,0,4,0,4,0.5714285714285714,1,0.0,0,0,0,0,0,0,0,4,0,0,4,1
4009,58212,ZguimpvCE02pFqkl0KfDAtmrarDM70Qf,SpATywNh6bZuzm8s1ceuBUnMUAeoAHHw,6,3,1,0,0,0,4,0,8,1.1428571428571428,1,0.0,0,1,0,0,3,0,0,4,0,1,7,1
4010,58214,nZTn5dZMRyIKKNGuMbIWH6lpWaWoYX62,5X6FeZozNMgE2VRi3MJYjkkFK8SETtu2,1,0,0,0,0,0,1,0,1,0.14285714285714285,1,0.0,0,0,0,0,0,0,0,1,0,0,1,1
4011,58217,v1amutsyDOYm3WMqvptGI8JyXdvsTElC,SpATywNh6bZuzm8s1ceuBUnMUAeoAHHw,17,35,8,21,2,5,24,4,99,14.142857142857142,4,0.0,9,8,18,2,26,5,3,24,4,37,62,1
4012,58219,edP9uXMvyr9FSmSy32CnOxTQSMqfGr89,bWdj2GDclj5ofokWjzoa5jAwMkxCykd6,14,25,11,154,4,3,6,0,203,29.0,1,0.0,8,11,145,4,17,3,9,6,0,168,35,1
4013,58223,nZTn5dZMRyIKKNGuMbIWH6lpWaWoYX62,A3fsA9Zfv1X2fVEQhTw51lKENdNrEqT3,8,9,1,0,0,2,8,0,20,2.857142857142857,2,0.0,0,1,0,0,9,2,0,8,0,1,19,1
4014,58235,L4PW9E8umRTJy4rgt9ZPyCVXzCxIYlU4,SpATywNh6bZuzm8s1ceuBUnMUAeoAHHw,19,32,10,25,1,49,13,3,133,19.0,6,0.0,18,10,22,1,14,49,3,13,3,51,82,0
4015,58251,9irOSn8DGZwWtwp11aWu1YWsaS4jzhvZ,SpATywNh6bZuzm8s1ceuBUnMUAeoAHHw,5,6,0,0,0,0,2,0,8,1.1428571428571428,2,0.0,0,0,0,0,6,0,0,2,0,0,8,1
4016,58280,5lq0KJvq1lt50dcD5m6Vr40ogvrDdcc4,bWdj2GDclj5ofokWjzoa5jAwMkxCykd6,6,8,5,0,3,0,5,0,21,3.0,2,0.0,0,5,0,3,8,0,0,5,0,8,13,1
4017,58282,Gqs4K8SBL8tl8fMHpBqpJerrgEsieHU3,SpATywNh6bZuzm8s1ceuBUnMUAeoAHHw,56,95,36,35,20,16,21,1,224,32.0,14,0.0,13,36,34,20,82,16,1,21,1,103,121,0
4018,58305,skJn7dtfSekFrPHRHs9swZ9AtSUKi36u,A3fsA9Zfv1X2fVEQhTw51lKENdNrEqT3,10,16,12,0,2,9,9,0,48,6.857142857142857,5,0.0,0,12,0,2,16,9,0,9,0,14,34,1
4019,58330,pMYwmEYG5tY3CdCDf2JdvCMAnvvBZ6Wf,5X6FeZozNMgE2VRi3MJYjkkFK8SETtu2,5,2,0,0,0,0,3,0,5,0.7142857142857143,1,0.0,0,0,0,0,2,0,0,3,0,0,5,1
4020,58333,e3wUoJuzsENUfMiDHKcPh8dxiNI0W3xf,G8EPVSXsOYB5YQWZGiz1aVq5Pgr2GrQu,40,53,4,54,4,4,13,2,134,19.142857142857142,5,0.0,22,4,33,4,31,4,21,13,2,63,71,0
4021,58334,ROctVkWGGi4RH8QWmC2p1iWZZ8pihPaJ,SpATywNh6bZuzm8s1ceuBUnMUAeoAHHw,25,66,11,25,4,14,11,0,131,18.714285714285715,7,0.0,9,11,22,4,57,14,3,11,0,46,85,0
4022,58336,LceCGRrY68iwKOq6ziCnmuJ3uxzNypKD,SpATywNh6bZuzm8s1ceuBUnMUAeoAHHw,12,13,4,0,3,0,7,2,29,4.142857142857143,1,0.0,2,4,0,3,11,0,0,7,2,9,20,1
4023,58341,MU4dVyJTD7iIRSTZIdJZ9VoLOxogfKQN,SpATywNh6bZuzm8s1ceuBUnMUAeoAHHw,24,31,18,24,5,1,11,1,91,13.0,7,0.0,6,18,24,5,25,1,0,11,1,53,38,0
4024,58348,n2LjMxx7cFpUJ3R3HfCHwCtJjfcc1KR0,G8EPVSXsOYB5YQWZGiz1aVq5Pgr2GrQu,29,44,30,36,19,2,13,0,144,20.571428571428573,5,0.0,7,30,29,19,37,2,7,13,0,85,59,0
4025,58356,O28nyHG0T9JeDH3GQl7amYJuULZ1QRpo,SpATywNh6bZuzm8s1ceuBUnMUAeoAHHw,12,16,2,14,0,0,4,0,36,5.142857142857143,2,0.0,7,2,12,0,9,0,2,4,0,21,15,1
4026,58385,ewcDv7X6I323ciCMJsU4n4MdvO632A9I,RXDvfPUBYFlVdlueBFbLW0mhhAyGEqpt,10,5,1,15,1,0,2,0,24,3.4285714285714284,1,0.0,1,1,15,1,4,0,0,2,0,18,6,1
4027,58409,TfXAnflKNnQz6DuwkJiGkjk0fNqIcdbb,RXDvfPUBYFlVdlueBFbLW0mhhAyGEqpt,5,0,0,0,0,0,5,1,6,0.8571428571428571,1,0.0,0,0,0,0,0,0,0,5,1,0,6,1
4028,58411,yvRYzlOzyvQRJ6DXF1Anm7UfajnELRZn,A3fsA9Zfv1X2fVEQhTw51lKENdNrEqT3,5,3,0,0,0,1,2,0,6,0.8571428571428571,1,0.0,0,0,0,0,3,1,0,2,0,0,6,1
4029,58414,TfXAnflKNnQz6DuwkJiGkjk0fNqIcdbb,G8EPVSXsOYB5YQWZGiz1aVq5Pgr2GrQu,5,1,0,0,1,0,3,0,5,0.7142857142857143,1,0.0,0,0,0,1,1,0,0,3,0,1,4,1
4030,58419,WuM67GwQW9M3d1mnuGHuvAdo907S9qb5,bWdj2GDclj5ofokWjzoa5jAwMkxCykd6,1,0,0,0,0,0,2,0,2,0.2857142857142857,2,0.0,0,0,0,0,0,0,0,2,0,0,2,1
4031,58428,tuO76fueBYFOMVa8D7FaN7k7B9sFUsap,SpATywNh6bZuzm8s1ceuBUnMUAeoAHHw,5,5,2,0,2,0,2,0,11,1.5714285714285714,1,0.0,0,2,0,2,5,0,0,2,0,4,7,1
4032,58430,Ymf9IGFQ8uCjyMPNR9dFL9vuwfZDvaPV,SpATywNh6bZuzm8s1ceuBUnMUAeoAHHw,37,127,5,45,5,140,36,1,359,51.285714285714285,12,0.0,28,5,40,5,99,140,5,36,1,78,281,0
4033,58458,fgzbUfrTxXYCuiFYTG1cTemcEJUl36an,SpATywNh6bZuzm8s1ceuBUnMUAeoAHHw,39,106,30,34,7,6,36,1,220,31.428571428571427,15,0.0,11,30,33,7,95,6,1,36,1,81,139,0
4034,58467,4ZEbiCstCbPqjH1vXT26zSCciOWvR8I5,G8EPVSXsOYB5YQWZGiz1aVq5Pgr2GrQu,5,2,1,0,1,0,2,0,6,0.8571428571428571,1,0.0,0,1,0,1,2,0,0,2,0,2,4,1
4035,58484,P84G9ZsyavajrfOKINVq0Jyux3TvjGmZ,G8EPVSXsOYB5YQWZGiz1aVq5Pgr2GrQu,7,6,5,12,2,0,2,0,27,3.857142857142857,1,0.0,0,5,10,2,6,0,2,2,0,17,10,1
4036,58509,HRP0Ut3HnZWoD62izV4kICPH3gchormt,SpATywNh6bZuzm8s1ceuBUnMUAeoAHHw,22,37,6,6,3,0,4,0,56,8.0,2,0.0,0,6,6,3,37,0,0,4,0,15,41,0
4037,58535,tdWhb9WfoB7e0A5Gjo7JvSpPeeCoQg77,SpATywNh6bZuzm8s1ceuBUnMUAeoAHHw,34,46,20,29,10,0,9,0,114,16.285714285714285,3,0.0,10,20,28,10,36,0,1,9,0,68,46,0
4038,58572,rFRGZ1wCWpRq5Le1v28DF6OVdqA54N4w,SpATywNh6bZuzm8s1ceuBUnMUAeoAHHw,6,2,0,0,0,0,4,0,6,0.8571428571428571,1,0.0,0,0,0,0,2,0,0,4,0,0,6,1
4039,58576,3mm3mJxVS0eLh8IUtBxaLL8aknBAQjDa,SpATywNh6bZuzm8s1ceuBUnMUAeoAHHw,6,5,0,0,0,0,2,0,7,1.0,1,0.0,0,0,0,0,5,0,0,2,0,0,7,1
4040,58578,3mm3mJxVS0eLh8IUtBxaLL8aknBAQjDa,5X6FeZozNMgE2VRi3MJYjkkFK8SETtu2,2,0,0,0,0,0,2,0,2,0.2857142857142857,1,0.0,0,0,0,0,0,0,0,2,0,0,2,1
4041,58580,likrBm8tgfB2kgdZuLI51EWK70wAYbOl,SpATywNh6bZuzm8s1ceuBUnMUAeoAHHw,4,2,1,0,0,0,2,0,5,0.7142857142857143,1,0.0,0,1,0,0,2,0,0,2,0,1,4,1
4042,58626,AsYvTZR1ylqWCh3nfRxgHS2CzZpeou5v,SpATywNh6bZuzm8s1ceuBUnMUAeoAHHw,61,101,52,54,23,21,39,3,293,41.857142857142854,10,0.0,23,52,51,23,78,21,3,39,3,149,144,0
4043,58628,BvTWqNCI5Vv3DyY42Ht6x5bgcNEbXEjw,SpATywNh6bZuzm8s1ceuBUnMUAeoAHHw,27,28,14,18,8,0,4,0,72,10.285714285714286,6,0.0,4,14,17,8,24,0,1,4,0,43,29,1
4044,58639,GaLDEM0QPnCAP0wDlZ6pkRoEABK9VTLg,bWdj2GDclj5ofokWjzoa5jAwMkxCykd6,4,5,0,0,1,3,1,0,10,1.4285714285714286,1,0.0,2,0,0,1,3,3,0,1,0,3,7,1
4045,58656,OtgLotOlNqEcaPG4XzsiqBelLdYnlk9e,A3fsA9Zfv1X2fVEQhTw51lKENdNrEqT3,33,20,16,32,13,0,1,0,82,11.714285714285714,1,0.0,2,16,32,13,18,0,0,1,0,63,19,1
4046,58661,t8qBiDTvOvYmrxcVIErRuEOf38tywm6t,SpATywNh6bZuzm8s1ceuBUnMUAeoAHHw,38,64,46,26,19,29,20,3,207,29.571428571428573,9,0.0,5,46,20,19,59,29,6,20,3,90,117,0
4047,58690,y9A8XMlmfPaglBBuQFjiuxUOvb1WQu2v,A3fsA9Zfv1X2fVEQhTw51lKENdNrEqT3,16,18,9,0,7,0,10,0,44,6.285714285714286,4,0.0,0,9,0,7,18,0,0,10,0,16,28,1
4048,58716,wvyfPUc1aKmHhDODOwE0BnlNIGHCCfJd,G8EPVSXsOYB5YQWZGiz1aVq5Pgr2GrQu,5,3,1,0,1,0,2,0,7,1.0,1,0.0,0,1,0,1,3,0,0,2,0,2,5,1
4049,58724,QEq8GPuIzTapWcXcWLs8dzh5C4ugJ6qX,G8EPVSXsOYB5YQWZGiz1aVq5Pgr2GrQu,130,218,100,232,60,24,25,2,661,94.42857142857143,10,0.0,94,100,179,60,124,24,53,25,2,433,228,0
4050,58725,kQl6hEKF14dslDmIkyc1xBQGSSHXGS8M,bWdj2GDclj5ofokWjzoa5jAwMkxCykd6,4,0,0,0,0,0,4,1,5,0.7142857142857143,1,0.0,0,0,0,0,0,0,0,4,1,0,5,1
4051,58739,IUn6MADAjAYkGlJisA1WiDvCeNlJd5Xd,bWdj2GDclj5ofokWjzoa5jAwMkxCykd6,10,12,5,20,4,6,3,0,50,7.142857142857143,2,0.0,3,5,20,4,9,6,0,3,0,32,18,1
4052,58783,cG2zraudtV44kPzel5abcAzgwVOUaAs4,5X6FeZozNMgE2VRi3MJYjkkFK8SETtu2,1,0,0,0,0,0,1,0,1,0.14285714285714285,1,0.0,0,0,0,0,0,0,0,1,0,0,1,1
4053,58805,HaNTytYTKLUDOv5j8ZGLMuMeNQsJjViU,SpATywNh6bZuzm8s1ceuBUnMUAeoAHHw,8,8,5,0,4,0,5,0,22,3.142857142857143,2,0.0,1,5,0,4,7,0,0,5,0,10,12,1
4054,58831,f1TK7a3kaFF32JoXcfjlq2WtR27QUBak,SpATywNh6bZuzm8s1ceuBUnMUAeoAHHw,22,26,0,23,0,3,10,1,63,9.0,2,0.0,8,0,21,0,18,3,2,10,1,29,34,1
4055,58840,uuM5V1CEd7qVq722bOUrzRwoxB5HlAl5,SpATywNh6bZuzm8s1ceuBUnMUAeoAHHw,19,22,12,8,9,0,3,0,54,7.714285714285714,2,0.0,3,12,8,9,19,0,0,3,0,32,22,1
4056,58851,HcP22z9Adhad0eR6ILSXQ1kzpXBgJlCr,bWdj2GDclj5ofokWjzoa5jAwMkxCykd6,17,26,5,68,2,0,8,0,109,15.571428571428571,6,0.0,3,5,60,2,23,0,8,8,0,70,39,1
4057,58853,7wyfXvc1g99QNmXzEb4w8C1vE0Vi2bHm,A3fsA9Zfv1X2fVEQhTw51lKENdNrEqT3,4,2,1,0,1,0,1,0,5,0.7142857142857143,1,0.0,0,1,0,1,2,0,0,1,0,2,3,0
4058,58869,qUEvY9WI1m6Sm8flMRVsOdJpkuUerQfo,A3fsA9Zfv1X2fVEQhTw51lKENdNrEqT3,3,0,0,0,0,0,5,2,7,1.0,1,0.0,0,0,0,0,0,0,0,5,2,0,7,1
4059,58876,KynvXtYIsEUZo4QPbGVWVhUBwzeS3e9w,SpATywNh6bZuzm8s1ceuBUnMUAeoAHHw,11,9,6,0,5,0,3,0,23,3.2857142857142856,2,0.0,0,6,0,5,9,0,0,3,0,11,12,1
4060,58888,Oh4qObC7j4dz8QtvEnVVjGNXqScAv0Td,5X6FeZozNMgE2VRi3MJYjkkFK8SETtu2,6,1,1,0,1,0,3,0,6,0.8571428571428571,1,0.0,0,1,0,1,1,0,0,3,0,2,4,1
4061,58909,BeY1QEJLx8hEoll66FHHZbsUvI2zt7s5,A3fsA9Zfv1X2fVEQhTw51lKENdNrEqT3,1,0,0,0,0,0,1,0,1,0.14285714285714285,1,0.0,0,0,0,0,0,0,0,1,0,0,1,1
4062,58914,DnweC9zfy9ur38RHmjIuaW6oqiFXCgkS,A3fsA9Zfv1X2fVEQhTw51lKENdNrEqT3,39,36,4,82,11,2,4,0,139,19.857142857142858,3,0.0,4,4,69,11,32,2,13,4,0,88,51,1
4063,58922,6HIBebNSnNEoSeekVShzxF3x0IcbgohT,SpATywNh6bZuzm8s1ceuBUnMUAeoAHHw,21,23,1,0,1,0,4,0,29,4.142857142857143,3,0.0,0,1,0,1,23,0,0,4,0,2,27,1
4064,58948,McYATdhZDDMDpni6a4GbjI06ustMpvdV,5X6FeZozNMgE2VRi3MJYjkkFK8SETtu2,1,0,0,0,0,0,1,0,1,0.14285714285714285,1,0.0,0,0,0,0,0,0,0,1,0,0,1,1
4065,58970,PvDd5wrDKH5IBJRRd1ycECXD88pHC4R8,SpATywNh6bZuzm8s1ceuBUnMUAeoAHHw,7,6,2,0,1,0,4,0,13,1.8571428571428572,1,0.0,0,2,0,1,6,0,0,4,0,3,10,1
4066,58996,w9HBKKfn4YUOWYdwRHKe80SIWiO37ZMJ,SpATywNh6bZuzm8s1ceuBUnMUAeoAHHw,46,82,42,40,18,1,39,0,222,31.714285714285715,13,0.0,15,42,37,18,67,1,3,39,0,112,110,0
4067,58997,1zErz13s8fNQRVaEvkOtvw6bLhr23yB4,bWdj2GDclj5ofokWjzoa5jAwMkxCykd6,16,28,17,98,2,0,6,0,151,21.571428571428573,4,0.0,3,17,90,2,25,0,8,6,0,112,39,0
4068,59002,yQ30DktO8KD929ApuNMOdNKTtmTpkfc3,G8EPVSXsOYB5YQWZGiz1aVq5Pgr2GrQu,3,0,0,0,0,4,2,0,6,0.8571428571428571,1,0.0,0,0,0,0,0,4,0,2,0,0,6,1
4069,59005,yQ30DktO8KD929ApuNMOdNKTtmTpkfc3,A3fsA9Zfv1X2fVEQhTw51lKENdNrEqT3,3,0,0,0,0,4,2,0,6,0.8571428571428571,1,0.0,0,0,0,0,0,4,0,2,0,0,6,1
4070,59014,D2lFXeOodglgSTRNVccRvVrNvHlYgfLJ,G8EPVSXsOYB5YQWZGiz1aVq5Pgr2GrQu,1,0,0,0,0,0,1,0,1,0.14285714285714285,1,0.0,0,0,0,0,0,0,0,1,0,0,1,1
4071,59018,Sz4iN9vM7plSJObu2Kgng7aJijtNNsts,A3fsA9Zfv1X2fVEQhTw51lKENdNrEqT3,8,17,1,0,1,0,10,0,29,4.142857142857143,3,0.0,0,1,0,1,17,0,0,10,0,2,27,1
4072,59019,EI0cegDgsKeutsMjmgvKh2Wn3MmJa02W,5X6FeZozNMgE2VRi3MJYjkkFK8SETtu2,10,10,2,10,3,0,5,1,31,4.428571428571429,2,0.0,7,2,8,3,3,0,2,5,1,20,11,1
4073,59056,HPaDTzk2xymxbpoa0VdcxdHl3uFfOfZk,A3fsA9Zfv1X2fVEQhTw51lKENdNrEqT3,11,17,12,0,0,1,27,0,57,8.142857142857142,6,0.0,0,12,0,0,17,1,0,27,0,12,45,1
4074,59064,gzTBwYPoQwnODJJ2vedsUKp2EoGao5Fz,A3fsA9Zfv1X2fVEQhTw51lKENdNrEqT3,2,0,0,0,0,0,4,0,4,0.5714285714285714,3,0.0,0,0,0,0,0,0,0,4,0,0,4,1
4075,59080,0wpgF8T87E4lIPjqoh0AkxyomANfbalw,5X6FeZozNMgE2VRi3MJYjkkFK8SETtu2,4,7,1,0,3,0,1,0,12,1.7142857142857142,1,0.0,2,1,0,3,5,0,0,1,0,6,6,1
4076,59081,QscGDFmAAH7jp4ntcbRqVptjZvFSEe7R,SpATywNh6bZuzm8s1ceuBUnMUAeoAHHw,1,0,0,0,0,0,1,0,1,0.14285714285714285,1,0.0,0,0,0,0,0,0,0,1,0,0,1,1
4077,59085,FJb17GnhVysnDMr4UIVdFwaw18TJ0gzC,A3fsA9Zfv1X2fVEQhTw51lKENdNrEqT3,8,3,2,0,2,0,4,0,11,1.5714285714285714,1,0.0,0,2,0,2,3,0,0,4,0,4,7,1
4078,59087,QscGDFmAAH7jp4ntcbRqVptjZvFSEe7R,A3fsA9Zfv1X2fVEQhTw51lKENdNrEqT3,33,19,16,18,14,0,7,0,74,10.571428571428571,2,0.0,0,16,15,14,19,0,3,7,0,45,29,1
4079,59099,NXeUyqTgIKYglW6oNMecGCOxIW2GzUKK,bWdj2GDclj5ofokWjzoa5jAwMkxCykd6,2,0,0,0,0,0,5,0,5,0.7142857142857143,1,0.0,0,0,0,0,0,0,0,5,0,0,5,1
4080,59100,Vn4kuqpkxWqlMyrGvyBY4A7iKQdYdIwO,SpATywNh6bZuzm8s1ceuBUnMUAeoAHHw,2,0,0,0,0,0,2,0,2,0.2857142857142857,1,0.0,0,0,0,0,0,0,0,2,0,0,2,1
4081,59102,Vn4kuqpkxWqlMyrGvyBY4A7iKQdYdIwO,A3fsA9Zfv1X2fVEQhTw51lKENdNrEqT3,5,2,1,0,1,0,2,0,6,0.8571428571428571,1,0.0,0,1,0,1,2,0,0,2,0,2,4,1
4082,59118,bEjkLIwm3iSyqTCwCLyh4lFO7vLzJeAj,SpATywNh6bZuzm8s1ceuBUnMUAeoAHHw,43,36,26,31,15,12,24,2,146,20.857142857142858,4,0.0,6,26,29,15,30,12,2,24,2,76,70,0
4083,59132,3LOMe6pmkiIt95Dd5LqCGi1tBreM2BMk,A3fsA9Zfv1X2fVEQhTw51lKENdNrEqT3,6,5,0,0,0,0,3,0,8,1.1428571428571428,2,0.0,0,0,0,0,5,0,0,3,0,0,8,0
4084,59136,3LOMe6pmkiIt95Dd5LqCGi1tBreM2BMk,bWdj2GDclj5ofokWjzoa5jAwMkxCykd6,1,0,0,0,0,0,1,0,1,0.14285714285714285,1,0.0,0,0,0,0,0,0,0,1,0,0,1,1
4085,59137,kqS8BwWN9R1093oeblGkvtCsQJ68Gh0G,bWdj2GDclj5ofokWjzoa5jAwMkxCykd6,6,8,6,0,2,0,3,0,19,2.7142857142857144,2,0.0,0,6,0,2,8,0,0,3,0,8,11,1
4086,59249,pgtfwPx3gBWk0s41FLIY8xNKvQvpnNYF,3VkHkmOtom3jM2wCu94xgzzu1d6Dn7or,82,188,77,75,94,44,15,2,495,70.71428571428571,12,0.0,104,77,71,94,84,44,4,15,2,346,149,0
4087,59259,K5WcXRk24XKmzfaggLfniRGhO7RrNYwU,3VkHkmOtom3jM2wCu94xgzzu1d6Dn7or,78,159,36,99,65,3,10,0,372,53.142857142857146,7,0.0,94,36,97,65,65,3,2,10,0,292,80,1
4088,59276,FVpwwdfn5Fmsfw0r1O3qv4L0FFnFaxUj,3VkHkmOtom3jM2wCu94xgzzu1d6Dn7or,1,0,0,0,0,0,2,0,2,0.2857142857142857,1,0.0,0,0,0,0,0,0,0,2,0,0,2,1
4089,59285,t0CXTWQ7WrgANKqIJnC4VUgKY5pjWYTr,3VkHkmOtom3jM2wCu94xgzzu1d6Dn7or,80,173,37,89,38,3,17,0,357,51.0,5,0.0,75,37,86,38,98,3,3,17,0,236,121,0
4090,59371,J37M26A4eu1dMNTJ4awU72BCV3pCgIgT,3VkHkmOtom3jM2wCu94xgzzu1d6Dn7or,55,141,48,28,37,9,16,12,291,41.57142857142857,5,0.0,35,48,22,37,106,9,6,16,12,142,149,0
4091,59389,BNeTtjRGqsezTEUWeyt7EBI5qiv9cGji,3VkHkmOtom3jM2wCu94xgzzu1d6Dn7or,1,0,0,0,0,0,1,0,1,0.14285714285714285,1,0.0,0,0,0,0,0,0,0,1,0,0,1,1
4092,59410,JqvGTplcVBLcq3YzEUVslmYGYOBREBZ1,3VkHkmOtom3jM2wCu94xgzzu1d6Dn7or,97,273,81,56,97,5,128,2,642,91.71428571428571,14,0.0,152,81,53,97,121,5,3,128,2,383,259,0
4093,59413,9IjA9lMcgPRYgobq8S0NcHZogVy6IOVi,3VkHkmOtom3jM2wCu94xgzzu1d6Dn7or,74,309,144,53,103,59,76,30,774,110.57142857142857,12,0.0,108,144,50,103,201,59,3,76,30,405,369,0
4094,59437,XUOiAiVbOv4JfR1kIXNyEruHxINz3Y5I,3VkHkmOtom3jM2wCu94xgzzu1d6Dn7or,7,1,1,0,1,0,6,1,10,1.4285714285714286,1,0.0,0,1,0,1,1,0,0,6,1,2,8,1
4095,59443,QWrnRw291WsDcGS3VosiRVOQFgq2dbZQ,3VkHkmOtom3jM2wCu94xgzzu1d6Dn7or,12,15,4,6,8,10,4,0,47,6.714285714285714,1,0.0,7,4,5,8,8,10,1,4,0,24,23,1
4096,59487,D78BRYJsTSEX9IhXU6pf9xLZreK4ME7H,3VkHkmOtom3jM2wCu94xgzzu1d6Dn7or,9,4,3,0,3,0,2,0,12,1.7142857142857142,1,0.0,0,3,0,3,4,0,0,2,0,6,6,1
4097,59500,lKNIOq5vN7FRlYNC363ARiDM2gYoUpfn,3VkHkmOtom3jM2wCu94xgzzu1d6Dn7or,18,46,10,11,22,24,10,1,124,17.714285714285715,2,0.0,33,10,9,22,13,24,2,10,1,74,50,1
4098,59525,JUlFmLEwsyE4h3GDjsDeEysCFVVb6Ze2,3VkHkmOtom3jM2wCu94xgzzu1d6Dn7or,1,0,0,0,0,0,1,0,1,0.14285714285714285,1,0.0,0,0,0,0,0,0,0,1,0,0,1,1
4099,59535,oskMvT9bm6tPbKr8z5m10beXtEHnygWp,3VkHkmOtom3jM2wCu94xgzzu1d6Dn7or,1,0,0,0,0,0,1,0,1,0.14285714285714285,1,0.0,0,0,0,0,0,0,0,1,0,0,1,1
4100,59542,ZdlJq1JbshoI9Xf2NcT388yoIk0LZFLR,3VkHkmOtom3jM2wCu94xgzzu1d6Dn7or,79,317,192,74,132,129,52,4,900,128.57142857142858,14,0.0,99,192,65,132,218,129,9,52,4,488,412,0
4101,59551,xms5yIfb8WmEpuH25dLflwHtkLnnKylG,3VkHkmOtom3jM2wCu94xgzzu1d6Dn7or,1,0,0,0,0,0,2,0,2,0.2857142857142857,2,0.0,0,0,0,0,0,0,0,2,0,0,2,1
4102,59565,p6rhKi68oPL0R5Po6jCCT1ruCe2sOWtP,3VkHkmOtom3jM2wCu94xgzzu1d6Dn7or,36,160,69,45,31,24,42,13,384,54.857142857142854,6,0.0,42,69,39,31,118,24,6,42,13,181,203,1
4103,59583,I7vOFLC3FBK6C2KcR371tMerIHOoM2go,3VkHkmOtom3jM2wCu94xgzzu1d6Dn7or,64,103,34,38,35,3,26,1,240,34.285714285714285,7,0.0,53,34,35,35,50,3,3,26,1,157,83,0
4104,59609,QJffKxs9lkFscQquMcfEw8hYo0ArYTkN,3VkHkmOtom3jM2wCu94xgzzu1d6Dn7or,42,49,26,1,24,18,11,6,135,19.285714285714285,3,0.0,12,26,1,24,37,18,0,11,6,63,72,1
4105,59614,cx5rc4XY3hf1uYzYIQcJ7om0rl1JmFnU,3VkHkmOtom3jM2wCu94xgzzu1d6Dn7or,8,16,7,0,4,0,4,0,31,4.428571428571429,2,0.0,2,7,0,4,14,0,0,4,0,13,18,1
4106,59657,oPDqUc1jMpRM1as5x92xQnWubkfyCZaR,3VkHkmOtom3jM2wCu94xgzzu1d6Dn7or,4,0,0,0,0,1,5,0,6,0.8571428571428571,2,0.0,0,0,0,0,0,1,0,5,0,0,6,1
4107,59662,GiK7Ro1CDK9bHpGz5NngB6VWgh04QYTF,3VkHkmOtom3jM2wCu94xgzzu1d6Dn7or,20,16,8,22,6,0,3,0,55,7.857142857142857,2,0.0,4,8,15,6,12,0,7,3,0,33,22,0
4108,59714,cYe4n4c9KPDfBEWjGIRj6ImLxtmj3FnE,3VkHkmOtom3jM2wCu94xgzzu1d6Dn7or,9,32,1,4,9,0,6,0,52,7.428571428571429,2,0.0,20,1,4,9,12,0,0,6,0,34,18,1
4109,59805,QjlpOVp2OfPr6el2UDKT8w3k8QqgbbR1,3VkHkmOtom3jM2wCu94xgzzu1d6Dn7or,7,3,2,0,2,0,2,0,9,1.2857142857142858,1,0.0,0,2,0,2,3,0,0,2,0,4,5,1
4110,59845,L19Rl61HvBd0dIlkC1jenj6WtHv9JPjx,3VkHkmOtom3jM2wCu94xgzzu1d6Dn7or,97,243,66,45,90,8,22,0,474,67.71428571428571,8,0.0,131,66,44,90,112,8,1,22,0,331,143,0
4111,59846,ahJ0XLttM9xeZ1eTvMINaiNiTsROIFbM,3VkHkmOtom3jM2wCu94xgzzu1d6Dn7or,1,0,0,0,0,0,1,0,1,0.14285714285714285,1,0.0,0,0,0,0,0,0,0,1,0,0,1,1
4112,59876,QJeDHnX9duNDaVhX1YBFrEjM07OpQY6u,3VkHkmOtom3jM2wCu94xgzzu1d6Dn7or,65,108,47,62,46,8,26,7,304,43.42857142857143,8,0.0,47,47,59,46,61,8,3,26,7,199,105,1
4113,59897,6vz0sqO547t2p3a0mSKkVI0plinQft8Y,3VkHkmOtom3jM2wCu94xgzzu1d6Dn7or,7,6,2,0,0,2,4,0,14,2.0,1,0.0,0,2,0,0,6,2,0,4,0,2,12,1
4114,60001,iwmwNweMTR2XxM8DDVCIW8FV8YpeIUk1,3VkHkmOtom3jM2wCu94xgzzu1d6Dn7or,1,0,0,0,0,0,1,0,1,0.14285714285714285,1,0.0,0,0,0,0,0,0,0,1,0,0,1,0
4115,60011,aq6RzL3Xg5EYCsH3vPkd60PgfB0ApzuH,3VkHkmOtom3jM2wCu94xgzzu1d6Dn7or,58,72,37,101,0,2,15,1,228,32.57142857142857,4,0.0,29,37,74,0,43,2,27,15,1,140,88,0
4116,60048,BVLL3tf1KrYCKKfxj1p07nnbpn909YvK,7GRhBDsirIGkRZBtSMEzNTyDr2JQm4xx,1,0,0,0,0,0,1,0,1,0.14285714285714285,1,0.0,0,0,0,0,0,0,0,1,0,0,1,0
4117,60082,Yre3ZpWIJIVmlOfN5qpPiUgPhyFZbBYP,7GRhBDsirIGkRZBtSMEzNTyDr2JQm4xx,1,0,0,0,0,0,1,0,1,0.14285714285714285,1,0.0,0,0,0,0,0,0,0,1,0,0,1,1
4118,60085,n63tS6f6RbAUQIT0fHxjepUtvV0en8Ph,7GRhBDsirIGkRZBtSMEzNTyDr2JQm4xx,21,19,1,50,2,0,2,0,74,10.571428571428571,1,0.0,9,1,42,2,10,0,8,2,0,54,20,1
4119,60203,ntJs93C1h80peQsrk4sMYD3xVOjdEHeo,7GRhBDsirIGkRZBtSMEzNTyDr2JQm4xx,110,315,75,186,80,93,37,0,786,112.28571428571429,13,0.0,223,75,172,80,92,93,14,37,0,550,236,0
4120,60281,jzL5Nt58a8ZENNg776MwldmnOh4VPeJQ,7GRhBDsirIGkRZBtSMEzNTyDr2JQm4xx,2,0,0,0,0,0,2,0,2,0.2857142857142857,1,0.0,0,0,0,0,0,0,0,2,0,0,2,1
4121,60338,eLYgTX3CtOgrxGxhjtnNhmto5eBGG5mu,5X6FeZozNMgE2VRi3MJYjkkFK8SETtu2,1,0,0,0,0,0,1,0,1,0.14285714285714285,1,0.0,0,0,0,0,0,0,0,1,0,0,1,1
4122,60353,kf5ROCzcgJvsKj9HScT2CaHiyyffBGek,7GRhBDsirIGkRZBtSMEzNTyDr2JQm4xx,12,6,5,0,5,1,1,0,18,2.5714285714285716,1,0.0,0,5,0,5,6,1,0,1,0,10,8,0
4123,60384,6PG8IjYnq0BnsuI9UCP9KSi4JIWeYzk9,5X6FeZozNMgE2VRi3MJYjkkFK8SETtu2,7,5,1,0,2,4,6,1,19,2.7142857142857144,1,0.0,3,1,0,2,2,4,0,6,1,6,13,1
4124,60413,i67qzouvUD7nINgK6d1xrH4pvufZqbFd,7GRhBDsirIGkRZBtSMEzNTyDr2JQm4xx,14,14,0,4,1,0,3,0,22,3.142857142857143,2,0.0,4,0,2,1,10,0,2,3,0,7,15,0
4125,60419,mZP93anQs7Q6391iFwgUyfSw444ov2HX,5X6FeZozNMgE2VRi3MJYjkkFK8SETtu2,9,14,7,0,0,1,5,0,27,3.857142857142857,1,0.0,4,7,0,0,10,1,0,5,0,11,16,0
4126,60420,5hts9kMf50L6rxwk0MtgECu1e5TGRRGY,7GRhBDsirIGkRZBtSMEzNTyDr2JQm4xx,29,52,14,33,8,7,15,0,129,18.428571428571427,2,0.0,30,14,30,8,22,7,3,15,0,82,47,1
4127,60474,vjrdb3dcIFRPzYBjbX9bQR9vxorLVp2R,5X6FeZozNMgE2VRi3MJYjkkFK8SETtu2,6,4,2,0,1,0,4,0,11,1.5714285714285714,2,0.0,0,2,0,1,4,0,0,4,0,3,8,1
4128,60528,MvqSmpyUgimv8LaGxWMIruwa3ijANQg7,7GRhBDsirIGkRZBtSMEzNTyDr2JQm4xx,65,90,33,14,37,7,7,0,188,26.857142857142858,2,0.0,51,33,11,37,39,7,3,7,0,132,56,0
4129,60546,uQUPzFXltLm3Yz8qgEvw1fMPbbS4q4MZ,7GRhBDsirIGkRZBtSMEzNTyDr2JQm4xx,18,13,9,0,7,1,6,0,36,5.142857142857143,2,0.0,1,9,0,7,12,1,0,6,0,17,19,1
4130,60582,rxoO7csZGXeNzFVWfGDQB1CjrR87Fi1E,7GRhBDsirIGkRZBtSMEzNTyDr2JQm4xx,2,0,0,0,0,0,4,0,4,0.5714285714285714,2,0.0,0,0,0,0,0,0,0,4,0,0,4,1
4131,60626,XXBE2gEIFzpOALYcvsQaoms0hFg2JiRj,5X6FeZozNMgE2VRi3MJYjkkFK8SETtu2,7,18,3,2,5,0,4,0,32,4.571428571428571,2,0.0,6,3,2,5,12,0,0,4,0,16,16,0
4132,60633,J2mZhHnfnDU9Z2NM0dfjKg8jCciGVkrO,5X6FeZozNMgE2VRi3MJYjkkFK8SETtu2,1,0,0,0,0,0,2,0,2,0.2857142857142857,2,0.0,0,0,0,0,0,0,0,2,0,0,2,1
4133,60704,yNvoGEAldEGg40wBXPaEulBPVW5wyRH0,7GRhBDsirIGkRZBtSMEzNTyDr2JQm4xx,22,49,9,34,1,0,15,0,108,15.428571428571429,2,0.0,16,9,24,1,33,0,10,15,0,50,58,1
4134,60718,Y7IgoRAqVJfNlsulCSI4HObujHPSzoLA,7GRhBDsirIGkRZBtSMEzNTyDr2JQm4xx,1,0,0,0,0,0,1,0,1,0.14285714285714285,1,0.0,0,0,0,0,0,0,0,1,0,0,1,1
4135,60723,QgvoRraMo579WBSQvu2KL1PVI0ztp4eg,7GRhBDsirIGkRZBtSMEzNTyDr2JQm4xx,30,70,22,0,24,1,3,0,120,17.142857142857142,3,0.0,15,22,0,24,55,1,0,3,0,61,59,0
4136,60741,D8UARtO8PEJDGRGb02jImyINnyDXbx45,7GRhBDsirIGkRZBtSMEzNTyDr2JQm4xx,2,0,0,0,0,0,2,0,2,0.2857142857142857,1,0.0,0,0,0,0,0,0,0,2,0,0,2,1
4137,60750,KIzKwTc9s5nLMeFkLowp0YY73nAebF3x,5X6FeZozNMgE2VRi3MJYjkkFK8SETtu2,1,0,0,0,0,0,1,0,1,0.14285714285714285,1,0.0,0,0,0,0,0,0,0,1,0,0,1,1
4138,60775,6jsGEWL0U9hBDrcwX1Jhf47LKTflSRAd,5Gyp41oLVo7Gg7vF4vpmggWP5MU70QO6,9,6,4,0,2,0,6,0,18,2.5714285714285716,3,0.0,0,4,0,2,6,0,0,6,0,6,12,1
4139,60783,o7l3PNeVIF0KFbKUxAraXosVaTUbHolk,5Gyp41oLVo7Gg7vF4vpmggWP5MU70QO6,17,35,16,0,3,14,9,1,78,11.142857142857142,5,0.0,0,16,0,3,35,14,0,9,1,19,59,0
4140,60842,WOMVOuYGnWcZ0JUVdlAJuK7IMUPymW9W,5Gyp41oLVo7Gg7vF4vpmggWP5MU70QO6,5,2,1,0,1,0,2,0,6,0.8571428571428571,1,0.0,0,1,0,1,2,0,0,2,0,2,4,1
4141,60849,8n73BBd3mvRJq2a0KZ4WJWTYj65s8f61,5Gyp41oLVo7Gg7vF4vpmggWP5MU70QO6,17,26,10,6,7,9,4,0,62,8.857142857142858,2,0.0,6,10,3,7,20,9,3,4,0,26,36,1
4142,60867,6MPgAabkihjgEiW7WAmGKWYKFdGXICpQ,5Gyp41oLVo7Gg7vF4vpmggWP5MU70QO6,12,17,6,4,3,3,10,2,45,6.428571428571429,1,0.0,4,6,3,3,13,3,1,10,2,16,29,1
4143,60882,jFlacyEy6lTVCBjW1JtG8q0M3te6pg5n,5Gyp41oLVo7Gg7vF4vpmggWP5MU70QO6,15,13,7,3,5,5,3,1,37,5.285714285714286,1,0.0,5,7,2,5,8,5,1,3,1,19,18,1
4144,60955,M3my6svOw1PavchA0YdMglvZWFkBWiG6,7GRhBDsirIGkRZBtSMEzNTyDr2JQm4xx,17,17,6,6,6,6,9,0,50,7.142857142857143,3,0.0,9,6,4,6,8,6,2,9,0,25,25,1
4145,60958,hcKYo6bLhlANvHE0FxLuR4YY8jocfBwJ,5X6FeZozNMgE2VRi3MJYjkkFK8SETtu2,1,0,0,0,0,0,2,0,2,0.2857142857142857,2,0.0,0,0,0,0,0,0,0,2,0,0,2,1
4146,60999,0mQOSUffcJjPsamqb6puS0gzn5BcFgYT,7GRhBDsirIGkRZBtSMEzNTyDr2JQm4xx,7,0,0,0,0,0,12,1,13,1.8571428571428572,2,0.0,0,0,0,0,0,0,0,12,1,0,13,1
4147,61017,fqE9fKOVWr7QYvXsbQOki5x99YlGSz4q,7GRhBDsirIGkRZBtSMEzNTyDr2JQm4xx,1,0,0,0,0,0,2,0,2,0.2857142857142857,1,0.0,0,0,0,0,0,0,0,2,0,0,2,1
4148,61021,ML7lqxkr8UE3GSzEAbC41OZ48awqIWDQ,5X6FeZozNMgE2VRi3MJYjkkFK8SETtu2,19,34,2,9,12,0,4,0,61,8.714285714285714,2,0.0,20,2,8,12,14,0,1,4,0,42,19,1
4149,61032,2YrfQZgyUPdiZGXhplgKBSkvHochAfw6,7GRhBDsirIGkRZBtSMEzNTyDr2JQm4xx,7,6,4,0,0,0,2,0,12,1.7142857142857142,1,0.0,1,4,0,0,5,0,0,2,0,5,7,1
4150,61034,2Jljmu9EbGTkE1rTEOxUuOimOJr4EGWY,7GRhBDsirIGkRZBtSMEzNTyDr2JQm4xx,37,43,1,39,10,14,5,0,112,16.0,2,0.0,27,1,24,10,16,14,15,5,0,62,50,1
4151,61042,hJwtwnOzJaTrAeP4eXJAEwz2xbKsgc4M,5X6FeZozNMgE2VRi3MJYjkkFK8SETtu2,1,0,0,0,0,0,7,0,7,1.0,6,0.0,0,0,0,0,0,0,0,7,0,0,7,0
4152,61046,T06O7WnBCRWoH9e9v0RWmUTKobJEYFfL,7GRhBDsirIGkRZBtSMEzNTyDr2JQm4xx,1,0,0,0,0,0,1,0,1,0.14285714285714285,1,0.0,0,0,0,0,0,0,0,1,0,0,1,1
4153,61053,n6MSfSRQxQ2tFGWCXdV4l1HaMuqMUtGk,5X6FeZozNMgE2VRi3MJYjkkFK8SETtu2,2,0,0,0,0,0,2,0,2,0.2857142857142857,1,0.0,0,0,0,0,0,0,0,2,0,0,2,1
4154,61078,32y2lN481foloAGLc2nySQzWPV3H4zBA,5X6FeZozNMgE2VRi3MJYjkkFK8SETtu2,52,64,17,70,11,33,23,6,224,32.0,3,0.0,33,17,61,11,31,33,9,23,6,122,102,0
4155,61085,AG6iKV2oiQPN8wTOXQgZ5wPRMFQuNd0H,7GRhBDsirIGkRZBtSMEzNTyDr2JQm4xx,2,0,0,0,0,0,2,0,2,0.2857142857142857,1,0.0,0,0,0,0,0,0,0,2,0,0,2,1
4156,61107,WdSoXtOMswCwqhOj9IeHsSFtlZ2Gh4td,5X6FeZozNMgE2VRi3MJYjkkFK8SETtu2,6,3,2,0,1,0,2,1,9,1.2857142857142858,1,0.0,0,2,0,1,3,0,0,2,1,3,6,1
4157,61111,v6Wfy2XnikKgnCNfehO3TIQzyPp7MzcN,5X6FeZozNMgE2VRi3MJYjkkFK8SETtu2,3,2,0,0,0,0,2,0,4,0.5714285714285714,1,0.0,0,0,0,0,2,0,0,2,0,0,4,1
4158,61116,9JKtUaJcAEBh7CYVmXIhRY2O1dODpq4M,7GRhBDsirIGkRZBtSMEzNTyDr2JQm4xx,14,20,7,0,5,0,1,0,33,4.714285714285714,1,0.0,2,7,0,5,18,0,0,1,0,14,19,1
4159,61117,Bv9FSXvHlE6wLC4E4yrAKqe3BQhrrtfx,5X6FeZozNMgE2VRi3MJYjkkFK8SETtu2,9,12,2,0,2,0,4,0,20,2.857142857142857,3,0.0,0,2,0,2,12,0,0,4,0,4,16,1
4160,61118,pGlV0XYWRjXFSIdN56x9p6AvQyXwsZVS,7GRhBDsirIGkRZBtSMEzNTyDr2JQm4xx,54,87,44,119,10,23,15,0,298,42.57142857142857,10,0.0,26,44,98,10,61,23,21,15,0,178,120,0
4161,61157,ZgFCLkDPzcdiy0sIzPjvfQAgjdD1TUt9,7GRhBDsirIGkRZBtSMEzNTyDr2JQm4xx,37,88,34,33,33,0,9,0,197,28.142857142857142,2,0.0,42,34,20,33,46,0,13,9,0,129,68,0
4162,61172,UMRdBsbRudHs8ingA4ke7ICTKEQFr49p,5X6FeZozNMgE2VRi3MJYjkkFK8SETtu2,3,2,1,0,0,0,3,0,6,0.8571428571428571,2,0.0,0,1,0,0,2,0,0,3,0,1,5,1
4163,61185,n7VbclmNFgHca9uIA7XLlwfjpU3yKU9I,5X6FeZozNMgE2VRi3MJYjkkFK8SETtu2,1,0,0,0,0,0,1,0,1,0.14285714285714285,1,0.0,0,0,0,0,0,0,0,1,0,0,1,1
4164,61191,3aCvKfVcHo3o7tH4s5PG9YBIGdvHDxQN,7GRhBDsirIGkRZBtSMEzNTyDr2JQm4xx,5,2,1,0,1,1,4,0,9,1.2857142857142858,1,0.0,0,1,0,1,2,1,0,4,0,2,7,1
4165,61219,x7KkvyitGXFvQqFgPSjCNkOjX6xpeh38,5X6FeZozNMgE2VRi3MJYjkkFK8SETtu2,1,0,0,0,0,0,1,0,1,0.14285714285714285,1,0.0,0,0,0,0,0,0,0,1,0,0,1,1
4166,61231,KkdnagFJtwwq5n9Iuy7rnQaTqa2llFa9,7GRhBDsirIGkRZBtSMEzNTyDr2JQm4xx,1,0,0,0,0,0,1,0,1,0.14285714285714285,1,0.0,0,0,0,0,0,0,0,1,0,0,1,1
4167,61232,ce2xgxgKPugRCQfAePYG4Tetc1mQMFo7,5X6FeZozNMgE2VRi3MJYjkkFK8SETtu2,12,9,1,0,3,0,11,2,26,3.7142857142857144,2,0.0,4,1,0,3,5,0,0,11,2,8,18,0
4168,61240,c9jABEJQla4i8vH29nKPFM4cx5bWdrLS,5X6FeZozNMgE2VRi3MJYjkkFK8SETtu2,6,4,3,0,2,0,1,0,10,1.4285714285714286,1,0.0,0,3,0,2,4,0,0,1,0,5,5,1
4169,61245,o2ZQJxCanJ3w0ltDKvU6h1ywkqWgYJ6P,5X6FeZozNMgE2VRi3MJYjkkFK8SETtu2,1,0,0,0,0,0,1,0,1,0.14285714285714285,1,0.0,0,0,0,0,0,0,0,1,0,0,1,1
4170,61247,NcQnTEbHZILfo8rybQg3CkBD2Sky9WEj,5X6FeZozNMgE2VRi3MJYjkkFK8SETtu2,1,0,0,0,0,0,1,0,1,0.14285714285714285,1,0.0,0,0,0,0,0,0,0,1,0,0,1,1
4171,61249,4BrxxQsWWJwGRocTSsfalu4whQ4Xfcpc,7GRhBDsirIGkRZBtSMEzNTyDr2JQm4xx,5,2,1,0,1,0,3,0,7,1.0,2,0.0,0,1,0,1,2,0,0,3,0,2,5,1
4172,61255,pZf9C3kBoPRYrDIubyGYbLZN4CZgU7xr,7GRhBDsirIGkRZBtSMEzNTyDr2JQm4xx,6,4,2,0,1,0,2,0,9,1.2857142857142858,1,0.0,2,2,0,1,2,0,0,2,0,5,4,1
4173,61260,cKCzrCCCXe9nkBgWepq9AEXje7SITRTz,7GRhBDsirIGkRZBtSMEzNTyDr2JQm4xx,1,0,0,0,0,0,1,0,1,0.14285714285714285,1,0.0,0,0,0,0,0,0,0,1,0,0,1,1
4174,61264,JEpliMmXtCD1f20f9cDXpO6iC4w7XAsT,3VkHkmOtom3jM2wCu94xgzzu1d6Dn7or,11,15,4,3,3,11,4,1,41,5.857142857142857,1,0.0,7,4,3,3,8,11,0,4,1,17,24,1
4175,61273,vdrctU6z84HquJbn26DyEa3NVX5vLhQL,3VkHkmOtom3jM2wCu94xgzzu1d6Dn7or,47,109,66,68,0,11,59,12,325,46.42857142857143,9,0.0,41,66,66,0,68,11,2,59,12,173,152,0
4176,61280,3ekpb9qQNnBvDGQePlspHv7VLn9RhUhL,3VkHkmOtom3jM2wCu94xgzzu1d6Dn7or,64,225,96,51,58,16,73,2,521,74.42857142857143,12,0.0,87,96,45,58,138,16,6,73,2,286,235,0
4177,61283,5aPAA192VwNTYk7841taL2eEoPM52Jfz,3VkHkmOtom3jM2wCu94xgzzu1d6Dn7or,53,197,34,47,13,1,16,0,308,44.0,4,0.0,84,34,44,13,113,1,3,16,0,175,133,0
4178,61287,vetJW7RuToyhRheyNbhLwQDgLf24lCFq,3VkHkmOtom3jM2wCu94xgzzu1d6Dn7or,71,189,86,41,62,19,26,4,427,61.0,9,0.0,53,86,40,62,136,19,1,26,4,241,186,0
4179,61288,zdy1QpN6U4yT7fJKj0iIeDZ8SZMHSUli,3VkHkmOtom3jM2wCu94xgzzu1d6Dn7or,25,115,59,1,0,8,19,3,205,29.285714285714285,8,0.0,6,59,1,0,109,8,0,19,3,66,139,1
4180,61289,hWqlzSeDUWvRgDnoegNqlT5f17ELTuKs,3VkHkmOtom3jM2wCu94xgzzu1d6Dn7or,1,0,0,0,0,0,1,0,1,0.14285714285714285,1,0.0,0,0,0,0,0,0,0,1,0,0,1,1
4181,61292,j7TgGntsKaHCn37V8wIZU588nsiRvQRv,3VkHkmOtom3jM2wCu94xgzzu1d6Dn7or,5,3,1,0,1,0,2,0,7,1.0,1,0.0,1,1,0,1,2,0,0,2,0,3,4,1
4182,61296,R23hQIkxpjGDipcAUB8Dm9M15B8oN1UL,3VkHkmOtom3jM2wCu94xgzzu1d6Dn7or,4,2,1,0,1,0,2,0,6,0.8571428571428571,1,0.0,0,1,0,1,2,0,0,2,0,2,4,1
4183,61297,IUA6p2JLyLSZjGDsPJmwHTr1A8GTMvVI,3VkHkmOtom3jM2wCu94xgzzu1d6Dn7or,1,0,0,0,0,0,1,0,1,0.14285714285714285,1,0.0,0,0,0,0,0,0,0,1,0,0,1,1
4184,61302,UoGg1lPcQINyRstNoDBUCvVALukMvBmE,3VkHkmOtom3jM2wCu94xgzzu1d6Dn7or,12,27,7,5,9,9,8,1,66,9.428571428571429,1,0.0,17,7,5,9,10,9,0,8,1,38,28,1
4185,61303,ANJ7A7TrnpRJsv1mG7Zq08b8gsBzPJqI,3VkHkmOtom3jM2wCu94xgzzu1d6Dn7or,18,16,5,1,6,8,5,0,41,5.857142857142857,2,0.0,1,5,1,6,15,8,0,5,0,13,28,1
4186,61309,XMft5aKdR2QyFQr0WCozlGeSY245StJA,3VkHkmOtom3jM2wCu94xgzzu1d6Dn7or,14,7,6,0,6,0,1,0,20,2.857142857142857,1,0.0,0,6,0,6,7,0,0,1,0,12,8,1
4187,61322,3BjF53t2QMAE7ObQUT7JSiEn9PG6iUMa,3VkHkmOtom3jM2wCu94xgzzu1d6Dn7or,51,112,57,43,41,1,26,0,280,40.0,8,0.0,33,57,39,41,79,1,4,26,0,170,110,0
4188,61330,8SxkVH1KXschEM8m0GUMD8LyRo49iJfX,3VkHkmOtom3jM2wCu94xgzzu1d6Dn7or,5,2,1,0,1,0,3,0,7,1.0,1,0.0,0,1,0,1,2,0,0,3,0,2,5,1
4189,61337,PBX3b8Kr9EgCK8wPL1p1l8ywBkxFbxYJ,3VkHkmOtom3jM2wCu94xgzzu1d6Dn7or,7,9,4,0,3,0,2,0,18,2.5714285714285716,1,0.0,0,4,0,3,9,0,0,2,0,7,11,1
4190,61338,7Bmm9GcoXo4ZVWS3KQRfYLX18LcqBOIZ,3VkHkmOtom3jM2wCu94xgzzu1d6Dn7or,25,28,18,7,17,4,10,1,85,12.142857142857142,2,0.0,4,18,6,17,24,4,1,10,1,45,40,1
4191,61339,aG1yf2MaLqi6uq33RqoMaXdTZU0rd74j,3VkHkmOtom3jM2wCu94xgzzu1d6Dn7or,1,0,0,0,0,0,1,0,1,0.14285714285714285,1,0.0,0,0,0,0,0,0,0,1,0,0,1,1
4192,61343,grEUheAl7r2qUdLFFy9nEMsG9X5GQrvY,3VkHkmOtom3jM2wCu94xgzzu1d6Dn7or,7,3,0,0,1,3,37,2,46,6.571428571428571,6,0.0,0,0,0,1,3,3,0,37,2,1,45,1
4193,61352,pdAqVvKgeCIaihAcxhTXOYjPQxxjaa8K,3VkHkmOtom3jM2wCu94xgzzu1d6Dn7or,27,43,26,0,9,19,12,3,112,16.0,7,0.0,0,26,0,9,43,19,0,12,3,35,77,0
4194,61358,m049rAeyoDiszWWKcpCd8SSBaFdNVXp5,3VkHkmOtom3jM2wCu94xgzzu1d6Dn7or,4,4,1,0,2,0,1,0,8,1.1428571428571428,1,0.0,2,1,0,2,2,0,0,1,0,5,3,1
4195,61361,v2BQnPPIdaQjY7RJTTV8xwj4C0h9I3eb,3VkHkmOtom3jM2wCu94xgzzu1d6Dn7or,4,2,1,0,1,0,2,0,6,0.8571428571428571,2,0.0,0,1,0,1,2,0,0,2,0,2,4,1
4196,61369,983eChF7TXCDNFahN1r3Vh0veTcz2k4r,3VkHkmOtom3jM2wCu94xgzzu1d6Dn7or,31,99,25,27,32,20,15,0,218,31.142857142857142,7,0.0,58,25,25,32,41,20,2,15,0,140,78,1
4197,61378,muRdAe2fZ5hc80crolkh8NalL0e0B6VK,3VkHkmOtom3jM2wCu94xgzzu1d6Dn7or,22,62,17,20,27,10,6,0,142,20.285714285714285,2,0.0,40,17,18,27,22,10,2,6,0,102,40,0
4198,61383,Nmas2ArombYYvowRmyUSQPWFycG8cFpP,3VkHkmOtom3jM2wCu94xgzzu1d6Dn7or,9,15,6,5,8,3,4,0,41,5.857142857142857,1,0.0,8,6,4,8,7,3,1,4,0,26,15,1
4199,61409,mDwdQwCw7B1nTYkcQqHPipLA4xUDSqaA,3VkHkmOtom3jM2wCu94xgzzu1d6Dn7or,12,7,5,0,4,0,3,0,19,2.7142857142857144,2,0.0,0,5,0,4,7,0,0,3,0,9,10,1
4200,61413,7MbcYCJMqsDkqF86OrGyQBYf6d8IyUP2,3VkHkmOtom3jM2wCu94xgzzu1d6Dn7or,6,1,1,0,1,0,4,0,7,1.0,1,0.0,0,1,0,1,1,0,0,4,0,2,5,1
4201,61414,cpwynrsc92vzcpcvaowjPQ8oLt1LV2qH,3VkHkmOtom3jM2wCu94xgzzu1d6Dn7or,8,11,1,0,4,1,5,0,22,3.142857142857143,2,0.0,0,1,0,4,11,1,0,5,0,5,17,1
4202,61415,C0CJOketxybQKnmXYZM4O9Q98wL6vPo7,3VkHkmOtom3jM2wCu94xgzzu1d6Dn7or,18,52,11,13,18,6,5,0,105,15.0,1,0.0,33,11,10,18,19,6,3,5,0,72,33,0
4203,61422,5v4FcTvaejU15T2ItxUWpcwwFvA20Pjq,3VkHkmOtom3jM2wCu94xgzzu1d6Dn7or,14,8,7,0,7,0,1,0,23,3.2857142857142856,1,0.0,0,7,0,7,8,0,0,1,0,14,9,1
4204,61424,OB72EsCF8FIJeTl5alitCf5PMpMSzMkw,3VkHkmOtom3jM2wCu94xgzzu1d6Dn7or,18,17,13,0,9,0,3,0,42,6.0,3,0.0,0,13,0,9,17,0,0,3,0,22,20,1
4205,61435,o70jYwhoKCmnPM1c3Oxa7KjxPlFBaR5Y,3VkHkmOtom3jM2wCu94xgzzu1d6Dn7or,13,9,5,0,4,3,9,1,31,4.428571428571429,2,0.0,2,5,0,4,7,3,0,9,1,11,20,1
4206,61436,daGaQWvd8jWD5XDvCZOsKViIYZg7WMm2,3VkHkmOtom3jM2wCu94xgzzu1d6Dn7or,20,27,6,12,8,14,4,0,71,10.142857142857142,3,0.0,7,6,11,8,20,14,1,4,0,32,39,1
4207,61441,uCB5uEbohrhji79dydXW4G40PBAqm3fB,3VkHkmOtom3jM2wCu94xgzzu1d6Dn7or,4,2,1,0,0,0,2,0,5,0.7142857142857143,1,0.0,0,1,0,0,2,0,0,2,0,1,4,1
4208,61442,7KmSj9gPWQW08MBykakmpuPR1HhDrt95,3VkHkmOtom3jM2wCu94xgzzu1d6Dn7or,3,0,0,0,0,0,4,0,4,0.5714285714285714,1,0.0,0,0,0,0,0,0,0,4,0,0,4,1
4209,61443,phZKknvLtktzxGbSqd3jYoZNzB4llO7e,3VkHkmOtom3jM2wCu94xgzzu1d6Dn7or,17,43,22,14,9,46,23,3,160,22.857142857142858,4,0.0,9,22,12,9,34,46,2,23,3,52,108,1
4210,61445,XEl6l3YNAqiK2bbAqUBja025BsmiOy3u,3VkHkmOtom3jM2wCu94xgzzu1d6Dn7or,6,4,0,0,1,0,2,0,7,1.0,1,0.0,0,0,0,1,4,0,0,2,0,1,6,1
4211,61453,NRS1MhesGO7zUR8hdwEPUCbOfwrM8vqe,3VkHkmOtom3jM2wCu94xgzzu1d6Dn7or,1,0,0,0,0,0,1,0,1,0.14285714285714285,1,0.0,0,0,0,0,0,0,0,1,0,0,1,1
4212,61454,9RGlF1zN4LpcMozL1W04PrZshJESSRMc,3VkHkmOtom3jM2wCu94xgzzu1d6Dn7or,21,54,21,18,9,13,8,0,123,17.571428571428573,4,0.0,20,21,16,9,34,13,2,8,0,66,57,0
4213,61458,s62wGhBGz9HXss3L6a4JWxa0i5RWwlaT,3VkHkmOtom3jM2wCu94xgzzu1d6Dn7or,16,28,13,5,10,14,9,0,79,11.285714285714286,1,0.0,6,13,4,10,22,14,1,9,0,33,46,1
4214,61463,JgSF96URyx4xETuoqSIyFv46Qndmj1Nf,3VkHkmOtom3jM2wCu94xgzzu1d6Dn7or,5,3,0,0,0,0,5,0,8,1.1428571428571428,2,0.0,0,0,0,0,3,0,0,5,0,0,8,1
4215,61472,xEf6ArYJDQPvlIL0dlKzw54A012YoV5b,3VkHkmOtom3jM2wCu94xgzzu1d6Dn7or,8,6,2,0,3,0,2,0,13,1.8571428571428572,1,0.0,0,2,0,3,6,0,0,2,0,5,8,1
4216,61476,tj4EHeHo9HuoGvU4vkCjfii6Us385itQ,3VkHkmOtom3jM2wCu94xgzzu1d6Dn7or,6,2,1,0,1,0,9,1,14,2.0,1,0.0,0,1,0,1,2,0,0,9,1,2,12,1
4217,61477,QclfSjcpKfuYDuPZ2QSbL6dQsQJRlpNz,3VkHkmOtom3jM2wCu94xgzzu1d6Dn7or,1,0,0,0,0,0,1,0,1,0.14285714285714285,1,0.0,0,0,0,0,0,0,0,1,0,0,1,1
4218,61487,YfLkHn3sP8pusiYlKK6o5F2jXKBNkL8d,3VkHkmOtom3jM2wCu94xgzzu1d6Dn7or,73,318,105,70,97,79,38,1,708,101.14285714285714,13,0.0,145,105,63,97,173,79,7,38,1,410,298,0
4219,61490,6LOq8KkmV5c0FKxzWJqIgAOWRnnZZoko,3VkHkmOtom3jM2wCu94xgzzu1d6Dn7or,8,18,7,0,4,1,8,1,39,5.571428571428571,4,0.0,0,7,0,4,18,1,0,8,1,11,28,1
4220,61491,QJLvLq3gePlOhM8YM9FYb5Ju7geKwvAe,3VkHkmOtom3jM2wCu94xgzzu1d6Dn7or,4,2,1,0,0,0,2,0,5,0.7142857142857143,1,0.0,0,1,0,0,2,0,0,2,0,1,4,1
4221,61494,a4RYqILKcnu8c617gYSbD0KQIm9DqZnc,3VkHkmOtom3jM2wCu94xgzzu1d6Dn7or,14,22,1,9,2,0,10,0,44,6.285714285714286,1,0.0,7,1,8,2,15,0,1,10,0,18,26,1
4222,61504,n3nLIdaq5tMG7W5fYlQfmpVKio954PQo,3VkHkmOtom3jM2wCu94xgzzu1d6Dn7or,56,137,39,38,48,31,22,1,316,45.142857142857146,7,0.0,80,39,32,48,57,31,6,22,1,199,117,0
4223,61505,TDWwQzWRFKSB58lhGmZfTgWh2AXj0IEg,3VkHkmOtom3jM2wCu94xgzzu1d6Dn7or,1,0,0,0,0,0,1,0,1,0.14285714285714285,1,0.0,0,0,0,0,0,0,0,1,0,0,1,1
4224,61515,V42fQnxEvfLIX0xediorVPrFT3AqjWxV,3VkHkmOtom3jM2wCu94xgzzu1d6Dn7or,11,13,7,0,5,0,3,0,28,4.0,2,0.0,3,7,0,5,10,0,0,3,0,15,13,1
4225,61525,PoH1dyt4rU4L6DwgAxdBCMIsFGeifqpi,3VkHkmOtom3jM2wCu94xgzzu1d6Dn7or,5,5,2,0,1,2,3,0,13,1.8571428571428572,1,0.0,0,2,0,1,5,2,0,3,0,3,10,1
4226,61527,0zObXmoXHP7rszDYuu8m5842mUKzCfEP,3VkHkmOtom3jM2wCu94xgzzu1d6Dn7or,14,23,12,7,7,48,22,9,128,18.285714285714285,2,0.0,3,12,6,7,20,48,1,22,9,28,100,1
4227,61546,wwbn6fxolJbKMPkZNKyvhoEMjxJa1TwV,3VkHkmOtom3jM2wCu94xgzzu1d6Dn7or,6,11,4,0,3,0,2,0,20,2.857142857142857,2,0.0,4,4,0,3,7,0,0,2,0,11,9,1
4228,61550,dJoaCvWN3EHhsbVDKX0go1Uowy9lNb0x,3VkHkmOtom3jM2wCu94xgzzu1d6Dn7or,25,33,21,10,16,1,5,0,86,12.285714285714286,3,0.0,6,21,9,16,27,1,1,5,0,52,34,1
4229,61551,wusaIU5qw1H9frm0uNri3Vm4KGQ9haEv,3VkHkmOtom3jM2wCu94xgzzu1d6Dn7or,21,51,21,9,12,15,19,2,129,18.428571428571427,3,0.0,12,21,8,12,39,15,1,19,2,53,76,1
4230,61557,sT9hGAnww95aeGvqwQpJlS3ORhWDT49F,3VkHkmOtom3jM2wCu94xgzzu1d6Dn7or,24,59,23,13,16,4,13,0,128,18.285714285714285,5,0.0,19,23,12,16,40,4,1,13,0,70,58,0
4231,61564,LPE2LOhMecA7VGBvL2FJKN8PdPw13cWH,3VkHkmOtom3jM2wCu94xgzzu1d6Dn7or,6,2,1,0,1,0,7,0,11,1.5714285714285714,2,0.0,0,1,0,1,2,0,0,7,0,2,9,1
4232,61566,RWCpdR1QB6n8j1h0KpkVY43KpnLl1nGl,3VkHkmOtom3jM2wCu94xgzzu1d6Dn7or,2,0,0,0,0,0,2,0,2,0.2857142857142857,1,0.0,0,0,0,0,0,0,0,2,0,0,2,1
4233,61567,IJw5Z6gzTBCnSJikgjAAPcSAKOBBnV80,3VkHkmOtom3jM2wCu94xgzzu1d6Dn7or,4,2,1,0,1,0,1,0,5,0.7142857142857143,1,0.0,0,1,0,1,2,0,0,1,0,2,3,1
4234,61574,EttKeSyg9r0EcjglXuiRsuMNde5ZPNQV,3VkHkmOtom3jM2wCu94xgzzu1d6Dn7or,1,0,0,0,0,0,1,0,1,0.14285714285714285,1,0.0,0,0,0,0,0,0,0,1,0,0,1,1
4235,61576,avQyhVbbLRU4xSqnn8C1NdzgvYmkJMZ5,3VkHkmOtom3jM2wCu94xgzzu1d6Dn7or,11,23,10,7,12,1,2,0,55,7.857142857142857,4,0.0,12,10,6,12,11,1,1,2,0,40,15,1
4236,61583,PB9Q9zUiehL1k7ymOn3dwnmL6aMiqjzW,3VkHkmOtom3jM2wCu94xgzzu1d6Dn7or,52,77,49,0,47,3,17,0,193,27.571428571428573,12,0.0,0,49,0,47,77,3,0,17,0,96,97,0
4237,61592,BAErsYTdltqVQgh0VALINL0pm3QcxIG4,SpATywNh6bZuzm8s1ceuBUnMUAeoAHHw,29,34,2,44,0,0,4,0,84,12.0,1,0.0,7,2,40,0,27,0,4,4,0,49,35,0
4238,61594,gAvRDaA2RH7LeyEqnpEQ7DzPuz3btZqk,SpATywNh6bZuzm8s1ceuBUnMUAeoAHHw,42,55,31,25,0,20,9,1,141,20.142857142857142,7,0.0,17,31,24,0,38,20,1,9,1,72,69,0
4239,61595,3rZRyyAqQR0LHT7iXSTyhR4wZI7IzOpN,SpATywNh6bZuzm8s1ceuBUnMUAeoAHHw,42,56,3,51,3,0,10,0,123,17.571428571428573,5,0.0,16,3,45,3,40,0,6,10,0,67,56,0
4240,61601,gLjUrp9o3bBy4JIhHE7DImScxZdU76o3,bWdj2GDclj5ofokWjzoa5jAwMkxCykd6,76,62,37,228,17,0,3,0,347,49.57142857142857,12,0.0,15,37,202,17,47,0,26,3,0,271,76,0
4241,61613,gF4BAuOIIfmyUL9KgVWqdIaoDpcXFfvU,SpATywNh6bZuzm8s1ceuBUnMUAeoAHHw,22,79,28,18,5,0,14,1,145,20.714285714285715,4,0.0,10,28,16,5,69,0,2,14,1,59,86,1
4242,61621,DalyYw8MkLaUQVgRjoRWxfyFlojIr1rE,SpATywNh6bZuzm8s1ceuBUnMUAeoAHHw,7,2,0,0,0,1,5,1,9,1.2857142857142858,1,0.0,0,0,0,0,2,1,0,5,1,0,9,1
4243,61630,mEaBiGskXMI8aCGx7L64re12PFHqkWG3,5X6FeZozNMgE2VRi3MJYjkkFK8SETtu2,1,0,0,0,0,0,1,0,1,0.14285714285714285,1,0.0,0,0,0,0,0,0,0,1,0,0,1,1
4244,61633,nAYvdcBZT3LBrha8JRPtv9HcsoTpFg23,SpATywNh6bZuzm8s1ceuBUnMUAeoAHHw,12,10,2,35,0,0,3,0,50,7.142857142857143,2,0.0,4,2,31,0,6,0,4,3,0,37,13,0
4245,61645,SFn8cPDrlBEOeUqlExt2aQA0JeO7ehU8,7GRhBDsirIGkRZBtSMEzNTyDr2JQm4xx,7,3,2,0,2,0,3,0,10,1.4285714285714286,1,0.0,0,2,0,2,3,0,0,3,0,4,6,1
4246,61683,e2DCnBsdIMfs4frEMfrVflupqPP0kjPk,SpATywNh6bZuzm8s1ceuBUnMUAeoAHHw,4,3,2,0,2,0,1,0,8,1.1428571428571428,1,0.0,0,2,0,2,3,0,0,1,0,4,4,1
4247,61685,Iy2ElCZpRw3zxSRKsJzk7TkINwbfRI7p,A3fsA9Zfv1X2fVEQhTw51lKENdNrEqT3,2,0,0,0,0,0,2,0,2,0.2857142857142857,1,0.0,0,0,0,0,0,0,0,2,0,0,2,1
4248,61700,BtXHQTU4PSU1WxWZavlraTV0sQL99KBJ,SpATywNh6bZuzm8s1ceuBUnMUAeoAHHw,26,160,55,39,3,4,24,1,286,40.857142857142854,5,0.0,59,55,34,3,101,4,5,24,1,151,135,0
4249,61718,dfQzarPyX3ZOG61gPJJguJUtLjMr4a3c,5X6FeZozNMgE2VRi3MJYjkkFK8SETtu2,10,11,1,0,2,4,14,1,33,4.714285714285714,2,0.0,2,1,0,2,9,4,0,14,1,5,28,1
4250,61720,g5Zuj0nrhTe9a8GO1yZuWyTfnljIqqOF,SpATywNh6bZuzm8s1ceuBUnMUAeoAHHw,1,0,0,0,0,0,1,0,1,0.14285714285714285,1,0.0,0,0,0,0,0,0,0,1,0,0,1,1
4251,61757,lH1Zg2rCl3kv8uXAu0T77rdY9bAtw7jj,A3fsA9Zfv1X2fVEQhTw51lKENdNrEqT3,1,0,0,0,0,0,1,0,1,0.14285714285714285,1,0.0,0,0,0,0,0,0,0,1,0,0,1,1
4252,61768,6ewbhsgJh7NTFUpGTc6v0or3nCOYP5Dz,A3fsA9Zfv1X2fVEQhTw51lKENdNrEqT3,7,4,3,0,3,0,3,0,13,1.8571428571428572,1,0.0,0,3,0,3,4,0,0,3,0,6,7,1
4253,61769,8OaIpodRGkGBtSK5GRdmOhSTzFcjSPbv,SpATywNh6bZuzm8s1ceuBUnMUAeoAHHw,4,2,0,0,0,0,2,1,5,0.7142857142857143,1,0.0,0,0,0,0,2,0,0,2,1,0,5,1
4254,61783,9y6ouBDNmbaFfULhDrj0DUptWL9j98bK,A3fsA9Zfv1X2fVEQhTw51lKENdNrEqT3,11,8,5,0,4,0,8,0,25,3.5714285714285716,2,0.0,0,5,0,4,8,0,0,8,0,9,16,1
4255,61786,CE534SSZ9CscDvjbZWQWNUmxhQozf8Uw,SpATywNh6bZuzm8s1ceuBUnMUAeoAHHw,41,55,32,50,14,0,5,0,156,22.285714285714285,4,0.0,17,32,41,14,38,0,9,5,0,104,52,0
4256,61792,0uyw0Qpq6NMqAKkX4nFU1z9zeAKJ6uAx,SpATywNh6bZuzm8s1ceuBUnMUAeoAHHw,1,0,0,0,0,0,2,0,2,0.2857142857142857,2,0.0,0,0,0,0,0,0,0,2,0,0,2,1
4257,61798,C912XMR2YQ2SiCcqNj7moioYbFr61u4G,SpATywNh6bZuzm8s1ceuBUnMUAeoAHHw,60,119,62,54,30,38,19,0,322,46.0,7,0.0,20,62,44,30,99,38,10,19,0,156,166,0
4258,61807,6ewbhsgJh7NTFUpGTc6v0or3nCOYP5Dz,7GRhBDsirIGkRZBtSMEzNTyDr2JQm4xx,1,0,0,0,0,0,1,0,1,0.14285714285714285,1,0.0,0,0,0,0,0,0,0,1,0,0,1,1
4259,61830,kwuXJ2OlYPv73Qvs7nhCrPuljDf9YYGy,SpATywNh6bZuzm8s1ceuBUnMUAeoAHHw,33,48,17,48,3,17,19,1,153,21.857142857142858,3,0.0,19,17,41,3,29,17,7,19,1,80,73,0
4260,61841,Oqve774ifHTeH2UMCaBdRSrpGoboQSMz,7GRhBDsirIGkRZBtSMEzNTyDr2JQm4xx,2,0,0,0,0,0,2,0,2,0.2857142857142857,1,0.0,0,0,0,0,0,0,0,2,0,0,2,1
4261,61871,P3kOv3cSNYdczGGa8D095f64NMPEAkCq,7GRhBDsirIGkRZBtSMEzNTyDr2JQm4xx,13,17,1,10,0,2,10,2,42,6.0,1,0.0,6,1,8,0,11,2,2,10,2,15,27,0
4262,61873,GjYrFH6x4o6vyLHEw4EuuSJvAfuLPk1y,SpATywNh6bZuzm8s1ceuBUnMUAeoAHHw,32,56,30,30,11,1,14,0,142,20.285714285714285,5,0.0,18,30,24,11,38,1,6,14,0,83,59,0
4263,61879,fHEcWln3a2mF8YT5C7MBT2amDZFG7e3O,bWdj2GDclj5ofokWjzoa5jAwMkxCykd6,6,3,2,0,2,0,1,0,8,1.1428571428571428,1,0.0,0,2,0,2,3,0,0,1,0,4,4,1
4264,61887,BCPOhUa2LrfH93ebCE15VbF0VEWEyi7T,A3fsA9Zfv1X2fVEQhTw51lKENdNrEqT3,2,0,0,0,0,0,3,0,3,0.42857142857142855,2,0.0,0,0,0,0,0,0,0,3,0,0,3,1
4265,61891,Ahk1LGYY70CyZ8ESdZW417bRWfeRmJfs,bWdj2GDclj5ofokWjzoa5jAwMkxCykd6,1,0,0,0,0,0,1,0,1,0.14285714285714285,1,0.0,0,0,0,0,0,0,0,1,0,0,1,1
4266,61894,Jpxsd7AQ90urdftfAf3y5kTy6w3x8OIk,bWdj2GDclj5ofokWjzoa5jAwMkxCykd6,7,7,3,0,1,0,4,0,15,2.142857142857143,2,0.0,0,3,0,1,7,0,0,4,0,4,11,0
4267,61898,9yCiTXZqdk1Eqh0c2zCIzdE0Lnr56YUk,bWdj2GDclj5ofokWjzoa5jAwMkxCykd6,7,2,1,0,1,21,8,0,33,4.714285714285714,1,0.0,0,1,0,1,2,21,0,8,0,2,31,1
4268,61901,kMbNfi6zi59dGBz5Mew0yipwDJ0jO4S2,7GRhBDsirIGkRZBtSMEzNTyDr2JQm4xx,34,72,31,34,32,6,15,2,192,27.428571428571427,3,0.0,31,31,29,32,41,6,5,15,2,123,69,1
4269,61902,q2vdNmhZGOp0NF57Oy2lI01Qgjw4Vdei,SpATywNh6bZuzm8s1ceuBUnMUAeoAHHw,13,32,21,1,12,0,6,0,72,10.285714285714286,5,0.0,3,21,1,12,29,0,0,6,0,37,35,1
4270,61904,zt8D4cN45BQ8WOokF7iya4FQJ1n05JY2,SpATywNh6bZuzm8s1ceuBUnMUAeoAHHw,8,12,9,0,0,0,4,0,25,3.5714285714285716,2,0.0,0,9,0,0,12,0,0,4,0,9,16,0
4271,61913,SELnldPPHeEehfXeLln8ZyG56a4eP0sK,bWdj2GDclj5ofokWjzoa5jAwMkxCykd6,10,10,7,0,5,0,3,0,25,3.5714285714285716,1,0.0,1,7,0,5,9,0,0,3,0,13,12,1
4272,61932,Bt8fhv7JWMS0R0BH7KVe6T8wFL5ltC7B,SpATywNh6bZuzm8s1ceuBUnMUAeoAHHw,1,0,0,0,0,0,1,0,1,0.14285714285714285,1,0.0,0,0,0,0,0,0,0,1,0,0,1,0
4273,61938,rf0PAlVV7dAbnB4kixwqY56KcswtG4PA,SpATywNh6bZuzm8s1ceuBUnMUAeoAHHw,45,92,20,50,15,0,13,4,194,27.714285714285715,3,0.0,14,20,42,15,78,0,8,13,4,91,103,0
4274,61940,gaDguOzhGUiRAlt47AbgfmnftuQ8EhI2,SpATywNh6bZuzm8s1ceuBUnMUAeoAHHw,56,92,47,82,25,47,11,1,305,43.57142857142857,5,0.0,23,47,70,25,69,47,12,11,1,165,140,1
4275,61966,CGa05qeYRddNsilbgdI6KEuTUktkBAbB,A3fsA9Zfv1X2fVEQhTw51lKENdNrEqT3,11,7,3,0,2,4,15,0,31,4.428571428571429,1,0.0,0,3,0,2,7,4,0,15,0,5,26,1
4276,61982,mVfMHNhmAc9wpidT4yWiDxyeVB96h1nE,5X6FeZozNMgE2VRi3MJYjkkFK8SETtu2,1,0,0,0,0,0,1,0,1,0.14285714285714285,1,0.0,0,0,0,0,0,0,0,1,0,0,1,1
4277,61988,FX39OUMp2fc5cOhN2hgQkfpLfm3Fwtwz,SpATywNh6bZuzm8s1ceuBUnMUAeoAHHw,1,0,0,0,0,0,1,0,1,0.14285714285714285,1,0.0,0,0,0,0,0,0,0,1,0,0,1,1
4278,62007,n9EKrEMijwWCzLds970XMB69EdoGIA9c,SpATywNh6bZuzm8s1ceuBUnMUAeoAHHw,3,2,1,0,0,0,2,0,5,0.7142857142857143,1,0.0,0,1,0,0,2,0,0,2,0,1,4,0
4279,62017,2YGBvXv59qjJLs5KOOScSmZh8Ujmphvd,7GRhBDsirIGkRZBtSMEzNTyDr2JQm4xx,7,12,5,0,1,1,2,0,21,3.0,2,0.0,4,5,0,1,8,1,0,2,0,10,11,1
4280,62020,RYtiMEnLizT9o6Yga3jfTWdH35jeH8Bp,SpATywNh6bZuzm8s1ceuBUnMUAeoAHHw,41,84,35,111,12,9,16,2,269,38.42857142857143,3,0.0,29,35,104,12,55,9,7,16,2,180,89,0
4281,62025,PDbQl9kvVSEqhb3jM3LOTLEyGnuh6urj,SpATywNh6bZuzm8s1ceuBUnMUAeoAHHw,42,53,34,3,20,0,13,0,123,17.571428571428573,5,0.0,3,34,3,20,50,0,0,13,0,60,63,0
4282,62026,CGa05qeYRddNsilbgdI6KEuTUktkBAbB,bWdj2GDclj5ofokWjzoa5jAwMkxCykd6,2,0,0,0,0,0,2,0,2,0.2857142857142857,1,0.0,0,0,0,0,0,0,0,2,0,0,2,1
4283,62027,NcracMTfiaTPMbO6SSDnt9CDc4SnvBs9,bWdj2GDclj5ofokWjzoa5jAwMkxCykd6,73,53,27,154,12,11,28,2,287,41.0,7,0.0,13,27,147,12,40,11,7,28,2,199,88,0
4284,62042,ml2yAwYHzufxZ6xJCtzUFr2eNYyPECGG,SpATywNh6bZuzm8s1ceuBUnMUAeoAHHw,27,53,23,42,8,0,6,0,132,18.857142857142858,3,0.0,23,23,37,8,30,0,5,6,0,91,41,1
4285,62055,a1efNowRcq2gF4IVdG8KeX19HTVYcbsT,SpATywNh6bZuzm8s1ceuBUnMUAeoAHHw,8,6,3,0,2,0,3,0,14,2.0,1,0.0,0,3,0,2,6,0,0,3,0,5,9,0
4286,62059,9ehdZJgt67O7mOenLhkYXTuYl4yTUru4,SpATywNh6bZuzm8s1ceuBUnMUAeoAHHw,1,0,0,0,0,0,1,0,1,0.14285714285714285,1,0.0,0,0,0,0,0,0,0,1,0,0,1,0
4287,62063,vWtXB9fnfyjB9iyhwPt2xcqr2iv2ZY0B,SpATywNh6bZuzm8s1ceuBUnMUAeoAHHw,1,0,0,0,0,0,1,0,1,0.14285714285714285,1,0.0,0,0,0,0,0,0,0,1,0,0,1,1
4288,62069,2Hz2Bz07sxK2sow8U4zT67rsa0lMVzzp,7GRhBDsirIGkRZBtSMEzNTyDr2JQm4xx,1,0,0,0,0,0,1,0,1,0.14285714285714285,1,0.0,0,0,0,0,0,0,0,1,0,0,1,1
4289,62071,gRHI1NeWW3c6BFrZIrJSlWu9NHDjRltm,7GRhBDsirIGkRZBtSMEzNTyDr2JQm4xx,1,0,0,0,0,0,1,0,1,0.14285714285714285,1,0.0,0,0,0,0,0,0,0,1,0,0,1,1
4290,62075,gRHI1NeWW3c6BFrZIrJSlWu9NHDjRltm,bWdj2GDclj5ofokWjzoa5jAwMkxCykd6,1,0,0,0,0,0,1,0,1,0.14285714285714285,1,0.0,0,0,0,0,0,0,0,1,0,0,1,1
4291,62088,bLPEpCuYsmeWbTY9JjZOVLY19KeTEHtM,A3fsA9Zfv1X2fVEQhTw51lKENdNrEqT3,6,4,1,2,0,1,2,0,10,1.4285714285714286,1,0.0,0,1,2,0,4,1,0,2,0,3,7,1
4292,62101,uJIh67cllxQLgAhipzdDZMEunDbuBxvF,SpATywNh6bZuzm8s1ceuBUnMUAeoAHHw,25,29,19,4,7,6,11,1,77,11.0,3,0.0,6,19,4,7,23,6,0,11,1,36,41,0
4293,62111,ty20JLEucwjTjC7HbP2Y2gtbJGr1vzD6,SpATywNh6bZuzm8s1ceuBUnMUAeoAHHw,1,0,0,0,0,0,1,0,1,0.14285714285714285,1,0.0,0,0,0,0,0,0,0,1,0,0,1,1
4294,62128,R2cga9JVVM2tXEVs2saYswslfxAU4nMk,A3fsA9Zfv1X2fVEQhTw51lKENdNrEqT3,15,16,12,2,3,0,12,0,45,6.428571428571429,9,0.0,1,12,2,3,15,0,0,12,0,18,27,1
4295,62129,i045qgxm9LaqFzlH53qyz9yZHDVsE7Hd,bWdj2GDclj5ofokWjzoa5jAwMkxCykd6,9,6,4,0,3,8,4,0,25,3.5714285714285716,1,0.0,0,4,0,3,6,8,0,4,0,7,18,0
4296,62140,WmzYkzlMNuHgERGSMthySa2d3K7cWcp2,7GRhBDsirIGkRZBtSMEzNTyDr2JQm4xx,12,7,5,0,4,0,4,0,20,2.857142857142857,1,0.0,0,5,0,4,7,0,0,4,0,9,11,1
4297,62169,9t1Jq485XoOlmuEU542k0g35doAqmykj,SpATywNh6bZuzm8s1ceuBUnMUAeoAHHw,8,11,7,0,2,0,5,0,25,3.5714285714285716,2,0.0,0,7,0,2,11,0,0,5,0,9,16,0
4298,62184,M0jptr5D68D6baUayyF6SculX0moohK0,5X6FeZozNMgE2VRi3MJYjkkFK8SETtu2,1,0,0,0,0,0,1,0,1,0.14285714285714285,1,0.0,0,0,0,0,0,0,0,1,0,0,1,1
4299,62203,PsNVk3Md7dMGBd7LIUOcdD27KZ5BQNaX,SpATywNh6bZuzm8s1ceuBUnMUAeoAHHw,4,2,0,0,0,0,2,0,4,0.5714285714285714,1,0.0,0,0,0,0,2,0,0,2,0,0,4,1
4300,62213,QbN1rcT6X70kGcCCu9qHO2zQXGCyhPMc,SpATywNh6bZuzm8s1ceuBUnMUAeoAHHw,32,47,29,21,16,0,9,0,122,17.428571428571427,4,0.0,5,29,18,16,42,0,3,9,0,68,54,1
4301,62214,P9ocaJAKrVY3fEwlpYkQdiICF2x4gV0B,7GRhBDsirIGkRZBtSMEzNTyDr2JQm4xx,5,6,3,0,2,1,1,0,13,1.8571428571428572,1,0.0,1,3,0,2,5,1,0,1,0,6,7,0
4302,62237,6uGfB9iS03wfmd1xUXhuaJ677E1IqurA,A3fsA9Zfv1X2fVEQhTw51lKENdNrEqT3,7,4,3,0,2,0,2,0,11,1.5714285714285714,1,0.0,0,3,0,2,4,0,0,2,0,5,6,1
4303,62244,FFy9L7p4obidKBTk4qOOmRiOMU1mIx1C,SpATywNh6bZuzm8s1ceuBUnMUAeoAHHw,1,0,0,0,0,0,1,0,1,0.14285714285714285,1,0.0,0,0,0,0,0,0,0,1,0,0,1,0
4304,62254,X4KSPkBIdPEeXdEy4Fa5NvixCQZdfNj3,SpATywNh6bZuzm8s1ceuBUnMUAeoAHHw,26,24,15,24,4,5,6,0,78,11.142857142857142,3,0.0,5,15,19,4,19,5,5,6,0,43,35,1
4305,62264,ayXSJHlkjoyFUB4Y9YHZnlOXt35wvwwu,A3fsA9Zfv1X2fVEQhTw51lKENdNrEqT3,23,52,29,0,23,0,11,0,115,16.428571428571427,3,0.0,0,29,0,23,52,0,0,11,0,52,63,1
4306,62267,e0Ue3uuVlmEePOF8zM1ckf1RsP4Zsuxv,bWdj2GDclj5ofokWjzoa5jAwMkxCykd6,6,2,1,0,1,1,3,1,9,1.2857142857142858,1,0.0,0,1,0,1,2,1,0,3,1,2,7,1
4307,62272,k7GcrgNM8NrAzS9cqFwxMdS1Vs120F2Y,A3fsA9Zfv1X2fVEQhTw51lKENdNrEqT3,7,5,1,0,0,0,2,0,8,1.1428571428571428,1,0.0,0,1,0,0,5,0,0,2,0,1,7,0
4308,62284,6PXZHdG3e34wBLMiUtuXkQDClu7qjM54,A3fsA9Zfv1X2fVEQhTw51lKENdNrEqT3,28,39,13,30,11,0,6,0,99,14.142857142857142,1,0.0,0,13,25,11,39,0,5,6,0,49,50,0
4309,62296,6iPl0SuUXO0i0LHkQ72lY7Z3ARsCLoWd,SpATywNh6bZuzm8s1ceuBUnMUAeoAHHw,9,8,2,0,2,0,5,0,17,2.4285714285714284,1,0.0,0,2,0,2,8,0,0,5,0,4,13,1
4310,62297,WmzYkzlMNuHgERGSMthySa2d3K7cWcp2,A3fsA9Zfv1X2fVEQhTw51lKENdNrEqT3,16,15,12,0,11,0,4,0,42,6.0,1,0.0,0,12,0,11,15,0,0,4,0,23,19,1
4311,62312,l4QykzFcC41mVGOdUpTYCbuYnqmkZCXe,SpATywNh6bZuzm8s1ceuBUnMUAeoAHHw,29,53,4,36,3,0,5,0,101,14.428571428571429,4,0.0,21,4,33,3,32,0,3,5,0,61,40,0
4312,62328,sw3OXyPqqSkej4mWR3KJTUD97lZa8Tx0,bWdj2GDclj5ofokWjzoa5jAwMkxCykd6,5,6,0,0,0,0,3,0,9,1.2857142857142858,2,0.0,0,0,0,0,6,0,0,3,0,0,9,0
4313,62334,mxPD6RdGoMu7JHsQZE9N0YGZHXBsDKre,7GRhBDsirIGkRZBtSMEzNTyDr2JQm4xx,6,1,1,0,1,0,4,0,7,1.0,1,0.0,0,1,0,1,1,0,0,4,0,2,5,1
4314,62335,o4bCCaWBA9uHbyXIM2IOJcgIkEya6ZFa,SpATywNh6bZuzm8s1ceuBUnMUAeoAHHw,16,19,6,16,3,0,5,0,49,7.0,2,0.0,7,6,15,3,12,0,1,5,0,31,18,0
4315,62349,YBtKAFQt6fk6EIukc4Ut5J2kdzYxomaP,SpATywNh6bZuzm8s1ceuBUnMUAeoAHHw,19,46,28,15,18,0,16,0,123,17.571428571428573,5,0.0,6,28,12,18,40,0,3,16,0,64,59,1
4316,62350,5iW3vlcO8vpNOCUFgKYYNPtpsdBe3kdD,SpATywNh6bZuzm8s1ceuBUnMUAeoAHHw,5,5,1,0,0,0,2,0,8,1.1428571428571428,1,0.0,2,1,0,0,3,0,0,2,0,3,5,1
4317,62356,wjS8ie6ACTxewSCQo7zpBy0tu4z4RYPD,SpATywNh6bZuzm8s1ceuBUnMUAeoAHHw,42,62,2,50,0,1,39,1,155,22.142857142857142,11,0.0,12,2,43,0,50,1,7,39,1,57,98,0
4318,62360,g1maG24WsPdpEOMuZUsxQc7SlEYHJjT4,bWdj2GDclj5ofokWjzoa5jAwMkxCykd6,11,23,11,0,5,0,11,1,51,7.285714285714286,4,0.0,2,11,0,5,21,0,0,11,1,18,33,0
4319,62368,4ct6kljhf27XSdXxxeVXKJL0lQ4aKOK7,7GRhBDsirIGkRZBtSMEzNTyDr2JQm4xx,20,43,4,10,1,0,15,0,73,10.428571428571429,3,0.0,5,4,8,1,38,0,2,15,0,18,55,1
4320,62373,coay6DHChZspTIiqVyUpf7Vdo7lLxepM,A3fsA9Zfv1X2fVEQhTw51lKENdNrEqT3,5,3,2,0,2,0,9,0,16,2.2857142857142856,1,0.0,0,2,0,2,3,0,0,9,0,4,12,1
4321,62381,m2GM5nfba5AfGmEJzump9yjCc3h5OBqL,SpATywNh6bZuzm8s1ceuBUnMUAeoAHHw,7,11,5,0,4,0,2,0,22,3.142857142857143,2,0.0,0,5,0,4,11,0,0,2,0,9,13,1
4322,62396,jGKZSsHerE5dciVNZBuJOf3EyWVEldkX,7GRhBDsirIGkRZBtSMEzNTyDr2JQm4xx,1,0,0,0,0,0,1,0,1,0.14285714285714285,1,0.0,0,0,0,0,0,0,0,1,0,0,1,1
4323,62402,yTWMOTSwApx7g1lIaGFcROXS4h3ETTZ1,SpATywNh6bZuzm8s1ceuBUnMUAeoAHHw,6,3,1,0,1,0,2,0,7,1.0,1,0.0,0,1,0,1,3,0,0,2,0,2,5,1
4324,62410,rORIPSFi0Cq6NYeD2hhC73kNxeeqmFyP,7GRhBDsirIGkRZBtSMEzNTyDr2JQm4xx,3,2,0,0,0,0,1,0,3,0.42857142857142855,1,0.0,0,0,0,0,2,0,0,1,0,0,3,1
4325,62418,xv4Co45Jkfnr7XgY6wKaXH06aRG1xbQV,5X6FeZozNMgE2VRi3MJYjkkFK8SETtu2,11,8,6,2,4,0,3,0,23,3.2857142857142856,3,0.0,0,6,2,4,8,0,0,3,0,12,11,0
4326,62425,2AUmJLK3ogn8OSTOrZM181baCczbYXkL,SpATywNh6bZuzm8s1ceuBUnMUAeoAHHw,1,0,0,0,0,0,1,0,1,0.14285714285714285,1,0.0,0,0,0,0,0,0,0,1,0,0,1,1
4327,62428,Y5CSlxjOPHMFV7ik3pSpx6t0PJdYKnrH,SpATywNh6bZuzm8s1ceuBUnMUAeoAHHw,55,60,38,27,23,5,16,0,169,24.142857142857142,8,0.0,12,38,22,23,48,5,5,16,0,95,74,0
4328,62437,vhnbHBui7nCh3pAshTJ2BoFD1CEurx5q,SpATywNh6bZuzm8s1ceuBUnMUAeoAHHw,29,54,10,19,7,1,20,5,116,16.571428571428573,10,0.0,5,10,16,7,49,1,3,20,5,38,78,0
4329,62443,ogzXep3azQvjQ2uIPIxw4TZLNiUXYlgD,A3fsA9Zfv1X2fVEQhTw51lKENdNrEqT3,10,28,20,0,2,0,5,0,55,7.857142857142857,3,0.0,2,20,0,2,26,0,0,5,0,24,31,0
4330,62457,k3z8wjqNUcBUtJc11ZY5CI3syE6W1pg9,SpATywNh6bZuzm8s1ceuBUnMUAeoAHHw,9,7,5,0,3,0,6,0,21,3.0,2,0.0,0,5,0,3,7,0,0,6,0,8,13,0
4331,62458,j8vYdYwa9gvt7hkF8dykZR2D4h75QsII,SpATywNh6bZuzm8s1ceuBUnMUAeoAHHw,53,69,33,65,13,13,16,1,210,30.0,7,0.0,27,33,54,13,42,13,11,16,1,127,83,1
4332,62467,n8L9wTZCh5rXNBzkkTit4t034Y491eKa,SpATywNh6bZuzm8s1ceuBUnMUAeoAHHw,25,48,2,31,2,0,7,1,91,13.0,1,0.0,11,2,29,2,37,0,2,7,1,44,47,0
4333,62473,f6KqnppFPlkp6t9yk3tSYaItqJ9vCGLv,SpATywNh6bZuzm8s1ceuBUnMUAeoAHHw,17,8,6,0,6,0,7,1,28,4.0,2,0.0,0,6,0,6,8,0,0,7,1,12,16,1
4334,62484,l0WeYpTymokLlVEEJTixsYdgJaxPgZqy,7GRhBDsirIGkRZBtSMEzNTyDr2JQm4xx,2,0,0,0,0,0,2,0,2,0.2857142857142857,2,0.0,0,0,0,0,0,0,0,2,0,0,2,1
4335,62485,sEiuytxgvtmcXA3wvuyEX6jl9ipM75JD,A3fsA9Zfv1X2fVEQhTw51lKENdNrEqT3,38,20,15,46,14,0,1,0,96,13.714285714285714,1,0.0,0,15,39,14,20,0,7,1,0,68,28,0
4336,62490,GWSq56qmQUucFgSgP2raEZeoKP7Athee,SpATywNh6bZuzm8s1ceuBUnMUAeoAHHw,38,107,2,49,2,15,21,1,197,28.142857142857142,8,0.0,10,2,47,2,97,15,2,21,1,61,136,0
4337,62495,cviEHKkObdnrsdhgu782x2qKQLthxxXP,SpATywNh6bZuzm8s1ceuBUnMUAeoAHHw,1,0,0,0,0,0,1,0,1,0.14285714285714285,1,0.0,0,0,0,0,0,0,0,1,0,0,1,1
4338,62496,sXsuKZQK6v2jgcNJf2x8mPlA2ABOffAD,bWdj2GDclj5ofokWjzoa5jAwMkxCykd6,3,2,0,0,0,0,1,0,3,0.42857142857142855,1,0.0,0,0,0,0,2,0,0,1,0,0,3,1
4339,62514,ggEr2STKTwtSSUdtGCmiPr3DBu3TJ34B,A3fsA9Zfv1X2fVEQhTw51lKENdNrEqT3,12,10,1,8,0,0,3,0,22,3.142857142857143,3,0.0,0,1,8,0,10,0,0,3,0,9,13,1
4340,62530,l7f4vHvlZkxCYoU9qM63V45bmndBSeZQ,SpATywNh6bZuzm8s1ceuBUnMUAeoAHHw,23,24,6,54,0,0,6,0,90,12.857142857142858,4,0.0,9,6,48,0,15,0,6,6,0,63,27,0
4341,62557,7FBwqoodmzhvrGGLuwBjRrxsykocUv8u,bWdj2GDclj5ofokWjzoa5jAwMkxCykd6,15,12,5,22,4,2,11,1,57,8.142857142857142,2,0.0,5,5,21,4,7,2,1,11,1,35,22,1
4342,62563,PrE64zhEuNh83grWL2cXaZZPY2nI1xUf,bWdj2GDclj5ofokWjzoa5jAwMkxCykd6,1,0,0,0,0,0,1,0,1,0.14285714285714285,1,0.0,0,0,0,0,0,0,0,1,0,0,1,1
4343,62565,oxtnm7X5FHQqXVLLooUhCWZ3R8fCCDoE,SpATywNh6bZuzm8s1ceuBUnMUAeoAHHw,7,3,2,0,2,0,2,0,9,1.2857142857142858,1,0.0,0,2,0,2,3,0,0,2,0,4,5,0
4344,62566,CO3sprBt7zms4eyX8oyF4N8qFejqwRFV,5X6FeZozNMgE2VRi3MJYjkkFK8SETtu2,93,128,47,21,80,0,9,0,285,40.714285714285715,6,0.0,69,47,19,80,59,0,2,9,0,215,70,1
4345,62576,ogmMRCX7tMP9zl6WROraIuGWloPIZQ3P,SpATywNh6bZuzm8s1ceuBUnMUAeoAHHw,62,76,47,34,27,36,14,3,237,33.857142857142854,6,0.0,20,47,31,27,56,36,3,14,3,125,112,1
4346,62589,EdUaZuk8ESEyWYRZCWJ8ZQBbz43WEgwY,A3fsA9Zfv1X2fVEQhTw51lKENdNrEqT3,7,3,2,0,2,0,2,0,9,1.2857142857142858,1,0.0,0,2,0,2,3,0,0,2,0,4,5,1
4347,62593,fBjkk55LEjUXpgvkPNjyZGCtR2am4TcN,SpATywNh6bZuzm8s1ceuBUnMUAeoAHHw,52,62,39,25,22,0,13,0,161,23.0,8,0.0,5,39,24,22,57,0,1,13,0,90,71,0
4348,62611,i2NIot2usiDyEsWQY7zT18X1uj2FHoWH,7GRhBDsirIGkRZBtSMEzNTyDr2JQm4xx,31,38,8,71,12,0,2,0,131,18.714285714285715,1,0.0,30,8,62,12,8,0,9,2,0,112,19,1
4349,62620,lmeMhWa8hXVoeC6vmJbPTxkNCUltvvzl,5X6FeZozNMgE2VRi3MJYjkkFK8SETtu2,5,2,1,0,1,0,5,0,9,1.2857142857142858,2,0.0,0,1,0,1,2,0,0,5,0,2,7,1
4350,62641,CiIoUCLeseImRUfekH5MRA89dX7Bqx1s,SpATywNh6bZuzm8s1ceuBUnMUAeoAHHw,9,12,1,0,0,0,7,1,21,3.0,1,0.0,0,1,0,0,12,0,0,7,1,1,20,0
4351,62642,uoDWDjctsplt3HhO40cJ31SItxonwlgR,SpATywNh6bZuzm8s1ceuBUnMUAeoAHHw,11,12,6,0,3,1,4,0,26,3.7142857142857144,3,0.0,1,6,0,3,11,1,0,4,0,10,16,1
4352,62648,tUrqZSUN7RW61T1PpyF2X9YW8Ok3vUek,A3fsA9Zfv1X2fVEQhTw51lKENdNrEqT3,7,5,3,0,2,0,2,0,12,1.7142857142857142,2,0.0,0,3,0,2,5,0,0,2,0,5,7,1
4353,62652,KfoZ69zTNu1FkbuybYuVyLqWQTXsDAu5,A3fsA9Zfv1X2fVEQhTw51lKENdNrEqT3,6,3,2,0,2,0,1,0,8,1.1428571428571428,1,0.0,0,2,0,2,3,0,0,1,0,4,4,1
4354,62655,8qABUnBBHxxZkfUhEQNUn5NNMSRrqvPC,SpATywNh6bZuzm8s1ceuBUnMUAeoAHHw,23,53,24,35,0,0,9,0,121,17.285714285714285,7,0.0,18,24,31,0,35,0,4,9,0,73,48,1
4355,62664,6rvhZ1qSfYtmyLXdh13xI1z8Ly1xy1X7,A3fsA9Zfv1X2fVEQhTw51lKENdNrEqT3,11,7,5,0,3,0,5,1,21,3.0,2,0.0,0,5,0,3,7,0,0,5,1,8,13,1
4356,62691,vLDUFKClgtT31VAwcYV5sIfp3TdS79BU,A3fsA9Zfv1X2fVEQhTw51lKENdNrEqT3,25,32,4,52,2,0,10,0,100,14.285714285714286,3,0.0,0,4,45,2,32,0,7,10,0,51,49,1
4357,62695,N0Sos51WanCzoSGKDmMPzQtMlLxY3bFb,A3fsA9Zfv1X2fVEQhTw51lKENdNrEqT3,187,168,102,352,51,86,108,5,872,124.57142857142857,16,0.0,13,102,300,51,155,86,52,108,5,466,406,0
4358,62704,HwmOe48TnHpxGJFpJY55xag3SIXvxDtW,SpATywNh6bZuzm8s1ceuBUnMUAeoAHHw,3,0,0,0,0,0,3,0,3,0.42857142857142855,1,0.0,0,0,0,0,0,0,0,3,0,0,3,1
4359,62716,Q21gO7wmi4OQk1e1YfdnwYevUUmHUJft,5X6FeZozNMgE2VRi3MJYjkkFK8SETtu2,5,5,3,0,3,0,3,0,14,2.0,2,0.0,0,3,0,3,5,0,0,3,0,6,8,1
4360,62728,Ve2CzncgteRmVYAwotsiyIfRd71Uy29E,SpATywNh6bZuzm8s1ceuBUnMUAeoAHHw,7,5,0,2,0,2,2,0,11,1.5714285714285714,1,0.0,3,0,2,0,2,2,0,2,0,5,6,1
4361,62741,SMph1YQCIZlmphiUl0TLsRAe6lO4LFpT,bWdj2GDclj5ofokWjzoa5jAwMkxCykd6,6,2,1,0,1,0,4,0,8,1.1428571428571428,1,0.0,0,1,0,1,2,0,0,4,0,2,6,0
4362,62751,RjUWkdPtbuKazr3SZ8iaujuOx2ne7ey1,7GRhBDsirIGkRZBtSMEzNTyDr2JQm4xx,30,54,23,26,17,23,7,1,151,21.571428571428573,3,0.0,24,23,26,17,30,23,0,7,1,90,61,0
4363,62753,TRu3o7re8Hct8XLR9vEEV1PqQQjCMyIk,SpATywNh6bZuzm8s1ceuBUnMUAeoAHHw,13,38,4,0,1,0,24,0,67,9.571428571428571,2,0.0,1,4,0,1,37,0,0,24,0,6,61,0
4364,62780,7lWGgkVC73zkYVnYZAzOXyCIO3N3M6br,SpATywNh6bZuzm8s1ceuBUnMUAeoAHHw,46,65,24,29,13,1,12,0,144,20.571428571428573,9,0.0,13,24,25,13,52,1,4,12,0,75,69,0
4365,62788,N24rIsVu8N2zgaIu1cFWHYg7IEXvRm7B,SpATywNh6bZuzm8s1ceuBUnMUAeoAHHw,25,22,4,52,1,7,9,0,95,13.571428571428571,2,0.0,7,4,52,1,15,7,0,9,0,64,31,0
4366,62790,wLyViiqrdSPB3KP8OihPcsmMpcPB2yFu,7GRhBDsirIGkRZBtSMEzNTyDr2JQm4xx,6,3,1,0,1,0,2,0,7,1.0,1,0.0,0,1,0,1,3,0,0,2,0,2,5,1
4367,62797,1OhYjs584O7cQTJvOonaydB6tDuRCwGL,SpATywNh6bZuzm8s1ceuBUnMUAeoAHHw,1,0,0,0,0,0,1,0,1,0.14285714285714285,1,0.0,0,0,0,0,0,0,0,1,0,0,1,1
4368,62810,jkLf5s9Tdb22fUhtxgRjd7TDlKmc2OGK,A3fsA9Zfv1X2fVEQhTw51lKENdNrEqT3,14,8,6,0,5,0,3,0,22,3.142857142857143,3,0.0,0,6,0,5,8,0,0,3,0,11,11,1
4369,62822,LJYBef7iIBiSZz8D7KTtMTsdkyd91gnR,7GRhBDsirIGkRZBtSMEzNTyDr2JQm4xx,1,0,0,0,0,0,1,0,1,0.14285714285714285,1,0.0,0,0,0,0,0,0,0,1,0,0,1,1
4370,62834,TfNQptQajWTQqzlzDAn72SRQxELYzNd4,SpATywNh6bZuzm8s1ceuBUnMUAeoAHHw,14,35,2,21,1,31,11,1,102,14.571428571428571,6,0.0,12,2,18,1,23,31,3,11,1,33,69,0
4371,62835,Wx4OW1b1MfVESAexiltid2V2dN7xsH1D,SpATywNh6bZuzm8s1ceuBUnMUAeoAHHw,16,53,3,0,1,2,5,0,64,9.142857142857142,7,0.0,1,3,0,1,52,2,0,5,0,5,59,0
4372,62888,mne1Bu1F2f0U7iravmS4eQYQtLTkVvPe,7GRhBDsirIGkRZBtSMEzNTyDr2JQm4xx,1,0,0,0,0,0,1,0,1,0.14285714285714285,1,0.0,0,0,0,0,0,0,0,1,0,0,1,1
4373,62899,o3ye5hXMUgVndWGmjUO0YDQyBTnAFl5e,SpATywNh6bZuzm8s1ceuBUnMUAeoAHHw,1,0,0,0,0,0,1,0,1,0.14285714285714285,1,0.0,0,0,0,0,0,0,0,1,0,0,1,1
4374,62900,eS5XywA64oauZkENyWLpeVNsSbZFhj1k,7GRhBDsirIGkRZBtSMEzNTyDr2JQm4xx,4,2,1,0,1,0,1,0,5,0.7142857142857143,1,0.0,0,1,0,1,2,0,0,1,0,2,3,0
4375,62902,ukCIrv5h45nbdIEPPmMlvipT87B8fFE7,7GRhBDsirIGkRZBtSMEzNTyDr2JQm4xx,1,0,0,0,0,0,1,0,1,0.14285714285714285,1,0.0,0,0,0,0,0,0,0,1,0,0,1,1
4376,62936,l6huwkyakLvA9G4ixwxpAcJxBdbbcmJP,SpATywNh6bZuzm8s1ceuBUnMUAeoAHHw,60,87,41,64,24,4,22,1,243,34.714285714285715,8,0.0,29,41,54,24,58,4,10,22,1,148,95,0
4377,62938,eLqag6twmL6nT6SLVrpY07QGG3bytKwe,SpATywNh6bZuzm8s1ceuBUnMUAeoAHHw,10,26,4,0,2,1,14,1,48,6.857142857142857,8,0.0,0,4,0,2,26,1,0,14,1,6,42,0
4378,62955,fHcFG25wfoThOxprF90lZQv51IcnKwVi,A3fsA9Zfv1X2fVEQhTw51lKENdNrEqT3,1,0,0,0,0,0,1,0,1,0.14285714285714285,1,0.0,0,0,0,0,0,0,0,1,0,0,1,1
4379,62970,RS564zscXajJOiW9woDtEu4M9LDaNEPd,7GRhBDsirIGkRZBtSMEzNTyDr2JQm4xx,28,32,15,0,11,0,5,0,63,9.0,4,0.0,0,15,0,11,32,0,0,5,0,26,37,1
4380,62985,SDq3f6KWdckVLJCSJxIwedwz5gfJhoTJ,SpATywNh6bZuzm8s1ceuBUnMUAeoAHHw,21,43,19,18,3,12,16,1,112,16.0,6,0.0,15,19,15,3,28,12,3,16,1,52,60,1
4381,62987,rPCeZQYVVNgo8SwvznMXuxYDPy2tLzTl,bWdj2GDclj5ofokWjzoa5jAwMkxCykd6,8,4,1,6,1,0,2,0,14,2.0,1,0.0,1,1,5,1,3,0,1,2,0,8,6,0
4382,62990,6TtfboxYzA2v82ZY0ZrDHWT36KPZi8LG,A3fsA9Zfv1X2fVEQhTw51lKENdNrEqT3,6,3,1,0,1,0,2,0,7,1.0,1,0.0,0,1,0,1,3,0,0,2,0,2,5,1
4383,63008,MjjHVlUuOHpErRpbxsSv5C4Ujl4db690,bWdj2GDclj5ofokWjzoa5jAwMkxCykd6,24,16,0,126,0,7,2,0,151,21.571428571428573,2,0.0,4,0,119,0,12,7,7,2,0,123,28,1
4384,63017,CJUKQmzJ66PH4IqEGPhfRE6a1iKmCA2J,SpATywNh6bZuzm8s1ceuBUnMUAeoAHHw,5,5,2,0,1,0,3,0,11,1.5714285714285714,1,0.0,0,2,0,1,5,0,0,3,0,3,8,0
4385,63019,W2ohBuN5JfRDGloM0s99vkGQJHKKrtyK,SpATywNh6bZuzm8s1ceuBUnMUAeoAHHw,4,2,0,0,0,0,2,0,4,0.5714285714285714,1,0.0,0,0,0,0,2,0,0,2,0,0,4,0
4386,63021,h6BCw3lF3hfMo5lMia90jbFn8R4SWDoH,bWdj2GDclj5ofokWjzoa5jAwMkxCykd6,5,2,1,0,1,0,2,0,6,0.8571428571428571,1,0.0,0,1,0,1,2,0,0,2,0,2,4,1
4387,63025,JSINmVzUIC6vntWsWg4ycbpyoaRbhs6q,SpATywNh6bZuzm8s1ceuBUnMUAeoAHHw,4,6,0,0,0,0,1,0,7,1.0,1,0.0,0,0,0,0,6,0,0,1,0,0,7,1
4388,63047,LWWGMAVHUf3PF6BlKef9Rc6itscQOf6h,A3fsA9Zfv1X2fVEQhTw51lKENdNrEqT3,8,9,2,0,2,0,5,0,18,2.5714285714285716,1,0.0,1,2,0,2,8,0,0,5,0,5,13,0
4389,63072,TvDWPoJyTprTu0vxto5NxLIJOfQBmxVE,7GRhBDsirIGkRZBtSMEzNTyDr2JQm4xx,48,133,15,44,15,8,28,1,244,34.857142857142854,9,0.0,30,15,33,15,103,8,11,28,1,93,151,0
4390,63082,IkcvB8sOwGvLINRAnWtwQaMkImc3j5J1,SpATywNh6bZuzm8s1ceuBUnMUAeoAHHw,11,8,7,0,7,0,3,0,25,3.5714285714285716,1,0.0,0,7,0,7,8,0,0,3,0,14,11,1
4391,63087,5SW8vE01d3BlXE9ngOPkuvhZYzh2PoXk,SpATywNh6bZuzm8s1ceuBUnMUAeoAHHw,1,0,0,0,0,0,1,0,1,0.14285714285714285,1,0.0,0,0,0,0,0,0,0,1,0,0,1,1
4392,63100,WYoMb9pjSPIkNMKnbh6vDtB0LRCn2aRR,A3fsA9Zfv1X2fVEQhTw51lKENdNrEqT3,6,5,3,0,1,0,3,0,12,1.7142857142857142,1,0.0,0,3,0,1,5,0,0,3,0,4,8,1
4393,63103,Hxi6d4DzV7K1jcnZIhXlJzpIYDP4sYeZ,SpATywNh6bZuzm8s1ceuBUnMUAeoAHHw,6,0,0,0,0,6,6,1,13,1.8571428571428572,1,0.0,0,0,0,0,0,6,0,6,1,0,13,0
4394,63124,8nlNDsWSaxHCvsMKtqhBs81sknEiTCeb,A3fsA9Zfv1X2fVEQhTw51lKENdNrEqT3,74,63,51,4,43,0,8,0,169,24.142857142857142,5,0.0,0,51,3,43,63,0,1,8,0,97,72,0
4395,63129,8nlNDsWSaxHCvsMKtqhBs81sknEiTCeb,5X6FeZozNMgE2VRi3MJYjkkFK8SETtu2,56,83,28,0,63,0,8,0,182,26.0,7,0.0,49,28,0,63,34,0,0,8,0,140,42,0
4396,63142,3GR5S0zuvKrN9Rve6lwut3ksRMKirOvu,SpATywNh6bZuzm8s1ceuBUnMUAeoAHHw,1,0,0,0,0,0,1,0,1,0.14285714285714285,1,0.0,0,0,0,0,0,0,0,1,0,0,1,0
4397,63161,CcZ2EQGxkq4lhEIujCU8FZkit7DT7C79,7GRhBDsirIGkRZBtSMEzNTyDr2JQm4xx,5,0,0,0,0,0,5,1,6,0.8571428571428571,2,0.0,0,0,0,0,0,0,0,5,1,0,6,0
4398,63187,CTfjOlWW4k8IhTEXOJYJ7bo74K8z07kZ,A3fsA9Zfv1X2fVEQhTw51lKENdNrEqT3,2,0,0,0,0,0,4,0,4,0.5714285714285714,2,0.0,0,0,0,0,0,0,0,4,0,0,4,0
4399,63227,B2dhxt3kePkYjJgrT7zCaVH7s7VuJwMd,A3fsA9Zfv1X2fVEQhTw51lKENdNrEqT3,8,4,3,0,3,0,1,0,11,1.5714285714285714,1,0.0,0,3,0,3,4,0,0,1,0,6,5,1
4400,63242,jzQypdHgDGImzo6sjFmv4z8itS7CTk6P,7GRhBDsirIGkRZBtSMEzNTyDr2JQm4xx,33,105,2,88,9,9,26,2,241,34.42857142857143,4,0.0,47,2,75,9,58,9,13,26,2,133,108,1
4401,63266,97ov4fTuLcUGM3NRcbowYBsVQSUEYP2S,A3fsA9Zfv1X2fVEQhTw51lKENdNrEqT3,2,0,0,0,0,0,2,0,2,0.2857142857142857,1,0.0,0,0,0,0,0,0,0,2,0,0,2,1
4402,63271,DHenWrxVzReZszxo1qw3Im0Zj99tiAII,A3fsA9Zfv1X2fVEQhTw51lKENdNrEqT3,67,50,26,138,13,32,20,1,280,40.0,7,0.0,10,26,118,13,40,32,20,20,1,167,113,0
4403,63299,HvCZ1bV9L7D0erySzp1UH1mW8tuWfYPw,7GRhBDsirIGkRZBtSMEzNTyDr2JQm4xx,32,68,21,43,12,18,10,0,172,24.571428571428573,3,0.0,24,21,34,12,44,18,9,10,0,91,81,1
4404,63301,NOKImnD6AK3k9IbTXegWVhq8o6CU7Nqb,5X6FeZozNMgE2VRi3MJYjkkFK8SETtu2,5,2,1,0,1,0,2,0,6,0.8571428571428571,1,0.0,0,1,0,1,2,0,0,2,0,2,4,1
4405,63313,EY7vkfJ7gquIHvxtRnRiXcTTf5pHgdjX,A3fsA9Zfv1X2fVEQhTw51lKENdNrEqT3,13,21,2,0,2,0,3,0,28,4.0,2,0.0,0,2,0,2,21,0,0,3,0,4,24,1
4406,63317,cCSfok1u0ViZa45fCaFvMzY0bswyqxIC,7GRhBDsirIGkRZBtSMEzNTyDr2JQm4xx,1,0,0,0,0,0,1,0,1,0.14285714285714285,1,0.0,0,0,0,0,0,0,0,1,0,0,1,1
4407,63322,Q7wqVDqz10tk4xe6QnkzI1dJqMLzdK4Z,7GRhBDsirIGkRZBtSMEzNTyDr2JQm4xx,29,76,24,12,15,1,16,0,144,20.571428571428573,8,0.0,46,24,7,15,30,1,5,16,0,92,52,0
4408,63368,UkY8GL1wnGxl65A7vEeGH2v9yDS6ABDQ,7GRhBDsirIGkRZBtSMEzNTyDr2JQm4xx,1,0,0,0,0,0,1,0,1,0.14285714285714285,1,0.0,0,0,0,0,0,0,0,1,0,0,1,1
4409,63379,jSPgiXDCISXGmLFuOlDszBfMRRboKynI,7GRhBDsirIGkRZBtSMEzNTyDr2JQm4xx,7,6,3,0,2,0,2,0,13,1.8571428571428572,2,0.0,0,3,0,2,6,0,0,2,0,5,8,1
4410,63383,KDzfaWgTSBqeMJLFLmFuh4CMLsva9aWu,A3fsA9Zfv1X2fVEQhTw51lKENdNrEqT3,67,26,1,144,1,0,9,1,182,26.0,2,0.0,3,1,129,1,23,0,15,9,1,134,48,0
4411,63422,6vO1t7bAvkyNzwmqVxy2KURwXULJdtv2,A3fsA9Zfv1X2fVEQhTw51lKENdNrEqT3,12,5,1,28,0,0,1,0,35,5.0,1,0.0,0,1,24,0,5,0,4,1,0,25,10,1
4412,63427,OcEwAP7KVM22YlzUoPdivyTSWtkZ4qVM,7GRhBDsirIGkRZBtSMEzNTyDr2JQm4xx,2,0,0,0,0,0,5,0,5,0.7142857142857143,2,0.0,0,0,0,0,0,0,0,5,0,0,5,1
4413,63439,YPxQmDfYnmHgiT7CBa1xK3KUyMZAnQfd,7GRhBDsirIGkRZBtSMEzNTyDr2JQm4xx,10,5,3,4,3,0,2,0,17,2.4285714285714284,1,0.0,1,3,4,3,4,0,0,2,0,11,6,1
4414,63461,4TtGjmtd4ISORDD5okRgx7kXAcGUW8IN,7GRhBDsirIGkRZBtSMEzNTyDr2JQm4xx,118,214,86,182,72,54,73,1,682,97.42857142857143,17,0.0,116,86,149,72,98,54,33,73,1,423,259,0
4415,63488,VYo3NyZyhfOpyU6dELs63jcxK1pOYgip,A3fsA9Zfv1X2fVEQhTw51lKENdNrEqT3,5,1,1,0,0,0,7,0,9,1.2857142857142858,1,0.0,0,1,0,0,1,0,0,7,0,1,8,0
4416,63529,DPNeCmHDELHrss8mkRKEcvkApu8OfWuh,7GRhBDsirIGkRZBtSMEzNTyDr2JQm4xx,6,3,2,0,2,0,1,0,8,1.1428571428571428,1,0.0,0,2,0,2,3,0,0,1,0,4,4,1
4417,63565,AumBArZbFsuZrJ22dCd66gJYrxhP9K8S,7GRhBDsirIGkRZBtSMEzNTyDr2JQm4xx,6,2,1,0,1,0,4,0,8,1.1428571428571428,1,0.0,0,1,0,1,2,0,0,4,0,2,6,1
4418,63568,ibHntt3xSwry6DyouiN0fYSmzCgepI7L,7GRhBDsirIGkRZBtSMEzNTyDr2JQm4xx,5,2,1,0,1,0,2,0,6,0.8571428571428571,1,0.0,0,1,0,1,2,0,0,2,0,2,4,1
4419,63569,oioEx16Qafdl8cwDYVMh95PwtEgk5wrw,7GRhBDsirIGkRZBtSMEzNTyDr2JQm4xx,6,7,0,7,0,0,2,0,16,2.2857142857142856,1,0.0,1,0,6,0,6,0,1,2,0,7,9,1
4420,63576,7MQqMUzAoBFEcqTatVu5Epa9H5xTJ6XT,A3fsA9Zfv1X2fVEQhTw51lKENdNrEqT3,199,100,79,382,57,3,28,1,650,92.85714285714286,8,0.0,7,79,326,57,93,3,56,28,1,469,181,0
4421,63596,koNIIdoqi1yUhLIZAXp5I3Fl17qrPzNm,A3fsA9Zfv1X2fVEQhTw51lKENdNrEqT3,8,7,0,0,0,0,3,0,10,1.4285714285714286,1,0.0,0,0,0,0,7,0,0,3,0,0,10,1
4422,63602,d0OQm2fl37nUvfl8Q7XxAwON3v0i0KHs,7GRhBDsirIGkRZBtSMEzNTyDr2JQm4xx,1,0,0,0,0,0,1,0,1,0.14285714285714285,1,0.0,0,0,0,0,0,0,0,1,0,0,1,1
4423,63605,Oq6ytGesBgZJoERFNPZjhX7GxTg6Xu0N,A3fsA9Zfv1X2fVEQhTw51lKENdNrEqT3,16,21,3,0,5,0,3,0,32,4.571428571428571,1,0.0,0,3,0,5,21,0,0,3,0,8,24,0
4424,63607,Z4Qw4SArt1e9s7GCjrn46q6LGr0U6QAS,A3fsA9Zfv1X2fVEQhTw51lKENdNrEqT3,1,0,0,0,0,0,1,0,1,0.14285714285714285,1,0.0,0,0,0,0,0,0,0,1,0,0,1,1
4425,63610,E8bimkwa2NguL8hrnTueXaCb8pmMf9l4,A3fsA9Zfv1X2fVEQhTw51lKENdNrEqT3,1,0,0,0,0,0,1,0,1,0.14285714285714285,1,0.0,0,0,0,0,0,0,0,1,0,0,1,1
4426,63620,it01smNZGBSxfN1xuqQJBeHc2ONqrDBW,A3fsA9Zfv1X2fVEQhTw51lKENdNrEqT3,14,12,2,0,2,1,8,1,26,3.7142857142857144,3,0.0,1,2,0,2,11,1,0,8,1,5,21,1
4427,63687,dtbXtMjPqeEvzoZBFe2y9uSDcjL0lnx2,A3fsA9Zfv1X2fVEQhTw51lKENdNrEqT3,102,170,49,147,32,30,45,1,474,67.71428571428571,11,0.0,9,49,120,32,161,30,27,45,1,210,264,0
4428,63689,CgV8h6fVQX3XsDvfyJSvNIv0BWBLNKWC,A3fsA9Zfv1X2fVEQhTw51lKENdNrEqT3,1,0,0,0,0,0,1,0,1,0.14285714285714285,1,0.0,0,0,0,0,0,0,0,1,0,0,1,1
4429,63698,uA8SH3KKGTykRcaxzO63OBZZtTvabLlI,7GRhBDsirIGkRZBtSMEzNTyDr2JQm4xx,7,3,1,0,1,0,3,0,8,1.1428571428571428,1,0.0,0,1,0,1,3,0,0,3,0,2,6,1
4430,63703,GulRMWFcPY5JE8HNbJPRyRdVqJqL2eEA,A3fsA9Zfv1X2fVEQhTw51lKENdNrEqT3,8,9,1,0,1,0,11,0,22,3.142857142857143,2,0.0,0,1,0,1,9,0,0,11,0,2,20,0
4431,63843,a6scXvKGCEGtZzcyo2e8X5h7SntETXd0,A3fsA9Zfv1X2fVEQhTw51lKENdNrEqT3,43,43,19,42,17,1,6,1,129,18.428571428571427,1,0.0,1,19,41,17,42,1,1,6,1,78,51,0
4432,63880,4RiemE5r88jWq9gaL0lVYzjeUhWq3sNP,7GRhBDsirIGkRZBtSMEzNTyDr2JQm4xx,2,0,0,0,0,0,3,0,3,0.42857142857142855,1,0.0,0,0,0,0,0,0,0,3,0,0,3,1
4433,63903,4RiemE5r88jWq9gaL0lVYzjeUhWq3sNP,A3fsA9Zfv1X2fVEQhTw51lKENdNrEqT3,9,4,3,0,3,0,3,0,13,1.8571428571428572,2,0.0,0,3,0,3,4,0,0,3,0,6,7,1
4434,63909,k57D5r1HBQsYTFYwjCvC4VLOFbsyC3KY,5X6FeZozNMgE2VRi3MJYjkkFK8SETtu2,3,2,1,0,0,0,1,0,4,0.5714285714285714,1,0.0,0,1,0,0,2,0,0,1,0,1,3,1
4435,63921,JgSF96URyx4xETuoqSIyFv46Qndmj1Nf,5X6FeZozNMgE2VRi3MJYjkkFK8SETtu2,6,7,2,0,1,0,5,0,15,2.142857142857143,3,0.0,0,2,0,1,7,0,0,5,0,3,12,1
4436,63975,vSoHqjlgOX9Gp12iQzdBUtqEoI4dyxq9,7GRhBDsirIGkRZBtSMEzNTyDr2JQm4xx,1,0,0,0,0,0,1,0,1,0.14285714285714285,1,0.0,0,0,0,0,0,0,0,1,0,0,1,1
4437,63986,kYf958xQgpYsrp0Tv3pEoO2XCYRj674R,7GRhBDsirIGkRZBtSMEzNTyDr2JQm4xx,7,3,2,0,0,1,6,1,13,1.8571428571428572,1,0.0,0,2,0,0,3,1,0,6,1,2,11,1
4438,64022,GSVK27iuI3PAZqwurTaJZ7s4wwjamYAo,A3fsA9Zfv1X2fVEQhTw51lKENdNrEqT3,5,2,1,0,1,0,2,0,6,0.8571428571428571,1,0.0,0,1,0,1,2,0,0,2,0,2,4,1
4439,64056,dpaGOQqV12WO7eNeCUpu7DUPmdhwuEC5,7GRhBDsirIGkRZBtSMEzNTyDr2JQm4xx,1,0,0,0,0,0,1,0,1,0.14285714285714285,1,0.0,0,0,0,0,0,0,0,1,0,0,1,1
4440,64077,mXlrU28Kv8cfLAxq0MxNoannB4pjWEly,5X6FeZozNMgE2VRi3MJYjkkFK8SETtu2,10,10,5,3,5,0,2,0,25,3.5714285714285716,1,0.0,4,5,3,5,6,0,0,2,0,17,8,1
4441,64081,lHeM4AOiziJNI87uU55rrS382KB11VeQ,5X6FeZozNMgE2VRi3MJYjkkFK8SETtu2,1,0,0,0,0,0,1,0,1,0.14285714285714285,1,0.0,0,0,0,0,0,0,0,1,0,0,1,1
4442,64107,D0c1Dv0mb5pX9YfP3iB7fNf1CKquBRcj,A3fsA9Zfv1X2fVEQhTw51lKENdNrEqT3,2,0,0,0,0,0,2,0,2,0.2857142857142857,1,0.0,0,0,0,0,0,0,0,2,0,0,2,1
4443,64121,o45RIQZX8Ed2OnEzyGdVHATs1znjDfJY,A3fsA9Zfv1X2fVEQhTw51lKENdNrEqT3,5,2,0,0,0,1,4,0,7,1.0,2,0.0,0,0,0,0,2,1,0,4,0,0,7,1
4444,64151,3ioSZYAXMViIN47K3FwYb4YRv6Ucf2yK,A3fsA9Zfv1X2fVEQhTw51lKENdNrEqT3,1,0,0,0,0,0,1,0,1,0.14285714285714285,1,0.0,0,0,0,0,0,0,0,1,0,0,1,1
4445,64152,e6qJWnBH5Aakpza4HlA3Q0irc2hEFZ0M,7GRhBDsirIGkRZBtSMEzNTyDr2JQm4xx,9,9,1,0,1,0,4,0,15,2.142857142857143,2,0.0,0,1,0,1,9,0,0,4,0,2,13,1
4446,64155,g1jy8yGB1FqGK09piS6JHmRh3fD1ZENx,A3fsA9Zfv1X2fVEQhTw51lKENdNrEqT3,1,0,0,0,0,0,1,0,1,0.14285714285714285,1,0.0,0,0,0,0,0,0,0,1,0,0,1,1
4447,64180,i2J6aqN1hjSmK6hlxQNLieqUjCtUZ1CB,5X6FeZozNMgE2VRi3MJYjkkFK8SETtu2,5,2,1,0,1,0,2,0,6,0.8571428571428571,1,0.0,0,1,0,1,2,0,0,2,0,2,4,1
4448,64207,KXpPNhmbAuFPVQDoTiad8XvdETYdDx1U,3VkHkmOtom3jM2wCu94xgzzu1d6Dn7or,21,30,18,8,12,1,4,1,74,10.571428571428571,3,0.0,6,18,7,12,24,1,1,4,1,43,31,0
4449,64313,gA3Xtx3mNrjoOeU8dGKyOoRAXgsBF1H9,3VkHkmOtom3jM2wCu94xgzzu1d6Dn7or,1,0,0,0,0,0,1,0,1,0.14285714285714285,1,0.0,0,0,0,0,0,0,0,1,0,0,1,1
4450,64318,abr7PsiExob7MGbkn4ZddaHwWS9BsVqH,3VkHkmOtom3jM2wCu94xgzzu1d6Dn7or,7,9,1,0,3,0,16,0,29,4.142857142857143,3,0.0,6,1,0,3,3,0,0,16,0,10,19,1
4451,64329,LSVa2jpU1dF8RnC5rzovm0tv2cSNIe8I,3VkHkmOtom3jM2wCu94xgzzu1d6Dn7or,39,57,22,20,18,6,12,0,135,19.285714285714285,5,0.0,14,22,19,18,43,6,1,12,0,73,62,0
4452,64335,g9lPvOzsSzINNTOU3e0WeqFWLYzy22Mt,3VkHkmOtom3jM2wCu94xgzzu1d6Dn7or,4,13,6,0,0,0,4,0,23,3.2857142857142856,5,0.0,0,6,0,0,13,0,0,4,0,6,17,1
4453,64352,wGNx6AKYlNdlUcU0SMOdNBG7bFkc1XEp,3VkHkmOtom3jM2wCu94xgzzu1d6Dn7or,97,237,120,60,104,17,33,4,575,82.14285714285714,12,0.0,95,120,55,104,142,17,5,33,4,374,201,0
4454,64370,c5xiLcSWAYPvXfuhPurcqOprSOGccHJS,3VkHkmOtom3jM2wCu94xgzzu1d6Dn7or,3,2,1,0,0,0,1,0,4,0.5714285714285714,1,0.0,0,1,0,0,2,0,0,1,0,1,3,1
4455,64373,3ppgfLiwMAHRPirVicx5QjeMUZaKkLmg,3VkHkmOtom3jM2wCu94xgzzu1d6Dn7or,2,0,0,0,0,0,6,0,6,0.8571428571428571,1,0.0,0,0,0,0,0,0,0,6,0,0,6,1
4456,64388,5o6riWtpxdBNBYGW08EacpQpAKp3IxEg,3VkHkmOtom3jM2wCu94xgzzu1d6Dn7or,1,0,0,0,0,0,1,0,1,0.14285714285714285,1,0.0,0,0,0,0,0,0,0,1,0,0,1,1
4457,64429,mmgvXxQPxWioLfZY5VD0SZnXZDUD442V,3VkHkmOtom3jM2wCu94xgzzu1d6Dn7or,3,0,0,0,0,1,3,0,4,0.5714285714285714,1,0.0,0,0,0,0,0,1,0,3,0,0,4,1
4458,64462,ZDVmuYiPoGm0gu1bR2BaE1soF6dU5v1W,3VkHkmOtom3jM2wCu94xgzzu1d6Dn7or,1,0,0,0,0,0,1,0,1,0.14285714285714285,1,0.0,0,0,0,0,0,0,0,1,0,0,1,1
4459,64463,BqrlUNDkAkHNnXp0FPZ73CSR3ngoq4bK,3VkHkmOtom3jM2wCu94xgzzu1d6Dn7or,5,7,4,0,3,0,1,0,15,2.142857142857143,1,0.0,1,4,0,3,6,0,0,1,0,8,7,1
4460,64470,omogDjehriHed7WOB06lowOCzWJT5HFG,3VkHkmOtom3jM2wCu94xgzzu1d6Dn7or,68,133,68,44,55,5,16,0,321,45.857142857142854,5,0.0,54,68,33,55,79,5,11,16,0,210,111,0
4461,64515,gbH0MMJ5rSAuwZ5qtlTmwRCxGiZQV4Al,3VkHkmOtom3jM2wCu94xgzzu1d6Dn7or,26,47,28,16,21,16,7,0,135,19.285714285714285,6,0.0,13,28,14,21,34,16,2,7,0,76,59,1
4462,64526,vhKK0CTAExtKMqOJm8URni5QBMk7gE0I,3VkHkmOtom3jM2wCu94xgzzu1d6Dn7or,1,0,0,0,0,0,1,0,1,0.14285714285714285,1,0.0,0,0,0,0,0,0,0,1,0,0,1,1
4463,64576,heDdYQu76fXvzO7TstIKbUaE92RZRujB,3VkHkmOtom3jM2wCu94xgzzu1d6Dn7or,3,7,1,0,0,0,1,0,9,1.2857142857142858,1,0.0,3,1,0,0,4,0,0,1,0,4,5,1
4464,64606,gRdV8TKfYOuiXGGwKnVS8SiUiAxajq1L,3VkHkmOtom3jM2wCu94xgzzu1d6Dn7or,8,5,3,0,2,0,5,0,15,2.142857142857143,2,0.0,0,3,0,2,5,0,0,5,0,5,10,1
4465,64631,w5zixBvtWXGohLO8Tn359nHeHgY2Uldn,3VkHkmOtom3jM2wCu94xgzzu1d6Dn7or,1,0,0,0,0,0,1,0,1,0.14285714285714285,1,0.0,0,0,0,0,0,0,0,1,0,0,1,1
4466,64672,8A7IRDfvatDnOXvyKv9N9weTLfOEiofD,3VkHkmOtom3jM2wCu94xgzzu1d6Dn7or,1,0,0,0,0,0,1,0,1,0.14285714285714285,1,0.0,0,0,0,0,0,0,0,1,0,0,1,1
4467,64701,frevGWOFyf2Wo6uQjpFNvZnyWeFbKP0E,3VkHkmOtom3jM2wCu94xgzzu1d6Dn7or,60,46,21,67,20,1,16,0,171,24.428571428571427,3,0.0,20,21,52,20,26,1,15,16,0,113,58,0
4468,64726,aORi8ctsRQPynx7huvSDB7SBijD2EamN,3VkHkmOtom3jM2wCu94xgzzu1d6Dn7or,1,0,0,0,0,0,1,0,1,0.14285714285714285,1,0.0,0,0,0,0,0,0,0,1,0,0,1,1
4469,64773,r0dFqjGI7dV5UI6Lt9zOJKOw8pPh1H9m,3VkHkmOtom3jM2wCu94xgzzu1d6Dn7or,66,257,99,30,77,18,54,16,551,78.71428571428571,8,0.0,92,99,26,77,165,18,4,54,16,294,257,0
4470,64780,w55bKoINycyJ2ymux6x0NB1MmB6QG3Dm,3VkHkmOtom3jM2wCu94xgzzu1d6Dn7or,20,28,15,18,9,5,10,2,87,12.428571428571429,3,0.0,7,15,17,9,21,5,1,10,2,48,39,1
4471,64820,LqxH2deSYujtWmr5bbm2moMw49DPD3vh,3VkHkmOtom3jM2wCu94xgzzu1d6Dn7or,1,0,0,0,0,0,1,0,1,0.14285714285714285,1,0.0,0,0,0,0,0,0,0,1,0,0,1,1
4472,65659,BGZaaH5HDVuGvqaegp5MyJblPEuJpcXP,5X6FeZozNMgE2VRi3MJYjkkFK8SETtu2,15,42,11,28,6,10,6,2,105,15.0,2,0.0,17,11,22,6,25,10,6,6,2,56,49,0
4473,65669,YXA6PyHIufuhVR6DkHMJ9uQ5pDJwufmy,7GRhBDsirIGkRZBtSMEzNTyDr2JQm4xx,4,3,0,0,0,0,2,0,5,0.7142857142857143,1,0.0,0,0,0,0,3,0,0,2,0,0,5,1
4474,65718,aPDsc8X2fcDutxzM0D9vmuKFKeVLb7iC,7GRhBDsirIGkRZBtSMEzNTyDr2JQm4xx,9,19,5,6,5,1,5,0,41,5.857142857142857,2,0.0,9,5,5,5,10,1,1,5,0,24,17,1
4475,65754,d7lqWAJ8cu1e9f8Lb1eNhG3YSdhF0Qy7,7GRhBDsirIGkRZBtSMEzNTyDr2JQm4xx,34,105,40,46,21,30,41,3,286,40.857142857142854,5,0.0,54,40,39,21,51,30,7,41,3,154,132,1
4476,65760,Eq2fj8YhTifRHDOTFGHgDmpANxyMLkTX,7GRhBDsirIGkRZBtSMEzNTyDr2JQm4xx,2,0,0,0,0,0,2,0,2,0.2857142857142857,1,0.0,0,0,0,0,0,0,0,2,0,0,2,1
4477,65795,XmvpcofboBRS9uAJYfRa3wpjPdvquqfs,5X6FeZozNMgE2VRi3MJYjkkFK8SETtu2,6,2,0,0,0,0,11,0,13,1.8571428571428572,2,0.0,0,0,0,0,2,0,0,11,0,0,13,1
4478,65803,frLOkZRmi3O7wD4LykXjaoVn2dsJFYHr,7GRhBDsirIGkRZBtSMEzNTyDr2JQm4xx,2,0,0,0,0,0,2,0,2,0.2857142857142857,1,0.0,0,0,0,0,0,0,0,2,0,0,2,1
4479,65811,eGQZZVxmcbNonF0wFWctXG5fJptHLiDM,7GRhBDsirIGkRZBtSMEzNTyDr2JQm4xx,13,6,4,0,3,0,7,2,22,3.142857142857143,1,0.0,0,4,0,3,6,0,0,7,2,7,15,0
4480,65839,OdMr7dE5UlAme9Tp979vREBvY5CV50po,5X6FeZozNMgE2VRi3MJYjkkFK8SETtu2,27,40,15,20,17,0,6,0,98,14.0,3,0.0,20,15,20,17,20,0,0,6,0,72,26,0
4481,65862,FWTjpNOuI4RsBkDu0yW01kwOX7KPfCTS,7GRhBDsirIGkRZBtSMEzNTyDr2JQm4xx,1,0,0,0,0,0,1,0,1,0.14285714285714285,1,0.0,0,0,0,0,0,0,0,1,0,0,1,1
4482,65872,dr13KuqOo10EJH5V4oOgMy17ewEUhD7o,7GRhBDsirIGkRZBtSMEzNTyDr2JQm4xx,1,0,0,0,0,0,1,0,1,0.14285714285714285,1,0.0,0,0,0,0,0,0,0,1,0,0,1,1
4483,65885,pcZtZEZYp6uimFg9bhkzSKY573TnBG4p,5X6FeZozNMgE2VRi3MJYjkkFK8SETtu2,11,23,3,17,0,0,3,0,46,6.571428571428571,1,0.0,19,3,15,0,4,0,2,3,0,37,9,1
4484,65947,qREvGviufJ3VVxNkA2MjB1npr7InnyIq,7GRhBDsirIGkRZBtSMEzNTyDr2JQm4xx,1,0,0,0,0,0,1,0,1,0.14285714285714285,1,0.0,0,0,0,0,0,0,0,1,0,0,1,1
4485,65951,OiCP77rDGj7m0OeIgoy8NyAC1iklb2Wq,7GRhBDsirIGkRZBtSMEzNTyDr2JQm4xx,1,0,0,0,0,0,1,0,1,0.14285714285714285,1,0.0,0,0,0,0,0,0,0,1,0,0,1,1
4486,66544,GsuSgvyvG4oCfnW3UaGKEeHZUImW7ybU,SpATywNh6bZuzm8s1ceuBUnMUAeoAHHw,12,30,4,13,3,1,6,0,57,8.142857142857142,4,0.0,9,4,12,3,21,1,1,6,0,28,29,1
4487,66553,X1KDcg6FJGcjALhOEz460JY2SzJ27Ewm,RXDvfPUBYFlVdlueBFbLW0mhhAyGEqpt,19,32,14,20,6,0,33,0,105,15.0,4,0.0,8,14,19,6,24,0,1,33,0,47,58,1
4488,66554,alnogGpZqhBWQHh6ZLeZUIXk896ksLOu,bWdj2GDclj5ofokWjzoa5jAwMkxCykd6,17,33,3,108,2,2,20,1,169,24.142857142857142,3,0.0,9,3,105,2,24,2,3,20,1,119,50,1
4489,66562,RbUxQb46RHLKt8MRdcRI6KFNQeGEWd4E,bWdj2GDclj5ofokWjzoa5jAwMkxCykd6,12,4,3,0,3,10,7,1,28,4.0,2,0.0,0,3,0,3,4,10,0,7,1,6,22,1
4490,66566,6PpQXjJomANl40NJZt5It7FhFUddOBZF,SpATywNh6bZuzm8s1ceuBUnMUAeoAHHw,16,19,8,12,3,23,7,1,73,10.428571428571429,2,0.0,6,8,9,3,13,23,3,7,1,26,47,1
4491,66567,Z5BNOGX3uaOaDJtXljja6tBV5seZD36x,SpATywNh6bZuzm8s1ceuBUnMUAeoAHHw,6,4,3,0,2,0,2,0,11,1.5714285714285714,1,0.0,0,3,0,2,4,0,0,2,0,5,6,1
4492,66572,IaHdA1JSOZlnXxW2Ea0M59RXapC6MjXI,SpATywNh6bZuzm8s1ceuBUnMUAeoAHHw,12,70,9,23,1,37,16,3,159,22.714285714285715,3,0.0,56,9,21,1,14,37,2,16,3,87,72,0
4493,66573,ES3MJj3KCIAnVbhhUwdNjoq2AG6ouBZT,SpATywNh6bZuzm8s1ceuBUnMUAeoAHHw,10,11,5,0,3,8,4,0,31,4.428571428571429,3,0.0,0,5,0,3,11,8,0,4,0,8,23,1
4494,66574,PizUKf6mRUas66X3VMYXf9aygnN1CUCf,RXDvfPUBYFlVdlueBFbLW0mhhAyGEqpt,40,48,34,0,17,11,10,3,123,17.571428571428573,2,0.0,7,34,0,17,41,11,0,10,3,58,65,1
4495,66583,L3sYIZrtCe33arrsIgJGTKImw4yL48kj,G8EPVSXsOYB5YQWZGiz1aVq5Pgr2GrQu,13,10,6,0,4,0,5,0,25,3.5714285714285716,2,0.0,0,6,0,4,10,0,0,5,0,10,15,0
4496,66584,ZRcEnEYSSBQbkjzMu7sidjbxasfrmw8l,RXDvfPUBYFlVdlueBFbLW0mhhAyGEqpt,27,69,36,31,2,2,15,0,155,22.142857142857142,8,0.0,6,36,29,2,63,2,2,15,0,73,82,1
4497,66587,Jag1EXQWfAuTRiCgcVLyhRRkdOL9RtSD,bWdj2GDclj5ofokWjzoa5jAwMkxCykd6,13,15,10,68,6,2,10,0,111,15.857142857142858,3,0.0,1,10,67,6,14,2,1,10,0,84,27,1
4498,66591,9EN3Z35raOUcrGDeovMj0gdxUNnPCeKU,SpATywNh6bZuzm8s1ceuBUnMUAeoAHHw,3,2,0,0,0,0,2,0,4,0.5714285714285714,1,0.0,0,0,0,0,2,0,0,2,0,0,4,1
4499,66598,nLUyFOoii85Kc6SiGICnU7SPdHRw1h9a,SpATywNh6bZuzm8s1ceuBUnMUAeoAHHw,9,5,2,0,1,15,5,3,31,4.428571428571429,1,0.0,2,2,0,1,3,15,0,5,3,5,26,1
4500,66605,XUPBJ1mitGxAzzRukKqjQOzBGJw166yc,G8EPVSXsOYB5YQWZGiz1aVq5Pgr2GrQu,14,19,9,0,4,0,7,0,39,5.571428571428571,4,0.0,0,9,0,4,19,0,0,7,0,13,26,1
4501,66615,fxrAFCrsLimQV1XJURgnMX9KS4WUkexG,G8EPVSXsOYB5YQWZGiz1aVq5Pgr2GrQu,14,5,4,28,3,0,3,0,43,6.142857142857143,1,0.0,0,4,25,3,5,0,3,3,0,32,11,1
4502,66616,aQkZtyhfWM4x1GodnKorBxGkYsdqjpct,G8EPVSXsOYB5YQWZGiz1aVq5Pgr2GrQu,26,26,17,0,12,1,7,0,63,9.0,4,0.0,0,17,0,12,26,1,0,7,0,29,34,1
4503,66617,bXR5OQsnMadJ3r7Y5b33xdbV7KcP5Zyw,bWdj2GDclj5ofokWjzoa5jAwMkxCykd6,8,9,6,0,5,0,3,0,23,3.2857142857142856,2,0.0,1,6,0,5,8,0,0,3,0,12,11,1
4504,66618,wyLapvNSkzqLsQoXZV3N6mjrWCECacth,RXDvfPUBYFlVdlueBFbLW0mhhAyGEqpt,49,44,24,101,16,8,8,0,201,28.714285714285715,3,0.0,13,24,95,16,31,8,6,8,0,148,53,1
4505,66621,5TeLMYHqzQAKUmQpWnvEv2hxOy9X1UKJ,SpATywNh6bZuzm8s1ceuBUnMUAeoAHHw,18,36,19,22,5,7,15,3,107,15.285714285714286,3,0.0,11,19,17,5,25,7,5,15,3,52,55,1
4506,66635,8fOucDZ8PgruKfhbtaGML7zYng8oMl2j,SpATywNh6bZuzm8s1ceuBUnMUAeoAHHw,5,2,1,0,1,0,3,0,7,1.0,1,0.0,0,1,0,1,2,0,0,3,0,2,5,1
4507,66637,ddHByaCLR2ByNnOPbXOAqZ6eqJzLVO7n,bWdj2GDclj5ofokWjzoa5jAwMkxCykd6,5,3,1,0,1,0,4,0,9,1.2857142857142858,1,0.0,0,1,0,1,3,0,0,4,0,2,7,1
4508,66644,102hMvC6gN7rty2ashlvDMHaB3ep6GZh,SpATywNh6bZuzm8s1ceuBUnMUAeoAHHw,15,46,2,27,1,12,14,2,104,14.857142857142858,2,0.0,18,2,21,1,28,12,6,14,2,42,62,1
4509,66646,qZhmmNUvkNXdf3u04DTUQOFEBxxO10p4,G8EPVSXsOYB5YQWZGiz1aVq5Pgr2GrQu,135,160,55,284,33,0,19,1,552,78.85714285714286,9,0.0,54,55,229,33,106,0,55,19,1,371,181,1
4510,66650,j8DEcgUENzfnfHONFl2IMtBsrYZzGv40,bWdj2GDclj5ofokWjzoa5jAwMkxCykd6,8,4,2,42,1,0,2,0,51,7.285714285714286,1,0.0,2,2,41,1,2,0,1,2,0,46,5,1
4511,66654,AA7aVbrpQJ2zUau6VJLFiC8rutvLHi1m,bWdj2GDclj5ofokWjzoa5jAwMkxCykd6,7,17,4,0,0,1,6,0,28,4.0,1,0.0,0,4,0,0,17,1,0,6,0,4,24,1
4512,66657,bpLyNpLNqZrg4X6eObo787HrocrHo6XF,RXDvfPUBYFlVdlueBFbLW0mhhAyGEqpt,7,4,1,0,1,0,2,0,8,1.1428571428571428,1,0.0,0,1,0,1,4,0,0,2,0,2,6,1
4513,66658,NiYgf1FsQGPvHpxeTQuDCV5yUQ8cmKec,SpATywNh6bZuzm8s1ceuBUnMUAeoAHHw,1,0,0,0,0,0,1,0,1,0.14285714285714285,1,0.0,0,0,0,0,0,0,0,1,0,0,1,1
4514,66662,GHjtRW2SWnsNCYGrWfNWjwqhAcWXggqC,G8EPVSXsOYB5YQWZGiz1aVq5Pgr2GrQu,31,37,3,70,1,5,4,0,120,17.142857142857142,1,0.0,16,3,52,1,21,5,18,4,0,72,48,1
4515,66664,WpYtemwKZQxcuLGpndx0lQojfh6o5GOv,RXDvfPUBYFlVdlueBFbLW0mhhAyGEqpt,11,7,1,0,1,3,7,1,20,2.857142857142857,2,0.0,0,1,0,1,7,3,0,7,1,2,18,1
4516,66677,O65XWOLgEMKBGdUDD3HXTmDvI5lmhsk8,SpATywNh6bZuzm8s1ceuBUnMUAeoAHHw,8,7,4,0,1,0,6,0,18,2.5714285714285716,2,0.0,0,4,0,1,7,0,0,6,0,5,13,1
4517,66688,ehuVxu7A35eDUFqKYYT7us9o7kymvupC,SpATywNh6bZuzm8s1ceuBUnMUAeoAHHw,8,6,4,0,4,0,6,1,21,3.0,2,0.0,1,4,0,4,5,0,0,6,1,9,12,1
4518,66691,4X8SsO11KgTMY23mHrkIQxUJcM5ft92O,SpATywNh6bZuzm8s1ceuBUnMUAeoAHHw,6,3,2,0,2,0,2,0,9,1.2857142857142858,1,0.0,0,2,0,2,3,0,0,2,0,4,5,1
4519,66695,9hMYmYnY4O2N6jg4p4MNxwDczZbVqp3T,RXDvfPUBYFlVdlueBFbLW0mhhAyGEqpt,24,29,21,0,14,0,7,1,72,10.285714285714286,4,0.0,2,21,0,14,27,0,0,7,1,37,35,1
4520,66703,pdhviBPVRpP6jkLxXzSmGnBMX5GRwslr,SpATywNh6bZuzm8s1ceuBUnMUAeoAHHw,9,24,13,0,0,1,12,0,50,7.142857142857143,1,0.0,0,13,0,0,24,1,0,12,0,13,37,1
4521,66704,DAjbimE4V5oFXI5ZD4kyBHNztDPF7CGC,G8EPVSXsOYB5YQWZGiz1aVq5Pgr2GrQu,5,4,1,0,2,0,3,0,10,1.4285714285714286,2,0.0,2,1,0,2,2,0,0,3,0,5,5,1
4522,66711,VS8f8oTxWcbwLqrK393hBZWMoBFa1gFJ,SpATywNh6bZuzm8s1ceuBUnMUAeoAHHw,23,36,17,20,6,2,23,1,105,15.0,7,0.0,8,17,16,6,28,2,4,23,1,47,58,0
4523,66713,LMGbvXS3ZBgtTcKCRLMcqBHrfADBxwXe,G8EPVSXsOYB5YQWZGiz1aVq5Pgr2GrQu,95,134,18,137,10,58,33,0,390,55.714285714285715,10,0.0,54,18,95,10,80,58,42,33,0,177,213,0
4524,66730,BaoCwxmOrD7InrgOrpoiCi2VVkCIKJfh,SpATywNh6bZuzm8s1ceuBUnMUAeoAHHw,17,24,6,20,3,3,12,1,69,9.857142857142858,2,0.0,16,6,17,3,8,3,3,12,1,42,27,1
4525,66732,e4qTXKc7Qs1Hoa2gaTnt5MCSxqsevbSQ,SpATywNh6bZuzm8s1ceuBUnMUAeoAHHw,1,0,0,0,0,0,1,0,1,0.14285714285714285,1,0.0,0,0,0,0,0,0,0,1,0,0,1,1
4526,66745,qt9pojYUdSU9dxSioMDEso1f0UH6has1,SpATywNh6bZuzm8s1ceuBUnMUAeoAHHw,23,55,21,26,5,1,10,0,118,16.857142857142858,5,0.0,10,21,22,5,45,1,4,10,0,58,60,1
4527,66747,p2gF3LN3ZgatpYPMj263kKzwr7f9hjKm,SpATywNh6bZuzm8s1ceuBUnMUAeoAHHw,8,4,1,0,1,0,8,0,14,2.0,2,0.0,0,1,0,1,4,0,0,8,0,2,12,0
4528,66756,aR3fk0CNwd9ygarvr0BOVu5p8WeU32I1,SpATywNh6bZuzm8s1ceuBUnMUAeoAHHw,17,21,7,10,4,9,8,1,60,8.571428571428571,2,0.0,11,7,9,4,10,9,1,8,1,31,29,1
4529,66776,1bINdBCm1VS5Qjqh6m0QvNj7bfNPAIxT,bWdj2GDclj5ofokWjzoa5jAwMkxCykd6,2,0,0,0,0,0,2,0,2,0.2857142857142857,2,0.0,0,0,0,0,0,0,0,2,0,0,2,1
4530,66778,c7cZPwJhMtLXXFSxYHM0ztf18Qe267SR,SpATywNh6bZuzm8s1ceuBUnMUAeoAHHw,11,16,9,0,7,0,3,0,35,5.0,2,0.0,1,9,0,7,15,0,0,3,0,17,18,1
4531,66779,r8TxqoZCuxs9o8OQbbHm8IWDrVmolNmN,SpATywNh6bZuzm8s1ceuBUnMUAeoAHHw,1,0,0,0,0,0,1,0,1,0.14285714285714285,1,0.0,0,0,0,0,0,0,0,1,0,0,1,1
4532,66780,OnyZH4F3oW4crdu4EYjgcCg5L4Cq5yIA,bWdj2GDclj5ofokWjzoa5jAwMkxCykd6,5,9,1,0,0,0,4,0,14,2.0,1,0.0,0,1,0,0,9,0,0,4,0,1,13,1
4533,66789,5ZyvCd3AP7a8azCiLN5JfLAP53iZpAyD,SpATywNh6bZuzm8s1ceuBUnMUAeoAHHw,3,0,0,0,0,0,8,0,8,1.1428571428571428,4,0.0,0,0,0,0,0,0,0,8,0,0,8,0
4534,66804,AlgEd5IzXHm0JGTUI9jbrnVeF8FATpV3,bWdj2GDclj5ofokWjzoa5jAwMkxCykd6,13,12,7,48,3,4,5,0,79,11.285714285714286,1,0.0,4,7,48,3,8,4,0,5,0,62,17,1
4535,66806,Qo1OAp8GglCOhKICbcJQhmG7Ih2RNYzD,SpATywNh6bZuzm8s1ceuBUnMUAeoAHHw,12,14,5,0,3,0,24,0,46,6.571428571428571,2,0.0,4,5,0,3,10,0,0,24,0,12,34,1
4536,66808,WMHcQA8MVYUjJWAMAB6fugsBuCZpVoIb,SpATywNh6bZuzm8s1ceuBUnMUAeoAHHw,14,22,6,13,2,9,14,4,70,10.0,1,0.0,16,6,12,2,6,9,1,14,4,36,34,1
4537,66810,nNPKgGT2Dns3AcXj6vzeFxTea7ZZLJPg,G8EPVSXsOYB5YQWZGiz1aVq5Pgr2GrQu,27,12,11,0,10,12,6,1,52,7.428571428571429,1,0.0,0,11,0,10,12,12,0,6,1,21,31,1
4538,66813,jtvqYfTt0YMo9BknX2A672jXhl21ashI,SpATywNh6bZuzm8s1ceuBUnMUAeoAHHw,7,5,1,0,1,0,1,0,8,1.1428571428571428,1,0.0,0,1,0,1,5,0,0,1,0,2,6,1
4539,66820,MvNnLQma2eBM9bCcMIR159XYSNp8VREs,bWdj2GDclj5ofokWjzoa5jAwMkxCykd6,38,30,17,162,7,23,11,0,250,35.714285714285715,5,0.0,6,17,135,7,24,23,27,11,0,165,85,1
4540,66828,U0qAQ57V9wygm6bDtrNRCaS95QeQ2J6g,G8EPVSXsOYB5YQWZGiz1aVq5Pgr2GrQu,31,56,30,0,17,4,18,2,127,18.142857142857142,3,0.0,13,30,0,17,43,4,0,18,2,60,67,1
4541,66844,zPWIhn8QAXkwvZr0vXSWUOjtKdeOxnx0,SpATywNh6bZuzm8s1ceuBUnMUAeoAHHw,4,4,0,0,0,0,2,0,6,0.8571428571428571,1,0.0,0,0,0,0,4,0,0,2,0,0,6,1
4542,66854,9uGUU0TH4lqYEkuGLK9jp9MwW0oSvGiG,SpATywNh6bZuzm8s1ceuBUnMUAeoAHHw,1,0,0,0,0,0,1,0,1,0.14285714285714285,1,0.0,0,0,0,0,0,0,0,1,0,0,1,1
4543,66859,YD54LiXoRcgp9TgUQFqtUoAuCL64ULEG,RXDvfPUBYFlVdlueBFbLW0mhhAyGEqpt,1,0,0,0,0,0,1,0,1,0.14285714285714285,1,0.0,0,0,0,0,0,0,0,1,0,0,1,1
4544,66862,grxgFxuiaSTlMIk1kWcHwbLAYZVnIvkA,RXDvfPUBYFlVdlueBFbLW0mhhAyGEqpt,7,5,1,0,1,0,4,0,11,1.5714285714285714,2,0.0,0,1,0,1,5,0,0,4,0,2,9,1
4545,66871,TkGLgRow1Lh4XUIZJk3PPt8KzHEZuW9e,SpATywNh6bZuzm8s1ceuBUnMUAeoAHHw,12,12,8,1,7,0,4,0,32,4.571428571428571,2,0.0,2,8,1,7,10,0,0,4,0,18,14,1
4546,66878,9uGUU0TH4lqYEkuGLK9jp9MwW0oSvGiG,bWdj2GDclj5ofokWjzoa5jAwMkxCykd6,1,0,0,0,0,0,1,0,1,0.14285714285714285,1,0.0,0,0,0,0,0,0,0,1,0,0,1,1
4547,66880,tBWD1VTj6Jcj3AQ0AXY8eZtUzkjmoiNH,bWdj2GDclj5ofokWjzoa5jAwMkxCykd6,9,12,5,14,1,8,10,0,50,7.142857142857143,2,0.0,1,5,13,1,11,8,1,10,0,20,30,1
4548,66893,HBNOGDmQrCA8ZCNHwMOm4mGR9448iscJ,SpATywNh6bZuzm8s1ceuBUnMUAeoAHHw,9,5,2,0,1,0,15,0,23,3.2857142857142856,4,0.0,0,2,0,1,5,0,0,15,0,3,20,0
4549,66900,SOap4GRyA4qmYvVJbfGh1nFSvLnlIhQw,SpATywNh6bZuzm8s1ceuBUnMUAeoAHHw,13,13,8,0,6,2,9,1,39,5.571428571428571,2,0.0,1,8,0,6,12,2,0,9,1,15,24,1
4550,66911,n0HFF3TwqKuBMzzkdLCbvb8Mji5ZUnVX,RXDvfPUBYFlVdlueBFbLW0mhhAyGEqpt,7,6,3,0,2,0,2,0,13,1.8571428571428572,2,0.0,0,3,0,2,6,0,0,2,0,5,8,1
4551,66922,wEaTyOJwwvOCk7eUttQISK5WPXL7ANNV,RXDvfPUBYFlVdlueBFbLW0mhhAyGEqpt,48,122,34,71,17,30,28,8,310,44.285714285714285,9,0.0,30,34,67,17,92,30,4,28,8,148,162,0
4552,66928,UnlpBoCCKa1g59dweQPJmefdPMpfSVLe,G8EPVSXsOYB5YQWZGiz1aVq5Pgr2GrQu,131,181,80,312,49,21,24,1,668,95.42857142857143,12,0.0,69,80,230,49,112,21,82,24,1,428,240,1
4553,66937,LYK1SCUULDZfFbUf8SQuy4cGJ6KDov7Z,G8EPVSXsOYB5YQWZGiz1aVq5Pgr2GrQu,13,8,4,0,2,2,15,2,33,4.714285714285714,3,0.0,0,4,0,2,8,2,0,15,2,6,27,1
4554,66938,mLUKkahZJn2S9K7hZVXpun7HflxZlNfK,RXDvfPUBYFlVdlueBFbLW0mhhAyGEqpt,38,52,4,98,4,0,4,0,162,23.142857142857142,3,0.0,15,4,91,4,37,0,7,4,0,114,48,1
4555,66947,8OfBrECVDzmqJABpw3ayApk0DiWDa3gF,SpATywNh6bZuzm8s1ceuBUnMUAeoAHHw,1,0,0,0,0,0,1,0,1,0.14285714285714285,1,0.0,0,0,0,0,0,0,0,1,0,0,1,1
4556,66948,ylHVd8NK0xyUeGJijtfFcdu7sSX07hsS,SpATywNh6bZuzm8s1ceuBUnMUAeoAHHw,16,15,2,8,1,1,11,3,41,5.857142857142857,3,0.0,2,2,8,1,13,1,0,11,3,13,28,1
4557,66959,wpRLL3XDggpsn9xMAH6hM6LGULXpz3ki,SpATywNh6bZuzm8s1ceuBUnMUAeoAHHw,3,2,0,0,0,0,2,0,4,0.5714285714285714,1,0.0,0,0,0,0,2,0,0,2,0,0,4,1
4558,66965,FXFJNl5vYMfodb6wUkei0GFkJtJALVJo,SpATywNh6bZuzm8s1ceuBUnMUAeoAHHw,1,0,0,0,0,0,2,0,2,0.2857142857142857,1,0.0,0,0,0,0,0,0,0,2,0,0,2,1
4559,66967,TZMHSuVEUzvE9F9oFUPDubVVCOh0OUwA,SpATywNh6bZuzm8s1ceuBUnMUAeoAHHw,8,15,7,0,4,0,6,0,32,4.571428571428571,4,0.0,0,7,0,4,15,0,0,6,0,11,21,1
4560,66972,4mxqWsjuug2blsnsk9e2hDH5ZKMeIfme,SpATywNh6bZuzm8s1ceuBUnMUAeoAHHw,19,33,12,24,5,1,13,2,90,12.857142857142858,3,0.0,17,12,20,5,16,1,4,13,2,54,36,1
4561,66981,ApSfmGvydhCGgdp1GU2OyiUFr43yEuYJ,RXDvfPUBYFlVdlueBFbLW0mhhAyGEqpt,9,11,6,0,2,0,5,3,27,3.857142857142857,1,0.0,1,6,0,2,10,0,0,5,3,9,18,1
4562,66983,e7lti3fBvO8XZNtS4I7hMo5JFh6PqMCH,SpATywNh6bZuzm8s1ceuBUnMUAeoAHHw,9,6,0,0,0,1,8,1,16,2.2857142857142856,2,0.0,0,0,0,0,6,1,0,8,1,0,16,1
4563,66991,c5MkJ205AcjWsm07YpOktUEc4lrC6DvN,bWdj2GDclj5ofokWjzoa5jAwMkxCykd6,4,3,0,0,0,0,4,0,7,1.0,2,0.0,0,0,0,0,3,0,0,4,0,0,7,1
4564,66995,RE0yxLQPG2DsKP2fVObFsaZxTyIGWyd9,SpATywNh6bZuzm8s1ceuBUnMUAeoAHHw,1,0,0,0,0,0,1,0,1,0.14285714285714285,1,0.0,0,0,0,0,0,0,0,1,0,0,1,1
4565,67003,jK7giBjce5DH7ZDYgKKwuLGFjg8bBMY3,SpATywNh6bZuzm8s1ceuBUnMUAeoAHHw,1,0,0,0,0,0,1,0,1,0.14285714285714285,1,0.0,0,0,0,0,0,0,0,1,0,0,1,1
4566,67017,R8e7xg0PB3WHpeFUd7XjboUcUmtjBoqn,G8EPVSXsOYB5YQWZGiz1aVq5Pgr2GrQu,65,60,12,182,10,2,7,0,273,39.0,4,0.0,39,12,138,10,21,2,44,7,0,199,74,1
4567,67020,jWJjb2ULtCbg7TxaVgejXvNjReg1rWMJ,SpATywNh6bZuzm8s1ceuBUnMUAeoAHHw,7,5,0,0,0,0,15,0,20,2.857142857142857,3,0.0,0,0,0,0,5,0,0,15,0,0,20,1
4568,67027,a1PUZwDv53lPTEF9hvk5ypoKBKNjAetJ,SpATywNh6bZuzm8s1ceuBUnMUAeoAHHw,1,0,0,0,0,0,1,0,1,0.14285714285714285,1,0.0,0,0,0,0,0,0,0,1,0,0,1,1
4569,67028,Up0SfqXbbz6NGY2S4ku6GM2FOwYrzCdN,G8EPVSXsOYB5YQWZGiz1aVq5Pgr2GrQu,17,25,9,56,5,5,6,1,107,15.285714285714286,1,0.0,15,9,44,5,10,5,12,6,1,73,34,1
4570,67031,bhM1l0w4WfwmiUZ8JL3hioN6rh1txoNY,G8EPVSXsOYB5YQWZGiz1aVq5Pgr2GrQu,1,0,0,0,0,0,1,0,1,0.14285714285714285,1,0.0,0,0,0,0,0,0,0,1,0,0,1,1
4571,67032,YLfjSoU2JNGG7f9SEbr83b8mp8z1n7i3,SpATywNh6bZuzm8s1ceuBUnMUAeoAHHw,5,3,2,0,1,0,2,0,8,1.1428571428571428,1,0.0,0,2,0,1,3,0,0,2,0,3,5,1
4572,67057,YGm3RWWdh53qv43WofC48V9ZiIjgJjMn,bWdj2GDclj5ofokWjzoa5jAwMkxCykd6,7,13,6,6,2,0,5,0,32,4.571428571428571,1,0.0,1,6,5,2,12,0,1,5,0,14,18,0
4573,67062,lsez2NExtDzqmHTj1WxlkldAKydbGpGz,SpATywNh6bZuzm8s1ceuBUnMUAeoAHHw,39,51,11,33,6,0,12,0,113,16.142857142857142,8,0.0,9,11,30,6,42,0,3,12,0,56,57,0
4574,67064,rgWDWnR8cl7dIVcqtFoTnaVoLEy1VLxc,SpATywNh6bZuzm8s1ceuBUnMUAeoAHHw,8,12,4,0,2,0,3,0,21,3.0,3,0.0,0,4,0,2,12,0,0,3,0,6,15,1
4575,67084,t2CefH6ir3GuQXTz3Lok7bxtMew2Evw7,RXDvfPUBYFlVdlueBFbLW0mhhAyGEqpt,19,19,15,0,10,0,10,4,58,8.285714285714286,3,0.0,0,15,0,10,19,0,0,10,4,25,33,1
4576,67088,k6QLpQDqSxoScgN883dLN4OsoeXNCHXO,RXDvfPUBYFlVdlueBFbLW0mhhAyGEqpt,47,56,29,123,15,2,4,0,229,32.714285714285715,2,0.0,18,29,115,15,38,2,8,4,0,177,52,0
4577,67089,JrNueBhmifdFgGWHM8aWG8EzCwr3tqQr,SpATywNh6bZuzm8s1ceuBUnMUAeoAHHw,14,33,11,21,5,0,2,0,72,10.285714285714286,1,0.0,18,11,18,5,15,0,3,2,0,52,20,1
4578,67100,zpsnILpURwXmIVlozwqgT5YIvGr5WOxX,bWdj2GDclj5ofokWjzoa5jAwMkxCykd6,13,18,1,58,1,0,13,0,91,13.0,4,0.0,6,1,54,1,12,0,4,13,0,62,29,1
4579,67101,a3HtyjZsIXy0rlfdz7IVbfqFoPB13M3i,SpATywNh6bZuzm8s1ceuBUnMUAeoAHHw,10,24,1,11,0,0,2,0,38,5.428571428571429,2,0.0,2,1,11,0,22,0,0,2,0,14,24,1
4580,67108,37B6M9S02XwjLkdM8Uyceavdi8PgXeFK,SpATywNh6bZuzm8s1ceuBUnMUAeoAHHw,7,6,0,0,0,3,4,1,14,2.0,1,0.0,1,0,0,0,5,3,0,4,1,1,13,1
4581,67109,MoirjNgz2xCcf95deN6TNEo1dg7pa7Td,RXDvfPUBYFlVdlueBFbLW0mhhAyGEqpt,5,3,0,0,0,0,2,0,5,0.7142857142857143,1,0.0,0,0,0,0,3,0,0,2,0,0,5,1
4582,67113,3WF0lrMOUTt8kHZhSzrGOICZhAfsfzhb,SpATywNh6bZuzm8s1ceuBUnMUAeoAHHw,28,71,31,36,14,10,23,0,185,26.428571428571427,5,0.0,19,31,33,14,52,10,3,23,0,97,88,0
4583,67124,LFivYoM8eQkzo9oGvIWHE5E2ixWSM4Zt,SpATywNh6bZuzm8s1ceuBUnMUAeoAHHw,8,9,3,6,2,0,1,0,21,3.0,1,0.0,1,3,5,2,8,0,1,1,0,11,10,1
4584,67125,NEAc7vMacEwIBrIHn90danMCNJSj65mj,SpATywNh6bZuzm8s1ceuBUnMUAeoAHHw,5,2,1,0,1,0,3,0,7,1.0,1,0.0,0,1,0,1,2,0,0,3,0,2,5,1
4585,67135,HeVeuuFVpMfNb8W01LL9Sl7iyoZqremo,SpATywNh6bZuzm8s1ceuBUnMUAeoAHHw,6,2,1,0,0,0,5,1,9,1.2857142857142858,1,0.0,0,1,0,0,2,0,0,5,1,1,8,1
4586,67146,cAjVoc8wOYDE8lScDAhEgvHdzkmg6Oh2,SpATywNh6bZuzm8s1ceuBUnMUAeoAHHw,7,13,6,0,3,0,4,0,26,3.7142857142857144,4,0.0,0,6,0,3,13,0,0,4,0,9,17,1
4587,67147,4O78nHzzZKRW7OphkkAmy8uaIoFo0RWM,bWdj2GDclj5ofokWjzoa5jAwMkxCykd6,1,0,0,0,0,0,1,0,1,0.14285714285714285,1,0.0,0,0,0,0,0,0,0,1,0,0,1,1
4588,67148,zBl0JzlLEJg6YrWwxVeTxU6A3wSwUgq8,SpATywNh6bZuzm8s1ceuBUnMUAeoAHHw,7,19,0,0,0,1,2,0,22,3.142857142857143,1,0.0,0,0,0,0,19,1,0,2,0,0,22,1
4589,67162,G2vTTAEhPpy1uiGVOSc3WfzCmuUhZyw6,G8EPVSXsOYB5YQWZGiz1aVq5Pgr2GrQu,8,2,2,0,2,0,6,0,12,1.7142857142857142,2,0.0,0,2,0,2,2,0,0,6,0,4,8,1
4590,67172,IdbptVxItEcsF1HvcM0Mmm9AW3Imyhv4,SpATywNh6bZuzm8s1ceuBUnMUAeoAHHw,4,3,0,0,0,0,2,0,5,0.7142857142857143,1,0.0,0,0,0,0,3,0,0,2,0,0,5,1
4591,67179,5Zxu05K7VSTA0XR5o51TQgeWQSwtutqu,SpATywNh6bZuzm8s1ceuBUnMUAeoAHHw,25,40,20,18,7,2,11,1,99,14.142857142857142,6,0.0,4,20,17,7,36,2,1,11,1,48,51,1
4592,67186,2mFdcZdKuSUvueHyZE3zvpjXpyVcJptR,bWdj2GDclj5ofokWjzoa5jAwMkxCykd6,25,50,3,79,1,9,18,3,163,23.285714285714285,5,0.0,16,3,72,1,34,9,7,18,3,92,71,1
4593,67197,OvFsbGXgDD3DXdRTUFBoMvrSVsi4VT3x,SpATywNh6bZuzm8s1ceuBUnMUAeoAHHw,26,29,13,36,6,20,16,1,121,17.285714285714285,3,0.0,8,13,30,6,21,20,6,16,1,57,64,0
4594,67201,oYST4cfTE5cxIGh0kVtzNelTkJwqpSI4,bWdj2GDclj5ofokWjzoa5jAwMkxCykd6,2,0,0,0,0,0,2,0,2,0.2857142857142857,1,0.0,0,0,0,0,0,0,0,2,0,0,2,1
4595,67204,IJDnP8nIf6GZvQ8vvewi9Kan2f5aO9mE,SpATywNh6bZuzm8s1ceuBUnMUAeoAHHw,8,3,1,0,1,1,5,1,12,1.7142857142857142,1,0.0,0,1,0,1,3,1,0,5,1,2,10,1
4596,67208,urQLwPNeBD6YiDmQkO3zzeclg8J0Lcqs,SpATywNh6bZuzm8s1ceuBUnMUAeoAHHw,9,10,1,0,0,19,14,3,47,6.714285714285714,1,0.0,2,1,0,0,8,19,0,14,3,3,44,1
4597,67210,Mw3CgUU6IvX32BhuujNu75RHWA7Tzf9A,bWdj2GDclj5ofokWjzoa5jAwMkxCykd6,2,0,0,0,0,0,4,0,4,0.5714285714285714,1,0.0,0,0,0,0,0,0,0,4,0,0,4,1
4598,67216,fxBTxCWQMcuL1ujf7SabjHZ1ZIFJ9pkF,SpATywNh6bZuzm8s1ceuBUnMUAeoAHHw,10,4,3,0,2,10,12,1,32,4.571428571428571,1,0.0,0,3,0,2,4,10,0,12,1,5,27,1
4599,67218,2XkiS6Di6usC8n7ND637MKllSt6TChsJ,SpATywNh6bZuzm8s1ceuBUnMUAeoAHHw,14,25,9,12,2,1,9,0,58,8.285714285714286,4,0.0,10,9,10,2,15,1,2,9,0,31,27,1
4600,67225,i2lUV72IHqqXWYqLFMWv3y4XGmlq2lXa,G8EPVSXsOYB5YQWZGiz1aVq5Pgr2GrQu,2,0,0,0,0,0,2,0,2,0.2857142857142857,1,0.0,0,0,0,0,0,0,0,2,0,0,2,1
4601,67227,8QIwRllpGKgpURtcmS5hWJ0AInSKESf0,SpATywNh6bZuzm8s1ceuBUnMUAeoAHHw,7,6,2,0,2,0,5,0,15,2.142857142857143,2,0.0,0,2,0,2,6,0,0,5,0,4,11,1
4602,67233,sIyBSBxCvJj2SnsLY9k322Y8X6bvKHy5,bWdj2GDclj5ofokWjzoa5jAwMkxCykd6,2,0,0,0,0,0,2,0,2,0.2857142857142857,1,0.0,0,0,0,0,0,0,0,2,0,0,2,1
4603,67242,vy0D7u7Ahtj15h3nmn3LQzZAhD31JIs2,G8EPVSXsOYB5YQWZGiz1aVq5Pgr2GrQu,37,53,22,62,9,2,8,1,157,22.428571428571427,2,0.0,26,22,44,9,27,2,18,8,1,101,56,1
4604,67251,hfSXPDFaR2dzrQsij0JMBqqFRCNkzN0i,bWdj2GDclj5ofokWjzoa5jAwMkxCykd6,11,11,2,0,2,0,7,1,23,3.2857142857142856,2,0.0,1,2,0,2,10,0,0,7,1,5,18,1
4605,67252,ZTdgLXHyPcHYh3Bqv5Ymq9ISFbVAj0an,SpATywNh6bZuzm8s1ceuBUnMUAeoAHHw,14,7,4,14,3,0,5,0,33,4.714285714285714,2,0.0,2,4,12,3,5,0,2,5,0,21,12,1
4606,67256,FZEwaAUaiR6zemazrUHMMvDLCgHez3sb,RXDvfPUBYFlVdlueBFbLW0mhhAyGEqpt,36,25,5,67,1,29,6,0,133,19.0,3,0.0,7,5,66,1,18,29,1,6,0,79,54,1
4607,67268,hZupBIfJ4ZGjbfVSNHt4j151AWxFYbOy,SpATywNh6bZuzm8s1ceuBUnMUAeoAHHw,15,20,9,7,6,1,5,0,48,6.857142857142857,2,0.0,8,9,7,6,12,1,0,5,0,30,18,1
4608,67271,1SJmhRDD4Bzcm6S9X3GSNxkp9PjEl8e5,G8EPVSXsOYB5YQWZGiz1aVq5Pgr2GrQu,25,27,12,34,8,4,2,0,87,12.428571428571429,1,0.0,11,12,24,8,16,4,10,2,0,55,32,0
4609,67274,ywsBc3bK8Vte1Tvgz902Tgp2J7M95FMX,RXDvfPUBYFlVdlueBFbLW0mhhAyGEqpt,20,23,14,0,4,12,22,5,80,11.428571428571429,3,0.0,0,14,0,4,23,12,0,22,5,18,62,1
4610,67292,grxgFxuiaSTlMIk1kWcHwbLAYZVnIvkA,SpATywNh6bZuzm8s1ceuBUnMUAeoAHHw,6,3,1,0,1,0,2,0,7,1.0,1,0.0,0,1,0,1,3,0,0,2,0,2,5,0
4611,67301,5ZZ7ac02MMtLItQmBAzvselJyRLR3oem,G8EPVSXsOYB5YQWZGiz1aVq5Pgr2GrQu,23,25,7,20,6,0,2,0,60,8.571428571428571,2,0.0,15,7,13,6,10,0,7,2,0,41,19,1
4612,67304,WYUvDmjrCchGW5prlJ6BZEDjHOYsgZsG,G8EPVSXsOYB5YQWZGiz1aVq5Pgr2GrQu,51,73,28,86,16,5,14,0,222,31.714285714285715,5,0.0,39,28,55,16,34,5,31,14,0,138,84,1
4613,67311,rRP9Jqic5Mwtv2NanjU01SwWXGZ8kuBu,SpATywNh6bZuzm8s1ceuBUnMUAeoAHHw,7,7,2,0,1,0,6,0,16,2.2857142857142856,3,0.0,0,2,0,1,7,0,0,6,0,3,13,1
4614,67315,gc2449Ag0boGNd6nrwcfyjhFar24UaYH,RXDvfPUBYFlVdlueBFbLW0mhhAyGEqpt,51,74,65,0,33,0,5,0,177,25.285714285714285,7,0.0,2,65,0,33,72,0,0,5,0,100,77,1
4615,67317,F5h4PBXJhKNor6Y20FkKW5ER39HKkW7z,SpATywNh6bZuzm8s1ceuBUnMUAeoAHHw,16,16,6,19,3,0,6,0,50,7.142857142857143,1,0.0,6,6,16,3,10,0,3,6,0,31,19,1
4616,67320,CJYyYE64ZjIblJNrc9qIS4a8OLIz3Slp,SpATywNh6bZuzm8s1ceuBUnMUAeoAHHw,1,0,0,0,0,0,1,0,1,0.14285714285714285,1,0.0,0,0,0,0,0,0,0,1,0,0,1,1
4617,67330,CXuXsLGeGwubGiU0pZVYOuy4zs49HMdw,SpATywNh6bZuzm8s1ceuBUnMUAeoAHHw,5,4,0,0,0,1,2,0,7,1.0,1,0.0,0,0,0,0,4,1,0,2,0,0,7,1
4618,67337,6JTisM1m4JxBhgrxr4NqMSmvvRfyxGKO,bWdj2GDclj5ofokWjzoa5jAwMkxCykd6,3,5,2,0,0,0,1,0,8,1.1428571428571428,1,0.0,2,2,0,0,3,0,0,1,0,4,4,1
4619,67339,3w3NoRuE9idoCLL2jfurkkC3vZE468Ey,G8EPVSXsOYB5YQWZGiz1aVq5Pgr2GrQu,7,8,3,0,3,0,4,0,18,2.5714285714285716,1,0.0,3,3,0,3,5,0,0,4,0,9,9,1
4620,67342,S8ozQPoki5gs21RwfromQBp1WzImlYaZ,SpATywNh6bZuzm8s1ceuBUnMUAeoAHHw,16,19,1,16,2,6,14,2,60,8.571428571428571,2,0.0,4,1,14,2,15,6,2,14,2,21,39,1
4621,67344,dWJvaQw3sMX6buidtTfwYxdEvR1DZxlK,bWdj2GDclj5ofokWjzoa5jAwMkxCykd6,7,6,1,0,1,0,7,0,15,2.142857142857143,2,0.0,0,1,0,1,6,0,0,7,0,2,13,1
4622,67356,T6lJMwNIVHZiShXC2FiLzuiG8wkuUByo,SpATywNh6bZuzm8s1ceuBUnMUAeoAHHw,7,2,0,0,0,1,8,1,12,1.7142857142857142,3,0.0,0,0,0,0,2,1,0,8,1,0,12,1
4623,67369,gNMjI69u5dKUTa6c5HKwijZOxWQK60Ms,RXDvfPUBYFlVdlueBFbLW0mhhAyGEqpt,9,5,0,0,0,1,6,1,13,1.8571428571428572,1,0.0,0,0,0,0,5,1,0,6,1,0,13,1
4624,67370,xutmfomAAAlPAVNt9XPAtdu3rEswaJtg,G8EPVSXsOYB5YQWZGiz1aVq5Pgr2GrQu,12,16,7,28,4,0,5,0,60,8.571428571428571,1,0.0,8,7,23,4,8,0,5,5,0,42,18,1
4625,67378,ICAkQ3nKBh6NBvMxfnhNNqVJis2pQKso,SpATywNh6bZuzm8s1ceuBUnMUAeoAHHw,8,1,1,0,1,1,12,1,17,2.4285714285714284,1,0.0,0,1,0,1,1,1,0,12,1,2,15,1
4626,67379,YkDfLiDseHtCR7dJh5rdSPT60rVAbQA9,bWdj2GDclj5ofokWjzoa5jAwMkxCykd6,5,10,7,0,0,0,4,0,21,3.0,2,0.0,0,7,0,0,10,0,0,4,0,7,14,1
4627,67390,aQ6WrdDe9pTNwVW3vmaMOs1pxy5r3Dxa,RXDvfPUBYFlVdlueBFbLW0mhhAyGEqpt,39,58,34,38,18,44,13,3,208,29.714285714285715,6,0.0,8,34,31,18,50,44,7,13,3,91,117,1
4628,67398,gYz3DXiXiB2ygQdrSqkvFFqa3NbdbDQD,SpATywNh6bZuzm8s1ceuBUnMUAeoAHHw,1,0,0,0,0,0,1,0,1,0.14285714285714285,1,0.0,0,0,0,0,0,0,0,1,0,0,1,1
4629,67399,dX8G0MwLqG7R1v0a5bVLBBEO2QeJVwW8,SpATywNh6bZuzm8s1ceuBUnMUAeoAHHw,16,10,6,13,4,0,3,0,36,5.142857142857143,2,0.0,2,6,11,4,8,0,2,3,0,23,13,1
4630,67403,s42YRljOqExiv71QhA2soTLfn9kHZdPI,bWdj2GDclj5ofokWjzoa5jAwMkxCykd6,6,15,10,0,0,0,8,0,33,4.714285714285714,3,0.0,0,10,0,0,15,0,0,8,0,10,23,1
4631,67407,s42YRljOqExiv71QhA2soTLfn9kHZdPI,G8EPVSXsOYB5YQWZGiz1aVq5Pgr2GrQu,11,19,13,0,0,0,7,0,39,5.571428571428571,5,0.0,0,13,0,0,19,0,0,7,0,13,26,1
4632,67410,SUuO92fg900YcWp4Zs3wbFF13otrTK0v,SpATywNh6bZuzm8s1ceuBUnMUAeoAHHw,9,10,0,11,0,0,5,0,26,3.7142857142857144,2,0.0,4,0,11,0,6,0,0,5,0,15,11,0
4633,67411,tvf3NtE6iYQ6D7C3fM47X9eIcuZU3rZg,SpATywNh6bZuzm8s1ceuBUnMUAeoAHHw,1,0,0,0,0,0,1,0,1,0.14285714285714285,1,0.0,0,0,0,0,0,0,0,1,0,0,1,1
4634,67415,JBvV2euLTmN1KOC1bV6ujBU9dbXkql5n,SpATywNh6bZuzm8s1ceuBUnMUAeoAHHw,7,3,1,0,2,0,3,0,9,1.2857142857142858,1,0.0,0,1,0,2,3,0,0,3,0,3,6,1
4635,67420,IQ0KwwSF7jAVaA1XdkRcnXVwTeEvf1Lv,G8EPVSXsOYB5YQWZGiz1aVq5Pgr2GrQu,8,8,2,0,1,0,7,0,18,2.5714285714285716,2,0.0,3,2,0,1,5,0,0,7,0,6,12,1
4636,67426,VFYk1GyeJyGqK1t09cLe0E5m7KsULmvc,G8EPVSXsOYB5YQWZGiz1aVq5Pgr2GrQu,58,131,64,100,43,47,25,1,411,58.714285714285715,10,0.0,8,64,86,43,123,47,14,25,1,201,210,1
4637,67428,oKLMQAZTIOtP37CLM9yXiFLXKHfYljGQ,SpATywNh6bZuzm8s1ceuBUnMUAeoAHHw,6,10,3,0,1,0,2,0,16,2.2857142857142856,2,0.0,0,3,0,1,10,0,0,2,0,4,12,1
4638,67430,RQJ9jLgqxRIRHJ3Dya9dRIuO3dlScgvn,SpATywNh6bZuzm8s1ceuBUnMUAeoAHHw,13,18,0,16,0,10,6,1,51,7.285714285714286,2,0.0,10,0,13,0,8,10,3,6,1,23,28,1
4639,67432,FdsEBC0mHy1vT6x3hjK3QpB4Q1Uhf4Gh,SpATywNh6bZuzm8s1ceuBUnMUAeoAHHw,34,54,0,39,0,1,22,1,117,16.714285714285715,8,0.0,6,0,32,0,48,1,7,22,1,38,79,0
4640,67453,BuFcLJJOy4ywnCaR2obicsAMubCpPv8W,G8EPVSXsOYB5YQWZGiz1aVq5Pgr2GrQu,14,34,8,0,6,1,14,1,64,9.142857142857142,1,0.0,3,8,0,6,31,1,0,14,1,17,47,1
4641,67459,Gb2kkDHyDR8EKKTcjBRaUmubTYuyJhiK,G8EPVSXsOYB5YQWZGiz1aVq5Pgr2GrQu,27,34,15,18,11,0,8,0,86,12.285714285714286,3,0.0,7,15,13,11,27,0,5,8,0,46,40,1
4642,67471,a6W98SSI7NFdfjtHnUJXqYQ7M2ljRDYt,SpATywNh6bZuzm8s1ceuBUnMUAeoAHHw,13,33,11,23,1,4,15,2,89,12.714285714285714,5,0.0,13,11,20,1,20,4,3,15,2,45,44,0
4643,67477,SivEvgGr7pG5rlJGO3LDvmVfpVlkOk9l,SpATywNh6bZuzm8s1ceuBUnMUAeoAHHw,11,17,3,0,1,0,7,1,29,4.142857142857143,3,0.0,1,3,0,1,16,0,0,7,1,5,24,1
4644,67502,aqNbKvnpDmE6ISe0Qz8K64tYcLrFHQcz,SpATywNh6bZuzm8s1ceuBUnMUAeoAHHw,6,3,2,0,2,0,1,0,8,1.1428571428571428,1,0.0,0,2,0,2,3,0,0,1,0,4,4,1
4645,67524,VaOhD86uWnK2TjloSi50DgiXbw9C3K0T,bWdj2GDclj5ofokWjzoa5jAwMkxCykd6,8,32,2,0,1,0,13,0,48,6.857142857142857,1,0.0,0,2,0,1,32,0,0,13,0,3,45,1
4646,67525,UwnKbl2ARSQ7IikE1xisJoI3ICSxWK5v,SpATywNh6bZuzm8s1ceuBUnMUAeoAHHw,3,2,1,0,0,0,2,0,5,0.7142857142857143,2,0.0,0,1,0,0,2,0,0,2,0,1,4,1
4647,67531,HXqJJTXStUqZG7I7cVStlMobVqz7irG0,SpATywNh6bZuzm8s1ceuBUnMUAeoAHHw,8,6,4,0,2,0,2,0,14,2.0,1,0.0,0,4,0,2,6,0,0,2,0,6,8,1
4648,67538,6IcVTIvgSxxMCCqvswEKCMSbCJJ6BHWS,RXDvfPUBYFlVdlueBFbLW0mhhAyGEqpt,25,33,19,28,11,3,4,0,98,14.0,2,0.0,7,19,25,11,26,3,3,4,0,62,36,1
4649,67541,wb1auupOEOByBWLVmCpIzBal9pmTApTW,bWdj2GDclj5ofokWjzoa5jAwMkxCykd6,16,19,8,78,8,18,5,2,138,19.714285714285715,2,0.0,7,8,75,8,12,18,3,5,2,98,40,1
4650,67544,gSzwbDlzeyvDrdHnrWsBTEKJeSjOW5Jb,RXDvfPUBYFlVdlueBFbLW0mhhAyGEqpt,17,23,10,0,6,0,20,0,59,8.428571428571429,3,0.0,5,10,0,6,18,0,0,20,0,21,38,1
4651,67552,Bfvp2pdOjaKzYdBNQKGPqSn1IHYZcfBw,SpATywNh6bZuzm8s1ceuBUnMUAeoAHHw,4,2,1,0,1,0,1,0,5,0.7142857142857143,1,0.0,0,1,0,1,2,0,0,1,0,2,3,1
4652,67553,YGhHDAwBdNiyL9eKoJUrnR1s8ObHumpL,SpATywNh6bZuzm8s1ceuBUnMUAeoAHHw,5,3,1,0,1,0,1,0,6,0.8571428571428571,1,0.0,0,1,0,1,3,0,0,1,0,2,4,1
4653,67559,q2OeaRVSMsymXTCsCZPucygIuEsf22CD,SpATywNh6bZuzm8s1ceuBUnMUAeoAHHw,1,0,0,0,0,0,1,0,1,0.14285714285714285,1,0.0,0,0,0,0,0,0,0,1,0,0,1,1
4654,67567,2famc4S1vDEuGFyXiIN218hXpJ7I8XBG,SpATywNh6bZuzm8s1ceuBUnMUAeoAHHw,5,2,1,0,1,2,2,0,8,1.1428571428571428,1,0.0,0,1,0,1,2,2,0,2,0,2,6,1
4655,67570,I1340YsGXK2BIG96XRWppOvFniqpKDu7,RXDvfPUBYFlVdlueBFbLW0mhhAyGEqpt,76,130,46,216,28,10,15,0,445,63.57142857142857,5,0.0,38,46,194,28,92,10,22,15,0,306,139,0
4656,67574,3bThVr1RhSpIoI7gmUCoVwEy4UIBaasx,RXDvfPUBYFlVdlueBFbLW0mhhAyGEqpt,5,2,1,0,1,9,3,0,16,2.2857142857142856,2,0.0,0,1,0,1,2,9,0,3,0,2,14,1
4657,67600,nSn0VSHBRSmwKbK0c8WkxsGEmgkNhPeq,SpATywNh6bZuzm8s1ceuBUnMUAeoAHHw,1,0,0,0,0,0,1,0,1,0.14285714285714285,1,0.0,0,0,0,0,0,0,0,1,0,0,1,1
4658,67609,VaOhD86uWnK2TjloSi50DgiXbw9C3K0T,SpATywNh6bZuzm8s1ceuBUnMUAeoAHHw,6,9,3,0,1,0,6,0,19,2.7142857142857144,2,0.0,0,3,0,1,9,0,0,6,0,4,15,1
4659,67623,Sqd3Eviij3ahMVLlwINw4LiDCg7rwrfy,RXDvfPUBYFlVdlueBFbLW0mhhAyGEqpt,10,9,5,0,3,0,4,1,22,3.142857142857143,2,0.0,0,5,0,3,9,0,0,4,1,8,14,1
4660,67629,BMgk3lhp6DaLc2hrRyAZS5f3pfgtil58,RXDvfPUBYFlVdlueBFbLW0mhhAyGEqpt,14,14,5,24,0,1,3,0,47,6.714285714285714,1,0.0,2,5,24,0,12,1,0,3,0,31,16,1
4661,67632,rztgByxlqb0NHiCkVNMSLs4z23c2EnGy,RXDvfPUBYFlVdlueBFbLW0mhhAyGEqpt,7,8,5,0,2,0,3,0,18,2.5714285714285716,3,0.0,1,5,0,2,7,0,0,3,0,8,10,1
4662,67641,8QtgTaOo9DCjgt6kc4Db1wXfaWgbOe0I,SpATywNh6bZuzm8s1ceuBUnMUAeoAHHw,16,24,10,15,3,0,17,0,69,9.857142857142858,4,0.0,7,10,13,3,17,0,2,17,0,33,36,1
4663,67642,BwXR7IzUtCAN8pzY1XJl6dbItwnWn8P1,SpATywNh6bZuzm8s1ceuBUnMUAeoAHHw,25,81,39,23,4,3,28,1,179,25.571428571428573,10,0.0,20,39,23,4,61,3,0,28,1,86,93,0
4664,67645,7qacCXNHfhtV3QzmLTTx2G76bXaJZKdF,SpATywNh6bZuzm8s1ceuBUnMUAeoAHHw,16,35,10,26,4,2,8,1,86,12.285714285714286,3,0.0,7,10,21,4,28,2,5,8,1,42,44,1
4665,67658,h5afPVcogbI1QW4dfwFBz4UIlWjjM3RW,SpATywNh6bZuzm8s1ceuBUnMUAeoAHHw,27,34,11,26,5,10,24,5,115,16.428571428571427,3,0.0,10,11,24,5,24,10,2,24,5,50,65,0
4666,67667,6uiFMn8grVARFSiZJzUXdXUiSRmDc7wn,SpATywNh6bZuzm8s1ceuBUnMUAeoAHHw,5,2,1,0,1,0,2,0,6,0.8571428571428571,1,0.0,0,1,0,1,2,0,0,2,0,2,4,1
4667,67673,kXJgNJrJLFK7Wt9KanP6QLSHH0toxORn,bWdj2GDclj5ofokWjzoa5jAwMkxCykd6,8,5,1,16,2,0,4,0,28,4.0,1,0.0,3,1,15,2,2,0,1,4,0,21,7,1
4668,67698,3T1Ajx8AzLKpkWsqnzq5ndyNCwXcvT6Q,G8EPVSXsOYB5YQWZGiz1aVq5Pgr2GrQu,9,10,3,4,2,0,1,0,20,2.857142857142857,1,0.0,6,3,2,2,4,0,2,1,0,13,7,1
4669,67700,Rj8CRmBx55LfZEmX69tsiuIQYQCOEvVu,bWdj2GDclj5ofokWjzoa5jAwMkxCykd6,4,6,1,0,1,0,2,0,10,1.4285714285714286,2,0.0,2,1,0,1,4,0,0,2,0,4,6,1
4670,67705,3cEo76QwJwldypMfZu21btn9IT8f6eL0,SpATywNh6bZuzm8s1ceuBUnMUAeoAHHw,15,34,3,22,2,5,10,4,80,11.428571428571429,2,0.0,17,3,19,2,17,5,3,10,4,41,39,1
4671,67729,KY9QavBrusW9AVV6DEyZrJ3FCnXy59JE,SpATywNh6bZuzm8s1ceuBUnMUAeoAHHw,9,19,10,0,3,0,12,0,44,6.285714285714286,3,0.0,0,10,0,3,19,0,0,12,0,13,31,1
4672,67732,2gXHY5qLgY96Nt3kImmboPawcy43EQXt,bWdj2GDclj5ofokWjzoa5jAwMkxCykd6,7,14,13,0,11,0,7,1,46,6.571428571428571,2,0.0,0,13,0,11,14,0,0,7,1,24,22,1
4673,67740,uCpSmjtsmbP6Tx3GZFwKoiUihKYXvJaM,SpATywNh6bZuzm8s1ceuBUnMUAeoAHHw,12,21,0,20,0,0,3,0,44,6.285714285714286,1,0.0,12,0,17,0,9,0,3,3,0,29,15,1
4674,67750,myyvmwvFjycfP5QErbd6tsUl0M6ndOJg,bWdj2GDclj5ofokWjzoa5jAwMkxCykd6,1,0,0,0,0,0,1,0,1,0.14285714285714285,1,0.0,0,0,0,0,0,0,0,1,0,0,1,1
4675,67751,myyvmwvFjycfP5QErbd6tsUl0M6ndOJg,SpATywNh6bZuzm8s1ceuBUnMUAeoAHHw,17,28,7,21,3,14,17,1,91,13.0,2,0.0,14,7,18,3,14,14,3,17,1,42,49,1
4676,67753,KY9QavBrusW9AVV6DEyZrJ3FCnXy59JE,bWdj2GDclj5ofokWjzoa5jAwMkxCykd6,5,2,1,0,1,0,2,0,6,0.8571428571428571,1,0.0,0,1,0,1,2,0,0,2,0,2,4,1
4677,67780,GlNbCQHDc8z8JZPiUwkPuJYi1fBEr1Uj,SpATywNh6bZuzm8s1ceuBUnMUAeoAHHw,8,27,9,0,0,0,5,0,41,5.857142857142857,2,0.0,8,9,0,0,19,0,0,5,0,17,24,1
4678,67782,0hRwE5vbowYRJTF6rcWCTgSh4yHA34bg,bWdj2GDclj5ofokWjzoa5jAwMkxCykd6,15,19,1,28,1,5,10,3,67,9.571428571428571,2,0.0,3,1,24,1,16,5,4,10,3,29,38,1
4679,67785,rqqNQl0bghaqvkPV1u2C08foWzi8FdRA,SpATywNh6bZuzm8s1ceuBUnMUAeoAHHw,12,13,5,11,3,0,2,0,34,4.857142857142857,2,0.0,4,5,10,3,9,0,1,2,0,22,12,1
4680,67791,knXx0VSX34ZZdw5j0pCDnRFFDbxG6IJ6,G8EPVSXsOYB5YQWZGiz1aVq5Pgr2GrQu,12,9,5,8,3,0,2,0,27,3.857142857142857,1,0.0,3,5,5,3,6,0,3,2,0,16,11,1
4681,67792,nhiUGENuXs75W6QlSu5vemDE5ZazLnGr,SpATywNh6bZuzm8s1ceuBUnMUAeoAHHw,11,13,5,13,2,0,4,0,37,5.285714285714286,2,0.0,6,5,11,2,7,0,2,4,0,24,13,1
4682,67795,ryJpL5sHkbmvdjizu6MIIT96L8Kj1MfG,SpATywNh6bZuzm8s1ceuBUnMUAeoAHHw,13,16,8,13,4,1,2,0,44,6.285714285714286,2,0.0,5,8,10,4,11,1,3,2,0,27,17,1
4683,67802,IEfUasRNK7F4OXmh9ZRgY5RLlk7j6VcY,bWdj2GDclj5ofokWjzoa5jAwMkxCykd6,9,15,9,6,3,0,5,0,38,5.428571428571429,3,0.0,1,9,6,3,14,0,0,5,0,19,19,1
4684,67805,3g0CiljEiblxCvXeNEcFARnThDq8TtPt,SpATywNh6bZuzm8s1ceuBUnMUAeoAHHw,21,46,19,13,11,15,10,1,115,16.428571428571427,6,0.0,12,19,12,11,34,15,1,10,1,54,61,0
4685,67814,7YAyDVo7GNQL9jwTCNlUB5NS22KP2Dmb,bWdj2GDclj5ofokWjzoa5jAwMkxCykd6,1,0,0,0,0,0,1,0,1,0.14285714285714285,1,0.0,0,0,0,0,0,0,0,1,0,0,1,1
4686,67826,arUYdy6tAdeT8uL5IVe1ucPvbGcQUSs0,RXDvfPUBYFlVdlueBFbLW0mhhAyGEqpt,45,32,19,89,14,2,8,1,165,23.571428571428573,3,0.0,10,19,82,14,22,2,7,8,1,125,40,0
4687,67828,8MQx62NrM26CEa5RRkhFUh36AiGGNx6S,SpATywNh6bZuzm8s1ceuBUnMUAeoAHHw,1,0,0,0,0,0,1,0,1,0.14285714285714285,1,0.0,0,0,0,0,0,0,0,1,0,0,1,1
4688,67840,liGkK11lmEt5l6sf4BenFBe3u0IYqC3Z,bWdj2GDclj5ofokWjzoa5jAwMkxCykd6,1,0,0,0,0,0,1,0,1,0.14285714285714285,1,0.0,0,0,0,0,0,0,0,1,0,0,1,1
4689,67844,e2v0YuUkw7VpGwXO9DL86A4Bv6MP4mEu,SpATywNh6bZuzm8s1ceuBUnMUAeoAHHw,6,3,1,0,1,0,3,0,8,1.1428571428571428,1,0.0,0,1,0,1,3,0,0,3,0,2,6,1
4690,67852,3Aezv8lgcVyIW4Uwgi3KMiL4RZSkwke5,SpATywNh6bZuzm8s1ceuBUnMUAeoAHHw,24,40,22,26,7,29,18,0,142,20.285714285714285,8,0.0,12,22,22,7,28,29,4,18,0,63,79,1
4691,67860,zILXfIGJjWXm6dA2MrEQWr2XeEUry8lN,G8EPVSXsOYB5YQWZGiz1aVq5Pgr2GrQu,7,2,1,0,1,0,4,0,8,1.1428571428571428,1,0.0,0,1,0,1,2,0,0,4,0,2,6,1
4692,67870,w3ElIgawNC8WwURVJSAJ04McneT8QIvi,G8EPVSXsOYB5YQWZGiz1aVq5Pgr2GrQu,22,22,19,48,10,3,4,0,106,15.142857142857142,2,0.0,0,19,38,10,22,3,10,4,0,67,39,1
4693,67877,3kPbFQO63O023TRazY2t5V1M3b8brUv8,SpATywNh6bZuzm8s1ceuBUnMUAeoAHHw,13,27,0,4,0,1,7,0,39,5.571428571428571,3,0.0,0,0,3,0,27,1,1,7,0,3,36,1
4694,67879,bRwq2z1Yz5KS0MW4CkmNDI34p59fmbas,RXDvfPUBYFlVdlueBFbLW0mhhAyGEqpt,6,5,1,0,0,0,3,0,9,1.2857142857142858,2,0.0,0,1,0,0,5,0,0,3,0,1,8,1
4695,67909,sFJi6moEGD2T3AyA8nWt11YDR7GEvwod,bWdj2GDclj5ofokWjzoa5jAwMkxCykd6,8,7,4,0,2,2,10,1,26,3.7142857142857144,2,0.0,0,4,0,2,7,2,0,10,1,6,20,1
4696,67912,P0LyrpZzGdWXSuU2oQCFUf1LzUdIEooV,SpATywNh6bZuzm8s1ceuBUnMUAeoAHHw,5,2,1,0,1,0,2,0,6,0.8571428571428571,1,0.0,0,1,0,1,2,0,0,2,0,2,4,1
4697,67916,kbnRP5v2Cp1hRovzbBsM6Gb1jKCIVIhL,bWdj2GDclj5ofokWjzoa5jAwMkxCykd6,5,8,2,0,2,0,5,0,17,2.4285714285714284,3,0.0,0,2,0,2,8,0,0,5,0,4,13,1
4698,67918,pzHaWUcmzb5LgLjIjpaBYBq7daMNFpyk,SpATywNh6bZuzm8s1ceuBUnMUAeoAHHw,34,68,3,50,0,2,36,0,159,22.714285714285715,8,0.0,21,3,43,0,47,2,7,36,0,67,92,1
4699,67921,QqqCImBc1OlgaSz0c9g0FVsZigKUtiqT,SpATywNh6bZuzm8s1ceuBUnMUAeoAHHw,6,1,1,0,1,0,3,0,6,0.8571428571428571,1,0.0,0,1,0,1,1,0,0,3,0,2,4,1
4700,67923,GDzMP0flkQ2hBX32d5dxAzabEDzF5Okt,SpATywNh6bZuzm8s1ceuBUnMUAeoAHHw,8,21,9,0,7,0,1,0,38,5.428571428571429,1,0.0,0,9,0,7,21,0,0,1,0,16,22,1
4701,67930,x6K6gEN1bi7EtUHqEXEFGztPxJcTq3NW,SpATywNh6bZuzm8s1ceuBUnMUAeoAHHw,44,57,30,49,13,0,15,0,164,23.428571428571427,6,0.0,9,30,41,13,48,0,8,15,0,93,71,1
4702,67931,OYfteiWNoHqPLaPu97Z12Qs0dcDVEU6S,SpATywNh6bZuzm8s1ceuBUnMUAeoAHHw,10,5,4,0,3,0,2,0,14,2.0,1,0.0,0,4,0,3,5,0,0,2,0,7,7,1
4703,67933,f517pkeTgS2hq8EkZsCwn6jk8FMpBlHa,bWdj2GDclj5ofokWjzoa5jAwMkxCykd6,5,5,3,0,2,0,2,0,12,1.7142857142857142,2,0.0,0,3,0,2,5,0,0,2,0,5,7,1
4704,67939,96BILLwhKLX5Hn5XJ4XGCvMlo8QDhAAj,bWdj2GDclj5ofokWjzoa5jAwMkxCykd6,1,0,0,0,0,0,1,0,1,0.14285714285714285,1,0.0,0,0,0,0,0,0,0,1,0,0,1,1
4705,67951,p9mlVtqvvgTSd0U238vycamcjMBfubit,SpATywNh6bZuzm8s1ceuBUnMUAeoAHHw,8,9,7,0,4,0,5,0,25,3.5714285714285716,1,0.0,0,7,0,4,9,0,0,5,0,11,14,1
4706,67956,laZtrdxzAU1QbcDNiYt367rO7zb5NT6r,SpATywNh6bZuzm8s1ceuBUnMUAeoAHHw,1,0,0,0,0,0,1,0,1,0.14285714285714285,1,0.0,0,0,0,0,0,0,0,1,0,0,1,1
4707,67974,5RgoX61rBJXf0CtdNHC5FjUHV0bRPnZt,SpATywNh6bZuzm8s1ceuBUnMUAeoAHHw,10,3,3,0,2,1,4,1,14,2.0,1,0.0,0,3,0,2,3,1,0,4,1,5,9,1
4708,67989,hSX8yZ4n5gfrq8om8peGXZoF496tHdJ6,SpATywNh6bZuzm8s1ceuBUnMUAeoAHHw,1,0,0,0,0,0,1,0,1,0.14285714285714285,1,0.0,0,0,0,0,0,0,0,1,0,0,1,1
4709,67995,LHXRg7L7kOMUaNixGAIsvmtlbCTLBkt1,G8EPVSXsOYB5YQWZGiz1aVq5Pgr2GrQu,12,10,1,26,0,0,5,0,42,6.0,1,0.0,1,1,23,0,9,0,3,5,0,25,17,1
4710,68000,zP7Uswh6CHfnx5kLYcdPpqokCtUDEMqC,SpATywNh6bZuzm8s1ceuBUnMUAeoAHHw,9,6,4,0,2,0,5,0,17,2.4285714285714284,1,0.0,0,4,0,2,6,0,0,5,0,6,11,1
4711,68003,hc3dSrci35Dy3FgQbfVD88Ol0CqYSCR2,RXDvfPUBYFlVdlueBFbLW0mhhAyGEqpt,39,34,20,56,13,5,1,0,129,18.428571428571427,1,0.0,12,20,53,13,22,5,3,1,0,98,31,1
4712,68011,Y0dtU5bUn0PrrnfgvOUCPfb1rktwn4CX,SpATywNh6bZuzm8s1ceuBUnMUAeoAHHw,11,13,9,0,5,0,3,0,30,4.285714285714286,2,0.0,0,9,0,5,13,0,0,3,0,14,16,1
4713,68014,eSHpbUzZvfLR4whtzGnR3u58hC1o1DTb,SpATywNh6bZuzm8s1ceuBUnMUAeoAHHw,19,29,10,17,7,1,7,0,71,10.142857142857142,3,0.0,16,10,14,7,13,1,3,7,0,47,24,1
4714,68031,bez5lZ7uTfbzlLF7Tc3pJJ6gxAYK8BMg,RXDvfPUBYFlVdlueBFbLW0mhhAyGEqpt,1,0,0,0,0,0,1,0,1,0.14285714285714285,1,0.0,0,0,0,0,0,0,0,1,0,0,1,1
4715,68033,g3VeqRwacliKE1TZTgZHIE5PL7TPQV85,SpATywNh6bZuzm8s1ceuBUnMUAeoAHHw,3,2,0,0,0,0,1,0,3,0.42857142857142855,1,0.0,0,0,0,0,2,0,0,1,0,0,3,1
4716,68043,mHfTvd1CfaCURBT44fgL7AymprwCoavs,SpATywNh6bZuzm8s1ceuBUnMUAeoAHHw,17,36,6,20,3,3,20,1,89,12.714285714285714,4,0.0,5,6,16,3,31,3,4,20,1,30,59,1
4717,68045,Qxy5KsClrN9vr6xM8xy9xnCXA2MaJ6Yo,SpATywNh6bZuzm8s1ceuBUnMUAeoAHHw,4,4,0,0,0,0,4,0,8,1.1428571428571428,2,0.0,0,0,0,0,4,0,0,4,0,0,8,1
4718,68057,zmlL73g2U1Ek37ZDQ2H6P7dwK1MBsxuX,SpATywNh6bZuzm8s1ceuBUnMUAeoAHHw,12,32,19,0,13,6,7,1,78,11.142857142857142,3,0.0,0,19,0,13,32,6,0,7,1,32,46,1
4719,68059,V87r8ov3AJYZnaKsWbASGu8Ya7b0fguH,SpATywNh6bZuzm8s1ceuBUnMUAeoAHHw,9,13,6,2,1,0,6,0,28,4.0,4,0.0,3,6,2,1,10,0,0,6,0,12,16,1
4720,68070,1VCQvdBqSLamldHF1ZwYh2NF4ESIqek2,bWdj2GDclj5ofokWjzoa5jAwMkxCykd6,13,5,2,46,2,1,9,0,65,9.285714285714286,3,0.0,2,2,41,2,3,1,5,9,0,47,18,1
4721,68073,Q3zfa1BaaSk3KZquv3yDWk8LnczxvujV,SpATywNh6bZuzm8s1ceuBUnMUAeoAHHw,13,8,5,0,4,1,10,1,29,4.142857142857143,1,0.0,2,5,0,4,6,1,0,10,1,11,18,1
4722,68080,PwGj8ON4yrWpMaoZE0ES8sG2eAqFQNfN,bWdj2GDclj5ofokWjzoa5jAwMkxCykd6,12,17,11,0,7,17,8,2,62,8.857142857142858,4,0.0,0,11,0,7,17,17,0,8,2,18,44,1
4723,68106,13DcuqcvvZMyCe7b78EqeBeeWiXw335e,G8EPVSXsOYB5YQWZGiz1aVq5Pgr2GrQu,28,119,5,0,35,0,20,2,181,25.857142857142858,4,0.0,73,5,0,35,46,0,0,20,2,113,68,1
4724,68109,uFrJImuWBoPsyUWzay10wbSOjd0eMaSI,SpATywNh6bZuzm8s1ceuBUnMUAeoAHHw,15,15,5,18,3,1,10,0,52,7.428571428571429,2,0.0,10,5,15,3,5,1,3,10,0,33,19,1
4725,68117,MDJGW12z1ZhMFT2gTIbEYAqP2tu7pkDh,SpATywNh6bZuzm8s1ceuBUnMUAeoAHHw,32,55,28,29,9,60,35,3,219,31.285714285714285,8,0.0,14,28,27,9,41,60,2,35,3,78,141,0
4726,68119,Wigd4PnyDnjfDcFOxsTBcEnXo7kl9GSg,RXDvfPUBYFlVdlueBFbLW0mhhAyGEqpt,15,37,5,29,1,0,8,4,84,12.0,3,0.0,5,5,22,1,32,0,7,8,4,33,51,1
4727,68122,q1MlrkW0KNfJjOXajII1Q1GZBULc6aNj,SpATywNh6bZuzm8s1ceuBUnMUAeoAHHw,22,29,2,38,2,11,16,3,101,14.428571428571429,3,0.0,8,2,33,2,21,11,5,16,3,45,56,1
4728,68135,HStxcO1eYnD7c9LphwK9HrPR7VO3IHfm,SpATywNh6bZuzm8s1ceuBUnMUAeoAHHw,12,11,0,13,0,7,5,1,37,5.285714285714286,1,0.0,3,0,11,0,8,7,2,5,1,14,23,1
4729,68153,EY0G0vEEEoCokHenoT1cdgE4rcGAf4FL,G8EPVSXsOYB5YQWZGiz1aVq5Pgr2GrQu,4,2,1,0,1,0,1,0,5,0.7142857142857143,1,0.0,0,1,0,1,2,0,0,1,0,2,3,0
4730,68154,APkKPEpve0ecRJut2qy8IYwsafYtrJRq,bWdj2GDclj5ofokWjzoa5jAwMkxCykd6,3,2,0,0,0,0,3,0,5,0.7142857142857143,2,0.0,0,0,0,0,2,0,0,3,0,0,5,1
4731,68160,DYC2TKuAWipp9UNJIdqFLJgrkLj9mdOD,bWdj2GDclj5ofokWjzoa5jAwMkxCykd6,15,22,7,36,2,0,10,1,78,11.142857142857142,3,0.0,5,7,32,2,17,0,4,10,1,46,32,0
4732,68169,U8vo2wOZC3Q8EW1kIl6iwoIzgmQUZ4u1,bWdj2GDclj5ofokWjzoa5jAwMkxCykd6,1,0,0,0,0,0,1,0,1,0.14285714285714285,1,0.0,0,0,0,0,0,0,0,1,0,0,1,1
4733,68170,bpxaFadaQixJuWRVtAAq5miKiBM3zC6u,bWdj2GDclj5ofokWjzoa5jAwMkxCykd6,17,70,10,32,3,0,27,0,142,20.285714285714285,7,0.0,13,10,31,3,57,0,1,27,0,57,85,1
4734,68171,XNe46LXabpvEI4s4Cxqc45erOVco8nzW,RXDvfPUBYFlVdlueBFbLW0mhhAyGEqpt,38,30,18,42,7,16,11,3,127,18.142857142857142,3,0.0,7,18,35,7,23,16,7,11,3,67,60,0
4735,68177,y6oK2aw09rZ1km46IcOJlYdWLv4Nbbgi,G8EPVSXsOYB5YQWZGiz1aVq5Pgr2GrQu,10,11,6,0,5,0,8,1,31,4.428571428571429,3,0.0,3,6,0,5,8,0,0,8,1,14,17,1
4736,68185,LGH5sOmtpw8WtitJ1dxQtTEBLQHqJEi1,SpATywNh6bZuzm8s1ceuBUnMUAeoAHHw,8,5,4,0,3,1,8,0,21,3.0,1,0.0,0,4,0,3,5,1,0,8,0,7,14,1
4737,68190,hWdLPP6trGxWYA1TuFBESlsN42OdBR5S,G8EPVSXsOYB5YQWZGiz1aVq5Pgr2GrQu,6,4,1,0,1,0,2,0,8,1.1428571428571428,1,0.0,0,1,0,1,4,0,0,2,0,2,6,1
4738,68192,TWLIxoyQjwriLBEzpRamZWHBF7mx1bZa,SpATywNh6bZuzm8s1ceuBUnMUAeoAHHw,6,11,0,0,0,0,4,0,15,2.142857142857143,2,0.0,1,0,0,0,10,0,0,4,0,1,14,1
4739,68199,rcnv42t7RT4fLoWqKHgTKDC8e00KMJQL,G8EPVSXsOYB5YQWZGiz1aVq5Pgr2GrQu,43,52,20,134,1,7,20,2,236,33.714285714285715,2,0.0,15,20,107,1,37,7,27,20,2,143,93,1
4740,68216,PiwCisYixMxmp8HVjRmlBlqNy6QSUUjE,SpATywNh6bZuzm8s1ceuBUnMUAeoAHHw,11,19,8,0,3,13,9,1,53,7.571428571428571,3,0.0,0,8,0,3,19,13,0,9,1,11,42,1
4741,68218,Lbpr3xWnQcIYr1qRkqlNlsrYRpIeuPh8,SpATywNh6bZuzm8s1ceuBUnMUAeoAHHw,9,37,11,0,5,2,12,0,67,9.571428571428571,7,0.0,2,11,0,5,35,2,0,12,0,18,49,1
4742,68219,PLTytqL5kLJdDGm9MvAFVaFDS2S7nPDO,SpATywNh6bZuzm8s1ceuBUnMUAeoAHHw,24,26,14,10,7,0,8,0,65,9.285714285714286,7,0.0,3,14,10,7,23,0,0,8,0,34,31,1
4743,68231,c21M8vKZ0MTakbncwKdeoIofnrY81cjv,SpATywNh6bZuzm8s1ceuBUnMUAeoAHHw,1,0,0,0,0,0,1,0,1,0.14285714285714285,1,0.0,0,0,0,0,0,0,0,1,0,0,1,1
4744,68232,afcoJmZ0nAGqrhElRzMbfqW6LhEtEJYc,bWdj2GDclj5ofokWjzoa5jAwMkxCykd6,7,8,4,0,3,0,4,0,19,2.7142857142857144,1,0.0,2,4,0,3,6,0,0,4,0,9,10,1
4745,68233,MulztkDP8i6NO9fvTruczDhNDdweXQmA,SpATywNh6bZuzm8s1ceuBUnMUAeoAHHw,7,6,5,0,1,0,1,0,13,1.8571428571428572,1,0.0,0,5,0,1,6,0,0,1,0,6,7,0
4746,68255,KkwBRsW7iwfoq3LjJ8XmEzXVsYBRv2GT,RXDvfPUBYFlVdlueBFbLW0mhhAyGEqpt,8,5,0,0,0,8,7,1,21,3.0,2,0.0,0,0,0,0,5,8,0,7,1,0,21,1
4747,68284,AffDAPGfOBWNdcJAjvPAA03wTtMubBsN,SpATywNh6bZuzm8s1ceuBUnMUAeoAHHw,14,7,4,9,3,0,3,0,26,3.7142857142857144,1,0.0,2,4,9,3,5,0,0,3,0,18,8,1
4748,68291,uuLKbFK5mMvYPMLqDF2i3zslYpeZQmHn,SpATywNh6bZuzm8s1ceuBUnMUAeoAHHw,3,0,0,0,0,1,3,0,4,0.5714285714285714,1,0.0,0,0,0,0,0,1,0,3,0,0,4,1
4749,68297,KGm62I3mVkjiGl4NGvCWbKWuafRNbMyV,SpATywNh6bZuzm8s1ceuBUnMUAeoAHHw,8,9,4,0,2,0,4,0,19,2.7142857142857144,2,0.0,1,4,0,2,8,0,0,4,0,7,12,0
4750,68301,NRKadp4j4jPDuLDbaa9Nm62h1VN187qT,SpATywNh6bZuzm8s1ceuBUnMUAeoAHHw,30,54,22,34,9,71,28,2,220,31.428571428571427,3,0.0,23,22,30,9,31,71,4,28,2,84,136,1
4751,68311,HbZIH6bmQW1HcPZo94YfjT1UBGLpCJBJ,SpATywNh6bZuzm8s1ceuBUnMUAeoAHHw,5,2,1,0,1,0,2,0,6,0.8571428571428571,1,0.0,0,1,0,1,2,0,0,2,0,2,4,1
4752,68315,egnijdxL4Cz1CfzoCQSNIgWry6KIzA7P,G8EPVSXsOYB5YQWZGiz1aVq5Pgr2GrQu,11,15,6,2,4,0,2,0,29,4.142857142857143,2,0.0,2,6,2,4,13,0,0,2,0,14,15,1
4753,68322,FfFp5bobRPRps1SNXZNMmjBhJWfjO7gk,RXDvfPUBYFlVdlueBFbLW0mhhAyGEqpt,5,2,1,0,1,0,2,0,6,0.8571428571428571,1,0.0,0,1,0,1,2,0,0,2,0,2,4,1
4754,68328,y9yy4SYGgNo4YF8eQGlTVidGNj2rzbsP,G8EPVSXsOYB5YQWZGiz1aVq5Pgr2GrQu,5,3,2,0,1,0,1,0,7,1.0,1,0.0,0,2,0,1,3,0,0,1,0,3,4,1
4755,68354,ojZgxZ6gEjMazXpFaRfu4Ae98N9ZNMRK,bWdj2GDclj5ofokWjzoa5jAwMkxCykd6,7,3,1,0,1,0,5,0,10,1.4285714285714286,2,0.0,1,1,0,1,2,0,0,5,0,3,7,1
4756,68355,Su5k7DFmddHd0lx2vnzPJZVUiGwHL7uO,SpATywNh6bZuzm8s1ceuBUnMUAeoAHHw,1,0,0,0,0,0,1,0,1,0.14285714285714285,1,0.0,0,0,0,0,0,0,0,1,0,0,1,1
4757,68358,MKeSX2kzyiQphau2C7yhMMzLx4acc2Cv,SpATywNh6bZuzm8s1ceuBUnMUAeoAHHw,9,11,6,0,3,0,2,0,22,3.142857142857143,1,0.0,0,6,0,3,11,0,0,2,0,9,13,1
4758,68366,KWreIfKGdz3TT4Efo15YH7GPido1RPFL,RXDvfPUBYFlVdlueBFbLW0mhhAyGEqpt,7,8,5,0,2,0,7,0,22,3.142857142857143,3,0.0,0,5,0,2,8,0,0,7,0,7,15,1
4759,68367,sU7Jp2ENUb9Oqtzi9ZG3CKbDOgPtBcP1,SpATywNh6bZuzm8s1ceuBUnMUAeoAHHw,11,22,11,0,6,19,13,1,72,10.285714285714286,1,0.0,6,11,0,6,16,19,0,13,1,23,49,1
4760,68368,jzWvwaTexkgbyBrPkQbXDb98Viqx6cSS,bWdj2GDclj5ofokWjzoa5jAwMkxCykd6,11,7,3,22,2,0,1,0,35,5.0,1,0.0,3,3,21,2,4,0,1,1,0,29,6,1
4761,68381,tx4grxmlQgEoy6eADYfJTj1STA6T1B91,RXDvfPUBYFlVdlueBFbLW0mhhAyGEqpt,4,2,1,0,1,0,1,0,5,0.7142857142857143,2,0.0,0,1,0,1,2,0,0,1,0,2,3,1
4762,68391,GVe9EjZzf7ESYXvbkluFC1UhcDJcs9er,bWdj2GDclj5ofokWjzoa5jAwMkxCykd6,9,26,12,40,5,10,7,0,100,14.285714285714286,3,0.0,5,12,37,5,21,10,3,7,0,59,41,1
4763,68431,lrklBeCwIZ4DDBQy8VTt6d0eH3oNMMDo,G8EPVSXsOYB5YQWZGiz1aVq5Pgr2GrQu,10,12,8,0,4,0,6,0,30,4.285714285714286,2,0.0,0,8,0,4,12,0,0,6,0,12,18,1
4764,68434,Ebz4oSsfYjG2sZnxJFfxROe10fAGS03Z,bWdj2GDclj5ofokWjzoa5jAwMkxCykd6,8,3,2,0,1,3,6,1,16,2.2857142857142856,1,0.0,0,2,0,1,3,3,0,6,1,3,13,1
4765,68452,BmDa42DEGdvrNnigHMvPc7GGH9qDy89v,bWdj2GDclj5ofokWjzoa5jAwMkxCykd6,3,0,0,0,0,0,3,0,3,0.42857142857142855,1,0.0,0,0,0,0,0,0,0,3,0,0,3,1
4766,68460,dxAA51K7owVPQlCgekrtAuSBHXcBEsAY,SpATywNh6bZuzm8s1ceuBUnMUAeoAHHw,8,5,3,0,3,0,1,0,12,1.7142857142857142,2,0.0,0,3,0,3,5,0,0,1,0,6,6,0
4767,68466,ZDEv7xdHlbONQGNdkwzMgbMsJFIzjdrJ,bWdj2GDclj5ofokWjzoa5jAwMkxCykd6,5,3,2,0,1,0,2,0,8,1.1428571428571428,1,0.0,0,2,0,1,3,0,0,2,0,3,5,1
4768,68469,Xa3jTMZEURd4gE5fwojMlxo2QtjAxwez,bWdj2GDclj5ofokWjzoa5jAwMkxCykd6,2,0,0,0,0,0,4,0,4,0.5714285714285714,3,0.0,0,0,0,0,0,0,0,4,0,0,4,1
4769,68481,pXqbqKhLN9u2vMm4aIB5JwL5PRPhZDCp,SpATywNh6bZuzm8s1ceuBUnMUAeoAHHw,14,20,2,13,1,8,7,2,53,7.571428571428571,3,0.0,9,2,11,1,11,8,2,7,2,23,30,0
4770,68486,DudAvEFW2YcxyABZugZo1M6Olvw9DyeE,SpATywNh6bZuzm8s1ceuBUnMUAeoAHHw,6,1,1,0,1,0,3,0,6,0.8571428571428571,1,0.0,0,1,0,1,1,0,0,3,0,2,4,1
4771,68490,hjbzzLF0uZqUL22zLBiQhzq51chcw6mb,SpATywNh6bZuzm8s1ceuBUnMUAeoAHHw,42,57,29,47,15,1,6,0,155,22.142857142857142,2,0.0,20,29,38,15,37,1,9,6,0,102,53,1
4772,68495,MT2eJtF59AVNdUs7mwFqputROb2HgEm3,bWdj2GDclj5ofokWjzoa5jAwMkxCykd6,6,8,4,0,4,0,3,0,19,2.7142857142857144,2,0.0,2,4,0,4,6,0,0,3,0,10,9,0
4773,68504,nB3KwulRK6CdNkJMXAR7thY3WeV5E2Rs,bWdj2GDclj5ofokWjzoa5jAwMkxCykd6,5,2,1,0,1,1,4,0,9,1.2857142857142858,1,0.0,0,1,0,1,2,1,0,4,0,2,7,1
4774,68506,FjEPRVEQHV2jJGjIE0BfvDTSFq9OoqAS,SpATywNh6bZuzm8s1ceuBUnMUAeoAHHw,15,18,11,4,7,0,11,2,53,7.571428571428571,3,0.0,5,11,4,7,13,0,0,11,2,27,26,1
4775,68512,hg5y95p09bcGVElNVwoGOakcfzg7TGFk,bWdj2GDclj5ofokWjzoa5jAwMkxCykd6,6,5,3,0,2,0,6,0,16,2.2857142857142856,1,0.0,0,3,0,2,5,0,0,6,0,5,11,1
4776,68518,FwweMXtSQjX7f97OVLsz3BQNG8M83X1n,SpATywNh6bZuzm8s1ceuBUnMUAeoAHHw,7,2,1,0,1,0,4,0,8,1.1428571428571428,1,0.0,0,1,0,1,2,0,0,4,0,2,6,1
4777,68522,iSIDy53M1GeZpXt46JkUT1CVMnifiRBT,G8EPVSXsOYB5YQWZGiz1aVq5Pgr2GrQu,43,88,51,52,21,89,44,21,366,52.285714285714285,7,0.0,11,51,44,21,77,89,8,44,21,127,239,1
4778,68525,y0PkAopIdLmRFrkWC9eBHvWT77KfVWMh,RXDvfPUBYFlVdlueBFbLW0mhhAyGEqpt,1,0,0,0,0,0,1,0,1,0.14285714285714285,1,0.0,0,0,0,0,0,0,0,1,0,0,1,1
4779,68530,roxYJjIM3BSzWIDsW2TPAjzeyToX557n,SpATywNh6bZuzm8s1ceuBUnMUAeoAHHw,1,0,0,0,0,0,1,0,1,0.14285714285714285,1,0.0,0,0,0,0,0,0,0,1,0,0,1,1
4780,68531,hZR4MwcYec4g0GoOyJFngJGEyWOySpv2,RXDvfPUBYFlVdlueBFbLW0mhhAyGEqpt,17,16,10,8,5,17,15,0,71,10.142857142857142,4,0.0,1,10,6,5,15,17,2,15,0,22,49,0
4781,68546,op92WqXlATrimvc1hvYZEQwtjHkoChge,RXDvfPUBYFlVdlueBFbLW0mhhAyGEqpt,13,11,2,0,2,7,11,0,33,4.714285714285714,3,0.0,5,2,0,2,6,7,0,11,0,9,24,1
4782,68557,5yc0fnnf6Ve0yL1SBLUJVE35F9aXHffP,bWdj2GDclj5ofokWjzoa5jAwMkxCykd6,1,0,0,0,0,0,2,0,2,0.2857142857142857,1,0.0,0,0,0,0,0,0,0,2,0,0,2,1
4783,68570,w66Ys32IF7bg4QEY48rFtd8o9lijcjC3,SpATywNh6bZuzm8s1ceuBUnMUAeoAHHw,7,5,2,0,2,0,5,0,14,2.0,2,0.0,0,2,0,2,5,0,0,5,0,4,10,1
4784,68576,eC5OrlIfDx9Fw0Jh12C4RyvK1vDrMSLj,SpATywNh6bZuzm8s1ceuBUnMUAeoAHHw,11,12,1,0,0,2,9,1,25,3.5714285714285716,2,0.0,0,1,0,0,12,2,0,9,1,1,24,1
4785,68579,forPgRyluFqH5fyMZfnKJctNYjPII95b,SpATywNh6bZuzm8s1ceuBUnMUAeoAHHw,1,0,0,0,0,0,1,0,1,0.14285714285714285,1,0.0,0,0,0,0,0,0,0,1,0,0,1,1
4786,68583,forPgRyluFqH5fyMZfnKJctNYjPII95b,RXDvfPUBYFlVdlueBFbLW0mhhAyGEqpt,15,17,2,0,1,23,18,6,67,9.571428571428571,2,0.0,0,2,0,1,17,23,0,18,6,3,64,1
4787,68588,yIoYmR4ll93f7EHu29moXjbx4kT37xAM,bWdj2GDclj5ofokWjzoa5jAwMkxCykd6,18,27,4,70,7,7,16,2,133,19.0,2,0.0,10,4,64,7,17,7,6,16,2,85,48,1
4788,68591,b8js5e6thEnzYItgffCHQwfAl1iYfizN,SpATywNh6bZuzm8s1ceuBUnMUAeoAHHw,9,9,6,0,4,1,12,2,34,4.857142857142857,1,0.0,0,6,0,4,9,1,0,12,2,10,24,1
4789,68605,SZOXOmDilP1KR3OJXHpIlLf61tEoqX1S,G8EPVSXsOYB5YQWZGiz1aVq5Pgr2GrQu,4,2,1,0,1,0,1,0,5,0.7142857142857143,1,0.0,0,1,0,1,2,0,0,1,0,2,3,1
4790,68625,4QX0UVH2mWoWEvrk1Om8ECy2pBWoKhcm,SpATywNh6bZuzm8s1ceuBUnMUAeoAHHw,6,5,1,0,1,0,1,0,8,1.1428571428571428,1,0.0,1,1,0,1,4,0,0,1,0,3,5,1
4791,68629,M2AmcvqhvMtUlyRV6vMvvoM2IhrMmAwT,bWdj2GDclj5ofokWjzoa5jAwMkxCykd6,9,10,5,0,2,0,5,0,22,3.142857142857143,4,0.0,0,5,0,2,10,0,0,5,0,7,15,1
4792,68637,M4sV24yJlA7UYO36nFDbwFj49msCFYqO,SpATywNh6bZuzm8s1ceuBUnMUAeoAHHw,1,0,0,0,0,0,1,0,1,0.14285714285714285,1,0.0,0,0,0,0,0,0,0,1,0,0,1,1
4793,68650,3blAUsZiu4FW1Jp6vOBSuHfrNCEPv1lZ,RXDvfPUBYFlVdlueBFbLW0mhhAyGEqpt,11,10,3,0,2,0,6,0,21,3.0,2,0.0,0,3,0,2,10,0,0,6,0,5,16,0
4794,68657,kouVFmC9KYKK6YQi2WuQuIKCuxGX5ljt,RXDvfPUBYFlVdlueBFbLW0mhhAyGEqpt,39,39,5,79,4,3,9,1,140,20.0,6,0.0,10,5,75,4,29,3,4,9,1,94,46,0
4795,68662,JZ0cPuTVmC70maYF6NIorZr3bOTKKvsS,SpATywNh6bZuzm8s1ceuBUnMUAeoAHHw,1,0,0,0,0,0,1,0,1,0.14285714285714285,1,0.0,0,0,0,0,0,0,0,1,0,0,1,1
4796,68664,DfCrd6VP4inLGSvbDnl7Xl7qOqvm6UpO,SpATywNh6bZuzm8s1ceuBUnMUAeoAHHw,4,2,1,0,1,0,1,0,5,0.7142857142857143,1,0.0,0,1,0,1,2,0,0,1,0,2,3,1
4797,68665,9LD2dY2JJUiq4N2gerCXLTVCO162xgQP,G8EPVSXsOYB5YQWZGiz1aVq5Pgr2GrQu,48,106,26,144,15,3,13,1,308,44.0,5,0.0,4,26,144,15,102,3,0,13,1,189,119,1
4798,68667,13fzVwLJSsgGzTLwjEHCuvf0Ks8dgxYZ,RXDvfPUBYFlVdlueBFbLW0mhhAyGEqpt,1,0,0,0,0,0,1,0,1,0.14285714285714285,1,0.0,0,0,0,0,0,0,0,1,0,0,1,1
4799,68676,OvG0QIZOPiV3oa4UqFgxzNEprO7pKVmV,SpATywNh6bZuzm8s1ceuBUnMUAeoAHHw,60,67,31,26,17,8,29,1,179,25.571428571428573,8,0.0,8,31,26,17,59,8,0,29,1,82,97,0
4800,68687,lPU0lJqSA3OSdb8bK1yzncqCybAP9bUO,SpATywNh6bZuzm8s1ceuBUnMUAeoAHHw,16,59,31,18,7,29,18,0,162,23.142857142857142,2,0.0,9,31,16,7,50,29,2,18,0,63,99,1
4801,68688,s4immbICvRMkMxvZyJBqO325qtK1yhVk,G8EPVSXsOYB5YQWZGiz1aVq5Pgr2GrQu,3,3,0,0,0,0,1,0,4,0.5714285714285714,1,0.0,1,0,0,0,2,0,0,1,0,1,3,1
4802,68699,lyCFhIpUX9eBaODrOlziE1wpuE5i2FcV,bWdj2GDclj5ofokWjzoa5jAwMkxCykd6,2,0,0,0,0,0,2,0,2,0.2857142857142857,1,0.0,0,0,0,0,0,0,0,2,0,0,2,1
4803,68703,Th6GGIKucyCokdQsUn3aOeloTzqx0Qbo,SpATywNh6bZuzm8s1ceuBUnMUAeoAHHw,1,0,0,0,0,0,1,0,1,0.14285714285714285,1,0.0,0,0,0,0,0,0,0,1,0,0,1,1
4804,68704,5MOHfgPntZIsRWkQebauzpUgUSaHvhFJ,SpATywNh6bZuzm8s1ceuBUnMUAeoAHHw,15,45,25,9,2,9,13,0,103,14.714285714285714,7,0.0,6,25,7,2,39,9,2,13,0,40,63,0
4805,68705,yZYTsrvrgsLaQebVaD5W80s8tJxpcy3t,SpATywNh6bZuzm8s1ceuBUnMUAeoAHHw,7,8,4,0,3,0,3,0,18,2.5714285714285716,1,0.0,0,4,0,3,8,0,0,3,0,7,11,1
4806,68711,fFCTtQQCOOjijvFKvRDQiA777EKDq9kt,RXDvfPUBYFlVdlueBFbLW0mhhAyGEqpt,39,39,22,59,3,0,11,7,141,20.142857142857142,5,0.0,10,22,56,3,29,0,3,11,7,91,50,1
4807,68717,XB4WTxkP3vNmHXjALkkfZII5POid4TAu,SpATywNh6bZuzm8s1ceuBUnMUAeoAHHw,3,2,0,0,0,0,1,0,3,0.42857142857142855,1,0.0,0,0,0,0,2,0,0,1,0,0,3,1
4808,68720,XJxfWg6ep0iC8D7yOZX3PZy18MtrFPsI,SpATywNh6bZuzm8s1ceuBUnMUAeoAHHw,9,13,10,0,5,0,2,0,30,4.285714285714286,2,0.0,0,10,0,5,13,0,0,2,0,15,15,1
4809,68731,KgATxoqrB3vgLjFK8Jvt9HJ7S86x88Nt,SpATywNh6bZuzm8s1ceuBUnMUAeoAHHw,1,0,0,0,0,0,1,0,1,0.14285714285714285,1,0.0,0,0,0,0,0,0,0,1,0,0,1,1
4810,68732,pyElpGpHSNzEpZ3jrGlcGeNI8YUApbgQ,bWdj2GDclj5ofokWjzoa5jAwMkxCykd6,19,45,19,38,8,20,7,4,141,20.142857142857142,3,0.0,6,19,35,8,39,20,3,7,4,68,73,1
4811,68739,kNijCkWRNCwIOtL9mKx9mB8Vau6ujWr3,SpATywNh6bZuzm8s1ceuBUnMUAeoAHHw,31,50,16,29,8,20,8,3,134,19.142857142857142,3,0.0,29,16,28,8,21,20,1,8,3,81,53,1
4812,68750,gf8nHDqKPX2j100RHCT9dT19AZw0vESt,bWdj2GDclj5ofokWjzoa5jAwMkxCykd6,4,2,1,0,1,0,1,0,5,0.7142857142857143,1,0.0,0,1,0,1,2,0,0,1,0,2,3,1
4813,68771,2DRl1D33z6i9gsgW5IB0KBdkJJ1Zsu7a,RXDvfPUBYFlVdlueBFbLW0mhhAyGEqpt,1,0,0,0,0,0,1,0,1,0.14285714285714285,1,0.0,0,0,0,0,0,0,0,1,0,0,1,1
4814,68776,n5lHa6MzF6UuuHLbdbmhitfwFFej0cUG,bWdj2GDclj5ofokWjzoa5jAwMkxCykd6,1,0,0,0,0,0,1,0,1,0.14285714285714285,1,0.0,0,0,0,0,0,0,0,1,0,0,1,1
4815,68785,g2zZYnTJ1Pk3cSjsVP5SH4UjJdsbDJv7,SpATywNh6bZuzm8s1ceuBUnMUAeoAHHw,14,19,7,16,4,23,4,0,73,10.428571428571429,2,0.0,9,7,14,4,10,23,2,4,0,34,39,1
4816,68794,xqGP5lHPgGUPDIL6gt03S8kze9HpOEIL,SpATywNh6bZuzm8s1ceuBUnMUAeoAHHw,4,2,1,0,1,0,1,0,5,0.7142857142857143,1,0.0,0,1,0,1,2,0,0,1,0,2,3,1
4817,68799,8uISS2OyAivNghskvH7qzmmtfHvBWiyo,SpATywNh6bZuzm8s1ceuBUnMUAeoAHHw,8,13,5,0,3,1,7,1,30,4.285714285714286,2,0.0,5,5,0,3,8,1,0,7,1,13,17,1
4818,68803,8DvAxou540FD0LKoQccPN3Xyo1nrtg8U,bWdj2GDclj5ofokWjzoa5jAwMkxCykd6,6,3,0,0,1,0,2,0,6,0.8571428571428571,2,0.0,0,0,0,1,3,0,0,2,0,1,5,1
4819,68804,3o4QanEzrLxU7IR8E0SkDLt6uwLmz5BV,G8EPVSXsOYB5YQWZGiz1aVq5Pgr2GrQu,57,85,31,88,11,0,13,0,228,32.57142857142857,5,0.0,32,31,58,11,53,0,30,13,0,132,96,1
4820,68806,J4cKirSbcBOsAeFSIp9ObJYWVvlxjPLO,SpATywNh6bZuzm8s1ceuBUnMUAeoAHHw,8,17,4,0,4,0,7,0,32,4.571428571428571,2,0.0,0,4,0,4,17,0,0,7,0,8,24,1
4821,68811,JXT9wmO8lGZMBaQQK0U8pHKQIW1oOnDo,RXDvfPUBYFlVdlueBFbLW0mhhAyGEqpt,14,12,12,0,6,0,6,0,36,5.142857142857143,2,0.0,0,12,0,6,12,0,0,6,0,18,18,1
4822,68815,jEfIANn9M5UCRbhWqJtJFlsF2uyG4fk6,A3fsA9Zfv1X2fVEQhTw51lKENdNrEqT3,4,5,1,0,0,0,3,0,9,1.2857142857142858,1,0.0,0,1,0,0,5,0,0,3,0,1,8,1
4823,68822,T3xcwszBjaOdB7YgVcZfsRhjJ9lfkEVZ,SpATywNh6bZuzm8s1ceuBUnMUAeoAHHw,1,0,0,0,0,0,1,0,1,0.14285714285714285,1,0.0,0,0,0,0,0,0,0,1,0,0,1,1
4824,68833,tn5nSlJLNdxx4Uni5Dn3S8nwDR8GJibq,SpATywNh6bZuzm8s1ceuBUnMUAeoAHHw,30,32,19,29,10,6,8,1,105,15.0,2,0.0,8,19,26,10,24,6,3,8,1,63,42,0
4825,68839,ci6w9FxXwoWvsu2Aw9ojvjfPhjaGgaxN,SpATywNh6bZuzm8s1ceuBUnMUAeoAHHw,16,36,17,21,1,21,19,0,115,16.428571428571427,6,0.0,7,17,17,1,29,21,4,19,0,42,73,1
4826,68849,l21tCwOolR7RD0CZyqRiNHHeEZC1D67K,bWdj2GDclj5ofokWjzoa5jAwMkxCykd6,5,6,3,0,2,0,2,0,13,1.8571428571428572,2,0.0,1,3,0,2,5,0,0,2,0,6,7,1
4827,68852,IC3lGAGjjevFNisK97Sg5rNNaiFl6GUf,SpATywNh6bZuzm8s1ceuBUnMUAeoAHHw,8,9,1,0,0,0,7,2,19,2.7142857142857144,1,0.0,0,1,0,0,9,0,0,7,2,1,18,1
4828,68855,QfnbskMOJDzclneyUxl9CDLAwpjYY8bi,SpATywNh6bZuzm8s1ceuBUnMUAeoAHHw,5,3,1,0,1,0,1,0,6,0.8571428571428571,1,0.0,0,1,0,1,3,0,0,1,0,2,4,1
4829,68858,nrnVeosxoYxlthTbtXiJng8EyjNCisBw,SpATywNh6bZuzm8s1ceuBUnMUAeoAHHw,22,28,2,35,1,1,16,5,88,12.571428571428571,3,0.0,8,2,27,1,20,1,8,16,5,38,50,1
4830,68867,mJAgtJKHxy28GsPIeuAEUCIOXmHzCywF,A3fsA9Zfv1X2fVEQhTw51lKENdNrEqT3,52,74,52,78,31,16,23,0,274,39.142857142857146,7,0.0,3,52,65,31,71,16,13,23,0,151,123,0
4831,68876,5IM8g7YMOYo5qH7Yu3x31T3JkVOH9iqe,SpATywNh6bZuzm8s1ceuBUnMUAeoAHHw,13,13,6,0,5,0,2,0,26,3.7142857142857144,2,0.0,0,6,0,5,13,0,0,2,0,11,15,0
4832,68889,jagu0OJDhWTGFhfCMk0ghqluLpW3kzdC,A3fsA9Zfv1X2fVEQhTw51lKENdNrEqT3,46,19,14,84,12,6,24,0,159,22.714285714285715,7,0.0,1,14,71,12,18,6,13,24,0,98,61,1
4833,68891,AyMpxTtI93rQBcmn1hZDJ5NB66ddrTt8,bWdj2GDclj5ofokWjzoa5jAwMkxCykd6,15,16,7,62,5,20,3,0,113,16.142857142857142,1,0.0,7,7,59,5,9,20,3,3,0,78,35,1
4834,68894,SG7N8DhpCuhIu06IIzLX0CSolbyIDsIx,SpATywNh6bZuzm8s1ceuBUnMUAeoAHHw,31,61,28,27,9,4,17,0,146,20.857142857142858,10,0.0,17,28,26,9,44,4,1,17,0,80,66,1
4835,68925,ObpezNQRvm77jf0ubZxdLKEQMiNil6VQ,bWdj2GDclj5ofokWjzoa5jAwMkxCykd6,7,9,2,0,1,0,10,0,22,3.142857142857143,1,0.0,0,2,0,1,9,0,0,10,0,3,19,1
4836,68941,g5OpPhveV3tEyIL9sXOQK1bIZWgyqgNP,SpATywNh6bZuzm8s1ceuBUnMUAeoAHHw,1,0,0,0,0,0,1,0,1,0.14285714285714285,1,0.0,0,0,0,0,0,0,0,1,0,0,1,1
4837,68966,GiA8pWWKZYTUi7chN7ntBN35fCWU2nBu,SpATywNh6bZuzm8s1ceuBUnMUAeoAHHw,8,1,1,0,1,0,6,1,10,1.4285714285714286,1,0.0,0,1,0,1,1,0,0,6,1,2,8,1
4838,68969,koujvnfMBhMkCgSrbEaysh2AE5Gpg2YT,G8EPVSXsOYB5YQWZGiz1aVq5Pgr2GrQu,27,30,15,40,11,0,9,0,105,15.0,3,0.0,11,15,33,11,19,0,7,9,0,70,35,0
4839,68970,TxEB3EFyNbwMBYmqmAZljhKEWyORCpLb,SpATywNh6bZuzm8s1ceuBUnMUAeoAHHw,1,0,0,0,0,0,1,0,1,0.14285714285714285,1,0.0,0,0,0,0,0,0,0,1,0,0,1,1
4840,68979,ugU2OsTm2YN2IbGmjW7DHhMX6BMMKbiK,G8EPVSXsOYB5YQWZGiz1aVq5Pgr2GrQu,8,7,4,6,0,0,2,0,19,2.7142857142857144,1,0.0,2,4,4,0,5,0,2,2,0,10,9,1
4841,68986,c7CZsOAhREk5r7i8Wn5QXe6C7ebs3xYP,A3fsA9Zfv1X2fVEQhTw51lKENdNrEqT3,8,7,4,0,2,2,7,0,22,3.142857142857143,3,0.0,0,4,0,2,7,2,0,7,0,6,16,1
4842,68994,Xl37kHv8hz1ETmkFgpIsXpoKOIdQzB5H,SpATywNh6bZuzm8s1ceuBUnMUAeoAHHw,5,2,1,0,1,0,2,0,6,0.8571428571428571,1,0.0,0,1,0,1,2,0,0,2,0,2,4,1
4843,68996,xC7QA3lJWLoIMEwPvqIxcLnCt0KwsxwT,SpATywNh6bZuzm8s1ceuBUnMUAeoAHHw,2,0,0,0,0,0,2,0,2,0.2857142857142857,1,0.0,0,0,0,0,0,0,0,2,0,0,2,1
4844,68998,sNC7XF6Nlmfza5mofBS4sZLhOb44U4Ts,G8EPVSXsOYB5YQWZGiz1aVq5Pgr2GrQu,1,0,0,0,0,0,1,0,1,0.14285714285714285,1,0.0,0,0,0,0,0,0,0,1,0,0,1,1
4845,69007,wYGhiFjdBLkU2x7JJ3K1n2UAh76fIcQi,SpATywNh6bZuzm8s1ceuBUnMUAeoAHHw,10,11,9,0,7,1,2,0,30,4.285714285714286,2,0.0,0,9,0,7,11,1,0,2,0,16,14,1
4846,69014,souC6CA0wrFXemJ5RC2IcVOFZKY3Ud6D,A3fsA9Zfv1X2fVEQhTw51lKENdNrEqT3,66,83,22,128,11,11,27,1,283,40.42857142857143,4,0.0,4,22,116,11,79,11,12,27,1,153,130,0
4847,69031,8lWVuB48GCoDnvIn7Nn1tDxRI6ibKTRq,SpATywNh6bZuzm8s1ceuBUnMUAeoAHHw,5,2,1,0,1,0,2,0,6,0.8571428571428571,1,0.0,0,1,0,1,2,0,0,2,0,2,4,1
4848,69043,YVCPApRVJS0XKKCEpBt52bsseKQk9Woy,SpATywNh6bZuzm8s1ceuBUnMUAeoAHHw,1,0,0,0,0,0,1,0,1,0.14285714285714285,1,0.0,0,0,0,0,0,0,0,1,0,0,1,1
4849,69054,CJYdZ6F1UmkUhSW1DIBQ5YjVYvVCeBEf,A3fsA9Zfv1X2fVEQhTw51lKENdNrEqT3,6,3,1,0,1,0,2,0,7,1.0,1,0.0,0,1,0,1,3,0,0,2,0,2,5,1
4850,69065,57ya2ykgKZwUUOXe4VfUt0HWtgZeemvj,SpATywNh6bZuzm8s1ceuBUnMUAeoAHHw,1,0,0,0,0,0,1,0,1,0.14285714285714285,1,0.0,0,0,0,0,0,0,0,1,0,0,1,1
4851,69080,WgYQBUzSJJLcj6PwA0d8MdNri6k7nN4s,A3fsA9Zfv1X2fVEQhTw51lKENdNrEqT3,2,0,0,0,0,0,2,0,2,0.2857142857142857,1,0.0,0,0,0,0,0,0,0,2,0,0,2,1
4852,69082,lt7x7W9L5dc1lSFEc965LhUn5shsg0v8,SpATywNh6bZuzm8s1ceuBUnMUAeoAHHw,4,3,0,0,0,0,2,0,5,0.7142857142857143,1,0.0,0,0,0,0,3,0,0,2,0,0,5,1
4853,69095,dK22lzU3sHpxa7kQiSzhTpdq8w2wdIKM,G8EPVSXsOYB5YQWZGiz1aVq5Pgr2GrQu,29,55,1,46,3,9,24,2,140,20.0,6,0.0,28,1,36,3,27,9,10,24,2,68,72,0
4854,69103,ZwACmcXP1dFceMUleNJ3flkTstESRohK,SpATywNh6bZuzm8s1ceuBUnMUAeoAHHw,29,35,16,39,6,0,9,0,105,15.0,2,0.0,14,16,36,6,21,0,3,9,0,72,33,1
4855,69115,Vd6ebRuiLfwgqB5waj4eS9hJ1uyBDxCf,A3fsA9Zfv1X2fVEQhTw51lKENdNrEqT3,15,20,2,0,1,0,17,1,41,5.857142857142857,3,0.0,0,2,0,1,20,0,0,17,1,3,38,1
4856,69116,8RAttpsmVeGyWHWVdhomVf58WbsxdKtJ,SpATywNh6bZuzm8s1ceuBUnMUAeoAHHw,9,7,6,0,6,0,2,0,21,3.0,4,0.0,0,6,0,6,7,0,0,2,0,12,9,1
4857,69131,8Ir6rIjO15kuvM3s5xrQH1rB1m97Mcy9,SpATywNh6bZuzm8s1ceuBUnMUAeoAHHw,15,39,3,20,1,21,16,2,102,14.571428571428571,6,0.0,14,3,18,1,25,21,2,16,2,36,66,0
4858,69147,cRQPwEYCK3Iw8dKAOD2ODiUgaKZ6yPed,SpATywNh6bZuzm8s1ceuBUnMUAeoAHHw,27,58,3,22,1,3,18,1,106,15.142857142857142,5,0.0,18,3,19,1,40,3,3,18,1,41,65,1
4859,69154,oBZQGNxV159KYVTxhJiCHURpoG2050SJ,SpATywNh6bZuzm8s1ceuBUnMUAeoAHHw,2,0,0,0,0,0,2,0,2,0.2857142857142857,1,0.0,0,0,0,0,0,0,0,2,0,0,2,1
4860,69155,K0iCXE1mno7izlBrkQAs4SEkYDRU9qXa,SpATywNh6bZuzm8s1ceuBUnMUAeoAHHw,5,3,1,0,1,0,2,0,7,1.0,1,0.0,2,1,0,1,1,0,0,2,0,4,3,1
4861,69161,3X0JLX6UvJnnRb5GkwbFJgAokE5g69D0,SpATywNh6bZuzm8s1ceuBUnMUAeoAHHw,35,72,18,19,7,1,14,0,131,18.714285714285715,9,0.0,17,18,19,7,55,1,0,14,0,61,70,0
4862,69165,4DUZBFD9Fwl71r8i0SB6pVZCzmNoxKnn,A3fsA9Zfv1X2fVEQhTw51lKENdNrEqT3,8,11,6,0,1,1,3,0,22,3.142857142857143,2,0.0,0,6,0,1,11,1,0,3,0,7,15,1
4863,69192,agX8fi6SsMsbGjpTUuXM1FgToYG9zbAn,SpATywNh6bZuzm8s1ceuBUnMUAeoAHHw,38,64,36,27,23,4,8,0,162,23.142857142857142,8,0.0,18,36,26,23,46,4,1,8,0,103,59,0
4864,69200,udnRYxurswpE4GUZcnc80kafg0hn3fpz,A3fsA9Zfv1X2fVEQhTw51lKENdNrEqT3,4,7,3,0,0,0,3,0,13,1.8571428571428572,2,0.0,0,3,0,0,7,0,0,3,0,3,10,0
4865,69231,yRvmuoOlApBAgoa9MY5Qvy0RDYuNtlAF,G8EPVSXsOYB5YQWZGiz1aVq5Pgr2GrQu,7,5,0,0,0,0,5,0,10,1.4285714285714286,1,0.0,0,0,0,0,5,0,0,5,0,0,10,1
4866,69237,xG3AmboF4HBUiYwQZV4JGVdvJNCIXdwN,SpATywNh6bZuzm8s1ceuBUnMUAeoAHHw,10,26,13,1,7,0,4,0,51,7.285714285714286,2,0.0,9,13,1,7,17,0,0,4,0,30,21,1
4867,69240,IXJE6OTajH0Geh8I1ZW7ljkRPJ4pkmfl,SpATywNh6bZuzm8s1ceuBUnMUAeoAHHw,10,9,6,4,0,0,1,0,20,2.857142857142857,1,0.0,1,6,3,0,8,0,1,1,0,10,10,1
4868,69259,7bRPtq6P8Xywkbl391z1cfKif2lsM9WW,SpATywNh6bZuzm8s1ceuBUnMUAeoAHHw,29,28,17,40,7,0,5,0,97,13.857142857142858,3,0.0,7,17,36,7,21,0,4,5,0,67,30,1
4869,69268,Eq98WSTQOt9fRmYbHT449FU0RWdVZ5zB,SpATywNh6bZuzm8s1ceuBUnMUAeoAHHw,5,2,1,0,1,0,2,0,6,0.8571428571428571,1,0.0,0,1,0,1,2,0,0,2,0,2,4,1
4870,69276,FSJWTYbpEABu1Che9CXJ2jTRzNOHiIPA,SpATywNh6bZuzm8s1ceuBUnMUAeoAHHw,9,6,2,0,2,0,7,0,17,2.4285714285714284,1,0.0,0,2,0,2,6,0,0,7,0,4,13,1
4871,69284,UhXyunBodgS5DssUOIaVTTsNfgvZZxEV,bWdj2GDclj5ofokWjzoa5jAwMkxCykd6,4,3,1,0,0,0,2,0,6,0.8571428571428571,1,0.0,0,1,0,0,3,0,0,2,0,1,5,1
4872,69285,3bqMPd7dmQ6bVwYt9AjfxpDPMW8ppczj,RXDvfPUBYFlVdlueBFbLW0mhhAyGEqpt,1,0,0,0,0,0,1,0,1,0.14285714285714285,1,0.0,0,0,0,0,0,0,0,1,0,0,1,1
4873,69293,ovvuiEhj0QBv4xi11GVjXr8JhlCgaPmd,A3fsA9Zfv1X2fVEQhTw51lKENdNrEqT3,9,3,3,0,3,0,5,0,14,2.0,2,0.0,0,3,0,3,3,0,0,5,0,6,8,1
4874,69297,X9IKf8GgqS6dvoKX3VBo51mIr8yb4uFC,bWdj2GDclj5ofokWjzoa5jAwMkxCykd6,25,55,18,13,14,7,12,0,119,17.0,4,0.0,15,18,12,14,40,7,1,12,0,59,60,1
4875,69308,YtPY6V9gKVYBGYaBakDnRKgXM0SCPhH8,RXDvfPUBYFlVdlueBFbLW0mhhAyGEqpt,113,107,64,149,42,2,24,0,388,55.42857142857143,11,0.0,32,64,145,42,75,2,4,24,0,283,105,0
4876,69322,WfiWheCcfnYrlo1ljQjtyFUB6mwR6CMB,SpATywNh6bZuzm8s1ceuBUnMUAeoAHHw,13,12,8,0,4,0,12,1,37,5.285714285714286,2,0.0,0,8,0,4,12,0,0,12,1,12,25,1
4877,69324,byxGWUJV72XqYw0RcV5v8EuZ9oh6gief,G8EPVSXsOYB5YQWZGiz1aVq5Pgr2GrQu,14,12,7,0,4,0,9,0,32,4.571428571428571,2,0.0,0,7,0,4,12,0,0,9,0,11,21,1
4878,69337,wMBHEwMS1ke1XCIE6pdAhfvU7lKPIoig,A3fsA9Zfv1X2fVEQhTw51lKENdNrEqT3,6,5,4,0,0,0,2,0,11,1.5714285714285714,1,0.0,0,4,0,0,5,0,0,2,0,4,7,1
4879,69345,pNeNjRs1mK0wHcAzJFxLXdAPA9xgPVV6,bWdj2GDclj5ofokWjzoa5jAwMkxCykd6,5,2,1,0,1,0,2,0,6,0.8571428571428571,1,0.0,0,1,0,1,2,0,0,2,0,2,4,1
4880,69360,VtYfYYb8PipDmwJ9fAnXpdTb4dF89SFx,SpATywNh6bZuzm8s1ceuBUnMUAeoAHHw,11,5,4,0,4,0,2,0,15,2.142857142857143,1,0.0,0,4,0,4,5,0,0,2,0,8,7,1
4881,69367,UeHaetwViLI5gC5HiwzWUg3JwpoZmRrG,A3fsA9Zfv1X2fVEQhTw51lKENdNrEqT3,1,0,0,0,0,0,1,0,1,0.14285714285714285,1,0.0,0,0,0,0,0,0,0,1,0,0,1,1
4882,69371,YaUoJwJr3oO9HJ6WDm7V4UT5kFsGziL7,bWdj2GDclj5ofokWjzoa5jAwMkxCykd6,1,0,0,0,0,0,1,0,1,0.14285714285714285,1,0.0,0,0,0,0,0,0,0,1,0,0,1,1
4883,69382,7jncvDKBN22Fxg064o0NyimMY6U2A5Li,SpATywNh6bZuzm8s1ceuBUnMUAeoAHHw,5,2,1,0,1,0,2,0,6,0.8571428571428571,1,0.0,0,1,0,1,2,0,0,2,0,2,4,1
4884,69387,hPdb7IzvQK13aLXEDwxSH4zOMfPRUsSC,SpATywNh6bZuzm8s1ceuBUnMUAeoAHHw,1,0,0,0,0,0,1,0,1,0.14285714285714285,1,0.0,0,0,0,0,0,0,0,1,0,0,1,1
4885,69391,d5euO6JYPz1tRdmilapWDL1Th3AQudPQ,SpATywNh6bZuzm8s1ceuBUnMUAeoAHHw,6,3,1,0,1,0,2,0,7,1.0,1,0.0,0,1,0,1,3,0,0,2,0,2,5,1
4886,69393,sQMQGXUKDLttJ8ntfMuRvWEcncBHKCzb,G8EPVSXsOYB5YQWZGiz1aVq5Pgr2GrQu,5,4,0,0,0,0,2,0,6,0.8571428571428571,1,0.0,0,0,0,0,4,0,0,2,0,0,6,1
4887,69394,9fEcx2YdFV830apuhCo8G8R1veKyhCNk,G8EPVSXsOYB5YQWZGiz1aVq5Pgr2GrQu,1,0,0,0,0,0,1,0,1,0.14285714285714285,1,0.0,0,0,0,0,0,0,0,1,0,0,1,1
4888,69396,x87E9Qmbnh2qCEUiaevhSD7rp8sUrupo,SpATywNh6bZuzm8s1ceuBUnMUAeoAHHw,6,4,3,0,2,0,3,0,12,1.7142857142857142,2,0.0,0,3,0,2,4,0,0,3,0,5,7,1
4889,69397,egpXv13dykaiU64GCgTaQGg1ErRD7Rsb,SpATywNh6bZuzm8s1ceuBUnMUAeoAHHw,24,19,16,8,10,15,8,1,77,11.0,5,0.0,0,16,7,10,19,15,1,8,1,33,44,0
4890,69400,FlAkKX6ow9SvOzk0dTWPWgnX5766zY29,SpATywNh6bZuzm8s1ceuBUnMUAeoAHHw,26,35,15,12,8,1,5,0,76,10.857142857142858,4,0.0,6,15,12,8,29,1,0,5,0,41,35,1
4891,69420,aI2WbSCktVyijPTHCbgAdpzpfdnFGcq9,bWdj2GDclj5ofokWjzoa5jAwMkxCykd6,1,0,0,0,0,0,1,0,1,0.14285714285714285,1,0.0,0,0,0,0,0,0,0,1,0,0,1,1
4892,69421,wj8cbMyESeAf93mp00EllV31jkPIrA6z,SpATywNh6bZuzm8s1ceuBUnMUAeoAHHw,7,4,2,0,0,0,7,3,16,2.2857142857142856,1,0.0,0,2,0,0,4,0,0,7,3,2,14,1
4893,69436,vEfGT3eaoianaMgM5zzcNn9WTzHGX3lJ,bWdj2GDclj5ofokWjzoa5jAwMkxCykd6,12,5,4,0,4,0,3,0,16,2.2857142857142856,1,0.0,0,4,0,4,5,0,0,3,0,8,8,1
4894,69445,raxo74HBCa6UxUGfmq3EGBBeCoVCmLfg,SpATywNh6bZuzm8s1ceuBUnMUAeoAHHw,20,41,4,38,1,9,16,1,110,15.714285714285714,3,0.0,17,4,33,1,24,9,5,16,1,55,55,1
4895,69462,SzqR1lIvSkqy1yQXOqGRgT5uhu7VR5Jw,SpATywNh6bZuzm8s1ceuBUnMUAeoAHHw,44,74,49,24,26,12,22,2,209,29.857142857142858,9,0.0,5,49,23,26,69,12,1,22,2,103,106,0
4896,69484,RbewLSSgBXbMSLEvzESHw0b6pdUZ0dT1,SpATywNh6bZuzm8s1ceuBUnMUAeoAHHw,15,17,7,0,5,0,2,0,31,4.428571428571429,1,0.0,0,7,0,5,17,0,0,2,0,12,19,1
4897,69488,0n2rFsphNy9JVeuypULNewx4jCGSFGND,bWdj2GDclj5ofokWjzoa5jAwMkxCykd6,5,2,1,0,1,0,2,0,6,0.8571428571428571,1,0.0,0,1,0,1,2,0,0,2,0,2,4,1
4898,69489,pAlH2DhoFB2i4Ut8T7hcWTIp67bJvsYn,SpATywNh6bZuzm8s1ceuBUnMUAeoAHHw,5,2,1,0,1,0,3,0,7,1.0,2,0.0,0,1,0,1,2,0,0,3,0,2,5,1
4899,69512,3MwBdkgOXpVBf89tXLybMhGjxxsiq8lW,SpATywNh6bZuzm8s1ceuBUnMUAeoAHHw,5,7,3,0,2,0,2,0,14,2.0,1,0.0,0,3,0,2,7,0,0,2,0,5,9,1
4900,69522,ujYI83byKXzx4VeC0hyxjCKBGRrqMCEx,SpATywNh6bZuzm8s1ceuBUnMUAeoAHHw,6,7,3,0,1,0,2,0,13,1.8571428571428572,2,0.0,0,3,0,1,7,0,0,2,0,4,9,1
4901,69525,wRAgiRhqkN35cIVBbnaU2eOM8fyImml7,SpATywNh6bZuzm8s1ceuBUnMUAeoAHHw,5,2,1,0,1,0,2,0,6,0.8571428571428571,1,0.0,0,1,0,1,2,0,0,2,0,2,4,1
4902,69528,ujAdSwtAMW0jWhrnzge1oByew4uYe5CY,SpATywNh6bZuzm8s1ceuBUnMUAeoAHHw,5,2,1,0,1,0,2,0,6,0.8571428571428571,1,0.0,0,1,0,1,2,0,0,2,0,2,4,1
4903,69550,rY4HuopoXNauFhpb4SYxSCmQkbvhS34C,SpATywNh6bZuzm8s1ceuBUnMUAeoAHHw,57,87,48,43,30,13,14,1,236,33.714285714285715,5,0.0,32,48,37,30,55,13,6,14,1,147,89,0
4904,69552,ZAi0jAKRdwQEtga2Yygb9adNtNc26TKH,A3fsA9Zfv1X2fVEQhTw51lKENdNrEqT3,1,0,0,0,0,0,1,0,1,0.14285714285714285,1,0.0,0,0,0,0,0,0,0,1,0,0,1,1
4905,69575,HnVGC3qJM46V1b2wdd4Z0HoEFuWu57RL,A3fsA9Zfv1X2fVEQhTw51lKENdNrEqT3,7,7,1,0,0,0,4,0,12,1.7142857142857142,3,0.0,0,1,0,0,7,0,0,4,0,1,11,1
4906,69598,KYXtOFYh9POr4cq75pjZ8a127l5uxf5U,SpATywNh6bZuzm8s1ceuBUnMUAeoAHHw,23,42,22,20,14,0,5,0,103,14.714285714285714,4,0.0,10,22,17,14,32,0,3,5,0,63,40,1
4907,69600,ebvWYER6Bde0EUcNXXIX0vyTB9ur6Kqi,A3fsA9Zfv1X2fVEQhTw51lKENdNrEqT3,6,7,0,0,0,0,2,0,9,1.2857142857142858,2,0.0,0,0,0,0,7,0,0,2,0,0,9,1
4908,69612,kgME9COu6f9ljQ8FhJeUQLVyeGDbkeLG,A3fsA9Zfv1X2fVEQhTw51lKENdNrEqT3,7,16,2,0,0,0,20,1,39,5.571428571428571,7,0.0,0,2,0,0,16,0,0,20,1,2,37,0
4909,69634,jnvcTpUtga8frGP2ONxrK4VjvbZCmOcF,A3fsA9Zfv1X2fVEQhTw51lKENdNrEqT3,7,10,0,0,0,0,4,0,14,2.0,2,0.0,3,0,0,0,7,0,0,4,0,3,11,1
4910,69636,xZLWfpPSNmIdAksyQxOWlrAmgCyQKxwi,A3fsA9Zfv1X2fVEQhTw51lKENdNrEqT3,3,2,0,0,0,0,2,0,4,0.5714285714285714,1,0.0,0,0,0,0,2,0,0,2,0,0,4,1
4911,69640,C78Rc70fLP1AFI7RwOL8R7Vch3jy9civ,bWdj2GDclj5ofokWjzoa5jAwMkxCykd6,7,8,1,4,4,0,2,0,19,2.7142857142857144,1,0.0,6,1,4,4,2,0,0,2,0,15,4,1
4912,69642,V5AS4ngknDMHs5ddf49SxlAoYguZsiN3,A3fsA9Zfv1X2fVEQhTw51lKENdNrEqT3,56,25,15,98,7,2,12,1,160,22.857142857142858,3,0.0,2,15,89,7,23,2,9,12,1,113,47,0
4913,69678,zprnKj46wnzt21jHYpriZ9OaUlDuPgz5,SpATywNh6bZuzm8s1ceuBUnMUAeoAHHw,8,6,4,0,3,3,4,0,20,2.857142857142857,1,0.0,0,4,0,3,6,3,0,4,0,7,13,1
4914,69691,C8X9Lf56reSC06tYvkcDbAXogOIv2aQH,SpATywNh6bZuzm8s1ceuBUnMUAeoAHHw,6,3,1,0,1,0,2,0,7,1.0,1,0.0,0,1,0,1,3,0,0,2,0,2,5,1
4915,69711,I8DzhVfDWUcYhRFQ0yqaOgzpzxPiQBKk,bWdj2GDclj5ofokWjzoa5jAwMkxCykd6,6,5,2,0,1,0,3,0,11,1.5714285714285714,1,0.0,0,2,0,1,5,0,0,3,0,3,8,1
4916,69731,mQNenLPD3Qc7tSPYw2VwygE2NmpBhKsk,A3fsA9Zfv1X2fVEQhTw51lKENdNrEqT3,10,3,2,0,2,1,5,3,16,2.2857142857142856,1,0.0,0,2,0,2,3,1,0,5,3,4,12,1
4917,69764,BLvQXA2YaaLZxMBjVQ5Po1TXbL69VEdH,SpATywNh6bZuzm8s1ceuBUnMUAeoAHHw,5,2,1,0,1,0,2,0,6,0.8571428571428571,1,0.0,0,1,0,1,2,0,0,2,0,2,4,1
4918,69770,JgN8P3Oh101qfcWX1dxprWYo04K2OTYg,bWdj2GDclj5ofokWjzoa5jAwMkxCykd6,4,2,1,0,1,0,1,0,5,0.7142857142857143,1,0.0,0,1,0,1,2,0,0,1,0,2,3,1
4919,69778,Lcc8QujJbkTuweBtBrKCB15IfiVLUIVq,A3fsA9Zfv1X2fVEQhTw51lKENdNrEqT3,20,21,15,0,10,0,3,0,49,7.0,2,0.0,1,15,0,10,20,0,0,3,0,26,23,1
4920,69786,231vKE9Ghn3hPwkNFyzJyi0Car52cYe1,bWdj2GDclj5ofokWjzoa5jAwMkxCykd6,1,0,0,0,0,0,1,0,1,0.14285714285714285,1,0.0,0,0,0,0,0,0,0,1,0,0,1,1
4921,69804,RBKGxYBfWpgkY9AF7ooiIKdEMpAJTvzp,bWdj2GDclj5ofokWjzoa5jAwMkxCykd6,1,0,0,0,0,0,1,0,1,0.14285714285714285,1,0.0,0,0,0,0,0,0,0,1,0,0,1,1
4922,69813,UOpfm9RdmrM2DaZfYaiUthWSvj5wRhpf,A3fsA9Zfv1X2fVEQhTw51lKENdNrEqT3,9,4,2,0,1,1,12,0,20,2.857142857142857,2,0.0,0,2,0,1,4,1,0,12,0,3,17,1
4923,69823,pD1s3J2DAVHqxnTOsnHBHGIq9d5lcpqD,SpATywNh6bZuzm8s1ceuBUnMUAeoAHHw,45,75,30,35,13,8,16,1,178,25.428571428571427,6,0.0,21,30,32,13,54,8,3,16,1,96,82,0
4924,69828,RI0oJHr7vWXzPLP3ybfgZBQolmA0lbjl,SpATywNh6bZuzm8s1ceuBUnMUAeoAHHw,41,44,19,39,12,0,6,0,120,17.142857142857142,4,0.0,6,19,32,12,38,0,7,6,0,69,51,0
4925,69868,gV1Y6A8RpgDuAD47r6UGF54v9TD2f7uU,SpATywNh6bZuzm8s1ceuBUnMUAeoAHHw,32,33,21,27,13,0,8,0,102,14.571428571428571,3,0.0,6,21,24,13,27,0,3,8,0,64,38,0
4926,69870,JosNAk0Jss8nuybl3t8YWavpQFNL43lY,A3fsA9Zfv1X2fVEQhTw51lKENdNrEqT3,13,8,6,0,5,0,7,0,26,3.7142857142857144,2,0.0,0,6,0,5,8,0,0,7,0,11,15,1
4927,69880,wJ6pUrPXT2xprnVlaCeorPmn4kCAli3G,A3fsA9Zfv1X2fVEQhTw51lKENdNrEqT3,51,55,39,72,24,120,16,1,327,46.714285714285715,7,0.0,2,39,56,24,53,120,16,16,1,121,206,1
4928,69900,KXHDxoyacxCXhUbcgqweNNZf38mVEmJs,SpATywNh6bZuzm8s1ceuBUnMUAeoAHHw,14,11,7,16,4,0,2,0,40,5.714285714285714,1,0.0,3,7,14,4,8,0,2,2,0,28,12,1
4929,69902,ZLrfFX2a65pmAVGtiIPK4faxDMnbmzh2,SpATywNh6bZuzm8s1ceuBUnMUAeoAHHw,4,5,2,0,0,0,3,0,10,1.4285714285714286,1,0.0,0,2,0,0,5,0,0,3,0,2,8,1
4930,69906,qowpjfcpUK1iU9rrtJ9U3WvarOVtt4V0,SpATywNh6bZuzm8s1ceuBUnMUAeoAHHw,30,51,29,24,14,18,11,1,148,21.142857142857142,3,0.0,9,29,21,14,42,18,3,11,1,73,75,0
4931,69916,V80I9ihOq6qwBn52j4Qxq5UKfYpTJipj,A3fsA9Zfv1X2fVEQhTw51lKENdNrEqT3,1,0,0,0,0,0,1,0,1,0.14285714285714285,1,0.0,0,0,0,0,0,0,0,1,0,0,1,1
4932,69970,dYC6Q6IXtOHRHCawBvKivQeuFVOWFZ5M,SpATywNh6bZuzm8s1ceuBUnMUAeoAHHw,14,10,7,6,5,1,5,1,35,5.0,2,0.0,1,7,5,5,9,1,1,5,1,18,17,1
4933,69972,6AqVXM3NzhPR7CIRltoRCDhzdk8YVusO,SpATywNh6bZuzm8s1ceuBUnMUAeoAHHw,31,46,27,32,7,9,21,4,146,20.857142857142858,5,0.0,11,27,28,7,35,9,4,21,4,73,73,0
4934,69983,CabsQjb2Sd2I3ynTdtsErAG67rLex08f,SpATywNh6bZuzm8s1ceuBUnMUAeoAHHw,7,3,0,0,0,1,4,1,9,1.2857142857142858,1,0.0,0,0,0,0,3,1,0,4,1,0,9,1
4935,69984,979PHlsnLj7fGUBEOVls6yVfgExSRWl0,SpATywNh6bZuzm8s1ceuBUnMUAeoAHHw,26,19,15,9,8,12,12,0,75,10.714285714285714,3,0.0,0,15,7,8,19,12,2,12,0,30,45,0
4936,70011,gfov2YfhzgUzN6Vbd3DOhS3J4f6Zpsmw,SpATywNh6bZuzm8s1ceuBUnMUAeoAHHw,17,19,14,19,12,0,2,0,66,9.428571428571429,4,0.0,2,14,16,12,17,0,3,2,0,44,22,1
4937,70019,mRVxG27OAHo6TDwz5EATZqlFWV3ONpTz,SpATywNh6bZuzm8s1ceuBUnMUAeoAHHw,2,0,0,0,0,0,2,0,2,0.2857142857142857,1,0.0,0,0,0,0,0,0,0,2,0,0,2,1
4938,70021,J782awhmjhWAohIOvWifbZTNvhSxGcmf,SpATywNh6bZuzm8s1ceuBUnMUAeoAHHw,14,21,11,0,7,0,9,0,48,6.857142857142857,2,0.0,0,11,0,7,21,0,0,9,0,18,30,1
4939,70042,7VdMdsntecIH9xdStqUN45Z6l4PdR7Lf,SpATywNh6bZuzm8s1ceuBUnMUAeoAHHw,4,4,1,0,0,0,3,0,8,1.1428571428571428,1,0.0,0,1,0,0,4,0,0,3,0,1,7,1
4940,70054,DyupaV8BmUavHjvovvxyDg1D0z37S8dm,SpATywNh6bZuzm8s1ceuBUnMUAeoAHHw,10,9,7,0,5,0,4,0,25,3.5714285714285716,2,0.0,0,7,0,5,9,0,0,4,0,12,13,1
4941,70060,nXqrD0yeRarrFPn56WxkuqRZ3ny2kh9R,SpATywNh6bZuzm8s1ceuBUnMUAeoAHHw,2,0,0,0,0,0,2,0,2,0.2857142857142857,1,0.0,0,0,0,0,0,0,0,2,0,0,2,1
4942,70066,wKNO0Jje7WXvAVQ9yfigFflnCrR4q8AL,A3fsA9Zfv1X2fVEQhTw51lKENdNrEqT3,13,17,8,0,5,0,10,0,40,5.714285714285714,3,0.0,0,8,0,5,17,0,0,10,0,13,27,1
4943,70080,lhSfCfPZnDk6mpF0h6gOX9NA2ZuZUrvg,SpATywNh6bZuzm8s1ceuBUnMUAeoAHHw,28,69,7,19,5,1,22,3,126,18.0,6,0.0,6,7,16,5,63,1,3,22,3,34,92,0
4944,70081,S0YS2NCKuZXB21pPEkAadXWVZsUyQWb2,SpATywNh6bZuzm8s1ceuBUnMUAeoAHHw,9,19,6,0,4,0,6,0,35,5.0,3,0.0,0,6,0,4,19,0,0,6,0,10,25,1
4945,70084,0uULbxMYxykuellS4DES6XbGTfaCngOW,SpATywNh6bZuzm8s1ceuBUnMUAeoAHHw,4,2,0,0,0,0,3,0,5,0.7142857142857143,2,0.0,0,0,0,0,2,0,0,3,0,0,5,1
4946,70086,05tZSn1VpjmBZfEP79jJJrxZA1bk8Ov5,SpATywNh6bZuzm8s1ceuBUnMUAeoAHHw,5,15,5,0,0,0,1,0,21,3.0,4,0.0,3,5,0,0,12,0,0,1,0,8,13,0
4947,70094,vjGeuAzCU9VuvJBAkOsbOGPQ1dhGyEOw,SpATywNh6bZuzm8s1ceuBUnMUAeoAHHw,10,11,1,0,0,0,6,2,20,2.857142857142857,1,0.0,3,1,0,0,8,0,0,6,2,4,16,1
4948,70097,0uULbxMYxykuellS4DES6XbGTfaCngOW,bWdj2GDclj5ofokWjzoa5jAwMkxCykd6,6,4,0,10,1,0,2,0,17,2.4285714285714284,1,0.0,2,0,10,1,2,0,0,2,0,13,4,1
4949,70112,CNg7OyU6zWgKAN5K0oJtHsglhaU3oGQ9,SpATywNh6bZuzm8s1ceuBUnMUAeoAHHw,5,4,1,0,1,0,1,0,7,1.0,1,0.0,0,1,0,1,4,0,0,1,0,2,5,1
4950,70113,xPyi5tVWLdzwESKbVSwWQTZrKjlUSal4,bWdj2GDclj5ofokWjzoa5jAwMkxCykd6,2,0,0,0,0,0,2,0,2,0.2857142857142857,1,0.0,0,0,0,0,0,0,0,2,0,0,2,1
4951,70117,Unmtjjmp5vQtsUKiq2OfCGrdrro6CfzN,SpATywNh6bZuzm8s1ceuBUnMUAeoAHHw,40,177,86,61,14,275,64,1,678,96.85714285714286,15,0.0,51,86,57,14,126,275,4,64,1,208,470,0
4952,70118,ynRrL3n4SK143BrBaMe5mVlDwKfYLlFe,SpATywNh6bZuzm8s1ceuBUnMUAeoAHHw,5,2,1,0,1,0,2,0,6,0.8571428571428571,1,0.0,0,1,0,1,2,0,0,2,0,2,4,1
4953,70130,r9R01U9QisCDxxLmorZFQ60ReGG1wPEx,SpATywNh6bZuzm8s1ceuBUnMUAeoAHHw,23,19,17,0,13,0,7,0,56,8.0,2,0.0,0,17,0,13,19,0,0,7,0,30,26,1
4954,70141,j4hecXKY3USBQpRwMuzKA9d9SPzBKhRY,SpATywNh6bZuzm8s1ceuBUnMUAeoAHHw,9,9,1,0,0,1,7,1,19,2.7142857142857144,2,0.0,3,1,0,0,6,1,0,7,1,4,15,1
4955,70184,wfgih84xA5GX8u9QHkcXZJABO675HdY1,3VkHkmOtom3jM2wCu94xgzzu1d6Dn7or,8,5,3,0,2,0,4,0,14,2.0,1,0.0,0,3,0,2,5,0,0,4,0,5,9,1
4956,70185,vRrdeghS9EQMMpi4QScjKFq8mUdoNIFC,3VkHkmOtom3jM2wCu94xgzzu1d6Dn7or,11,25,8,9,6,23,15,1,87,12.428571428571429,6,0.0,12,8,6,6,13,23,3,15,1,32,55,1
4957,70187,rZIQ6zXXqp8rIbAh3assmnLbZtesRTC3,3VkHkmOtom3jM2wCu94xgzzu1d6Dn7or,10,19,8,1,4,0,9,0,41,5.857142857142857,3,0.0,1,8,1,4,18,0,0,9,0,14,27,1
4958,70190,Yd5zGIdfRVjsKVvUqU0Kt9qhRzmstpyR,3VkHkmOtom3jM2wCu94xgzzu1d6Dn7or,1,0,0,0,0,0,1,0,1,0.14285714285714285,1,0.0,0,0,0,0,0,0,0,1,0,0,1,1
4959,70193,sHAYvl1dLfmvHVukxJjADxIc0aa6JDK3,3VkHkmOtom3jM2wCu94xgzzu1d6Dn7or,20,64,19,14,8,22,14,2,143,20.428571428571427,5,0.0,20,19,12,8,44,22,2,14,2,59,84,1
4960,70194,NLJiRsXygk1AOHXbn7On7wrRn6XDaaQv,3VkHkmOtom3jM2wCu94xgzzu1d6Dn7or,32,111,52,40,26,72,28,1,330,47.142857142857146,5,0.0,24,52,30,26,87,72,10,28,1,132,198,1
4961,70207,UGYGSfRkJhOkgkdlCI6YSCshpNvwBF31,3VkHkmOtom3jM2wCu94xgzzu1d6Dn7or,30,97,34,26,26,36,46,1,266,38.0,6,0.0,28,34,24,26,69,36,2,46,1,112,154,0
4962,70209,ZUw0LYpLdAJKOcR9I1RaOT65e1Pt1j4a,3VkHkmOtom3jM2wCu94xgzzu1d6Dn7or,12,18,6,8,7,7,4,0,50,7.142857142857143,1,0.0,8,6,7,7,10,7,1,4,0,28,22,1
4963,70211,dvhsNwzNVzFTV5yfSmTM5e1a1EPOb8Ea,3VkHkmOtom3jM2wCu94xgzzu1d6Dn7or,6,5,2,0,1,0,4,0,12,1.7142857142857142,1,0.0,1,2,0,1,4,0,0,4,0,4,8,1
4964,70214,8eA5IS6Vn6RndGmKQ0JBmF923RsdRLP8,3VkHkmOtom3jM2wCu94xgzzu1d6Dn7or,1,0,0,0,0,0,1,0,1,0.14285714285714285,1,0.0,0,0,0,0,0,0,0,1,0,0,1,1
4965,70215,C8sKreRCy05fqxE0b2IRNRcgeAaK4kyW,3VkHkmOtom3jM2wCu94xgzzu1d6Dn7or,13,10,6,0,5,0,3,0,24,3.4285714285714284,3,0.0,0,6,0,5,10,0,0,3,0,11,13,1
4966,70216,eJLAKFPtAeth3Br6K30Tc61aatMUaXTu,3VkHkmOtom3jM2wCu94xgzzu1d6Dn7or,4,0,0,0,0,1,4,0,5,0.7142857142857143,1,0.0,0,0,0,0,0,1,0,4,0,0,5,1
4967,70217,VGvFre4X4qO429b6IKhowwkalHckrjkx,3VkHkmOtom3jM2wCu94xgzzu1d6Dn7or,1,0,0,0,0,0,1,0,1,0.14285714285714285,1,0.0,0,0,0,0,0,0,0,1,0,0,1,1
4968,70218,jD0UeNY9hJbk1PhtJSrh0jfo0FXBK4QE,3VkHkmOtom3jM2wCu94xgzzu1d6Dn7or,6,5,2,0,1,0,2,0,10,1.4285714285714286,1,0.0,0,2,0,1,5,0,0,2,0,3,7,1
4969,70222,dDGa4ygDIORPTxpWiC8uM2JjUI6DLTKR,3VkHkmOtom3jM2wCu94xgzzu1d6Dn7or,45,293,95,86,0,71,68,8,621,88.71428571428571,8,0.0,134,95,80,0,159,71,6,68,8,309,312,0
4970,70229,Jp1T2WVhjU6GdNvl7ZnDDYxQSrlz2FK0,3VkHkmOtom3jM2wCu94xgzzu1d6Dn7or,33,114,36,35,24,20,12,2,243,34.714285714285715,4,0.0,30,36,33,24,84,20,2,12,2,123,120,1
4971,70244,tNi3Zh7tytIDOpzRPgVjOrJz00QBqqDn,3VkHkmOtom3jM2wCu94xgzzu1d6Dn7or,1,0,0,0,0,0,2,0,2,0.2857142857142857,1,0.0,0,0,0,0,0,0,0,2,0,0,2,1
4972,70246,n64wka2sSaJq5DaA5JslbLBFoS4230k9,3VkHkmOtom3jM2wCu94xgzzu1d6Dn7or,14,16,7,0,6,1,14,0,44,6.285714285714286,1,0.0,4,7,0,6,12,1,0,14,0,17,27,1
4973,70248,gscO81uyFXakN6G7EORyf3gCaOhqQGKx,3VkHkmOtom3jM2wCu94xgzzu1d6Dn7or,8,12,7,0,3,7,11,1,41,5.857142857142857,1,0.0,0,7,0,3,12,7,0,11,1,10,31,1
4974,70251,0HuSQpwX1iWYzYyMmZ0529M9saU0hwj8,3VkHkmOtom3jM2wCu94xgzzu1d6Dn7or,5,1,1,0,1,0,4,0,7,1.0,1,0.0,0,1,0,1,1,0,0,4,0,2,5,1
4975,70253,dtUZ7Km4hQshJPZtpZL6oMxkrl1azThU,3VkHkmOtom3jM2wCu94xgzzu1d6Dn7or,1,0,0,0,0,0,1,0,1,0.14285714285714285,1,0.0,0,0,0,0,0,0,0,1,0,0,1,1
4976,70259,1aeZlGsApAjNHF2sTtN2ykYhmZIwHRj3,3VkHkmOtom3jM2wCu94xgzzu1d6Dn7or,15,38,7,12,8,7,18,1,91,13.0,2,0.0,20,7,9,8,18,7,3,18,1,44,47,1
4977,70270,Qu8QUkvr1KTlBexOowWu8oGayNCHenCY,3VkHkmOtom3jM2wCu94xgzzu1d6Dn7or,4,6,1,0,0,0,2,0,9,1.2857142857142858,1,0.0,0,1,0,0,6,0,0,2,0,1,8,1
4978,70273,TSm2R7cUPaXhbTrj1LddmwVL7dduRSSa,3VkHkmOtom3jM2wCu94xgzzu1d6Dn7or,11,5,3,0,2,1,13,2,26,3.7142857142857144,1,0.0,0,3,0,2,5,1,0,13,2,5,21,1
4979,70276,lFdHWGqsbM8uredLqtykcOMiqpT9vQZh,3VkHkmOtom3jM2wCu94xgzzu1d6Dn7or,20,12,10,0,9,0,4,0,35,5.0,2,0.0,0,10,0,9,12,0,0,4,0,19,16,1
4980,70284,BcgzvHoQgHyOCpoLwekWJ52M6u8p1BNv,3VkHkmOtom3jM2wCu94xgzzu1d6Dn7or,6,3,2,0,2,0,1,0,8,1.1428571428571428,1,0.0,0,2,0,2,3,0,0,1,0,4,4,1
4981,70287,hRVlNOTS6jXxXFoegXsRTavsZxsubLWH,3VkHkmOtom3jM2wCu94xgzzu1d6Dn7or,1,0,0,0,0,0,1,0,1,0.14285714285714285,1,0.0,0,0,0,0,0,0,0,1,0,0,1,1
4982,70299,HUdGvoMbBNNA1ZqsKSrSpFS4asnWhnvB,3VkHkmOtom3jM2wCu94xgzzu1d6Dn7or,78,139,47,58,55,33,20,1,353,50.42857142857143,4,0.0,73,47,51,55,66,33,7,20,1,226,127,0
4983,70304,aKsC7UhttF7Nkw8b5fbIrqYUfZaSStLM,3VkHkmOtom3jM2wCu94xgzzu1d6Dn7or,13,46,2,9,10,11,5,1,84,12.0,1,0.0,22,2,7,10,24,11,2,5,1,41,43,1
4984,70307,dMNoKAXoN62rKBeF7DLHss80bKinXTuJ,3VkHkmOtom3jM2wCu94xgzzu1d6Dn7or,1,0,0,0,0,0,1,0,1,0.14285714285714285,1,0.0,0,0,0,0,0,0,0,1,0,0,1,1
4985,70317,HIBuQQWRKjdUStZhe7V5BYz6wgihMKqV,3VkHkmOtom3jM2wCu94xgzzu1d6Dn7or,29,67,17,20,20,17,7,0,148,21.142857142857142,4,0.0,31,17,20,20,36,17,0,7,0,88,60,0
4986,70323,BnP6SRuNadhjBLDhTSpRuYXuZ6HAwvxW,3VkHkmOtom3jM2wCu94xgzzu1d6Dn7or,19,47,13,7,18,8,7,1,101,14.428571428571429,2,0.0,23,13,5,18,24,8,2,7,1,59,42,1
4987,70326,sZITkO7Sh1MA53F3zZx2CU20b5I5kt4P,3VkHkmOtom3jM2wCu94xgzzu1d6Dn7or,15,15,5,0,4,0,11,0,35,5.0,2,0.0,0,5,0,4,15,0,0,11,0,9,26,1
4988,70333,xjWkEdO0xALsCMyXVJLQ76Q1mnSHD20m,3VkHkmOtom3jM2wCu94xgzzu1d6Dn7or,28,67,23,38,13,21,5,0,167,23.857142857142858,5,0.0,15,23,37,13,52,21,1,5,0,88,79,0
4989,70337,4qqXsY3Nc9wmkdhweEho3hjfk0nn3MKk,3VkHkmOtom3jM2wCu94xgzzu1d6Dn7or,11,13,6,3,5,4,2,0,33,4.714285714285714,2,0.0,5,6,3,5,8,4,0,2,0,19,14,1
4990,70343,SIKFAHBZ2fVNjKQ3C1KlOBy1R3yMHlgk,3VkHkmOtom3jM2wCu94xgzzu1d6Dn7or,5,2,1,0,2,0,3,0,8,1.1428571428571428,1,0.0,0,1,0,2,2,0,0,3,0,3,5,1
4991,70344,GHtuONp0s9mJs9ViX96arxU4OpI3IP64,3VkHkmOtom3jM2wCu94xgzzu1d6Dn7or,1,0,0,0,0,0,1,0,1,0.14285714285714285,1,0.0,0,0,0,0,0,0,0,1,0,0,1,1
4992,70347,8h8kudlb5lUeOe03JJgIlAsgTzCK6jP5,3VkHkmOtom3jM2wCu94xgzzu1d6Dn7or,65,143,46,52,45,33,40,1,360,51.42857142857143,11,0.0,71,46,51,45,72,33,1,40,1,213,147,0
4993,70353,BQ3eBJK5uTZKVqw2FUWvJbXxk4Z7jeq1,3VkHkmOtom3jM2wCu94xgzzu1d6Dn7or,10,19,7,9,7,4,12,0,58,8.285714285714286,1,0.0,9,7,6,7,10,4,3,12,0,29,29,1
4994,70358,tkWTBuD8nrYklSlgsF9aKVPineGUm2wd,3VkHkmOtom3jM2wCu94xgzzu1d6Dn7or,1,0,0,0,0,0,2,0,2,0.2857142857142857,2,0.0,0,0,0,0,0,0,0,2,0,0,2,1
4995,70361,wQATXyXcLqQpcDtwYaqTkn0go5xZGZIB,3VkHkmOtom3jM2wCu94xgzzu1d6Dn7or,1,0,0,0,0,0,1,0,1,0.14285714285714285,1,0.0,0,0,0,0,0,0,0,1,0,0,1,1
4996,70362,zp9CVU4G1wbuvD6zHeghytszv1OWHRbH,fbPkOYLVPtPgIt0MxizjfFJov3JbHyAi,5,2,1,0,1,0,5,0,9,1.2857142857142858,1,0.0,0,1,0,1,2,0,0,5,0,2,7,1
4997,70364,d11XQPw4CaDnMkkvSEo4JqU6avErSb1R,fbPkOYLVPtPgIt0MxizjfFJov3JbHyAi,12,15,3,7,5,17,16,2,65,9.285714285714286,3,0.0,10,3,6,5,5,17,1,16,2,24,41,1
4998,70366,PpnPvK9DbTHdgRWHJHXOlINRXSc8Npmg,fbPkOYLVPtPgIt0MxizjfFJov3JbHyAi,7,3,2,0,2,0,4,0,11,1.5714285714285714,1,0.0,0,2,0,2,3,0,0,4,0,4,7,1
4999,70367,mJZNVvZltlGUOWmItS7lca1ZZKMYLgfv,fbPkOYLVPtPgIt0MxizjfFJov3JbHyAi,4,2,1,0,1,0,1,0,5,0.7142857142857143,1,0.0,0,1,0,1,2,0,0,1,0,2,3,1
5000,70369,QCF16jxhtQhmTizksY0agEWgfjSL0OQi,fbPkOYLVPtPgIt0MxizjfFJov3JbHyAi,6,1,1,0,1,0,3,0,6,0.8571428571428571,1,0.0,0,1,0,1,1,0,0,3,0,2,4,1
5001,70370,aM5KMfNvJMZXpckhWVfcYsB4JIRgyTpb,fbPkOYLVPtPgIt0MxizjfFJov3JbHyAi,3,0,0,0,0,0,5,0,5,0.7142857142857143,1,0.0,0,0,0,0,0,0,0,5,0,0,5,1
5002,70374,i7IcrBPDb6j5yESxBfBh5UcQNbAuMnQu,fbPkOYLVPtPgIt0MxizjfFJov3JbHyAi,1,0,0,0,0,0,1,0,1,0.14285714285714285,1,0.0,0,0,0,0,0,0,0,1,0,0,1,1
5003,70380,kI6ffxnrSLteZt1Y2KV2Lxy8Xwr4FbXB,fbPkOYLVPtPgIt0MxizjfFJov3JbHyAi,18,16,7,6,10,0,2,0,41,5.857142857142857,1,0.0,6,7,6,10,10,0,0,2,0,29,12,1
5004,70382,elPwHt777Sck2SbnBg6Zjs34W93VBNVZ,fbPkOYLVPtPgIt0MxizjfFJov3JbHyAi,8,6,4,0,3,0,4,0,17,2.4285714285714284,1,0.0,0,4,0,3,6,0,0,4,0,7,10,1
5005,70383,Op31ey1e8ia2T8lQ6kca7MllnthYRRtp,fbPkOYLVPtPgIt0MxizjfFJov3JbHyAi,19,32,19,8,8,11,21,5,104,14.857142857142858,5,0.0,6,19,8,8,26,11,0,21,5,41,63,1
5006,70386,SP7hg1EWo2mZkHuxZFtI4Vbcyr5vcP4h,fbPkOYLVPtPgIt0MxizjfFJov3JbHyAi,16,26,6,11,8,2,17,1,71,10.142857142857142,2,0.0,11,6,10,8,15,2,1,17,1,35,36,1
5007,70387,gTEZJ29F2arwuZ50nMHedjyXqssA1HaK,fbPkOYLVPtPgIt0MxizjfFJov3JbHyAi,8,6,3,0,4,0,1,0,14,2.0,1,0.0,2,3,0,4,4,0,0,1,0,9,5,1
5008,70402,b8GqJ93lAZFVpg9Mwv9wl7tS2AylqN7M,fbPkOYLVPtPgIt0MxizjfFJov3JbHyAi,7,7,4,0,2,0,4,0,17,2.4285714285714284,1,0.0,0,4,0,2,7,0,0,4,0,6,11,1
5009,70403,n0BoTjy9bHkXIWArHniej1rGvdJMGwHf,fbPkOYLVPtPgIt0MxizjfFJov3JbHyAi,8,5,2,0,2,6,4,1,20,2.857142857142857,1,0.0,0,2,0,2,5,6,0,4,1,4,16,1
5010,70405,0mn9lI6rmOQgtsjwJJCZKT5aBtKrZOEC,fbPkOYLVPtPgIt0MxizjfFJov3JbHyAi,4,2,0,0,0,0,2,0,4,0.5714285714285714,2,0.0,0,0,0,0,2,0,0,2,0,0,4,1
5011,70408,rPtP72DMEyNlpUomeqVVqrg44j30SIpW,fbPkOYLVPtPgIt0MxizjfFJov3JbHyAi,11,20,14,0,4,16,11,3,68,9.714285714285714,3,0.0,0,14,0,4,20,16,0,11,3,18,50,1
5012,70411,84PbfOPlGI9IjAK4ghphRdENNw1iTjGO,fbPkOYLVPtPgIt0MxizjfFJov3JbHyAi,1,0,0,0,0,0,1,0,1,0.14285714285714285,1,0.0,0,0,0,0,0,0,0,1,0,0,1,1
5013,70413,kMAOJzCNXdlJhsuMcIBGlBO8JULKbUln,fbPkOYLVPtPgIt0MxizjfFJov3JbHyAi,9,12,7,0,4,0,6,0,29,4.142857142857143,2,0.0,0,7,0,4,12,0,0,6,0,11,18,1
5014,70415,dRkGRhgEz0P6Cj2gSWKZ3jwm6LAB5sTl,fbPkOYLVPtPgIt0MxizjfFJov3JbHyAi,1,0,0,0,0,0,1,0,1,0.14285714285714285,1,0.0,0,0,0,0,0,0,0,1,0,0,1,1
5015,70416,TkGkraxFZeISMMLd87fcbklBTVTLGOhm,fbPkOYLVPtPgIt0MxizjfFJov3JbHyAi,46,53,32,28,18,8,14,1,154,22.0,3,0.0,15,32,27,18,38,8,1,14,1,92,62,1
5016,70417,U3vRWJ9ZlxOl62be4tXpqiQTVZSIgIE3,fbPkOYLVPtPgIt0MxizjfFJov3JbHyAi,1,0,0,0,0,0,1,0,1,0.14285714285714285,1,0.0,0,0,0,0,0,0,0,1,0,0,1,1
5017,70418,TgD7HTL6BBYi1V76wOsbmKwneDk5GeY1,fbPkOYLVPtPgIt0MxizjfFJov3JbHyAi,11,9,4,0,3,0,3,0,19,2.7142857142857144,1,0.0,4,4,0,3,5,0,0,3,0,11,8,1
5018,70420,nb4zZ4thsaPUV3M4XPmI0s66LlJvQ5KS,fbPkOYLVPtPgIt0MxizjfFJov3JbHyAi,12,7,5,0,3,0,5,0,20,2.857142857142857,1,0.0,0,5,0,3,7,0,0,5,0,8,12,1
5019,70421,JRVFRZlL9O1Hg2XIIgM1SU6gF5ZFwBDs,fbPkOYLVPtPgIt0MxizjfFJov3JbHyAi,1,0,0,0,0,0,1,0,1,0.14285714285714285,1,0.0,0,0,0,0,0,0,0,1,0,0,1,1
5020,70422,BaBxjEn3TWZ4ftqH98jukKacUK8Z3SVk,fbPkOYLVPtPgIt0MxizjfFJov3JbHyAi,5,2,1,0,1,0,2,0,6,0.8571428571428571,1,0.0,0,1,0,1,2,0,0,2,0,2,4,1
5021,70425,Cko24A4msOu0ocJWLZJpsB3dmU1FdwtS,fbPkOYLVPtPgIt0MxizjfFJov3JbHyAi,1,0,0,0,0,0,1,0,1,0.14285714285714285,1,0.0,0,0,0,0,0,0,0,1,0,0,1,1
5022,70426,y2pJnc0KPSLQND52yd5rcX8VRJR3QNZU,fbPkOYLVPtPgIt0MxizjfFJov3JbHyAi,5,2,1,0,1,2,2,0,8,1.1428571428571428,1,0.0,0,1,0,1,2,2,0,2,0,2,6,1
5023,70430,wEobeJ4f0gBmMcwQxjxFZn1OCeOPZzYY,fbPkOYLVPtPgIt0MxizjfFJov3JbHyAi,9,4,3,0,3,1,5,1,17,2.4285714285714284,1,0.0,0,3,0,3,4,1,0,5,1,6,11,1
5024,70432,TINvhk9VLXQ3D49XU1y8baDw0NlbVtwm,fbPkOYLVPtPgIt0MxizjfFJov3JbHyAi,1,0,0,0,0,0,1,0,1,0.14285714285714285,1,0.0,0,0,0,0,0,0,0,1,0,0,1,1
5025,70440,s8W8cdIMLI0wttTxhl9oTzo8KNby6TlB,fbPkOYLVPtPgIt0MxizjfFJov3JbHyAi,5,2,1,0,1,0,2,0,6,0.8571428571428571,1,0.0,0,1,0,1,2,0,0,2,0,2,4,1
5026,70442,wMrBLf0Bj3KcyXZhbv1Gc8JYaCbLqMxI,fbPkOYLVPtPgIt0MxizjfFJov3JbHyAi,1,0,0,0,0,0,1,0,1,0.14285714285714285,1,0.0,0,0,0,0,0,0,0,1,0,0,1,1
5027,70443,KU2ZvHkEQEb3JAaLolzvBVJ54ROyNU4O,fbPkOYLVPtPgIt0MxizjfFJov3JbHyAi,8,3,2,0,2,1,3,0,11,1.5714285714285714,1,0.0,0,2,0,2,3,1,0,3,0,4,7,1
5028,70444,9DnTA9cJdXk1sLNPfwadV56caZuYgPFA,fbPkOYLVPtPgIt0MxizjfFJov3JbHyAi,7,6,4,0,4,0,2,0,16,2.2857142857142856,1,0.0,1,4,0,4,5,0,0,2,0,9,7,1
5029,70447,e1JkrjLmoNWMhYF8oakgy1uiYBC2tSp7,fbPkOYLVPtPgIt0MxizjfFJov3JbHyAi,7,7,3,0,2,3,3,0,18,2.5714285714285716,1,0.0,0,3,0,2,7,3,0,3,0,5,13,1
5030,70448,Tnqp8RxwOeUuCC7Qp8CqF6vKQxL9Cimc,fbPkOYLVPtPgIt0MxizjfFJov3JbHyAi,7,7,1,0,1,0,8,0,17,2.4285714285714284,1,0.0,0,1,0,1,7,0,0,8,0,2,15,1
5031,70450,B9Ey1tIo6ANxVa0IvzoinvUWj4cenbLl,fbPkOYLVPtPgIt0MxizjfFJov3JbHyAi,30,69,1,29,4,0,2,0,105,15.0,2,0.0,24,1,24,4,45,0,5,2,0,53,52,1
5032,70451,5n43m0O6jMd9u06uLjQWfLgplW2Mj8WG,fbPkOYLVPtPgIt0MxizjfFJov3JbHyAi,7,3,2,0,2,0,3,0,10,1.4285714285714286,2,0.0,0,2,0,2,3,0,0,3,0,4,6,1
5033,70453,j5jJTM3hFoonQXLPD4VBAk3sLP9YQf22,fbPkOYLVPtPgIt0MxizjfFJov3JbHyAi,6,1,1,0,1,0,5,0,8,1.1428571428571428,1,0.0,0,1,0,1,1,0,0,5,0,2,6,1
5034,70454,6GqrPcO4oJU2rSJnj2GMOg35aldNMAg2,fbPkOYLVPtPgIt0MxizjfFJov3JbHyAi,1,0,0,0,0,0,1,0,1,0.14285714285714285,1,0.0,0,0,0,0,0,0,0,1,0,0,1,1
5035,70460,uIBAKDJwWewmJzOoAu8wXcXt7IZWFCLk,fbPkOYLVPtPgIt0MxizjfFJov3JbHyAi,4,0,0,0,0,0,4,0,4,0.5714285714285714,1,0.0,0,0,0,0,0,0,0,4,0,0,4,1
5036,70464,5pNBiCcrjVf8w8PgJKHP647T7U9arPze,fbPkOYLVPtPgIt0MxizjfFJov3JbHyAi,2,0,0,0,0,0,2,0,2,0.2857142857142857,1,0.0,0,0,0,0,0,0,0,2,0,0,2,1
5037,70465,5CrBlR6zrkauTaeaZtpYKwSZbYlbmRp4,fbPkOYLVPtPgIt0MxizjfFJov3JbHyAi,7,3,2,0,2,0,2,0,9,1.2857142857142858,1,0.0,0,2,0,2,3,0,0,2,0,4,5,1
5038,70466,peaGEeAVqM29YYBxjRmiLTEtcrDX5FwI,fbPkOYLVPtPgIt0MxizjfFJov3JbHyAi,1,0,0,0,0,0,1,0,1,0.14285714285714285,1,0.0,0,0,0,0,0,0,0,1,0,0,1,1
5039,70467,AF2WqhAeg8UXHquisOTxLVKHXh1OOPd5,fbPkOYLVPtPgIt0MxizjfFJov3JbHyAi,11,4,2,6,2,3,6,1,24,3.4285714285714284,1,0.0,1,2,5,2,3,3,1,6,1,10,14,1
5040,70468,ETCPUMqyU09gcKrtaCRQ42i068JLqy26,fbPkOYLVPtPgIt0MxizjfFJov3JbHyAi,13,7,4,7,5,4,7,1,35,5.0,1,0.0,2,4,5,5,5,4,2,7,1,16,19,1
5041,70475,r5QBoGyTGzPPNMXpOkVWAVSD4WtheLjK,fbPkOYLVPtPgIt0MxizjfFJov3JbHyAi,1,0,0,0,0,0,1,0,1,0.14285714285714285,1,0.0,0,0,0,0,0,0,0,1,0,0,1,1
5042,70479,IeJFnRP45F5IqEsCwWOVkYId1qIootxH,fbPkOYLVPtPgIt0MxizjfFJov3JbHyAi,8,5,3,0,3,0,2,0,13,1.8571428571428572,2,0.0,0,3,0,3,5,0,0,2,0,6,7,1
5043,70480,ZnZUpsAwhsKxOeo88uKWqXms7Hr6vGQ0,fbPkOYLVPtPgIt0MxizjfFJov3JbHyAi,1,0,0,0,0,0,1,0,1,0.14285714285714285,1,0.0,0,0,0,0,0,0,0,1,0,0,1,1
5044,70483,F8PplJ0MdSBFJMkvQSa7z6RMAQvcxOkt,fbPkOYLVPtPgIt0MxizjfFJov3JbHyAi,14,37,3,8,1,5,8,0,62,8.857142857142858,6,0.0,5,3,7,1,32,5,1,8,0,16,46,0
5045,70489,1KY2xQE7nTlowha0qhSxoa3VZ8IEtTuU,fbPkOYLVPtPgIt0MxizjfFJov3JbHyAi,4,2,1,0,1,0,1,0,5,0.7142857142857143,1,0.0,0,1,0,1,2,0,0,1,0,2,3,1
5046,70491,o72e1M3GwrvLzNPjTViCBNsXT3sIbItE,fbPkOYLVPtPgIt0MxizjfFJov3JbHyAi,8,5,2,0,2,0,4,0,13,1.8571428571428572,1,0.0,0,2,0,2,5,0,0,4,0,4,9,1
5047,70493,PQN68zvQWtqLWovgQi2j4ZPXjsSbybWb,fbPkOYLVPtPgIt0MxizjfFJov3JbHyAi,1,0,0,0,0,0,1,0,1,0.14285714285714285,1,0.0,0,0,0,0,0,0,0,1,0,0,1,1
5048,70494,lgip049r6Eu24ga2SPdixKHu4ShoVkOP,fbPkOYLVPtPgIt0MxizjfFJov3JbHyAi,1,0,0,0,0,0,1,0,1,0.14285714285714285,1,0.0,0,0,0,0,0,0,0,1,0,0,1,1
5049,70497,vGQJgu8tmA9kQpG8GdauGWSuqyqtNE3M,fbPkOYLVPtPgIt0MxizjfFJov3JbHyAi,1,0,0,0,0,0,1,0,1,0.14285714285714285,1,0.0,0,0,0,0,0,0,0,1,0,0,1,1
5050,70498,LK1fNSP3UpGaGwYkuo0BQyI3g1s3ODJ4,fbPkOYLVPtPgIt0MxizjfFJov3JbHyAi,7,3,2,0,2,0,4,0,11,1.5714285714285714,1,0.0,0,2,0,2,3,0,0,4,0,4,7,1
5051,70499,R0fqJCKSDdlape9O3QiJvxhX8OJnijdc,fbPkOYLVPtPgIt0MxizjfFJov3JbHyAi,14,27,15,19,11,3,12,0,87,12.428571428571429,3,0.0,9,15,13,11,18,3,6,12,0,48,39,1
5052,70500,wuj7kbmCy3JkqjSYqFBD6rEwetA5ny2r,fbPkOYLVPtPgIt0MxizjfFJov3JbHyAi,8,3,2,0,2,2,6,0,15,2.142857142857143,1,0.0,0,2,0,2,3,2,0,6,0,4,11,1
5053,70505,0uebMpTrpNYgDgvdKb7MmNThyYHd0W5n,fbPkOYLVPtPgIt0MxizjfFJov3JbHyAi,8,6,3,0,2,1,6,0,18,2.5714285714285716,1,0.0,0,3,0,2,6,1,0,6,0,5,13,1
5054,70507,edTxzupkEcnjoBMEEWcWCMVwXX7Jf82i,fbPkOYLVPtPgIt0MxizjfFJov3JbHyAi,9,8,3,2,2,0,2,0,17,2.4285714285714284,1,0.0,1,3,2,2,7,0,0,2,0,8,9,1
5055,70508,gJS3lYqFTHr060G9WKP0FBIIOt76kylk,fbPkOYLVPtPgIt0MxizjfFJov3JbHyAi,7,5,2,0,2,0,2,0,11,1.5714285714285714,1,0.0,0,2,0,2,5,0,0,2,0,4,7,1
5056,70619,EUbYS528SLpUvydqHGhniNAZDkRxQSUM,fbPkOYLVPtPgIt0MxizjfFJov3JbHyAi,1,0,0,0,0,0,1,0,1,0.14285714285714285,1,0.0,0,0,0,0,0,0,0,1,0,0,1,1
5057,70621,w0u223fmMcj8R0XYvkRYTxBWPO2H34gs,fbPkOYLVPtPgIt0MxizjfFJov3JbHyAi,10,8,6,9,5,0,6,0,34,4.857142857142857,3,0.0,1,6,6,5,7,0,3,6,0,18,16,0
5058,70628,cDndPN0bU03X7W27vQCXFKmVpa2a5fXn,fbPkOYLVPtPgIt0MxizjfFJov3JbHyAi,6,3,2,0,0,1,4,1,11,1.5714285714285714,1,0.0,0,2,0,0,3,1,0,4,1,2,9,1
5059,70630,6BV3xjXq9ekiRfYm3O3pN6jZMMACVAnm,fbPkOYLVPtPgIt0MxizjfFJov3JbHyAi,1,0,0,0,0,0,1,0,1,0.14285714285714285,1,0.0,0,0,0,0,0,0,0,1,0,0,1,0
5060,70631,zhUkf3kMMzWlXsKEezEHBm9LsgVJDdTP,fbPkOYLVPtPgIt0MxizjfFJov3JbHyAi,5,2,1,0,1,0,10,0,14,2.0,2,0.0,0,1,0,1,2,0,0,10,0,2,12,1
5061,70633,PnTAr4JQ7W1gITYEASL2GPQdvilj2Kny,fbPkOYLVPtPgIt0MxizjfFJov3JbHyAi,3,2,0,0,0,0,1,0,3,0.42857142857142855,1,0.0,0,0,0,0,2,0,0,1,0,0,3,1
5062,70634,HU8ThwxdRuW919irq38IcjLXhEvT4bai,fbPkOYLVPtPgIt0MxizjfFJov3JbHyAi,9,9,6,0,4,1,12,0,32,4.571428571428571,2,0.0,0,6,0,4,9,1,0,12,0,10,22,1
5063,70639,NjNUHcUgwvm9xYQvil0yjwq6PWKHWHr6,fbPkOYLVPtPgIt0MxizjfFJov3JbHyAi,7,3,2,0,1,4,13,0,23,3.2857142857142856,2,0.0,0,2,0,1,3,4,0,13,0,3,20,1
5064,70640,KqGhfmSqWtSa4SJELlmAXcwsyTwdeOL4,fbPkOYLVPtPgIt0MxizjfFJov3JbHyAi,7,6,4,0,4,0,2,0,16,2.2857142857142856,1,0.0,1,4,0,4,5,0,0,2,0,9,7,1
5065,70643,cdEsk1qpGnOY8M8xILMNOVhPCtmvS3gr,fbPkOYLVPtPgIt0MxizjfFJov3JbHyAi,7,3,2,0,2,0,4,0,11,1.5714285714285714,1,0.0,0,2,0,2,3,0,0,4,0,4,7,1
5066,70645,sikVclrYgcpS3p4V6eW44EtX4b5SsNLE,fbPkOYLVPtPgIt0MxizjfFJov3JbHyAi,11,30,1,3,8,4,3,0,49,7.0,1,0.0,20,1,3,8,10,4,0,3,0,32,17,1
5067,70650,kbSUu2Z40fu4lSlgv22Wu70hAt5BnJoC,fbPkOYLVPtPgIt0MxizjfFJov3JbHyAi,22,45,0,12,6,52,16,1,132,18.857142857142858,4,0.0,21,0,10,6,24,52,2,16,1,37,95,1
5068,70654,LAVkRDyEDRYFfA0FMc6U4JnWPWsDLjhi,fbPkOYLVPtPgIt0MxizjfFJov3JbHyAi,7,12,1,0,2,0,3,0,18,2.5714285714285716,1,0.0,2,1,0,2,10,0,0,3,0,5,13,1
5069,70660,J1bBTxr7xQhu6wEykZt3Bd9gSlmRIWmq,fbPkOYLVPtPgIt0MxizjfFJov3JbHyAi,2,0,0,0,0,0,3,0,3,0.42857142857142855,1,0.0,0,0,0,0,0,0,0,3,0,0,3,1
5070,70662,u3wB3K0Js3pmFsJGQpe7V7v42hnAvDay,fbPkOYLVPtPgIt0MxizjfFJov3JbHyAi,5,2,1,0,1,0,4,0,8,1.1428571428571428,2,0.0,0,1,0,1,2,0,0,4,0,2,6,1
5071,70663,EpLshGb6fxFM19N1QN5M0uUEP2YQoz65,fbPkOYLVPtPgIt0MxizjfFJov3JbHyAi,6,6,2,0,2,0,5,0,15,2.142857142857143,1,0.0,2,2,0,2,4,0,0,5,0,6,9,1
5072,70665,jWXtvduhcSeQYRX8KBGNnUGlWXZhf8j7,fbPkOYLVPtPgIt0MxizjfFJov3JbHyAi,7,4,2,0,1,0,9,0,16,2.2857142857142856,1,0.0,0,2,0,1,4,0,0,9,0,3,13,1
5073,70667,m6MSFO9wulR4Nf5CljOSKizOwoCC2JYl,fbPkOYLVPtPgIt0MxizjfFJov3JbHyAi,21,44,19,21,14,25,6,0,129,18.428571428571427,4,0.0,20,19,15,14,24,25,6,6,0,68,61,1
5074,70668,6Bdl0MkwJ5lZUJnVsPp6IjSTHrXnqeTx,fbPkOYLVPtPgIt0MxizjfFJov3JbHyAi,2,0,0,0,0,0,9,0,9,1.2857142857142858,1,0.0,0,0,0,0,0,0,0,9,0,0,9,1
5075,70671,RMxcBkJoAGieBk6NcKXJqusraN8qxLZ7,fbPkOYLVPtPgIt0MxizjfFJov3JbHyAi,1,0,0,0,0,0,1,0,1,0.14285714285714285,1,0.0,0,0,0,0,0,0,0,1,0,0,1,1
5076,70673,RyoftXJlSPPQnlnD7mk7JNhtKBWRLRWG,fbPkOYLVPtPgIt0MxizjfFJov3JbHyAi,2,0,0,0,0,0,5,0,5,0.7142857142857143,1,0.0,0,0,0,0,0,0,0,5,0,0,5,1
5077,70679,YXIqJ6spT3Ja1ygrmNWuBLibK013t0q5,fbPkOYLVPtPgIt0MxizjfFJov3JbHyAi,1,0,0,0,0,0,1,0,1,0.14285714285714285,1,0.0,0,0,0,0,0,0,0,1,0,0,1,1
5078,70680,I2YlhnUPXZKF2nHJmVrtwRFgGB2nHSiZ,fbPkOYLVPtPgIt0MxizjfFJov3JbHyAi,9,12,3,0,3,1,8,1,28,4.0,1,0.0,6,3,0,3,6,1,0,8,1,12,16,1
5079,70681,XSTWk85DGQnV3ClLFIpSnGKTu2dEFPYv,fbPkOYLVPtPgIt0MxizjfFJov3JbHyAi,6,1,1,0,1,0,8,0,11,1.5714285714285714,1,0.0,0,1,0,1,1,0,0,8,0,2,9,1
5080,70683,hkJbQtfl1ac72y2vr8c3dGSqgpUqSDf1,fbPkOYLVPtPgIt0MxizjfFJov3JbHyAi,1,0,0,0,0,0,1,0,1,0.14285714285714285,1,0.0,0,0,0,0,0,0,0,1,0,0,1,1
5081,70684,Cd9ft0A4qlmf8URzSzFBOzoArPR6PTDL,fbPkOYLVPtPgIt0MxizjfFJov3JbHyAi,44,62,24,67,23,16,8,1,201,28.714285714285715,3,0.0,33,24,59,23,29,16,8,8,1,139,62,1
5082,70686,NUUrfkmQ6PTn8vYLlenz4k9BmiPCmi7I,fbPkOYLVPtPgIt0MxizjfFJov3JbHyAi,7,6,4,0,1,0,3,0,14,2.0,2,0.0,0,4,0,1,6,0,0,3,0,5,9,0
5083,70689,WFLWEfQrQsuFMQB4h1DfinKxHOxaJgRw,fbPkOYLVPtPgIt0MxizjfFJov3JbHyAi,9,9,5,0,2,5,3,0,24,3.4285714285714284,1,0.0,0,5,0,2,9,5,0,3,0,7,17,1
5084,70692,6qrT2bYbFD0verDQZWOnrOjhEccqo56g,fbPkOYLVPtPgIt0MxizjfFJov3JbHyAi,82,272,117,53,68,186,65,2,763,109.0,21,0.0,114,117,51,68,158,186,2,65,2,350,413,0
5085,70694,a0K0pCjTVYvmpJhsgniZUHaxogtZRZu6,fbPkOYLVPtPgIt0MxizjfFJov3JbHyAi,1,0,0,0,0,0,1,0,1,0.14285714285714285,1,0.0,0,0,0,0,0,0,0,1,0,0,1,1
5086,70696,Pt9EMdXHAJoREYsz9PnQvEKtrmRTWsTp,fbPkOYLVPtPgIt0MxizjfFJov3JbHyAi,2,0,0,0,0,0,2,0,2,0.2857142857142857,1,0.0,0,0,0,0,0,0,0,2,0,0,2,1
5087,70698,FN0V2FJ9PwsmZe2ZdtFoTzNeftwa8lew,fbPkOYLVPtPgIt0MxizjfFJov3JbHyAi,4,2,1,0,1,0,1,0,5,0.7142857142857143,1,0.0,0,1,0,1,2,0,0,1,0,2,3,1
5088,70707,KIkxhCvZoGl3wo3zfjbQsMpSQMiIEEXM,fbPkOYLVPtPgIt0MxizjfFJov3JbHyAi,6,7,4,0,2,0,5,0,18,2.5714285714285716,1,0.0,0,4,0,2,7,0,0,5,0,6,12,1
5089,70714,NPIHq6nnRF0fUledjFKG5ROeHLCshlez,fbPkOYLVPtPgIt0MxizjfFJov3JbHyAi,13,12,8,0,6,0,9,0,35,5.0,2,0.0,0,8,0,6,12,0,0,9,0,14,21,1
5090,70716,7aQ84DnQTSRkdmQzmLpA6ZuenMv0j2zy,fbPkOYLVPtPgIt0MxizjfFJov3JbHyAi,1,0,0,0,0,0,1,0,1,0.14285714285714285,1,0.0,0,0,0,0,0,0,0,1,0,0,1,1
5091,70718,Zh4ywqGGZpnusw56NY7i4goj5JrNtqvq,fbPkOYLVPtPgIt0MxizjfFJov3JbHyAi,13,9,5,0,6,0,2,0,22,3.142857142857143,1,0.0,3,5,0,6,6,0,0,2,0,14,8,1
5092,70719,mCG9v0HfdST0gIHQ17sgmmDB5sK4zRUH,fbPkOYLVPtPgIt0MxizjfFJov3JbHyAi,4,2,0,0,0,0,4,0,6,0.8571428571428571,1,0.0,0,0,0,0,2,0,0,4,0,0,6,1
5093,70720,1sdBeDtu3vvbkIr8j4KgcWPZ5NNqSuy1,fbPkOYLVPtPgIt0MxizjfFJov3JbHyAi,2,0,0,0,0,0,2,0,2,0.2857142857142857,1,0.0,0,0,0,0,0,0,0,2,0,0,2,1
5094,70724,Tp7YlU9FicEPdF8OYctnhCNGsZgZyAsQ,fbPkOYLVPtPgIt0MxizjfFJov3JbHyAi,1,0,0,0,0,0,1,0,1,0.14285714285714285,1,0.0,0,0,0,0,0,0,0,1,0,0,1,1
5095,70725,GKYvnmyIP1jWi6afQrMmOmjTFVpSxJct,fbPkOYLVPtPgIt0MxizjfFJov3JbHyAi,11,8,6,0,6,3,19,1,43,6.142857142857143,1,0.0,2,6,0,6,6,3,0,19,1,14,29,1
5096,70726,yz3oOBelfOSc6Zj3ARcY1Ttj6774hRYk,fbPkOYLVPtPgIt0MxizjfFJov3JbHyAi,13,15,8,0,5,3,10,1,42,6.0,2,0.0,0,8,0,5,15,3,0,10,1,13,29,1
5097,70731,baDb9SDqFGaUm6SQ1U1wIZZwVOEGfEyo,fbPkOYLVPtPgIt0MxizjfFJov3JbHyAi,5,2,1,0,1,0,4,0,8,1.1428571428571428,1,0.0,0,1,0,1,2,0,0,4,0,2,6,1
5098,70733,ZmL8VQqDEMaFfRIwjy7tQi9WkUzCCBLM,fbPkOYLVPtPgIt0MxizjfFJov3JbHyAi,10,9,6,0,2,0,9,2,28,4.0,1,0.0,0,6,0,2,9,0,0,9,2,8,20,1
5099,70735,p9NcQP74LARrulF6JzGeab5yk6ciJM9V,fbPkOYLVPtPgIt0MxizjfFJov3JbHyAi,5,6,2,0,2,0,2,0,12,1.7142857142857142,1,0.0,0,2,0,2,6,0,0,2,0,4,8,0
5100,70738,6dbTbyd09itvDaSueIGFOrLEXchCwk95,fbPkOYLVPtPgIt0MxizjfFJov3JbHyAi,1,0,0,0,0,0,1,0,1,0.14285714285714285,1,0.0,0,0,0,0,0,0,0,1,0,0,1,1
5101,70739,UpVcxzqMkt11Nj9X8RwveSuqRLLT8jcK,fbPkOYLVPtPgIt0MxizjfFJov3JbHyAi,1,0,0,0,0,0,2,0,2,0.2857142857142857,1,0.0,0,0,0,0,0,0,0,2,0,0,2,1
5102,70740,dfuGl47rq6fydJ1Iu9G64MAVsec4tYLw,fbPkOYLVPtPgIt0MxizjfFJov3JbHyAi,8,4,3,0,2,0,4,0,13,1.8571428571428572,1,0.0,0,3,0,2,4,0,0,4,0,5,8,1
5103,70741,UkIsdTaWagDppaZDW5tymVOWOun6ZaQI,fbPkOYLVPtPgIt0MxizjfFJov3JbHyAi,2,0,0,0,0,0,2,0,2,0.2857142857142857,1,0.0,0,0,0,0,0,0,0,2,0,0,2,1
5104,70745,p6AFdMGSdHZgjyt65ZYRzektbK0I84xl,fbPkOYLVPtPgIt0MxizjfFJov3JbHyAi,6,2,1,0,1,0,3,0,7,1.0,1,0.0,0,1,0,1,2,0,0,3,0,2,5,1
5105,70746,LQmyF5rgACOl1PlQazAUIkQQzPowi62e,fbPkOYLVPtPgIt0MxizjfFJov3JbHyAi,6,1,1,0,1,0,5,0,8,1.1428571428571428,1,0.0,0,1,0,1,1,0,0,5,0,2,6,1
5106,70748,Ym6TvHrxnwJdfewbwqJsshYwGQqwpbLU,fbPkOYLVPtPgIt0MxizjfFJov3JbHyAi,1,0,0,0,0,0,1,0,1,0.14285714285714285,1,0.0,0,0,0,0,0,0,0,1,0,0,1,1
5107,70751,ENyodDgJyA2wd97NHYIDwdpe1Vs11mPZ,fbPkOYLVPtPgIt0MxizjfFJov3JbHyAi,1,0,0,0,0,0,1,0,1,0.14285714285714285,1,0.0,0,0,0,0,0,0,0,1,0,0,1,1
5108,70754,nFgkSMwO2ng2Retk5DgcNAqWaKFo0gCU,fbPkOYLVPtPgIt0MxizjfFJov3JbHyAi,8,8,3,0,3,0,3,0,17,2.4285714285714284,1,0.0,0,3,0,3,8,0,0,3,0,6,11,1
5109,70755,3HpxfMDfQbW9g9Tin4Z0gZM45TYocput,fbPkOYLVPtPgIt0MxizjfFJov3JbHyAi,5,2,1,0,1,0,2,0,6,0.8571428571428571,1,0.0,0,1,0,1,2,0,0,2,0,2,4,1
5110,70756,vBhHgjMP9zQ8a4hHaJHnj26pjx8bQlTJ,fbPkOYLVPtPgIt0MxizjfFJov3JbHyAi,1,0,0,0,0,0,2,0,2,0.2857142857142857,1,0.0,0,0,0,0,0,0,0,2,0,0,2,1
5111,70758,RwU7Y7lavLbhtCQP0Z40qchKwKbkXpWv,fbPkOYLVPtPgIt0MxizjfFJov3JbHyAi,2,0,0,0,0,0,2,0,2,0.2857142857142857,1,0.0,0,0,0,0,0,0,0,2,0,0,2,1
5112,70759,9yy85NagPiS34NJ87i7KYeHGwZcaY5RV,fbPkOYLVPtPgIt0MxizjfFJov3JbHyAi,1,0,0,0,0,0,1,0,1,0.14285714285714285,1,0.0,0,0,0,0,0,0,0,1,0,0,1,1
5113,70763,Dcb7ijWo8pQsf9LOueamq5fOrw00PG6q,fbPkOYLVPtPgIt0MxizjfFJov3JbHyAi,6,5,3,0,2,2,3,0,15,2.142857142857143,1,0.0,0,3,0,2,5,2,0,3,0,5,10,1
5114,70766,GjiH1IkIccjLrYuqfEsVjmx7CFuQL57X,fbPkOYLVPtPgIt0MxizjfFJov3JbHyAi,6,6,1,0,2,0,2,0,11,1.5714285714285714,1,0.0,3,1,0,2,3,0,0,2,0,6,5,1
5115,70767,NdQp2i50zLfip7hkQMmu9RAwjvzQx8Ro,fbPkOYLVPtPgIt0MxizjfFJov3JbHyAi,1,0,0,0,0,0,1,0,1,0.14285714285714285,1,0.0,0,0,0,0,0,0,0,1,0,0,1,1
5116,70768,k5ImVzQqedaNbB81c2Hwkrfmv9j8DVBf,fbPkOYLVPtPgIt0MxizjfFJov3JbHyAi,7,3,2,0,2,0,4,0,11,1.5714285714285714,1,0.0,0,2,0,2,3,0,0,4,0,4,7,1
5117,70777,WyyKrch61UrttdMbjuQKzg4QBmDCrCBH,fbPkOYLVPtPgIt0MxizjfFJov3JbHyAi,5,2,1,0,1,0,2,0,6,0.8571428571428571,1,0.0,0,1,0,1,2,0,0,2,0,2,4,1
5118,70778,MIqfP3VsJ9nH7bZE9ekfrlzlbcWQcCFl,fbPkOYLVPtPgIt0MxizjfFJov3JbHyAi,1,0,0,0,0,0,1,0,1,0.14285714285714285,1,0.0,0,0,0,0,0,0,0,1,0,0,1,1
5119,70782,rdl2Dm3C3i0ppIthR1Qn4oaBGTeiNx1U,fbPkOYLVPtPgIt0MxizjfFJov3JbHyAi,7,3,2,0,2,0,2,0,9,1.2857142857142858,1,0.0,0,2,0,2,3,0,0,2,0,4,5,1
5120,70785,hW0YVXPA152YM5ruixi6vg4sBZmIyH6B,fbPkOYLVPtPgIt0MxizjfFJov3JbHyAi,2,0,0,0,0,0,5,0,5,0.7142857142857143,1,0.0,0,0,0,0,0,0,0,5,0,0,5,1
5121,70786,jqG9CfpKiNNgI1mgrk9KW86K86stS6Mi,fbPkOYLVPtPgIt0MxizjfFJov3JbHyAi,9,9,0,0,1,1,13,1,25,3.5714285714285716,1,0.0,3,0,0,1,6,1,0,13,1,4,21,1
5122,70788,ekWb02aBPJno00ztvjZNAv3AR4LI6ZAw,fbPkOYLVPtPgIt0MxizjfFJov3JbHyAi,5,2,0,0,1,0,2,0,5,0.7142857142857143,1,0.0,0,0,0,1,2,0,0,2,0,1,4,1
5123,70790,TmPyC7E4NTBA6YmjfcP4ojkHVXONYmBN,fbPkOYLVPtPgIt0MxizjfFJov3JbHyAi,5,2,1,0,1,0,2,0,6,0.8571428571428571,1,0.0,0,1,0,1,2,0,0,2,0,2,4,1
5124,70791,3qcRHdffVLa2D7HfTn4z6WZ2lXzvrhpG,fbPkOYLVPtPgIt0MxizjfFJov3JbHyAi,6,3,1,0,1,0,2,0,7,1.0,1,0.0,0,1,0,1,3,0,0,2,0,2,5,1
5125,70792,JkroiUnjq2uHCiIMgFI03fh765OIWPrR,fbPkOYLVPtPgIt0MxizjfFJov3JbHyAi,1,0,0,0,0,0,1,0,1,0.14285714285714285,1,0.0,0,0,0,0,0,0,0,1,0,0,1,1
5126,70795,jjlr08B8z0coeMcgDdnBVJKSEYA9jwu6,fbPkOYLVPtPgIt0MxizjfFJov3JbHyAi,1,0,0,0,0,0,1,0,1,0.14285714285714285,1,0.0,0,0,0,0,0,0,0,1,0,0,1,1
5127,70798,boC2S8uyvVowlqLg3Y1XsVwiDCwAmln4,fbPkOYLVPtPgIt0MxizjfFJov3JbHyAi,5,2,1,0,1,0,4,0,8,1.1428571428571428,1,0.0,0,1,0,1,2,0,0,4,0,2,6,1
5128,70800,2mpeAdpOL3tGWTeEe4ZWOPVvXPu3FJnP,fbPkOYLVPtPgIt0MxizjfFJov3JbHyAi,6,2,0,0,0,0,6,1,9,1.2857142857142858,1,0.0,0,0,0,0,2,0,0,6,1,0,9,1
5129,70801,a5niF0PQgSShvkt9NB1sc4s6iuS0oVal,fbPkOYLVPtPgIt0MxizjfFJov3JbHyAi,5,2,1,0,1,0,2,0,6,0.8571428571428571,1,0.0,0,1,0,1,2,0,0,2,0,2,4,1
5130,70802,KSimnpWBH0drMHTMBZ6ujLNrpiHo2Ats,fbPkOYLVPtPgIt0MxizjfFJov3JbHyAi,6,0,0,0,0,1,13,3,17,2.4285714285714284,1,0.0,0,0,0,0,0,1,0,13,3,0,17,1
5131,70805,X5eROzQX7rhyrxBey0oqBe6jtRxHyD2A,fbPkOYLVPtPgIt0MxizjfFJov3JbHyAi,6,1,1,0,1,0,3,0,6,0.8571428571428571,1,0.0,0,1,0,1,1,0,0,3,0,2,4,1
5132,70806,BVznem1ellaAs8tYskTZaTrvHXJyT2Zb,fbPkOYLVPtPgIt0MxizjfFJov3JbHyAi,5,2,1,0,1,0,2,0,6,0.8571428571428571,1,0.0,0,1,0,1,2,0,0,2,0,2,4,1
5133,70807,lcguF24eJLLJpEr3dB9FY8rhbtdiFvGC,fbPkOYLVPtPgIt0MxizjfFJov3JbHyAi,1,0,0,0,0,0,1,0,1,0.14285714285714285,1,0.0,0,0,0,0,0,0,0,1,0,0,1,1
5134,70810,CBBhqECPTNqAKZUrRWMmwFKMWNkqEZn0,fbPkOYLVPtPgIt0MxizjfFJov3JbHyAi,7,3,2,0,2,0,2,0,9,1.2857142857142858,1,0.0,0,2,0,2,3,0,0,2,0,4,5,1
5135,70811,m78E7vltQhJgZgrROuk3QTJpjWRjCXpP,fbPkOYLVPtPgIt0MxizjfFJov3JbHyAi,5,3,1,0,1,0,2,0,7,1.0,1,0.0,1,1,0,1,2,0,0,2,0,3,4,1
5136,70815,w5jq4cUGCLiYNuQqjhzyyIK1nCXtEQY7,fbPkOYLVPtPgIt0MxizjfFJov3JbHyAi,2,0,0,0,0,0,2,0,2,0.2857142857142857,1,0.0,0,0,0,0,0,0,0,2,0,0,2,1
5137,70816,5CB4swFPweP7kpiIuMEez08nNIJxrTCU,fbPkOYLVPtPgIt0MxizjfFJov3JbHyAi,7,3,2,0,2,0,2,0,9,1.2857142857142858,1,0.0,0,2,0,2,3,0,0,2,0,4,5,1
5138,70818,VYp7s59UUnQczX0IlO39VEvKPQphb7ko,fbPkOYLVPtPgIt0MxizjfFJov3JbHyAi,1,0,0,0,0,0,1,0,1,0.14285714285714285,1,0.0,0,0,0,0,0,0,0,1,0,0,1,1
5139,70819,vjFBv13y086gggICV62EHu0yBgOzNutV,fbPkOYLVPtPgIt0MxizjfFJov3JbHyAi,7,7,2,0,2,0,5,0,16,2.2857142857142856,2,0.0,0,2,0,2,7,0,0,5,0,4,12,1
5140,70827,ldVvKkl14x8Ir8UvT4LavBfHwbFTWxfX,fbPkOYLVPtPgIt0MxizjfFJov3JbHyAi,2,0,0,0,0,0,3,0,3,0.42857142857142855,1,0.0,0,0,0,0,0,0,0,3,0,0,3,1
5141,70834,KVX7Y5dqohnBCFqFu0UMGdbJ0FKj1RGE,fbPkOYLVPtPgIt0MxizjfFJov3JbHyAi,7,2,1,0,1,0,4,0,8,1.1428571428571428,1,0.0,0,1,0,1,2,0,0,4,0,2,6,1
5142,70835,yEUx5EDkSQZ0AERWiDLd07Yf3D0jNmra,fbPkOYLVPtPgIt0MxizjfFJov3JbHyAi,5,2,1,0,1,0,2,0,6,0.8571428571428571,1,0.0,0,1,0,1,2,0,0,2,0,2,4,0
5143,70838,V2oXO5MUVbmMLpm49RH7wP2e7GBuZQIG,fbPkOYLVPtPgIt0MxizjfFJov3JbHyAi,6,5,1,0,1,0,3,0,10,1.4285714285714286,1,0.0,0,1,0,1,5,0,0,3,0,2,8,1
5144,70841,pzZeaYxzJXbuhi5KTdAt0eeAxzLlFc60,fbPkOYLVPtPgIt0MxizjfFJov3JbHyAi,8,17,0,4,1,0,6,0,28,4.0,1,0.0,5,0,3,1,12,0,1,6,0,9,19,1
5145,70843,4Ofl2Ny0Hi8mgxaGCrkktZk3mHl8PQkx,fbPkOYLVPtPgIt0MxizjfFJov3JbHyAi,1,0,0,0,0,0,2,0,2,0.2857142857142857,1,0.0,0,0,0,0,0,0,0,2,0,0,2,1
5146,70844,JKI9pSyEwU7yqpCLpxIR9F4XQMHCp20K,fbPkOYLVPtPgIt0MxizjfFJov3JbHyAi,5,2,1,0,1,0,2,0,6,0.8571428571428571,1,0.0,0,1,0,1,2,0,0,2,0,2,4,1
5147,70848,dizRBkb9QQnO5lOZ4qzzgmJWVuYvCZWl,fbPkOYLVPtPgIt0MxizjfFJov3JbHyAi,1,0,0,0,0,0,1,0,1,0.14285714285714285,1,0.0,0,0,0,0,0,0,0,1,0,0,1,1
5148,70849,rvGeJBDthuxogYD9iVgKqZ9WWdzkhnrb,fbPkOYLVPtPgIt0MxizjfFJov3JbHyAi,1,0,0,0,0,0,1,0,1,0.14285714285714285,1,0.0,0,0,0,0,0,0,0,1,0,0,1,1
5149,70851,aMumXCd09eIRYN1LbGM5nVYZFHRtNPDe,fbPkOYLVPtPgIt0MxizjfFJov3JbHyAi,6,2,1,0,1,0,4,0,8,1.1428571428571428,1,0.0,0,1,0,1,2,0,0,4,0,2,6,1
5150,70852,hgNqBAseHohc9BKsFOMM49J0ufMjGDL5,fbPkOYLVPtPgIt0MxizjfFJov3JbHyAi,4,2,1,0,0,0,2,0,5,0.7142857142857143,1,0.0,0,1,0,0,2,0,0,2,0,1,4,1
5151,70853,t6NWwU4qK3YyLYX7t7fzZJQHw55QhxpE,fbPkOYLVPtPgIt0MxizjfFJov3JbHyAi,10,13,4,7,4,0,4,0,32,4.571428571428571,1,0.0,5,4,5,4,8,0,2,4,0,18,14,1
5152,70856,2ZrkcHnwnE6Pn0A4sJYSZoI8FSiFAo2R,fbPkOYLVPtPgIt0MxizjfFJov3JbHyAi,7,1,1,0,1,1,4,1,9,1.2857142857142858,1,0.0,0,1,0,1,1,1,0,4,1,2,7,1
5153,70857,P4rYy4VFFS1aWSnIl4t3iCnhdV1GUZUL,fbPkOYLVPtPgIt0MxizjfFJov3JbHyAi,5,2,1,0,1,1,3,0,8,1.1428571428571428,1,0.0,0,1,0,1,2,1,0,3,0,2,6,1
5154,70860,gDi6f8yecAtULPjPfuTZCDylLlh4kFrA,fbPkOYLVPtPgIt0MxizjfFJov3JbHyAi,5,2,1,0,1,0,2,0,6,0.8571428571428571,1,0.0,0,1,0,1,2,0,0,2,0,2,4,1
5155,70863,xDc1xgzFSFoS6IiGjf8r0vplCBQSLEw0,fbPkOYLVPtPgIt0MxizjfFJov3JbHyAi,11,9,4,2,4,0,4,0,23,3.2857142857142856,1,0.0,3,4,2,4,6,0,0,4,0,13,10,1
5156,70865,scS3D2DWLKsKrvVVvWQWPPqVUehrWkS1,fbPkOYLVPtPgIt0MxizjfFJov3JbHyAi,1,0,0,0,0,0,1,0,1,0.14285714285714285,1,0.0,0,0,0,0,0,0,0,1,0,0,1,1
5157,70868,9t6TphVDPn8QCqkJMSSSD8suJg54nDg1,fbPkOYLVPtPgIt0MxizjfFJov3JbHyAi,7,3,2,0,2,0,3,0,10,1.4285714285714286,1,0.0,0,2,0,2,3,0,0,3,0,4,6,1
5158,70871,EVZzKo71oTynD4qvlIqI8WHFpHDNDZTk,fbPkOYLVPtPgIt0MxizjfFJov3JbHyAi,8,6,3,0,1,1,4,0,15,2.142857142857143,1,0.0,1,3,0,1,5,1,0,4,0,5,10,0
5159,70873,p9vt4gNfihsixdGiLCuufIHsmW3jvD7a,fbPkOYLVPtPgIt0MxizjfFJov3JbHyAi,1,0,0,0,0,0,1,0,1,0.14285714285714285,1,0.0,0,0,0,0,0,0,0,1,0,0,1,1
5160,70874,0bySEAm2oYtQ2Tleetx3OtzbFfR26iOs,fbPkOYLVPtPgIt0MxizjfFJov3JbHyAi,9,7,5,0,5,0,2,0,19,2.7142857142857144,1,0.0,0,5,0,5,7,0,0,2,0,10,9,1
5161,70878,JJ6wlXEIablDydF4jOHDhv4TjKDeXQan,fbPkOYLVPtPgIt0MxizjfFJov3JbHyAi,7,7,2,0,3,0,2,0,14,2.0,1,0.0,4,2,0,3,3,0,0,2,0,9,5,1
5162,70879,4OTqFMCZxx7r7u5a2qYtSI5NaNF7PvO8,fbPkOYLVPtPgIt0MxizjfFJov3JbHyAi,8,4,3,0,3,0,1,0,11,1.5714285714285714,1,0.0,0,3,0,3,4,0,0,1,0,6,5,1
5163,70880,K8EiUmRs9Nq0Qj4O9mjSk5qQn6E6D5cj,fbPkOYLVPtPgIt0MxizjfFJov3JbHyAi,5,2,1,0,1,0,2,0,6,0.8571428571428571,1,0.0,0,1,0,1,2,0,0,2,0,2,4,1
5164,70881,sOSUJ9Hzn8EsMXvSoMXyqd2CJLKFDkw3,fbPkOYLVPtPgIt0MxizjfFJov3JbHyAi,1,0,0,0,0,0,1,0,1,0.14285714285714285,1,0.0,0,0,0,0,0,0,0,1,0,0,1,1
5165,70882,XluaP5TPFhLRlajx7bmLwFy9eBFAVswr,fbPkOYLVPtPgIt0MxizjfFJov3JbHyAi,1,0,0,0,0,0,1,0,1,0.14285714285714285,1,0.0,0,0,0,0,0,0,0,1,0,0,1,1
5166,70883,NeDoKNVSKD8Aiq0pOti0J4aVmpnS5aEL,fbPkOYLVPtPgIt0MxizjfFJov3JbHyAi,7,7,2,0,3,0,7,0,19,2.7142857142857144,1,0.0,2,2,0,3,5,0,0,7,0,7,12,1
5167,70886,8p7u7RxFna6sXuG4TtD3bPfcMY9zmEQb,fbPkOYLVPtPgIt0MxizjfFJov3JbHyAi,5,2,1,0,1,0,4,0,8,1.1428571428571428,1,0.0,0,1,0,1,2,0,0,4,0,2,6,1
5168,70887,JROXjwvC9rxe26lrQwNHzIbtlVSWvibf,fbPkOYLVPtPgIt0MxizjfFJov3JbHyAi,5,3,1,0,1,0,2,0,7,1.0,1,0.0,0,1,0,1,3,0,0,2,0,2,5,1
5169,70890,4G4NYV5HdrqJgMd8tHZhlgK9Wwk62py3,fbPkOYLVPtPgIt0MxizjfFJov3JbHyAi,1,0,0,0,0,0,1,0,1,0.14285714285714285,1,0.0,0,0,0,0,0,0,0,1,0,0,1,1
5170,70892,kITorNxbn0jKRrU5oeVoAkoKxKssAebK,fbPkOYLVPtPgIt0MxizjfFJov3JbHyAi,7,5,2,0,3,0,2,0,12,1.7142857142857142,1,0.0,2,2,0,3,3,0,0,2,0,7,5,1
5171,70893,RMMuFeZ2nCFjdFF7Br5oAsh68xDnP2Kt,fbPkOYLVPtPgIt0MxizjfFJov3JbHyAi,2,0,0,0,0,0,2,0,2,0.2857142857142857,1,0.0,0,0,0,0,0,0,0,2,0,0,2,1
5172,70895,iAXqLonwJtIlRlvnGYLtu7A6G32sN6pK,fbPkOYLVPtPgIt0MxizjfFJov3JbHyAi,2,0,0,0,0,0,2,0,2,0.2857142857142857,1,0.0,0,0,0,0,0,0,0,2,0,0,2,1
5173,70900,w5Nz5FF2iacISxkk1j18hYO33XJu5f6u,fbPkOYLVPtPgIt0MxizjfFJov3JbHyAi,2,0,0,0,0,0,2,0,2,0.2857142857142857,1,0.0,0,0,0,0,0,0,0,2,0,0,2,1
5174,70901,5Sdd90y9f6G1O01oh8dNylP38h97ZkQP,fbPkOYLVPtPgIt0MxizjfFJov3JbHyAi,5,2,1,0,1,0,2,0,6,0.8571428571428571,1,0.0,0,1,0,1,2,0,0,2,0,2,4,1
5175,70928,iem7aobLjfwmsInz2aJm33FyllmcOoxM,SpATywNh6bZuzm8s1ceuBUnMUAeoAHHw,11,22,4,0,0,6,18,2,52,7.428571428571429,4,0.0,1,4,0,0,21,6,0,18,2,5,47,1
5176,70935,JiFgudQA4nZtHR8rdanNuKW7boGcferp,SpATywNh6bZuzm8s1ceuBUnMUAeoAHHw,15,22,10,17,7,0,4,0,60,8.571428571428571,2,0.0,8,10,16,7,14,0,1,4,0,41,19,1
5177,70936,u2D7DEFYPnV7TgAwmWCf915LuQlPziwx,SpATywNh6bZuzm8s1ceuBUnMUAeoAHHw,1,0,0,0,0,0,1,0,1,0.14285714285714285,1,0.0,0,0,0,0,0,0,0,1,0,0,1,1
5178,70966,USLTnsAwagwK2c83KXd1SNEeENnzkTTo,SpATywNh6bZuzm8s1ceuBUnMUAeoAHHw,1,0,0,0,0,0,2,0,2,0.2857142857142857,1,0.0,0,0,0,0,0,0,0,2,0,0,2,1
5179,70971,1GwCcPnawuwjaFyAi38hoJxQ9NHTHcHa,A3fsA9Zfv1X2fVEQhTw51lKENdNrEqT3,6,2,1,0,0,0,8,0,11,1.5714285714285714,1,0.0,0,1,0,0,2,0,0,8,0,1,10,1
5180,71007,ah7dn7oeJ2Zo8NzKmljnoEEVEzPzQawZ,A3fsA9Zfv1X2fVEQhTw51lKENdNrEqT3,10,13,5,0,2,1,7,0,28,4.0,2,0.0,0,5,0,2,13,1,0,7,0,7,21,1
5181,71008,l5FaUWasiv60gSjMCgxRDYxpxpwnBW6p,SpATywNh6bZuzm8s1ceuBUnMUAeoAHHw,13,10,5,2,3,0,3,0,23,3.2857142857142856,1,0.0,0,5,2,3,10,0,0,3,0,10,13,1
5182,71009,CKlApvgsp3P7WP3VG5px4QWIpk803niH,A3fsA9Zfv1X2fVEQhTw51lKENdNrEqT3,5,0,0,0,0,0,6,3,9,1.2857142857142858,1,0.0,0,0,0,0,0,0,0,6,3,0,9,1
5183,71012,2UIdqPRKpgTkXkubY12P5suWz65Jis6l,SpATywNh6bZuzm8s1ceuBUnMUAeoAHHw,9,18,10,0,2,0,7,1,38,5.428571428571429,2,0.0,2,10,0,2,16,0,0,7,1,14,24,1
5184,71013,pHnPjZi5mLgI5QDOW2G2xaXlZsc2fDRf,5X6FeZozNMgE2VRi3MJYjkkFK8SETtu2,17,33,12,17,13,0,8,1,84,12.0,4,0.0,14,12,15,13,19,0,2,8,1,54,30,1
5185,71017,QjbLQSoFVavd6LHLH5XtUy4x4q9nhmtF,SpATywNh6bZuzm8s1ceuBUnMUAeoAHHw,15,9,8,0,7,0,1,0,25,3.5714285714285716,1,0.0,0,8,0,7,9,0,0,1,0,15,10,0
5186,71084,PehZ8w7lhwueNJQVLn4O4a5DjlM7RVHJ,A3fsA9Zfv1X2fVEQhTw51lKENdNrEqT3,77,39,18,204,13,0,5,0,279,39.857142857142854,2,0.0,3,18,177,13,36,0,27,5,0,211,68,1
5187,71089,bOlBfDLwRlFztzXeRI7M3tpbHNy8C56c,SpATywNh6bZuzm8s1ceuBUnMUAeoAHHw,16,25,0,23,0,14,5,0,67,9.571428571428571,1,0.0,5,0,19,0,20,14,4,5,0,24,43,1
5188,71104,zxmge3ZElgX2vkJ2cCOzkeMQCnk45k6Y,G8EPVSXsOYB5YQWZGiz1aVq5Pgr2GrQu,4,7,4,0,0,0,3,0,14,2.0,3,0.0,0,4,0,0,7,0,0,3,0,4,10,1
5189,71106,8IMVGvB09WRKHeXEjWGkZOVu6CXmlVXA,A3fsA9Zfv1X2fVEQhTw51lKENdNrEqT3,1,0,0,0,0,0,1,0,1,0.14285714285714285,1,0.0,0,0,0,0,0,0,0,1,0,0,1,1
5190,71110,D5E2Qt7jBeIZBIFcDabwhaaXeayXbs8U,bWdj2GDclj5ofokWjzoa5jAwMkxCykd6,4,5,2,0,0,0,4,0,11,1.5714285714285714,2,0.0,0,2,0,0,5,0,0,4,0,2,9,1
5191,71116,gMihFFRgCbvgH3cTGh2cgQ4GULLM91Yq,SpATywNh6bZuzm8s1ceuBUnMUAeoAHHw,20,31,3,6,2,4,10,1,57,8.142857142857142,3,0.0,5,3,6,2,26,4,0,10,1,16,41,0
5192,71139,loLM1q927UBCE6cjZ1Vielkh2VBpufUl,A3fsA9Zfv1X2fVEQhTw51lKENdNrEqT3,39,29,26,0,21,0,5,0,81,11.571428571428571,2,0.0,0,26,0,21,29,0,0,5,0,47,34,1
5193,71140,loLM1q927UBCE6cjZ1Vielkh2VBpufUl,SpATywNh6bZuzm8s1ceuBUnMUAeoAHHw,19,12,11,0,9,0,3,0,35,5.0,1,0.0,0,11,0,9,12,0,0,3,0,20,15,1
5194,71162,FixP7IuJ80KsWtzMzcQsJZKOjLxDKZgC,G8EPVSXsOYB5YQWZGiz1aVq5Pgr2GrQu,1,0,0,0,0,0,1,0,1,0.14285714285714285,1,0.0,0,0,0,0,0,0,0,1,0,0,1,1
5195,71166,FixP7IuJ80KsWtzMzcQsJZKOjLxDKZgC,5X6FeZozNMgE2VRi3MJYjkkFK8SETtu2,1,0,0,0,0,0,1,0,1,0.14285714285714285,1,0.0,0,0,0,0,0,0,0,1,0,0,1,1
5196,71180,6zXGZtvwHnFZCYFcS3Xzk5yrVH7CXdoJ,bWdj2GDclj5ofokWjzoa5jAwMkxCykd6,7,4,2,4,0,0,2,0,12,1.7142857142857142,1,0.0,1,2,4,0,3,0,0,2,0,7,5,0
5197,71197,5PZBmKEXGmnHhrok7M9vaGB06CAzFVOO,A3fsA9Zfv1X2fVEQhTw51lKENdNrEqT3,68,35,16,126,14,0,4,0,195,27.857142857142858,2,0.0,4,16,109,14,31,0,17,4,0,143,52,0
5198,71204,SEiRJIrKqIUXJc6AKB5rH8Do4LEjJRIR,SpATywNh6bZuzm8s1ceuBUnMUAeoAHHw,8,4,3,0,2,0,2,0,11,1.5714285714285714,1,0.0,0,3,0,2,4,0,0,2,0,5,6,1
5199,71227,HieJch2LMldZteUgpMFf3KIoNYB4ohUW,RXDvfPUBYFlVdlueBFbLW0mhhAyGEqpt,5,2,1,0,1,0,2,0,6,0.8571428571428571,1,0.0,0,1,0,1,2,0,0,2,0,2,4,0
5200,71233,OYKjrPxX9BZcmbpGQNe0saEMxsDF2LNu,SpATywNh6bZuzm8s1ceuBUnMUAeoAHHw,1,0,0,0,0,0,1,0,1,0.14285714285714285,1,0.0,0,0,0,0,0,0,0,1,0,0,1,1
5201,71277,ZzEeIm98vbP9lRunZYePLW46UyhiVxbR,bWdj2GDclj5ofokWjzoa5jAwMkxCykd6,5,8,3,0,1,0,3,0,15,2.142857142857143,2,0.0,0,3,0,1,8,0,0,3,0,4,11,1
5202,71279,YYCI1ivPCDRa3x25VBUTnS1EqXk51k7P,A3fsA9Zfv1X2fVEQhTw51lKENdNrEqT3,44,29,21,70,11,11,10,1,153,21.857142857142858,3,0.0,2,21,60,11,27,11,10,10,1,94,59,1
5203,71280,YUT6CW7iSh1xoUpF2nfmR8w0ThlxeIYe,SpATywNh6bZuzm8s1ceuBUnMUAeoAHHw,24,32,0,39,0,15,17,0,103,14.714285714285714,5,0.0,11,0,33,0,21,15,6,17,0,44,59,0
5204,71288,ynZwxbnEbKW0W9hd646CFEVp0hOxydow,SpATywNh6bZuzm8s1ceuBUnMUAeoAHHw,24,25,11,30,6,0,4,0,76,10.857142857142858,2,0.0,13,11,27,6,12,0,3,4,0,57,19,0
5205,71302,xNhIay3NLh7QqL0JWfWBdzb4B9nitBX9,G8EPVSXsOYB5YQWZGiz1aVq5Pgr2GrQu,5,2,1,0,1,0,2,0,6,0.8571428571428571,1,0.0,0,1,0,1,2,0,0,2,0,2,4,0
5206,71309,04MTc9DP7u70zt8WMvntZYPfTFQUHhtX,SpATywNh6bZuzm8s1ceuBUnMUAeoAHHw,4,2,0,0,0,0,4,0,6,0.8571428571428571,3,0.0,0,0,0,0,2,0,0,4,0,0,6,0
5207,71318,bOlBfDLwRlFztzXeRI7M3tpbHNy8C56c,bWdj2GDclj5ofokWjzoa5jAwMkxCykd6,5,2,1,0,1,0,2,0,6,0.8571428571428571,1,0.0,0,1,0,1,2,0,0,2,0,2,4,1
5208,71358,WfFzDu02yVQhznDpti9qz88KkaHNMAz5,SpATywNh6bZuzm8s1ceuBUnMUAeoAHHw,14,9,7,0,7,0,16,0,39,5.571428571428571,6,0.0,0,7,0,7,9,0,0,16,0,14,25,1
5209,71361,fnAQHOrM0aOC0GQVDcBG5sVn1wNxVUAt,SpATywNh6bZuzm8s1ceuBUnMUAeoAHHw,45,41,24,23,12,1,6,0,107,15.285714285714286,4,0.0,10,24,21,12,31,1,2,6,0,67,40,0
5210,71373,oNf6qoW6E6dhoPJKSUjvElFlUKN9drLY,G8EPVSXsOYB5YQWZGiz1aVq5Pgr2GrQu,5,12,3,0,4,0,3,0,22,3.142857142857143,2,0.0,7,3,0,4,5,0,0,3,0,14,8,1
5211,71404,hKHtoNLNdXjroo5MBUJPMKLH6p5UkRTG,SpATywNh6bZuzm8s1ceuBUnMUAeoAHHw,8,5,1,0,0,1,6,1,14,2.0,1,0.0,0,1,0,0,5,1,0,6,1,1,13,1
5212,71421,5Ls9Y8mfUb8JgZfSWkF8kDMEq3gGISZD,G8EPVSXsOYB5YQWZGiz1aVq5Pgr2GrQu,6,5,1,0,1,0,4,0,11,1.5714285714285714,1,0.0,0,1,0,1,5,0,0,4,0,2,9,1
5213,71426,onsmNYIoPFEi185f5ZLsQXD70I3K25Cb,bWdj2GDclj5ofokWjzoa5jAwMkxCykd6,7,21,4,16,1,0,4,0,46,6.571428571428571,3,0.0,8,4,15,1,13,0,1,4,0,28,18,1
5214,71558,nqvxWBh8RMlOMSpTtlC0WlRIvQffkk6Q,SpATywNh6bZuzm8s1ceuBUnMUAeoAHHw,36,28,19,28,15,1,9,0,100,14.285714285714286,2,0.0,7,19,26,15,21,1,2,9,0,67,33,0
5215,71562,6yNhQyEbKEsWZJAOZYhGdgOd9YcNxjUf,G8EPVSXsOYB5YQWZGiz1aVq5Pgr2GrQu,1,0,0,0,0,0,1,0,1,0.14285714285714285,1,0.0,0,0,0,0,0,0,0,1,0,0,1,1
5216,71579,01fFtDlb7q6YVhWJvhsOvwQMPs8xw65f,A3fsA9Zfv1X2fVEQhTw51lKENdNrEqT3,1,0,0,0,0,0,1,0,1,0.14285714285714285,1,0.0,0,0,0,0,0,0,0,1,0,0,1,1
5217,71586,DgIUsdyZ2bZRmyXrVqC2xYLKsZlQY2uf,SpATywNh6bZuzm8s1ceuBUnMUAeoAHHw,11,10,1,3,1,0,3,0,18,2.5714285714285716,2,0.0,0,1,3,1,10,0,0,3,0,5,13,1
5218,71593,EU6hvCkOpmY7eHAp1iULlNAf6vTYfvA3,G8EPVSXsOYB5YQWZGiz1aVq5Pgr2GrQu,1,0,0,0,0,0,1,0,1,0.14285714285714285,1,0.0,0,0,0,0,0,0,0,1,0,0,1,1
5219,71594,gIXV45WkMOjKV6SvlgkVrQlYJRphcrVX,A3fsA9Zfv1X2fVEQhTw51lKENdNrEqT3,8,4,3,0,3,0,1,0,11,1.5714285714285714,1,0.0,0,3,0,3,4,0,0,1,0,6,5,1
5220,71601,jsJkZlRrCs7XDDe36sdBTD1SNVw3QiEY,SpATywNh6bZuzm8s1ceuBUnMUAeoAHHw,4,0,0,0,0,0,4,0,4,0.5714285714285714,2,0.0,0,0,0,0,0,0,0,4,0,0,4,0
5221,71611,KWdhtnEkrke9rgi3l1csNclNjZVhn1s4,SpATywNh6bZuzm8s1ceuBUnMUAeoAHHw,26,147,5,17,0,58,45,15,287,41.0,11,0.0,4,5,14,0,143,58,3,45,15,23,264,1
5222,71634,ojqn4pgOfPG4Pc3ke3CSjZ4IF82Cz5Gt,SpATywNh6bZuzm8s1ceuBUnMUAeoAHHw,3,2,0,0,0,0,1,0,3,0.42857142857142855,1,0.0,0,0,0,0,2,0,0,1,0,0,3,1
5223,71640,jj6BKJzz2LfNkxpbRScKRBOb519d4fcM,5X6FeZozNMgE2VRi3MJYjkkFK8SETtu2,3,2,0,0,0,0,9,0,11,1.5714285714285714,4,0.0,0,0,0,0,2,0,0,9,0,0,11,0
5224,71670,AqzJls3OFl2nFap48g5Tia0Yo0Y7Cer3,G8EPVSXsOYB5YQWZGiz1aVq5Pgr2GrQu,7,8,2,0,3,0,3,0,16,2.2857142857142856,1,0.0,2,2,0,3,6,0,0,3,0,7,9,1
5225,71690,MELwpFsIi2XkPIOGygAX1FgCz7x3lucR,5X6FeZozNMgE2VRi3MJYjkkFK8SETtu2,1,0,0,0,0,0,1,0,1,0.14285714285714285,1,0.0,0,0,0,0,0,0,0,1,0,0,1,1
5226,71711,NwQCoUHJKyAdqdG7U0utXO1oyZsmr8V3,bWdj2GDclj5ofokWjzoa5jAwMkxCykd6,1,0,0,0,0,0,1,0,1,0.14285714285714285,1,0.0,0,0,0,0,0,0,0,1,0,0,1,1
5227,71754,MwsjD881hF2KUCEG3rXUPSq3GKMfMo2d,A3fsA9Zfv1X2fVEQhTw51lKENdNrEqT3,7,4,2,0,1,0,5,0,12,1.7142857142857142,1,0.0,0,2,0,1,4,0,0,5,0,3,9,0
5228,71759,foGsrANktd6dCLnplglYgW0LYGi2yeuV,bWdj2GDclj5ofokWjzoa5jAwMkxCykd6,8,6,3,8,1,0,5,0,23,3.2857142857142856,2,0.0,0,3,7,1,6,0,1,5,0,11,12,1
5229,71761,IVf9pr5nElMkd4OXzOFEQ79wv07lJihp,5X6FeZozNMgE2VRi3MJYjkkFK8SETtu2,3,0,0,0,0,21,4,0,25,3.5714285714285716,1,0.0,0,0,0,0,0,21,0,4,0,0,25,1
5230,71809,3VdXvjSQZjkmaMxk7jVlpKzQwHK0VW6h,RXDvfPUBYFlVdlueBFbLW0mhhAyGEqpt,1,0,0,0,0,0,1,0,1,0.14285714285714285,1,0.0,0,0,0,0,0,0,0,1,0,0,1,0
5231,71829,n1JdH8HPXOUoCHQIEd4YCo0nlAshsKdG,SpATywNh6bZuzm8s1ceuBUnMUAeoAHHw,38,42,19,47,8,4,20,2,142,20.285714285714285,7,0.0,8,19,41,8,34,4,6,20,2,76,66,0
5232,71836,BVpzzXeXh42vyU3wE9rUQpEUs8P1ZpSo,SpATywNh6bZuzm8s1ceuBUnMUAeoAHHw,8,15,8,4,0,0,4,0,31,4.428571428571429,3,0.0,3,8,3,0,12,0,1,4,0,14,17,0
5233,71843,TtktJZVgpwig0r3gUw8lQnr2rEFBADhH,G8EPVSXsOYB5YQWZGiz1aVq5Pgr2GrQu,6,9,3,0,2,0,2,0,16,2.2857142857142856,1,0.0,5,3,0,2,4,0,0,2,0,10,6,1
5234,71860,kTJIJds7bRsw0KFlLhCoB2PivF66Tf3q,A3fsA9Zfv1X2fVEQhTw51lKENdNrEqT3,39,25,20,50,14,0,8,1,118,16.857142857142858,3,0.0,0,20,44,14,25,0,6,8,1,78,40,1
5235,71865,nvXkSuJjNwPy4x4PN83PXogIa9iXtJsm,A3fsA9Zfv1X2fVEQhTw51lKENdNrEqT3,27,20,15,0,12,6,12,0,65,9.285714285714286,4,0.0,1,15,0,12,19,6,0,12,0,28,37,1
5236,71871,xyDv5uzKguLKwuLAtjs5magaAGWqhgm8,A3fsA9Zfv1X2fVEQhTw51lKENdNrEqT3,5,4,0,0,0,0,4,0,8,1.1428571428571428,1,0.0,0,0,0,0,4,0,0,4,0,0,8,0
5237,71872,pxwAvlbOFGjXMz981vvB3RuwcS56iZNF,SpATywNh6bZuzm8s1ceuBUnMUAeoAHHw,1,0,0,0,0,0,1,0,1,0.14285714285714285,1,0.0,0,0,0,0,0,0,0,1,0,0,1,1
5238,71880,YaP2AuckukEZITP3IVvIt6Z8ci6RHew7,5X6FeZozNMgE2VRi3MJYjkkFK8SETtu2,24,38,12,39,18,0,10,0,117,16.714285714285715,3,0.0,21,12,32,18,17,0,7,10,0,83,34,1
5239,71892,AimQk6bFhhGPpMH9HY88V7PvSxxOwe07,SpATywNh6bZuzm8s1ceuBUnMUAeoAHHw,7,3,1,0,1,0,4,0,9,1.2857142857142858,2,0.0,0,1,0,1,3,0,0,4,0,2,7,1
5240,71928,z9s7UAFfwXliVd2GScbNHLyqLTBO7649,SpATywNh6bZuzm8s1ceuBUnMUAeoAHHw,6,3,1,0,1,0,2,0,7,1.0,1,0.0,0,1,0,1,3,0,0,2,0,2,5,1
5241,71961,LyDM0yrwn8zKtQsuxEGqFMxdhffaZNVY,A3fsA9Zfv1X2fVEQhTw51lKENdNrEqT3,11,19,2,0,2,0,8,1,32,4.571428571428571,2,0.0,1,2,0,2,18,0,0,8,1,5,27,1
5242,71962,Gq7C34w2v5h08r5B2E14BoawNOpfmfl0,SpATywNh6bZuzm8s1ceuBUnMUAeoAHHw,4,2,1,0,1,0,1,0,5,0.7142857142857143,1,0.0,0,1,0,1,2,0,0,1,0,2,3,1
5243,71999,Pe5WMotTf5HMq3hNpICq7pbnjQeqT1z5,SpATywNh6bZuzm8s1ceuBUnMUAeoAHHw,43,53,30,29,16,15,11,0,154,22.0,7,0.0,15,30,25,16,38,15,4,11,0,86,68,0
5244,72014,KL9U9geosSonjO9r5P2YyGdv6jdUGAmi,SpATywNh6bZuzm8s1ceuBUnMUAeoAHHw,5,2,1,0,1,0,2,0,6,0.8571428571428571,1,0.0,0,1,0,1,2,0,0,2,0,2,4,1
5245,72071,7gwAY8GKvsU7xwUilNpzEOAvbLd2D9r9,A3fsA9Zfv1X2fVEQhTw51lKENdNrEqT3,1,0,0,0,0,0,1,0,1,0.14285714285714285,1,0.0,0,0,0,0,0,0,0,1,0,0,1,1
5246,72086,0LMHRy44jwjr4gUThAzfzfGCUeg2Lm1J,SpATywNh6bZuzm8s1ceuBUnMUAeoAHHw,21,57,32,17,12,67,18,0,203,29.0,5,0.0,13,32,14,12,44,67,3,18,0,71,132,1
5247,72092,bLIF0ETNcg7fjkutu8YBWJptM3zxtu2Z,bWdj2GDclj5ofokWjzoa5jAwMkxCykd6,12,10,8,0,7,0,7,0,32,4.571428571428571,2,0.0,2,8,0,7,8,0,0,7,0,17,15,0
5248,72114,UuK4SgZkmPrFxeH0ZPCRQ63pVXUSe96N,bWdj2GDclj5ofokWjzoa5jAwMkxCykd6,1,0,0,0,0,0,1,0,1,0.14285714285714285,1,0.0,0,0,0,0,0,0,0,1,0,0,1,1
5249,72116,QeJMYd11is6DqiF8uVkla2ZwnHb26tuu,RXDvfPUBYFlVdlueBFbLW0mhhAyGEqpt,13,15,1,0,1,0,6,0,23,3.2857142857142856,4,0.0,3,1,0,1,12,0,0,6,0,5,18,0
5250,72120,a8HvMkBRr1QnoDxivZVIhrkeiZFWplka,A3fsA9Zfv1X2fVEQhTw51lKENdNrEqT3,32,28,15,72,8,0,9,0,132,18.857142857142858,4,0.0,5,15,56,8,23,0,16,9,0,84,48,1
5251,72128,6oNhI3z3lPtYcSpGC1lnWpyyeDMBUOtK,SpATywNh6bZuzm8s1ceuBUnMUAeoAHHw,6,8,4,0,1,0,8,0,21,3.0,3,0.0,0,4,0,1,8,0,0,8,0,5,16,1
5252,72133,2qQuu2Qhkw7hRYngnGfnNzXYklrDkMwy,SpATywNh6bZuzm8s1ceuBUnMUAeoAHHw,17,31,6,20,4,0,9,0,70,10.0,6,0.0,5,6,17,4,26,0,3,9,0,32,38,1
5253,72150,dDLv4oouOmVB45Y4hnRyV7IUqT7tMKiq,A3fsA9Zfv1X2fVEQhTw51lKENdNrEqT3,63,54,36,100,21,12,20,2,245,35.0,4,0.0,6,36,81,21,48,12,19,20,2,144,101,0
5254,72158,kiNfuRpgeROReVuBtap1KwDDZc9hG55i,A3fsA9Zfv1X2fVEQhTw51lKENdNrEqT3,10,6,2,0,1,0,7,1,17,2.4285714285714284,2,0.0,0,2,0,1,6,0,0,7,1,3,14,1
5255,72169,Lb7wmhbhC16FSS5Xq3dqazq7PwTHyvZu,bWdj2GDclj5ofokWjzoa5jAwMkxCykd6,6,7,4,0,2,0,3,0,16,2.2857142857142856,2,0.0,0,4,0,2,7,0,0,3,0,6,10,1
5256,72173,yS4hKsLzPsdj6M1qMcvQzXXEbCXgtzUx,bWdj2GDclj5ofokWjzoa5jAwMkxCykd6,2,0,0,0,0,0,2,0,2,0.2857142857142857,1,0.0,0,0,0,0,0,0,0,2,0,0,2,1
5257,72222,Fdt86Xu5OLPdaOgl6M1XDpiJ3zar7SU6,RXDvfPUBYFlVdlueBFbLW0mhhAyGEqpt,23,17,11,38,7,1,10,1,85,12.142857142857142,3,0.0,3,11,30,7,14,1,8,10,1,51,34,1
5258,72255,H9uyY7qx5i6ZDOUonFHaANKxCA5aZsQi,G8EPVSXsOYB5YQWZGiz1aVq5Pgr2GrQu,27,31,3,52,4,0,9,0,99,14.142857142857142,3,0.0,12,3,42,4,19,0,10,9,0,61,38,1
5259,72259,tzUG2qRl7N6mPYRCQUU2RS3J3hIQZLrD,A3fsA9Zfv1X2fVEQhTw51lKENdNrEqT3,4,2,1,0,1,0,1,0,5,0.7142857142857143,1,0.0,0,1,0,1,2,0,0,1,0,2,3,1
5260,72271,VCY6PHshXOjPWWfmo1l8Uf1lH1o7rZ3R,A3fsA9Zfv1X2fVEQhTw51lKENdNrEqT3,17,13,9,0,5,0,6,0,33,4.714285714285714,2,0.0,0,9,0,5,13,0,0,6,0,14,19,1
5261,72280,Daw06K1PSOXldo19kBgHP5sewulb7Vu5,RXDvfPUBYFlVdlueBFbLW0mhhAyGEqpt,65,131,4,172,6,90,14,4,421,60.142857142857146,4,0.0,16,4,160,6,115,90,12,14,4,186,235,1
5262,72303,hrPjKcL9rUfM1fnC8qta4lu2HmlsBLv6,RXDvfPUBYFlVdlueBFbLW0mhhAyGEqpt,28,49,13,24,7,0,22,0,115,16.428571428571427,3,0.0,14,13,22,7,35,0,2,22,0,56,59,0
5263,72333,uqA5Smdw6BACOcL0f2tmxwTTxZXBpZpE,bWdj2GDclj5ofokWjzoa5jAwMkxCykd6,7,9,3,0,2,0,4,0,18,2.5714285714285716,3,0.0,0,3,0,2,9,0,0,4,0,5,13,1
5264,72350,axVh7TT3ftc0JLvNMlUvTGTAABKlThNj,A3fsA9Zfv1X2fVEQhTw51lKENdNrEqT3,17,24,4,0,3,0,8,0,39,5.571428571428571,2,0.0,0,4,0,3,24,0,0,8,0,7,32,1
5265,72378,dQa6sgmVY94byuB0fCTjymlGLIKJnAZ4,RXDvfPUBYFlVdlueBFbLW0mhhAyGEqpt,11,10,6,0,5,0,3,0,24,3.4285714285714284,1,0.0,1,6,0,5,9,0,0,3,0,12,12,1
5266,72389,1WzAMExdp2DcGRBAFaFF5ZvQSa9V2NEI,SpATywNh6bZuzm8s1ceuBUnMUAeoAHHw,5,2,1,0,1,0,2,0,6,0.8571428571428571,1,0.0,0,1,0,1,2,0,0,2,0,2,4,1
5267,72390,L6W8jpUrnYiTQTQzsQIQrX6pgKIdMfa4,SpATywNh6bZuzm8s1ceuBUnMUAeoAHHw,13,18,10,4,3,0,7,0,42,6.0,3,0.0,0,10,4,3,18,0,0,7,0,17,25,1
5268,72392,dQQ8UnfzoKHmhQlZOaaW0cB14DhE2hvY,A3fsA9Zfv1X2fVEQhTw51lKENdNrEqT3,41,58,2,68,0,6,10,0,144,20.571428571428573,5,0.0,6,2,59,0,52,6,9,10,0,67,77,0
5269,72428,s8yyjhcg4BVOip4HSP4txOTTHFJ4aWPU,5X6FeZozNMgE2VRi3MJYjkkFK8SETtu2,1,0,0,0,0,0,2,0,2,0.2857142857142857,1,0.0,0,0,0,0,0,0,0,2,0,0,2,1
5270,72455,tAelht5FQdpcbtZQoKgvZA90XQy6zeRb,RXDvfPUBYFlVdlueBFbLW0mhhAyGEqpt,12,17,1,0,1,4,3,4,30,4.285714285714286,2,0.0,3,1,0,1,14,4,0,3,4,5,25,1
5271,72456,IP3TW53lg1ZMqNldZdGWMD6MaLDRhhOf,SpATywNh6bZuzm8s1ceuBUnMUAeoAHHw,16,13,8,15,4,0,4,0,44,6.285714285714286,3,0.0,2,8,14,4,11,0,1,4,0,28,16,1
5272,72476,gpgk1aIkjyvlgo7OYZtMXPlVgE39gvnr,SpATywNh6bZuzm8s1ceuBUnMUAeoAHHw,34,74,34,26,13,4,23,1,175,25.0,7,0.0,23,34,23,13,51,4,3,23,1,93,82,0
5273,72500,yYXy4lOleg47AQUxi7o5Lu77Hx9q6unU,bWdj2GDclj5ofokWjzoa5jAwMkxCykd6,5,3,2,0,1,1,2,0,9,1.2857142857142858,1,0.0,0,2,0,1,3,1,0,2,0,3,6,1
5274,72533,kPw5nR6GIfIGfnUDhfrz9sq3P6l2CmOK,RXDvfPUBYFlVdlueBFbLW0mhhAyGEqpt,21,46,28,16,12,14,11,0,127,18.142857142857142,8,0.0,5,28,14,12,41,14,2,11,0,59,68,1
5275,72536,j8vYdYwa9gvt7hkF8dykZR2D4h75QsII,G8EPVSXsOYB5YQWZGiz1aVq5Pgr2GrQu,9,7,5,0,3,0,4,0,19,2.7142857142857144,1,0.0,0,5,0,3,7,0,0,4,0,8,11,1
5276,72537,jjKgBLfKr1bgWBjonayzbZy5XgTBUiEC,G8EPVSXsOYB5YQWZGiz1aVq5Pgr2GrQu,5,2,1,0,1,0,3,0,7,1.0,1,0.0,0,1,0,1,2,0,0,3,0,2,5,1
5277,72560,9czpFwHJ3FpE9rgLseKKVivLeSQjwoKI,SpATywNh6bZuzm8s1ceuBUnMUAeoAHHw,5,8,3,0,3,0,1,0,15,2.142857142857143,2,0.0,0,3,0,3,8,0,0,1,0,6,9,1
5278,72564,R5b7anZZznZcISIbyICZwboB1D1ac57s,SpATywNh6bZuzm8s1ceuBUnMUAeoAHHw,6,3,1,0,0,0,4,0,8,1.1428571428571428,2,0.0,0,1,0,0,3,0,0,4,0,1,7,1
5279,72572,2QSRX6tWhC0oLYllnKUwIH2KIoHl3tDb,SpATywNh6bZuzm8s1ceuBUnMUAeoAHHw,34,46,0,32,0,1,9,1,89,12.714285714285714,3,0.0,15,0,26,0,31,1,6,9,1,41,48,1
5280,72592,yYXy4lOleg47AQUxi7o5Lu77Hx9q6unU,G8EPVSXsOYB5YQWZGiz1aVq5Pgr2GrQu,1,0,0,0,0,0,1,0,1,0.14285714285714285,1,0.0,0,0,0,0,0,0,0,1,0,0,1,1
5281,72621,RDShgnILA5yAnXM7kXsfq5adI49HPdeC,A3fsA9Zfv1X2fVEQhTw51lKENdNrEqT3,5,4,0,0,0,0,3,0,7,1.0,2,0.0,0,0,0,0,4,0,0,3,0,0,7,1
5282,72649,rPY59o3LLmGBPTPMGcA5vX57KVfmywv5,A3fsA9Zfv1X2fVEQhTw51lKENdNrEqT3,7,8,1,0,0,2,8,1,20,2.857142857142857,2,0.0,0,1,0,0,8,2,0,8,1,1,19,1
5283,72667,9FaPBbsYKn0C9myyRYf9vYNhns2eJDpD,A3fsA9Zfv1X2fVEQhTw51lKENdNrEqT3,16,35,16,0,13,0,6,0,70,10.0,4,0.0,0,16,0,13,35,0,0,6,0,29,41,1
5284,72686,JoqAGqbao71wc04PyVzx7SVvlZZ0knbI,A3fsA9Zfv1X2fVEQhTw51lKENdNrEqT3,51,39,17,116,3,40,13,0,228,32.57142857142857,7,0.0,4,17,115,3,35,40,1,13,0,139,89,0
5285,72758,IU4mzAYv3AON3EBKGRzZhQZqrR0hM5uu,SpATywNh6bZuzm8s1ceuBUnMUAeoAHHw,16,19,11,14,8,22,7,0,81,11.571428571428571,4,0.0,4,11,13,8,15,22,1,7,0,36,45,1
5286,72762,Sn4V2T6RAiQ47UvRCtMkFCdxnmF36LZI,SpATywNh6bZuzm8s1ceuBUnMUAeoAHHw,1,0,0,0,0,0,1,0,1,0.14285714285714285,1,0.0,0,0,0,0,0,0,0,1,0,0,1,1
5287,72765,pHhp9CI7VmM6wgR3zr0LKfyfj9hb4ctX,SpATywNh6bZuzm8s1ceuBUnMUAeoAHHw,5,2,0,0,0,1,4,0,7,1.0,1,0.0,0,0,0,0,2,1,0,4,0,0,7,1
5288,72780,DLQjQ8KI2pm8VfJepKRqQrT7eYq3mD8r,RXDvfPUBYFlVdlueBFbLW0mhhAyGEqpt,30,38,27,0,16,2,10,1,94,13.428571428571429,3,0.0,7,27,0,16,31,2,0,10,1,50,44,0
5289,72812,xgPoMcAyqtOnl7aMAll1Vnr6k8ioz2It,SpATywNh6bZuzm8s1ceuBUnMUAeoAHHw,2,0,0,0,0,0,3,0,3,0.42857142857142855,2,0.0,0,0,0,0,0,0,0,3,0,0,3,1
5290,72815,OvxL2ijquKYfjNqaOR5I9ilNOVFLo0dG,A3fsA9Zfv1X2fVEQhTw51lKENdNrEqT3,2,0,0,0,0,0,4,0,4,0.5714285714285714,1,0.0,0,0,0,0,0,0,0,4,0,0,4,1
5291,72838,JLIulwgtbPcmpwL3Ibb9AniYS6ncpOrp,A3fsA9Zfv1X2fVEQhTw51lKENdNrEqT3,5,0,0,0,0,1,7,0,8,1.1428571428571428,1,0.0,0,0,0,0,0,1,0,7,0,0,8,1
5292,72848,pQdSl7i5ZuZeH9uPILgdHrvwskp4vc4V,bWdj2GDclj5ofokWjzoa5jAwMkxCykd6,8,6,4,0,3,4,4,0,21,3.0,3,0.0,0,4,0,3,6,4,0,4,0,7,14,1
5293,72871,3z37iBp19kh1LYVfVTprpt7Nc7WFUSh9,A3fsA9Zfv1X2fVEQhTw51lKENdNrEqT3,23,21,19,0,2,0,4,0,46,6.571428571428571,2,0.0,0,19,0,2,21,0,0,4,0,21,25,1
5294,72904,BaoTOxDWhvejgHTi1F9XwMHc0M9R5At7,SpATywNh6bZuzm8s1ceuBUnMUAeoAHHw,6,1,1,0,1,0,3,0,6,0.8571428571428571,1,0.0,0,1,0,1,1,0,0,3,0,2,4,1
5295,72935,EOrD3HkA0FfCJhrA6AxTfDE3tsE6V3D0,5X6FeZozNMgE2VRi3MJYjkkFK8SETtu2,5,6,1,0,3,0,3,0,13,1.8571428571428572,1,0.0,4,1,0,3,2,0,0,3,0,8,5,1
5296,72936,oIV4CHUFSVzLmdvea6ZMZ3tpsiIb8a2U,RXDvfPUBYFlVdlueBFbLW0mhhAyGEqpt,23,49,3,16,4,14,11,10,107,15.285714285714286,3,0.0,10,3,14,4,39,14,2,11,10,31,76,0
5297,72944,lv2TJU2QSmR6ZpD7FaidN3ql3NuYRcZ1,A3fsA9Zfv1X2fVEQhTw51lKENdNrEqT3,8,9,1,0,1,0,5,0,16,2.2857142857142856,1,0.0,0,1,0,1,9,0,0,5,0,2,14,1
5298,72948,DEGiuzhB04pwSFBxNndJCumCtMNBwFrd,A3fsA9Zfv1X2fVEQhTw51lKENdNrEqT3,10,8,4,0,3,0,4,0,19,2.7142857142857144,1,0.0,0,4,0,3,8,0,0,4,0,7,12,1
5299,72966,5bg7aQCg1xT3BNwuorGcguCUDl8W5Lwl,SpATywNh6bZuzm8s1ceuBUnMUAeoAHHw,23,47,1,27,0,6,9,1,91,13.0,2,0.0,16,1,21,0,31,6,6,9,1,38,53,0
5300,72979,6BV17cQBS0vMXReFAexYd9wW7Rs6YIDr,RXDvfPUBYFlVdlueBFbLW0mhhAyGEqpt,2,0,0,0,0,0,2,0,2,0.2857142857142857,1,0.0,0,0,0,0,0,0,0,2,0,0,2,1
5301,72993,N8pR87BNJJZF5Ez15Nl4SeXnB2JbgnGF,SpATywNh6bZuzm8s1ceuBUnMUAeoAHHw,3,2,0,0,0,0,1,0,3,0.42857142857142855,1,0.0,0,0,0,0,2,0,0,1,0,0,3,1
5302,73001,NlHO5hXiy7TmVTHiRgExH6y7p9gJG1YF,A3fsA9Zfv1X2fVEQhTw51lKENdNrEqT3,40,32,26,0,22,0,7,1,88,12.571428571428571,4,0.0,0,26,0,22,32,0,0,7,1,48,40,1
5303,73013,Sle0t5zy0VbRjUdpojBY9wV6zuG12LCM,5X6FeZozNMgE2VRi3MJYjkkFK8SETtu2,1,0,0,0,0,0,1,0,1,0.14285714285714285,1,0.0,0,0,0,0,0,0,0,1,0,0,1,1
5304,73019,Sle0t5zy0VbRjUdpojBY9wV6zuG12LCM,RXDvfPUBYFlVdlueBFbLW0mhhAyGEqpt,1,0,0,0,0,0,1,0,1,0.14285714285714285,1,0.0,0,0,0,0,0,0,0,1,0,0,1,1
5305,73039,NlHO5hXiy7TmVTHiRgExH6y7p9gJG1YF,5X6FeZozNMgE2VRi3MJYjkkFK8SETtu2,7,7,4,0,2,0,4,0,17,2.4285714285714284,3,0.0,0,4,0,2,7,0,0,4,0,6,11,1
5306,73050,Hj6wuu6IJzCenxWAs1sLyWNMm32YIpDq,SpATywNh6bZuzm8s1ceuBUnMUAeoAHHw,16,24,12,0,5,0,10,0,51,7.285714285714286,3,0.0,0,12,0,5,24,0,0,10,0,17,34,1
5307,73075,y1PyjNePB0NOk56DVMODQe87hVVXR5yE,5X6FeZozNMgE2VRi3MJYjkkFK8SETtu2,2,0,0,0,0,0,7,0,7,1.0,2,0.0,0,0,0,0,0,0,0,7,0,0,7,1
5308,73078,pQJkPXwRF9VuLrQomaax9ecDhBYo49Wz,bWdj2GDclj5ofokWjzoa5jAwMkxCykd6,1,0,0,0,0,0,1,0,1,0.14285714285714285,1,0.0,0,0,0,0,0,0,0,1,0,0,1,0
5309,73079,Oe7zyPdqUKEu4xpqbiVxJiAwdUxxeOQv,bWdj2GDclj5ofokWjzoa5jAwMkxCykd6,9,12,8,0,5,1,8,2,36,5.142857142857143,3,0.0,1,8,0,5,11,1,0,8,2,14,22,1
5310,73101,AeXY5V6bNirN94d0GfQQQX1fFim1uqSr,SpATywNh6bZuzm8s1ceuBUnMUAeoAHHw,8,20,2,0,0,0,17,0,39,5.571428571428571,8,0.0,2,2,0,0,18,0,0,17,0,4,35,0
5311,73110,TOybu3VTl57Gwz61jxLAAYZF2xYkGB5M,SpATywNh6bZuzm8s1ceuBUnMUAeoAHHw,28,23,16,12,8,7,8,0,74,10.571428571428571,4,0.0,0,16,10,8,23,7,2,8,0,34,40,1
5312,73115,Zx0bFLnVRMy9krgKUk9lItbN7v3mJCyu,SpATywNh6bZuzm8s1ceuBUnMUAeoAHHw,1,0,0,0,0,0,1,0,1,0.14285714285714285,1,0.0,0,0,0,0,0,0,0,1,0,0,1,1
5313,73116,ikZ5e1jXRpMQVOcFqH67Ve7tNtXOJxoc,bWdj2GDclj5ofokWjzoa5jAwMkxCykd6,3,2,1,0,0,0,2,0,5,0.7142857142857143,1,0.0,0,1,0,0,2,0,0,2,0,1,4,1
5314,73126,ikZ5e1jXRpMQVOcFqH67Ve7tNtXOJxoc,SpATywNh6bZuzm8s1ceuBUnMUAeoAHHw,1,0,0,0,0,0,1,0,1,0.14285714285714285,1,0.0,0,0,0,0,0,0,0,1,0,0,1,1
5315,73144,rSEfJyHxNlxmmbC9ORIbqcFKKq08QDrh,bWdj2GDclj5ofokWjzoa5jAwMkxCykd6,13,41,17,40,8,43,13,0,162,23.142857142857142,4,0.0,5,17,39,8,36,43,1,13,0,69,93,0
5316,73147,wbFZf0vBGr8ZagqGAnXAxrCWXPqmHozC,5X6FeZozNMgE2VRi3MJYjkkFK8SETtu2,1,0,0,0,0,0,1,0,1,0.14285714285714285,1,0.0,0,0,0,0,0,0,0,1,0,0,1,1
5317,73159,wZbfkDTJEKLN8i3q2vyR2D63BVy1yfzP,RXDvfPUBYFlVdlueBFbLW0mhhAyGEqpt,1,0,0,0,0,0,1,0,1,0.14285714285714285,1,0.0,0,0,0,0,0,0,0,1,0,0,1,1
5318,73160,bQyVE18uOQgosEkzDxCae8JLEu2KcOfx,bWdj2GDclj5ofokWjzoa5jAwMkxCykd6,16,26,14,26,10,2,5,1,84,12.0,2,0.0,9,14,23,10,17,2,3,5,1,56,28,1
5319,73165,QeAOpQzyLu4fxeYb4rnli0YrGwCr0z5U,RXDvfPUBYFlVdlueBFbLW0mhhAyGEqpt,1,0,0,0,0,0,1,0,1,0.14285714285714285,1,0.0,0,0,0,0,0,0,0,1,0,0,1,1
5320,73170,afdo7sttc7aaNvz9ca7YCfhlkfRUdKCm,A3fsA9Zfv1X2fVEQhTw51lKENdNrEqT3,1,0,0,0,0,0,1,0,1,0.14285714285714285,1,0.0,0,0,0,0,0,0,0,1,0,0,1,1
5321,73190,kbMv7EO3A91wuEPFHCa22AOeSwxNJKSp,5X6FeZozNMgE2VRi3MJYjkkFK8SETtu2,7,13,1,0,1,0,2,0,17,2.4285714285714284,2,0.0,2,1,0,1,11,0,0,2,0,4,13,1
5322,73203,jd8MXn6vqDpoHFl1TCHyXimPI4EsaYkX,3VkHkmOtom3jM2wCu94xgzzu1d6Dn7or,9,7,3,0,1,2,8,3,24,3.4285714285714284,1,0.0,0,3,0,1,7,2,0,8,3,4,20,1
5323,73206,9zMytBTVoe6Tn7dJKaX3NNcggrjEkcTk,3VkHkmOtom3jM2wCu94xgzzu1d6Dn7or,20,22,13,0,13,0,6,0,54,7.714285714285714,3,0.0,2,13,0,13,20,0,0,6,0,28,26,1
5324,73211,9vbi0qVB5xQ2wSMCh1OrppOawp7UFwsK,3VkHkmOtom3jM2wCu94xgzzu1d6Dn7or,12,17,9,0,4,14,19,3,66,9.428571428571429,2,0.0,2,9,0,4,15,14,0,19,3,15,51,1
5325,73227,rq47UXDAYzP0huW4VpeI8U2jckeqLc26,3VkHkmOtom3jM2wCu94xgzzu1d6Dn7or,5,0,0,0,0,6,7,4,17,2.4285714285714284,2,0.0,0,0,0,0,0,6,0,7,4,0,17,1
5326,73230,h8BwrBZ61dHhi5fhxZzTUeeYh9J3sER4,3VkHkmOtom3jM2wCu94xgzzu1d6Dn7or,1,0,0,0,0,0,1,0,1,0.14285714285714285,1,0.0,0,0,0,0,0,0,0,1,0,0,1,0
5327,73232,Z6A9SVqRdCrhqu0rHQmWfwtwx80YGT5M,3VkHkmOtom3jM2wCu94xgzzu1d6Dn7or,1,0,0,0,0,0,1,0,1,0.14285714285714285,1,0.0,0,0,0,0,0,0,0,1,0,0,1,1
5328,73236,dozFnSZsUs00J9MX4ct7e6ZtU5sdV69O,3VkHkmOtom3jM2wCu94xgzzu1d6Dn7or,8,10,3,0,3,0,2,0,18,2.5714285714285716,1,0.0,2,3,0,3,8,0,0,2,0,8,10,1
5329,73238,O7BkYKGPbSCKVITR1KG0UTtUy6cDdabs,3VkHkmOtom3jM2wCu94xgzzu1d6Dn7or,14,23,5,6,12,1,8,0,55,7.857142857142857,2,0.0,18,5,5,12,5,1,1,8,0,40,15,1
5330,73240,r3f7wHZSFd07HF32hSE8PkUZaySPvN4d,3VkHkmOtom3jM2wCu94xgzzu1d6Dn7or,8,7,3,0,3,2,9,1,25,3.5714285714285716,1,0.0,2,3,0,3,5,2,0,9,1,8,17,1
5331,73244,JFezdq3HQwoFzokOD81lnmoMmkvol7xQ,3VkHkmOtom3jM2wCu94xgzzu1d6Dn7or,19,39,1,14,10,13,55,4,136,19.428571428571427,7,0.0,16,1,13,10,23,13,1,55,4,40,96,0
5332,73248,R2cga9JVVM2tXEVs2saYswslfxAU4nMk,3VkHkmOtom3jM2wCu94xgzzu1d6Dn7or,59,82,42,28,34,6,28,0,220,31.428571428571427,9,0.0,31,42,28,34,51,6,0,28,0,135,85,0
5333,73252,m1zn7AvLnmlCJ9brb0HZdSG0FeKaLUqp,3VkHkmOtom3jM2wCu94xgzzu1d6Dn7or,18,47,12,18,11,15,15,0,118,16.857142857142858,1,0.0,22,12,16,11,25,15,2,15,0,61,57,1
5334,73256,pbaqjkvaUNQsMIN40YaHH4YISJL3nrdi,3VkHkmOtom3jM2wCu94xgzzu1d6Dn7or,1,0,0,0,0,0,2,0,2,0.2857142857142857,1,0.0,0,0,0,0,0,0,0,2,0,0,2,1
5335,73261,N5TKMxyWKdkFzZA279Rfen1L0QsEHnKY,3VkHkmOtom3jM2wCu94xgzzu1d6Dn7or,1,0,0,0,0,0,1,0,1,0.14285714285714285,1,0.0,0,0,0,0,0,0,0,1,0,0,1,1
5336,73278,cnKN4D3R34GcHxNlrqbidGHEbLO4eEid,3VkHkmOtom3jM2wCu94xgzzu1d6Dn7or,5,2,1,0,1,0,2,0,6,0.8571428571428571,1,0.0,0,1,0,1,2,0,0,2,0,2,4,1
5337,73281,5SOdJYPnvYxeS4UBSuKkVojxVP4sxLEw,3VkHkmOtom3jM2wCu94xgzzu1d6Dn7or,8,2,1,0,1,0,10,1,15,2.142857142857143,1,0.0,0,1,0,1,2,0,0,10,1,2,13,1
5338,73283,PDFZvgAb72rGPlFZqaletmZsr46HXIyJ,3VkHkmOtom3jM2wCu94xgzzu1d6Dn7or,1,0,0,0,0,0,1,0,1,0.14285714285714285,1,0.0,0,0,0,0,0,0,0,1,0,0,1,1
5339,73295,M8V2y9Z5sWfpduzlKwp3srW2j2nT8uwk,3VkHkmOtom3jM2wCu94xgzzu1d6Dn7or,67,150,31,67,54,17,13,0,332,47.42857142857143,7,0.0,87,31,64,54,63,17,3,13,0,236,96,0
5340,73299,K3jSJcWKnTiEzZJnp0Ou8365M9lH5Ih1,3VkHkmOtom3jM2wCu94xgzzu1d6Dn7or,1,0,0,0,0,0,1,0,1,0.14285714285714285,1,0.0,0,0,0,0,0,0,0,1,0,0,1,1
5341,73302,Cgp6Fjg1TRpzTbhJh6918E6BFXkTGrsR,3VkHkmOtom3jM2wCu94xgzzu1d6Dn7or,64,94,21,71,31,86,21,2,326,46.57142857142857,5,0.0,35,21,66,31,59,86,5,21,2,153,173,0
5342,73308,jIYo67IJxGwYwwBEl2YZhnVAM20w2MgR,3VkHkmOtom3jM2wCu94xgzzu1d6Dn7or,9,5,3,0,3,0,3,0,14,2.0,2,0.0,0,3,0,3,5,0,0,3,0,6,8,1
5343,73310,R1SqdpVYyj7bWmKgOM9V6ZIx9N5AUoG4,3VkHkmOtom3jM2wCu94xgzzu1d6Dn7or,5,2,1,0,1,0,4,0,8,1.1428571428571428,1,0.0,0,1,0,1,2,0,0,4,0,2,6,1
5344,73313,mzy01fDwJBwMUlHWMoXH7OMrYxJe1zvH,3VkHkmOtom3jM2wCu94xgzzu1d6Dn7or,5,11,5,0,2,0,2,0,20,2.857142857142857,1,0.0,0,5,0,2,11,0,0,2,0,7,13,1
5345,73317,nZBEO25QEEdKJsNDjWc27BQlFlOJqVIP,3VkHkmOtom3jM2wCu94xgzzu1d6Dn7or,1,0,0,0,0,0,1,0,1,0.14285714285714285,1,0.0,0,0,0,0,0,0,0,1,0,0,1,1
5346,73318,Ay92zmnnqi5ek8HqbeSzTmVXrof1x39k,3VkHkmOtom3jM2wCu94xgzzu1d6Dn7or,1,0,0,0,0,0,1,0,1,0.14285714285714285,1,0.0,0,0,0,0,0,0,0,1,0,0,1,1
5347,73334,2ENDZhPlfPQ7xqwHjrfLuuWg5Duw7ZBj,3VkHkmOtom3jM2wCu94xgzzu1d6Dn7or,6,12,4,2,3,0,2,0,23,3.2857142857142856,2,0.0,3,4,2,3,9,0,0,2,0,12,11,1
5348,73337,te0V0ywwiaO8UKeN3BcfBiTjsNYrZi3v,3VkHkmOtom3jM2wCu94xgzzu1d6Dn7or,8,4,3,0,3,0,1,0,11,1.5714285714285714,1,0.0,0,3,0,3,4,0,0,1,0,6,5,1
5349,73340,zNnqmF2sQm5pVrk4EjykARlvIbp0hTq0,3VkHkmOtom3jM2wCu94xgzzu1d6Dn7or,9,11,5,5,2,1,4,0,28,4.0,1,0.0,2,5,4,2,9,1,1,4,0,13,15,1
5350,73341,ADMIFDZbPY9hQL0eY7HQGU4BfyaHLhHb,3VkHkmOtom3jM2wCu94xgzzu1d6Dn7or,1,0,0,0,0,0,1,0,1,0.14285714285714285,1,0.0,0,0,0,0,0,0,0,1,0,0,1,1
5351,73345,kO0z920NpjGq3cakMSbDokznFh1eCAnW,3VkHkmOtom3jM2wCu94xgzzu1d6Dn7or,1,0,0,0,0,0,1,0,1,0.14285714285714285,1,0.0,0,0,0,0,0,0,0,1,0,0,1,1
5352,73348,xDyboMn2OhWuXmtjJNkeQw53zYuRLVzY,3VkHkmOtom3jM2wCu94xgzzu1d6Dn7or,10,6,4,0,3,0,8,0,21,3.0,1,0.0,0,4,0,3,6,0,0,8,0,7,14,1
5353,73357,knD21VtknSqFu1mOSObOT0TPlZT8RhxA,3VkHkmOtom3jM2wCu94xgzzu1d6Dn7or,7,4,2,0,1,0,6,0,13,1.8571428571428572,1,0.0,0,2,0,1,4,0,0,6,0,3,10,1
5354,73359,uC9oS0wlvLniEnxIoGOAeAvh5sdHUknJ,3VkHkmOtom3jM2wCu94xgzzu1d6Dn7or,1,0,0,0,0,0,1,0,1,0.14285714285714285,1,0.0,0,0,0,0,0,0,0,1,0,0,1,1
5355,73366,63k2apv6Vp9s0xPXNwa5FAgRK25JC0lA,3VkHkmOtom3jM2wCu94xgzzu1d6Dn7or,18,15,12,0,9,0,2,0,38,5.428571428571429,4,0.0,0,12,0,9,15,0,0,2,0,21,17,1
5356,73369,UN3Q60QibxjdS87vGRCzXIIbFljeUB0v,3VkHkmOtom3jM2wCu94xgzzu1d6Dn7or,1,0,0,0,0,0,1,0,1,0.14285714285714285,1,0.0,0,0,0,0,0,0,0,1,0,0,1,1
5357,73374,986WgoFI0AZSDPIvWwBI8MUZveW4E4Xu,3VkHkmOtom3jM2wCu94xgzzu1d6Dn7or,33,60,22,38,11,18,14,1,164,23.428571428571427,3,0.0,12,22,35,11,48,18,3,14,1,80,84,0
5358,73382,rsiMGvEJZqczqD08x9MQAR0kFgDd2l1B,3VkHkmOtom3jM2wCu94xgzzu1d6Dn7or,1,0,0,0,0,0,1,0,1,0.14285714285714285,1,0.0,0,0,0,0,0,0,0,1,0,0,1,1
5359,73398,0SJa4sq43fjfzXheW19DL0aDJrxMILdx,3VkHkmOtom3jM2wCu94xgzzu1d6Dn7or,64,143,70,30,41,0,23,0,307,43.857142857142854,9,0.0,49,70,29,41,94,0,1,23,0,189,118,0
5360,73404,b5cuBi91panGPWP50qpw7aKYdBMxoKav,3VkHkmOtom3jM2wCu94xgzzu1d6Dn7or,4,2,1,0,0,0,3,0,6,0.8571428571428571,1,0.0,0,1,0,0,2,0,0,3,0,1,5,1
5361,73406,GQSZs8nrUHTGbP9vFHBPJ8hfphwSqg4w,3VkHkmOtom3jM2wCu94xgzzu1d6Dn7or,4,2,1,0,1,0,1,0,5,0.7142857142857143,1,0.0,0,1,0,1,2,0,0,1,0,2,3,1
5362,73417,L5pA3H7m2qYFia4DHW15gmoKoflabQUC,3VkHkmOtom3jM2wCu94xgzzu1d6Dn7or,45,96,43,39,27,0,19,0,224,32.0,5,0.0,24,43,37,27,72,0,2,19,0,131,93,1
5363,73420,pWVshvgu2I0zZvqKEaUa3vMzUz2E4uP3,3VkHkmOtom3jM2wCu94xgzzu1d6Dn7or,1,0,0,0,0,0,1,0,1,0.14285714285714285,1,0.0,0,0,0,0,0,0,0,1,0,0,1,1
5364,73426,9w2MJQeZHeyFkqwhaftUSXLuvPN6lDkw,3VkHkmOtom3jM2wCu94xgzzu1d6Dn7or,1,0,0,0,0,0,1,0,1,0.14285714285714285,1,0.0,0,0,0,0,0,0,0,1,0,0,1,1
5365,73494,oqEIAtGTt4InlQEThHndS9WQldZK5nao,fbPkOYLVPtPgIt0MxizjfFJov3JbHyAi,14,14,6,5,7,0,1,0,33,4.714285714285714,1,0.0,6,6,5,7,8,0,0,1,0,24,9,0
5366,73495,2yHDApK48Bpxk4ycdhvNjswXV9pG17S8,fbPkOYLVPtPgIt0MxizjfFJov3JbHyAi,1,0,0,0,0,0,1,0,1,0.14285714285714285,1,0.0,0,0,0,0,0,0,0,1,0,0,1,1
5367,73496,qAeLkkvoXaT45canBik0DwIUrhYxKAAw,fbPkOYLVPtPgIt0MxizjfFJov3JbHyAi,13,13,9,0,10,0,2,0,34,4.857142857142857,1,0.0,3,9,0,10,10,0,0,2,0,22,12,1
5368,73497,73wvSugERlgXlzZkjMla01pxZjIWCzPw,fbPkOYLVPtPgIt0MxizjfFJov3JbHyAi,1,0,0,0,0,0,1,0,1,0.14285714285714285,1,0.0,0,0,0,0,0,0,0,1,0,0,1,1
5369,73502,UGYGSfRkJhOkgkdlCI6YSCshpNvwBF31,fbPkOYLVPtPgIt0MxizjfFJov3JbHyAi,8,11,8,0,2,0,7,0,28,4.0,2,0.0,0,8,0,2,11,0,0,7,0,10,18,1
5370,73504,50aSuabL02e7lLNBHTRXsMQnBChV2lSX,fbPkOYLVPtPgIt0MxizjfFJov3JbHyAi,8,11,4,0,2,0,6,0,23,3.2857142857142856,3,0.0,0,4,0,2,11,0,0,6,0,6,17,1
5371,73505,bhD9bouqHgaUVRbs8dGQRsEiqOqvpuYM,fbPkOYLVPtPgIt0MxizjfFJov3JbHyAi,1,0,0,0,0,0,1,0,1,0.14285714285714285,1,0.0,0,0,0,0,0,0,0,1,0,0,1,1
5372,73506,Rx3G6WDqhxXAFzDE5dP0dCkALUmrsPnH,fbPkOYLVPtPgIt0MxizjfFJov3JbHyAi,23,32,15,12,15,11,5,0,90,12.857142857142858,1,0.0,11,15,10,15,21,11,2,5,0,51,39,1
5373,73508,YNIWjVVReCMnb4p25EmH6YanIJI1UWGe,fbPkOYLVPtPgIt0MxizjfFJov3JbHyAi,6,5,1,0,1,0,6,0,13,1.8571428571428572,2,0.0,0,1,0,1,5,0,0,6,0,2,11,1
5374,73509,OOIu03NBEHePUSUIFa86FGFP5M136EAn,fbPkOYLVPtPgIt0MxizjfFJov3JbHyAi,3,6,0,0,0,0,1,0,7,1.0,1,0.0,0,0,0,0,6,0,0,1,0,0,7,1
5375,73511,9iX0A4Y0q2thIU9usJFlwmiE8DoNTRvB,fbPkOYLVPtPgIt0MxizjfFJov3JbHyAi,12,9,5,4,3,0,2,0,23,3.2857142857142856,1,0.0,2,5,4,3,7,0,0,2,0,14,9,1
5376,73516,vLjohboP8EuarkC6oMKBUVa7YmHcZWmk,fbPkOYLVPtPgIt0MxizjfFJov3JbHyAi,6,1,1,0,1,0,4,0,7,1.0,1,0.0,0,1,0,1,1,0,0,4,0,2,5,1
5377,73518,mEXms676UX2nEtOWi785T3a9YDRXn6eo,fbPkOYLVPtPgIt0MxizjfFJov3JbHyAi,16,15,9,0,7,3,5,1,40,5.714285714285714,3,0.0,0,9,0,7,15,3,0,5,1,16,24,1
5378,73519,BjBet1XrpmufRo3nJSBrADvKxDiooNdd,fbPkOYLVPtPgIt0MxizjfFJov3JbHyAi,10,10,6,0,3,10,7,1,37,5.285714285714286,2,0.0,1,6,0,3,9,10,0,7,1,10,27,1
5379,73520,XRprdFoWtySQSNhPZow4aE4x8DdY6QhU,fbPkOYLVPtPgIt0MxizjfFJov3JbHyAi,7,3,2,0,2,0,2,0,9,1.2857142857142858,1,0.0,0,2,0,2,3,0,0,2,0,4,5,1
5380,73525,YYAhVs5wmP4F74gdoBHpFlxdJmuG5pXA,fbPkOYLVPtPgIt0MxizjfFJov3JbHyAi,1,0,0,0,0,0,1,0,1,0.14285714285714285,1,0.0,0,0,0,0,0,0,0,1,0,0,1,1
5381,73526,OxEmYoAPQNdxXumQAaCmWKRfombYnFvQ,fbPkOYLVPtPgIt0MxizjfFJov3JbHyAi,5,3,1,0,1,0,2,0,7,1.0,1,0.0,0,1,0,1,3,0,0,2,0,2,5,1
5382,73528,mBIkr9FKQiN1ufY0GShlq8gtUf6KY3Wf,fbPkOYLVPtPgIt0MxizjfFJov3JbHyAi,1,0,0,0,0,0,1,0,1,0.14285714285714285,1,0.0,0,0,0,0,0,0,0,1,0,0,1,1
5383,73529,9OIml0SV4dEAJAFAwgEIKnYzkcxrQvU3,fbPkOYLVPtPgIt0MxizjfFJov3JbHyAi,1,0,0,0,0,0,1,0,1,0.14285714285714285,1,0.0,0,0,0,0,0,0,0,1,0,0,1,1
5384,73536,cAGDrQKi6UBwqQTSWSVc30OIcWrPac5g,fbPkOYLVPtPgIt0MxizjfFJov3JbHyAi,1,0,0,0,0,0,1,0,1,0.14285714285714285,1,0.0,0,0,0,0,0,0,0,1,0,0,1,1
5385,73539,2LWu6JMOYyxkKMq63i00WbtT7iPpdOSr,fbPkOYLVPtPgIt0MxizjfFJov3JbHyAi,10,13,5,6,3,0,8,0,35,5.0,1,0.0,5,5,4,3,8,0,2,8,0,17,18,1
5386,73542,WlsAmr4q7aQixI2ydMQ1hllbYNweh5Yc,fbPkOYLVPtPgIt0MxizjfFJov3JbHyAi,5,4,0,0,0,0,5,0,9,1.2857142857142858,1,0.0,1,0,0,0,3,0,0,5,0,1,8,1
5387,73543,qCHnpaFMgw6f0BW7hG9Qa9zJ3b9yr9G8,fbPkOYLVPtPgIt0MxizjfFJov3JbHyAi,7,1,1,0,1,1,12,4,20,2.857142857142857,2,0.0,0,1,0,1,1,1,0,12,4,2,18,1
5388,73545,Khrg4vJLRO2BLXCnotgKckm2alLmBqlG,fbPkOYLVPtPgIt0MxizjfFJov3JbHyAi,1,0,0,0,0,0,1,0,1,0.14285714285714285,1,0.0,0,0,0,0,0,0,0,1,0,0,1,1
5389,73546,ffYbnIyANDjzLf3ELTXl50wDF2eVsyNm,fbPkOYLVPtPgIt0MxizjfFJov3JbHyAi,8,8,0,0,0,0,5,0,13,1.8571428571428572,3,0.0,0,0,0,0,8,0,0,5,0,0,13,1
5390,73549,zQW97Cs28pPZNFmFrSf1IuV78UQZFOY4,fbPkOYLVPtPgIt0MxizjfFJov3JbHyAi,7,6,2,0,2,0,3,0,13,1.8571428571428572,1,0.0,2,2,0,2,4,0,0,3,0,6,7,1
5391,73550,k5oVYco32vQ3DmUE6ZDHecga51LfmXuY,fbPkOYLVPtPgIt0MxizjfFJov3JbHyAi,5,3,1,0,1,0,2,0,7,1.0,1,0.0,0,1,0,1,3,0,0,2,0,2,5,1
5392,73552,h7q8BDRJv6YwUTxA0nYbUskOJqg41gHy,3VkHkmOtom3jM2wCu94xgzzu1d6Dn7or,1,0,0,0,0,0,1,0,1,0.14285714285714285,1,0.0,0,0,0,0,0,0,0,1,0,0,1,1
5393,73571,AheFqUnyunvQI5u1wgqcNuJg3W7Wljz8,3VkHkmOtom3jM2wCu94xgzzu1d6Dn7or,18,20,10,20,7,14,3,0,74,10.571428571428571,1,0.0,5,10,16,7,15,14,4,3,0,38,36,1
5394,73575,CFUx7WKUxHEsW0H7zKcUairzxQEPJJ9t,3VkHkmOtom3jM2wCu94xgzzu1d6Dn7or,12,9,5,0,6,8,10,1,39,5.571428571428571,1,0.0,3,5,0,6,6,8,0,10,1,14,25,1
5395,73581,v4mnpN1ZzmBWLe7g9zIGsloagGKXr7Sw,3VkHkmOtom3jM2wCu94xgzzu1d6Dn7or,53,99,48,56,32,33,40,9,317,45.285714285714285,10,0.0,26,48,50,32,73,33,6,40,9,156,161,0
5396,73584,nRWRN1VFS4Bx83JlgThpaau0M5l9PhDv,3VkHkmOtom3jM2wCu94xgzzu1d6Dn7or,4,4,1,0,1,0,1,0,7,1.0,1,0.0,0,1,0,1,4,0,0,1,0,2,5,1
5397,73585,U11KhdeSf7Ds7XggaiHnRtu6k7OIQmFC,3VkHkmOtom3jM2wCu94xgzzu1d6Dn7or,5,3,1,0,1,2,2,1,10,1.4285714285714286,1,0.0,0,1,0,1,3,2,0,2,1,2,8,0
5398,73590,Nt3cbsiz8P6NnQBf5AuW9IadrwZqmTm2,3VkHkmOtom3jM2wCu94xgzzu1d6Dn7or,10,19,3,7,9,0,1,0,39,5.571428571428571,1,0.0,15,3,6,9,4,0,1,1,0,33,6,0
5399,73599,fCHWLC8lBZgcpthEq6o0NTnCmXmHDago,3VkHkmOtom3jM2wCu94xgzzu1d6Dn7or,1,0,0,0,0,0,2,0,2,0.2857142857142857,1,0.0,0,0,0,0,0,0,0,2,0,0,2,1
5400,73601,uISGM4LqBUfXPHskRZuSs9XeQkD4VUeT,3VkHkmOtom3jM2wCu94xgzzu1d6Dn7or,8,14,4,0,1,0,5,1,25,3.5714285714285716,1,0.0,0,4,0,1,14,0,0,5,1,5,20,1
5401,73602,5ZyvCd3AP7a8azCiLN5JfLAP53iZpAyD,3VkHkmOtom3jM2wCu94xgzzu1d6Dn7or,1,0,0,0,0,0,1,0,1,0.14285714285714285,1,0.0,0,0,0,0,0,0,0,1,0,0,1,1
5402,73604,eOxm8XEI11Xs6eiBi1Nu5QzIagZXwEm9,3VkHkmOtom3jM2wCu94xgzzu1d6Dn7or,11,10,6,0,4,0,5,0,25,3.5714285714285716,3,0.0,0,6,0,4,10,0,0,5,0,10,15,1
5403,73609,4JVunCIVvMuOsnD3wm7ZujOEI1ZSDCNJ,3VkHkmOtom3jM2wCu94xgzzu1d6Dn7or,1,0,0,0,0,0,1,0,1,0.14285714285714285,1,0.0,0,0,0,0,0,0,0,1,0,0,1,1
5404,73611,6ajy2Xo0RPItlR9bxIFl8dIymIKOcLWj,3VkHkmOtom3jM2wCu94xgzzu1d6Dn7or,10,12,3,5,2,1,6,1,30,4.285714285714286,2,0.0,4,3,5,2,8,1,0,6,1,14,16,0
5405,73612,GMJria24VEYJwthC8X1pUN8GkDnMmvbg,3VkHkmOtom3jM2wCu94xgzzu1d6Dn7or,1,0,0,0,0,0,1,0,1,0.14285714285714285,1,0.0,0,0,0,0,0,0,0,1,0,0,1,1
5406,73617,8dCm5ykoggbuw6B52chvXPMcB3CvbDNd,3VkHkmOtom3jM2wCu94xgzzu1d6Dn7or,1,0,0,0,0,0,1,0,1,0.14285714285714285,1,0.0,0,0,0,0,0,0,0,1,0,0,1,1
5407,73622,KKZGEplHAZHJaar0wTXBKGAPnvAmcV8C,3VkHkmOtom3jM2wCu94xgzzu1d6Dn7or,1,0,0,0,0,0,1,0,1,0.14285714285714285,1,0.0,0,0,0,0,0,0,0,1,0,0,1,1
5408,73623,O7rdwueb8EOnoWTm58cGX7VWoWsu2Ef2,3VkHkmOtom3jM2wCu94xgzzu1d6Dn7or,5,2,1,0,1,0,2,0,6,0.8571428571428571,1,0.0,0,1,0,1,2,0,0,2,0,2,4,1
5409,73630,j8ZdsvT8MT6TX0QqCYipGET178fHxNme,3VkHkmOtom3jM2wCu94xgzzu1d6Dn7or,2,0,0,0,0,0,2,0,2,0.2857142857142857,1,0.0,0,0,0,0,0,0,0,2,0,0,2,1
5410,73631,hZyRWM8r2Wur33dMoFmMYzW3jbY706vJ,3VkHkmOtom3jM2wCu94xgzzu1d6Dn7or,8,16,6,0,7,0,10,1,40,5.714285714285714,2,0.0,7,6,0,7,9,0,0,10,1,20,20,1
5411,73634,vuqFPhnjwQKBPhmOAdfWdPVUnftTeBnB,3VkHkmOtom3jM2wCu94xgzzu1d6Dn7or,5,2,0,0,1,2,3,0,8,1.1428571428571428,2,0.0,0,0,0,1,2,2,0,3,0,1,7,0
5412,73642,lYPmLriKoOtOY3Z7HGFZO5NVsNqoAoKk,3VkHkmOtom3jM2wCu94xgzzu1d6Dn7or,7,8,3,0,3,0,2,0,16,2.2857142857142856,2,0.0,3,3,0,3,5,0,0,2,0,9,7,1
5413,73654,WUAwaEskSQZLXog8ztw0hK4kyOuc1bFw,3VkHkmOtom3jM2wCu94xgzzu1d6Dn7or,5,9,2,0,1,1,3,0,16,2.2857142857142856,2,0.0,4,2,0,1,5,1,0,3,0,7,9,1
5414,73661,aakRkEs35rIopwbwvTlrZnDDdPavpR3N,3VkHkmOtom3jM2wCu94xgzzu1d6Dn7or,68,67,27,50,22,0,5,0,171,24.428571428571427,2,0.0,25,27,49,22,42,0,1,5,0,123,48,0
5415,73662,PQESuxv4e41P5YT6QHXabQPITVM48wey,3VkHkmOtom3jM2wCu94xgzzu1d6Dn7or,13,27,5,6,8,8,12,5,71,10.142857142857142,1,0.0,11,5,5,8,16,8,1,12,5,29,42,1
5416,73663,YOs6ux6EWxgiQyrj54reczfd5GQ0XsKa,3VkHkmOtom3jM2wCu94xgzzu1d6Dn7or,1,0,0,0,0,0,2,0,2,0.2857142857142857,1,0.0,0,0,0,0,0,0,0,2,0,0,2,1
5417,73664,TKhSwLlLUW07V4Zy6fEEB6PQLFKHNLl4,3VkHkmOtom3jM2wCu94xgzzu1d6Dn7or,6,1,1,0,1,0,5,0,8,1.1428571428571428,1,0.0,0,1,0,1,1,0,0,5,0,2,6,1
5418,73666,fJdUKH8czX92V7yfMeG7e087z1xbQDMc,3VkHkmOtom3jM2wCu94xgzzu1d6Dn7or,94,170,64,86,55,12,16,0,403,57.57142857142857,12,0.0,60,64,75,55,110,12,11,16,0,254,149,0
5419,73667,kIHi48IR2QZ9J9hQnL1Ja49z6Z4606Rk,3VkHkmOtom3jM2wCu94xgzzu1d6Dn7or,7,3,2,0,2,0,5,0,12,1.7142857142857142,1,0.0,0,2,0,2,3,0,0,5,0,4,8,1
5420,73671,QC1BA9gfkKnyyyTIN6kJlhn9JDxOqLvx,3VkHkmOtom3jM2wCu94xgzzu1d6Dn7or,17,52,10,25,17,7,7,0,118,16.857142857142858,2,0.0,37,10,25,17,15,7,0,7,0,89,29,1
5421,73674,rsf9v14pDD4ud2Coca160pyP6fjYq3oQ,3VkHkmOtom3jM2wCu94xgzzu1d6Dn7or,21,44,13,11,21,4,11,1,105,15.0,2,0.0,27,13,11,21,17,4,0,11,1,72,33,1
5422,73685,lLrAVEWQ2x5apL4fu1w1v7KTH1d0J6qB,3VkHkmOtom3jM2wCu94xgzzu1d6Dn7or,5,2,1,0,0,0,5,0,8,1.1428571428571428,1,0.0,0,1,0,0,2,0,0,5,0,1,7,1
5423,73687,gDULbPgIPZbnvXYXX6gO0n1O9A1rzVCQ,3VkHkmOtom3jM2wCu94xgzzu1d6Dn7or,6,2,1,0,1,0,4,0,8,1.1428571428571428,1,0.0,0,1,0,1,2,0,0,4,0,2,6,1
5424,73690,muvF5wkfrbWIpy4qvfHaaVq9NJuDH4m3,3VkHkmOtom3jM2wCu94xgzzu1d6Dn7or,1,0,0,0,0,0,1,0,1,0.14285714285714285,1,0.0,0,0,0,0,0,0,0,1,0,0,1,1
5425,73695,3MCx9ifi5b3ADtCHN4ZbVLOjeVGRf8YZ,3VkHkmOtom3jM2wCu94xgzzu1d6Dn7or,11,4,1,0,3,0,5,1,14,2.0,1,0.0,0,1,0,3,4,0,0,5,1,4,10,1
5426,73707,rYvSXMUkS6EklQLnrQ2Wy21uJvBI6Xec,3VkHkmOtom3jM2wCu94xgzzu1d6Dn7or,6,4,2,4,1,1,2,0,14,2.0,1,0.0,1,2,3,1,3,1,1,2,0,7,7,1
5427,73713,S2Jvj0BMWrUdwvYyrlC2Nc5Yv2Vt2kH1,3VkHkmOtom3jM2wCu94xgzzu1d6Dn7or,5,5,1,0,0,0,6,0,12,1.7142857142857142,3,0.0,0,1,0,0,5,0,0,6,0,1,11,1
5428,73715,JxLtKAnMek98G5fWpyeTaKlh0zheuNnU,3VkHkmOtom3jM2wCu94xgzzu1d6Dn7or,14,24,11,6,6,1,4,0,52,7.428571428571429,2,0.0,6,11,5,6,18,1,1,4,0,28,24,1
5429,73716,axnpovA8lCh1wXce3rIHB8faN3xr7hGy,3VkHkmOtom3jM2wCu94xgzzu1d6Dn7or,1,0,0,0,0,0,1,0,1,0.14285714285714285,1,0.0,0,0,0,0,0,0,0,1,0,0,1,1
5430,73723,H3KVva2JTKkPzY4Y9DqQmDABTZNfRCVw,3VkHkmOtom3jM2wCu94xgzzu1d6Dn7or,5,2,1,0,1,2,5,0,11,1.5714285714285714,1,0.0,0,1,0,1,2,2,0,5,0,2,9,1
5431,73725,fKyVxj9gIMpHVAVz3ay8pzjOLuqLzptR,3VkHkmOtom3jM2wCu94xgzzu1d6Dn7or,4,3,1,0,1,1,1,0,7,1.0,1,0.0,1,1,0,1,2,1,0,1,0,3,4,1
5432,73739,y3PPOxRJ4p0YKSweB5X6zh0D55cH80aD,3VkHkmOtom3jM2wCu94xgzzu1d6Dn7or,7,39,6,0,2,0,23,0,70,10.0,3,0.0,4,6,0,2,35,0,0,23,0,12,58,1
5433,73740,gph8VkJd7s0DFKNUtkJpFFmI5CFliEg5,3VkHkmOtom3jM2wCu94xgzzu1d6Dn7or,10,10,3,0,2,1,4,0,20,2.857142857142857,1,0.0,1,3,0,2,9,1,0,4,0,6,14,1
5434,73741,OsiBTMHF52Tb90yx6bNrwujKW9Ty8Vgc,3VkHkmOtom3jM2wCu94xgzzu1d6Dn7or,12,23,10,4,8,10,9,0,64,9.142857142857142,3,0.0,7,10,4,8,16,10,0,9,0,29,35,1
5435,73743,cGVoxMV3C2x2s10xZorcuauBzHRjYcK5,3VkHkmOtom3jM2wCu94xgzzu1d6Dn7or,5,4,0,0,0,0,7,0,11,1.5714285714285714,2,0.0,2,0,0,0,2,0,0,7,0,2,9,1
5436,73752,u7hSziEA8AItNZdMGptoIA8ysXHdaLFj,3VkHkmOtom3jM2wCu94xgzzu1d6Dn7or,15,30,6,1,2,0,8,0,47,6.714285714285714,3,0.0,4,6,1,2,26,0,0,8,0,13,34,1
5437,73766,F3I0tBwAnj15WhwXGuHYoPcDGPAf3HtZ,3VkHkmOtom3jM2wCu94xgzzu1d6Dn7or,23,51,17,4,11,3,8,0,94,13.428571428571429,6,0.0,6,17,3,11,45,3,1,8,0,37,57,1
5438,73777,MFwpmZbEHI9Y2cwhDbAPo04ZaiioDaCz,3VkHkmOtom3jM2wCu94xgzzu1d6Dn7or,4,2,0,0,0,0,2,0,4,0.5714285714285714,1,0.0,0,0,0,0,2,0,0,2,0,0,4,1
5439,73780,UUChwaVAZ1oKveTt0Vj8xyjjfyHU0i0A,3VkHkmOtom3jM2wCu94xgzzu1d6Dn7or,1,0,0,0,0,0,1,0,1,0.14285714285714285,1,0.0,0,0,0,0,0,0,0,1,0,0,1,1
5440,73784,1Q1RccUywWVMfWnesxO4lgaUR4eFFO72,3VkHkmOtom3jM2wCu94xgzzu1d6Dn7or,41,150,8,28,10,7,21,1,225,32.142857142857146,6,0.0,55,8,26,10,95,7,2,21,1,99,126,0
5441,73785,xCkK7k1NUxNOOD7sYQMaMHcf5E0nRUdO,3VkHkmOtom3jM2wCu94xgzzu1d6Dn7or,5,7,3,0,1,0,3,0,14,2.0,1,0.0,0,3,0,1,7,0,0,3,0,4,10,1
5442,73904,TMzaU5DW9rklHO5S86JO0t475aLHlncW,SpATywNh6bZuzm8s1ceuBUnMUAeoAHHw,36,56,25,33,15,0,11,1,141,20.142857142857142,5,0.0,27,25,30,15,29,0,3,11,1,97,44,1
5443,73905,4Y6ySID5iQf80xGHEGKPq13tPSHHOAOF,SpATywNh6bZuzm8s1ceuBUnMUAeoAHHw,15,36,12,17,5,0,1,0,71,10.142857142857142,1,0.0,16,12,15,5,20,0,2,1,0,48,23,1
5444,73906,oXeIIZJhS8XqLTW0ryKumqV3ZtrZlFuh,7GRhBDsirIGkRZBtSMEzNTyDr2JQm4xx,42,71,18,55,20,3,14,0,181,25.857142857142858,4,0.0,27,18,47,20,44,3,8,14,0,112,69,1
5445,73908,4sCPuVlkq4rBRlBYNyTR5EDg94co1oy4,7GRhBDsirIGkRZBtSMEzNTyDr2JQm4xx,28,49,18,34,12,0,4,0,117,16.714285714285715,3,0.0,27,18,28,12,22,0,6,4,0,85,32,1
5446,73915,CPXJLPoqpAOiv8Mv4U7wyesIpIX2ZEAc,SpATywNh6bZuzm8s1ceuBUnMUAeoAHHw,1,0,0,0,0,0,1,0,1,0.14285714285714285,1,0.0,0,0,0,0,0,0,0,1,0,0,1,1
5447,73928,VBP5PzVQEKJYFH0y5ffEek5WfP9EW7uc,7GRhBDsirIGkRZBtSMEzNTyDr2JQm4xx,17,16,10,10,8,0,4,0,48,6.857142857142857,2,0.0,3,10,9,8,13,0,1,4,0,30,18,1
5448,73935,ZjAnj7LejyrDjdytaW8xiEftNjkACZgi,7GRhBDsirIGkRZBtSMEzNTyDr2JQm4xx,31,48,22,43,16,0,10,2,141,20.142857142857142,2,0.0,19,22,40,16,29,0,3,10,2,97,44,1
5449,73953,7VDn6ntyPpx1GsPLNVgZQF03WDWTuKJo,bWdj2GDclj5ofokWjzoa5jAwMkxCykd6,45,107,65,140,15,24,30,0,381,54.42857142857143,8,0.0,13,65,118,15,94,24,22,30,0,211,170,0
5450,73956,ks4Bg3QCnzBSrFPW18QfINyVAhl01iQP,7GRhBDsirIGkRZBtSMEzNTyDr2JQm4xx,1,0,0,0,0,0,1,0,1,0.14285714285714285,1,0.0,0,0,0,0,0,0,0,1,0,0,1,1
5451,73957,q5R81Yw8uRP3FrwNvV49L9qc5ag0j7J9,5X6FeZozNMgE2VRi3MJYjkkFK8SETtu2,4,3,1,0,0,0,3,0,7,1.0,2,0.0,0,1,0,0,3,0,0,3,0,1,6,1
5452,73959,UNKWHkTsZ3RudPGKkhB4ao4XLNWXegZ9,7GRhBDsirIGkRZBtSMEzNTyDr2JQm4xx,30,60,2,84,10,7,10,1,174,24.857142857142858,4,0.0,36,2,72,10,24,7,12,10,1,120,54,1
5453,73967,31aB1n1dsQQ1ksrWlX8ZehnLm4yKoPC4,7GRhBDsirIGkRZBtSMEzNTyDr2JQm4xx,1,0,0,0,0,0,2,0,2,0.2857142857142857,2,0.0,0,0,0,0,0,0,0,2,0,0,2,1
5454,73968,fwlGH5gehdOA0f9hZd0xb19Diqa5Heyh,7GRhBDsirIGkRZBtSMEzNTyDr2JQm4xx,4,2,1,0,0,0,3,0,6,0.8571428571428571,1,0.0,0,1,0,0,2,0,0,3,0,1,5,1
5455,73980,4sSRGcSDSLzxYWcglxw7d9PzYXxgOT88,7GRhBDsirIGkRZBtSMEzNTyDr2JQm4xx,5,4,1,0,0,1,2,0,8,1.1428571428571428,2,0.0,0,1,0,0,4,1,0,2,0,1,7,1
5456,73985,58MUEzrczRikT4gXBjyXknuMU1aGIyQK,7GRhBDsirIGkRZBtSMEzNTyDr2JQm4xx,1,0,0,0,0,0,1,0,1,0.14285714285714285,1,0.0,0,0,0,0,0,0,0,1,0,0,1,1
5457,73991,XnmbufyRkGbBNj2S65IEmwgm9FwmHwEd,SpATywNh6bZuzm8s1ceuBUnMUAeoAHHw,8,4,4,0,4,4,8,1,25,3.5714285714285716,1,0.0,0,4,0,4,4,4,0,8,1,8,17,1
5458,73997,LsKfrBRYdD4gggczcaha9PBojfMCU4hy,SpATywNh6bZuzm8s1ceuBUnMUAeoAHHw,16,21,16,9,10,0,8,0,64,9.142857142857142,2,0.0,0,16,7,10,21,0,2,8,0,33,31,1
5459,73998,ej4gQoO7wYuk4hf1qDoakX8UCNofUE33,SpATywNh6bZuzm8s1ceuBUnMUAeoAHHw,6,5,3,0,0,0,5,0,13,1.8571428571428572,2,0.0,0,3,0,0,5,0,0,5,0,3,10,1
5460,74021,EPmLjBxeWpwhjwoRgtmLV8RkhFOu2zzj,A3fsA9Zfv1X2fVEQhTw51lKENdNrEqT3,11,5,4,0,3,0,5,0,17,2.4285714285714284,2,0.0,0,4,0,3,5,0,0,5,0,7,10,1
5461,74035,79Eh0WdhadJNiwxQWsLXR8INp63Y21nq,7GRhBDsirIGkRZBtSMEzNTyDr2JQm4xx,9,19,5,6,3,2,7,0,42,6.0,1,0.0,7,5,5,3,12,2,1,7,0,20,22,1
5462,74048,vQAS0obh0bWlfi2VaK7gKWVKUzPkWalY,A3fsA9Zfv1X2fVEQhTw51lKENdNrEqT3,2,0,0,0,0,0,2,0,2,0.2857142857142857,1,0.0,0,0,0,0,0,0,0,2,0,0,2,1
5463,74053,SjOzZscJIO4ulmLmX1Ejwn4Qjdb7qmSK,SpATywNh6bZuzm8s1ceuBUnMUAeoAHHw,7,5,1,0,1,0,2,0,9,1.2857142857142858,1,0.0,0,1,0,1,5,0,0,2,0,2,7,1
5464,74062,1cBYtB7KOC3ODHrTHPWmdxuvdPQZ4YhT,SpATywNh6bZuzm8s1ceuBUnMUAeoAHHw,12,19,15,3,5,0,4,0,46,6.571428571428571,3,0.0,0,15,3,5,19,0,0,4,0,23,23,0
5465,74067,ve7Ft3pn5zWGBanwhSnSQvIFg9ZaO7O3,7GRhBDsirIGkRZBtSMEzNTyDr2JQm4xx,1,0,0,0,0,0,1,0,1,0.14285714285714285,1,0.0,0,0,0,0,0,0,0,1,0,0,1,1
5466,74092,fs1l75tl2rJ0qd1qJKuhVRR2VwK6Slkd,SpATywNh6bZuzm8s1ceuBUnMUAeoAHHw,1,0,0,0,0,0,1,0,1,0.14285714285714285,1,0.0,0,0,0,0,0,0,0,1,0,0,1,1
5467,74101,Uvr135kFC9KlMOM943bFXvTUT71uSm4O,G8EPVSXsOYB5YQWZGiz1aVq5Pgr2GrQu,18,32,18,8,12,2,13,1,86,12.285714285714286,2,0.0,7,18,6,12,25,2,2,13,1,43,43,0
5468,74104,7TkkuA0EEQqi6jLSaHSvDaS7U5kNSv36,SpATywNh6bZuzm8s1ceuBUnMUAeoAHHw,44,105,45,53,13,21,34,6,277,39.57142857142857,7,0.0,22,45,46,13,83,21,7,34,6,126,151,0
5469,74107,0oxo9rZM5dGgpN8rq6aFGU3IpbIKGlK0,7GRhBDsirIGkRZBtSMEzNTyDr2JQm4xx,7,6,4,0,2,0,2,0,14,2.0,1,0.0,0,4,0,2,6,0,0,2,0,6,8,1
5470,74125,FxNNtpAKePULpDZjsrs8zCvX1MSFauHF,7GRhBDsirIGkRZBtSMEzNTyDr2JQm4xx,29,32,11,45,13,1,2,0,104,14.857142857142858,1,0.0,20,11,42,13,12,1,3,2,0,86,18,1
5471,74135,LFLcxwCrNiuinAjspGRRRup0s9DizBlW,G8EPVSXsOYB5YQWZGiz1aVq5Pgr2GrQu,7,3,2,0,2,0,4,0,11,1.5714285714285714,2,0.0,0,2,0,2,3,0,0,4,0,4,7,1
5472,74139,gVHbwM9IOrk1olFEuw0FAfVujUgJm8AG,7GRhBDsirIGkRZBtSMEzNTyDr2JQm4xx,37,101,27,62,14,14,21,2,241,34.42857142857143,4,0.0,67,27,56,14,34,14,6,21,2,164,77,0
5473,74145,AYn8itqWLXLy37nOctHXi3n4YvQOz54J,bWdj2GDclj5ofokWjzoa5jAwMkxCykd6,3,0,0,0,0,9,3,1,13,1.8571428571428572,2,0.0,0,0,0,0,0,9,0,3,1,0,13,1
5474,74149,mWao7cvXlyZJViXXeBzOOV4p4AC8rvCX,7GRhBDsirIGkRZBtSMEzNTyDr2JQm4xx,35,53,19,38,20,1,18,1,150,21.428571428571427,2,0.0,33,19,32,20,20,1,6,18,1,104,46,1
5475,74150,HjIrUt1Ax8b3fBkdKQupL2gDMbKYgLrZ,RXDvfPUBYFlVdlueBFbLW0mhhAyGEqpt,22,15,11,38,6,2,4,1,77,11.0,1,0.0,2,11,31,6,13,2,7,4,1,50,27,1
5476,74167,qEQGNCv0DTznAP1gMwDRVGTAjB8ymoH3,7GRhBDsirIGkRZBtSMEzNTyDr2JQm4xx,1,0,0,0,0,0,1,0,1,0.14285714285714285,1,0.0,0,0,0,0,0,0,0,1,0,0,1,1
5477,74178,74Dywe4dn2al60hXONYhqNpcRQDf18AP,A3fsA9Zfv1X2fVEQhTw51lKENdNrEqT3,2,0,0,0,0,0,2,0,2,0.2857142857142857,1,0.0,0,0,0,0,0,0,0,2,0,0,2,1
5478,74180,EUS0PtlDQBOBMfXoJzMCULHFCBIf0VV4,SpATywNh6bZuzm8s1ceuBUnMUAeoAHHw,5,2,1,0,1,0,2,0,6,0.8571428571428571,1,0.0,0,1,0,1,2,0,0,2,0,2,4,1
5479,74189,jjXwu6JpFQ9AzYn6ZMlMU16MF4VF7IC7,SpATywNh6bZuzm8s1ceuBUnMUAeoAHHw,4,3,2,0,0,0,1,0,6,0.8571428571428571,1,0.0,0,2,0,0,3,0,0,1,0,2,4,1
5480,74213,Hzo5Ctg10ZQey5IjMeCvl0CH7lPNTM5X,7GRhBDsirIGkRZBtSMEzNTyDr2JQm4xx,2,0,0,0,0,0,4,0,4,0.5714285714285714,2,0.0,0,0,0,0,0,0,0,4,0,0,4,1
5481,74218,Hzo5Ctg10ZQey5IjMeCvl0CH7lPNTM5X,bWdj2GDclj5ofokWjzoa5jAwMkxCykd6,2,0,0,0,0,0,2,0,2,0.2857142857142857,1,0.0,0,0,0,0,0,0,0,2,0,0,2,1
5482,74222,FsDHYzf7kXddjaitMOVxbo2SbZ3MpAze,A3fsA9Zfv1X2fVEQhTw51lKENdNrEqT3,7,3,2,0,2,0,6,0,13,1.8571428571428572,1,0.0,0,2,0,2,3,0,0,6,0,4,9,1
5483,74244,ipQCHpy6wiUwlX5KYwBvpzBdqgm7xLba,7GRhBDsirIGkRZBtSMEzNTyDr2JQm4xx,5,2,1,0,1,0,2,0,6,0.8571428571428571,1,0.0,0,1,0,1,2,0,0,2,0,2,4,1
5484,74249,7n0QZ7z1Xa9itNmJQbQwoSvEI6n7oD9f,SpATywNh6bZuzm8s1ceuBUnMUAeoAHHw,8,3,2,0,2,0,3,0,10,1.4285714285714286,1,0.0,0,2,0,2,3,0,0,3,0,4,6,0
5485,74299,GUEWTq9dWLLDLVWGGRMdJ9TNmItGCjS4,5X6FeZozNMgE2VRi3MJYjkkFK8SETtu2,80,254,78,154,78,45,23,0,632,90.28571428571429,6,0.0,125,78,127,78,129,45,27,23,0,408,224,1
5486,74300,MgS6WK9esRya9QyP2ZOjbNdLSIL7NuM9,SpATywNh6bZuzm8s1ceuBUnMUAeoAHHw,26,59,26,43,3,0,12,0,143,20.428571428571427,5,0.0,21,26,35,3,38,0,8,12,0,85,58,0
5487,74301,WCAIb19YcAzAlp07XtATiiwpdzMqbAbp,7GRhBDsirIGkRZBtSMEzNTyDr2JQm4xx,46,52,24,79,11,0,4,0,170,24.285714285714285,3,0.0,25,24,71,11,27,0,8,4,0,131,39,0
5488,74306,h5KJmuIyQGH66BE7hBmcyhhaiLqOmsLZ,G8EPVSXsOYB5YQWZGiz1aVq5Pgr2GrQu,24,38,5,24,5,0,8,0,80,11.428571428571429,3,0.0,5,5,21,5,33,0,3,8,0,36,44,0
5489,74308,cynSK4pVMg8QkEFbKcs3bJdr6KIkWo0k,bWdj2GDclj5ofokWjzoa5jAwMkxCykd6,5,2,1,0,1,0,2,0,6,0.8571428571428571,1,0.0,0,1,0,1,2,0,0,2,0,2,4,1
5490,74326,TueMDIMX3gvaGFBwrGkCX4Me136y3V2Q,G8EPVSXsOYB5YQWZGiz1aVq5Pgr2GrQu,11,13,9,0,1,0,5,0,28,4.0,2,0.0,0,9,0,1,13,0,0,5,0,10,18,1
5491,74334,ovvuiEhj0QBv4xi11GVjXr8JhlCgaPmd,SpATywNh6bZuzm8s1ceuBUnMUAeoAHHw,36,54,29,33,19,5,29,0,169,24.142857142857142,5,0.0,13,29,29,19,41,5,4,29,0,90,79,0
5492,74386,QlvFciinGDGt7csjDmjYPPZqFlKAzfUP,SpATywNh6bZuzm8s1ceuBUnMUAeoAHHw,41,81,25,57,12,2,11,1,189,27.0,4,0.0,33,25,46,12,48,2,11,11,1,116,73,0
5493,74408,Ra9AxcPuu5j5vTOkoJFrcEzyHUcLxhn0,7GRhBDsirIGkRZBtSMEzNTyDr2JQm4xx,6,2,1,0,1,0,4,0,8,1.1428571428571428,1,0.0,0,1,0,1,2,0,0,4,0,2,6,1
5494,74422,wQR8RZQNRkM3a3DVwBNXhaadMjbVENc0,bWdj2GDclj5ofokWjzoa5jAwMkxCykd6,1,0,0,0,0,0,1,0,1,0.14285714285714285,1,0.0,0,0,0,0,0,0,0,1,0,0,1,0
5495,74437,Anr82PPgHyVjFu2RaZRNpr3IKYwAUnAW,bWdj2GDclj5ofokWjzoa5jAwMkxCykd6,1,0,0,0,0,0,1,0,1,0.14285714285714285,1,0.0,0,0,0,0,0,0,0,1,0,0,1,1
5496,74468,rgJ7j684KtaDcmKD94RFdpwPnoKFUmIV,7GRhBDsirIGkRZBtSMEzNTyDr2JQm4xx,22,23,16,30,9,9,4,0,91,13.0,3,0.0,2,16,26,9,21,9,4,4,0,53,38,1
5497,74473,GVRJN4wkoooaXJUVmwnX983A87KsrZPK,7GRhBDsirIGkRZBtSMEzNTyDr2JQm4xx,4,2,1,0,1,0,1,0,5,0.7142857142857143,1,0.0,0,1,0,1,2,0,0,1,0,2,3,1
5498,74499,lmeMhWa8hXVoeC6vmJbPTxkNCUltvvzl,A3fsA9Zfv1X2fVEQhTw51lKENdNrEqT3,35,9,7,64,4,1,7,1,93,13.285714285714286,1,0.0,1,7,55,4,8,1,9,7,1,67,26,1
5499,74507,pjJJuxaXEuw09zVn6xAhWQF9JKw7sgKR,5X6FeZozNMgE2VRi3MJYjkkFK8SETtu2,2,0,0,0,0,0,2,0,2,0.2857142857142857,1,0.0,0,0,0,0,0,0,0,2,0,0,2,1
5500,74509,QfBD8mMClwgY0rD8w1rSnRjdXKLH7oSP,7GRhBDsirIGkRZBtSMEzNTyDr2JQm4xx,2,0,0,0,0,0,3,0,3,0.42857142857142855,1,0.0,0,0,0,0,0,0,0,3,0,0,3,1
5501,74518,xhevg6JjK2rrYOm315OyMAnP1ijNPsHG,SpATywNh6bZuzm8s1ceuBUnMUAeoAHHw,1,0,0,0,0,0,1,0,1,0.14285714285714285,1,0.0,0,0,0,0,0,0,0,1,0,0,1,1
5502,74519,XgD1QVsWWGLho1UFxzA4qhUNghhl4Er9,RXDvfPUBYFlVdlueBFbLW0mhhAyGEqpt,6,4,1,0,1,0,2,0,8,1.1428571428571428,1,0.0,0,1,0,1,4,0,0,2,0,2,6,1
5503,74529,YfLkHn3sP8pusiYlKK6o5F2jXKBNkL8d,SpATywNh6bZuzm8s1ceuBUnMUAeoAHHw,46,120,52,24,21,16,36,3,272,38.857142857142854,17,0.0,19,52,24,21,101,16,0,36,3,116,156,0
5504,74535,VSis3GPLe3g5PXWWtZzI0G79Q5DGCKD1,SpATywNh6bZuzm8s1ceuBUnMUAeoAHHw,1,0,0,0,0,0,1,0,1,0.14285714285714285,1,0.0,0,0,0,0,0,0,0,1,0,0,1,0
5505,74555,Q8RGPBI5Ez4dcsYeaCg7LkbJmto9C3oj,SpATywNh6bZuzm8s1ceuBUnMUAeoAHHw,27,44,23,47,9,15,36,7,181,25.857142857142858,5,0.0,17,23,41,9,27,15,6,36,7,90,91,0
5506,74573,OK8QGV0tYeSvHoJprBbFr837PnoinpOg,5X6FeZozNMgE2VRi3MJYjkkFK8SETtu2,1,0,0,0,0,0,1,0,1,0.14285714285714285,1,0.0,0,0,0,0,0,0,0,1,0,0,1,1
5507,74581,GUEWTq9dWLLDLVWGGRMdJ9TNmItGCjS4,SpATywNh6bZuzm8s1ceuBUnMUAeoAHHw,1,0,0,0,0,0,1,0,1,0.14285714285714285,1,0.0,0,0,0,0,0,0,0,1,0,0,1,1
5508,74582,RwE9FiLrBLNeexkGLu7IRwAZMt3TO12Z,bWdj2GDclj5ofokWjzoa5jAwMkxCykd6,5,2,0,0,0,0,3,1,6,0.8571428571428571,1,0.0,0,0,0,0,2,0,0,3,1,0,6,1
5509,74583,Srs2zxwdsKPZud9M0i8SAhTaQwEf4X4V,5X6FeZozNMgE2VRi3MJYjkkFK8SETtu2,8,7,2,0,2,9,7,0,27,3.857142857142857,2,0.0,1,2,0,2,6,9,0,7,0,5,22,1
5510,74589,BXD72vLG7gPEbE6jX5yHvh6FjDG3GoKK,SpATywNh6bZuzm8s1ceuBUnMUAeoAHHw,6,5,2,0,1,0,2,0,10,1.4285714285714286,1,0.0,0,2,0,1,5,0,0,2,0,3,7,1
5511,74608,U3R4m4eLMm2lirgI7HLueBKsNpxhFpn9,7GRhBDsirIGkRZBtSMEzNTyDr2JQm4xx,106,113,60,117,18,0,13,0,321,45.857142857142854,6,0.0,43,60,117,18,70,0,0,13,0,238,83,1
5512,74611,oulkc1tf0Kd1NPyUx3LDpZLt1fzzxHYa,SpATywNh6bZuzm8s1ceuBUnMUAeoAHHw,6,10,0,0,0,0,3,0,13,1.8571428571428572,2,0.0,0,0,0,0,10,0,0,3,0,0,13,1
5513,74618,RtmYmukzSU8h3Uq6suOYxJKRcISOQfvL,RXDvfPUBYFlVdlueBFbLW0mhhAyGEqpt,64,51,36,94,21,1,12,0,215,30.714285714285715,7,0.0,8,36,90,21,43,1,4,12,0,155,60,0
5514,74622,zPAVoNOooAkEz0VkTeYjPUYyBUMYQvD0,A3fsA9Zfv1X2fVEQhTw51lKENdNrEqT3,10,14,2,0,3,0,11,0,30,4.285714285714286,2,0.0,1,2,0,3,13,0,0,11,0,6,24,1
5515,74635,3Mo4KKxt5XsXFl1wmKukaZclKwhABriO,bWdj2GDclj5ofokWjzoa5jAwMkxCykd6,1,0,0,0,0,0,1,0,1,0.14285714285714285,1,0.0,0,0,0,0,0,0,0,1,0,0,1,1
5516,74643,2VA4csxIMQCx8OPT1JNIuyOwjieGR5SH,A3fsA9Zfv1X2fVEQhTw51lKENdNrEqT3,4,3,0,0,0,0,4,0,7,1.0,1,0.0,0,0,0,0,3,0,0,4,0,0,7,1
5517,74653,HL0jm7zWkHTTtUFklIJxsfljBDgcIEre,SpATywNh6bZuzm8s1ceuBUnMUAeoAHHw,22,66,5,51,1,8,11,0,142,20.285714285714285,6,0.0,22,5,45,1,44,8,6,11,0,73,69,1
5518,74658,xFE5tfvhHqpc8q4ByUwGnIzhZrTnJEgg,SpATywNh6bZuzm8s1ceuBUnMUAeoAHHw,1,0,0,0,0,0,1,0,1,0.14285714285714285,1,0.0,0,0,0,0,0,0,0,1,0,0,1,1
5519,74668,QNugDWVi5qk9oRx0FjSG4WF2CyPqMBfw,bWdj2GDclj5ofokWjzoa5jAwMkxCykd6,7,8,3,0,1,4,5,0,21,3.0,1,0.0,2,3,0,1,6,4,0,5,0,6,15,1
5520,74669,QYUKXD6RJtSdizcdlNjQSBFOXbEQl1FA,SpATywNh6bZuzm8s1ceuBUnMUAeoAHHw,9,13,6,0,0,13,8,0,40,5.714285714285714,3,0.0,0,6,0,0,13,13,0,8,0,6,34,1
5521,74670,YviwWEN6zon2XUnzizUs5e4hMfvZTKyo,SpATywNh6bZuzm8s1ceuBUnMUAeoAHHw,8,6,1,8,1,0,1,0,17,2.4285714285714284,1,0.0,0,1,6,1,6,0,2,1,0,8,9,1
5522,74703,vSL0kRsKOWBMpC6pqEAxri0eLNug5E20,RXDvfPUBYFlVdlueBFbLW0mhhAyGEqpt,52,90,13,65,5,9,20,0,202,28.857142857142858,6,0.0,12,13,63,5,78,9,2,20,0,93,109,0
5523,74706,zT1WyWGnYCfKfATU7zQU9FVr4gxBMiyV,SpATywNh6bZuzm8s1ceuBUnMUAeoAHHw,15,19,6,10,3,0,3,0,41,5.857142857142857,2,0.0,10,6,8,3,9,0,2,3,0,27,14,0
5524,74717,tBy7E7qZZZ98Oih5sTNUdDZRIpZZM98z,SpATywNh6bZuzm8s1ceuBUnMUAeoAHHw,23,58,17,49,0,14,14,0,152,21.714285714285715,8,0.0,27,17,40,0,31,14,9,14,0,84,68,0
5525,74726,PIxnueIZLpBbMAAHbhlsEVGPkWRYGpMI,A3fsA9Zfv1X2fVEQhTw51lKENdNrEqT3,16,14,2,0,2,0,2,0,20,2.857142857142857,1,0.0,0,2,0,2,14,0,0,2,0,4,16,1
5526,74729,Y0Kg8VlywQM3MgkPLCaUvRZWlzcWLHyc,SpATywNh6bZuzm8s1ceuBUnMUAeoAHHw,1,0,0,0,0,0,1,0,1,0.14285714285714285,1,0.0,0,0,0,0,0,0,0,1,0,0,1,1
5527,74733,nd2ZHSI1Tvo1sLaItC7AKiAwHujqev1a,SpATywNh6bZuzm8s1ceuBUnMUAeoAHHw,18,17,1,2,1,0,5,0,26,3.7142857142857144,2,0.0,0,1,2,1,17,0,0,5,0,4,22,1
5528,74736,sgWvC8NRvYtrmKjALzTvn9SNvnbzDMjJ,SpATywNh6bZuzm8s1ceuBUnMUAeoAHHw,16,27,12,14,5,0,3,0,61,8.714285714285714,2,0.0,2,12,14,5,25,0,0,3,0,33,28,1
5529,74748,usRZSdDsUQfZaciTJTskV4NLSeP1lHRl,bWdj2GDclj5ofokWjzoa5jAwMkxCykd6,1,0,0,0,0,0,1,0,1,0.14285714285714285,1,0.0,0,0,0,0,0,0,0,1,0,0,1,1
5530,74751,KLtOKXGj6O1GoIRtB8vhhhK5KJkUm486,bWdj2GDclj5ofokWjzoa5jAwMkxCykd6,7,6,4,0,3,0,4,0,17,2.4285714285714284,1,0.0,0,4,0,3,6,0,0,4,0,7,10,0
5531,74755,MLEFHCMFllWu55FD5Lk76TFNbtPRpP0W,7GRhBDsirIGkRZBtSMEzNTyDr2JQm4xx,21,27,2,16,1,0,12,2,60,8.571428571428571,1,0.0,8,2,13,1,19,0,3,12,2,24,36,0
5532,74792,DSoedfH3iEqkDSoEfnR9hPK9fGA03nvE,A3fsA9Zfv1X2fVEQhTw51lKENdNrEqT3,52,21,16,114,10,8,7,0,176,25.142857142857142,3,0.0,1,16,94,10,20,8,20,7,0,121,55,1
5533,74801,L0e1YP7bRzjNsIzxzTyXlM0Ldh6xltNG,SpATywNh6bZuzm8s1ceuBUnMUAeoAHHw,47,82,32,56,15,2,9,1,197,28.142857142857142,2,0.0,13,32,50,15,69,2,6,9,1,110,87,0
5534,74804,W5ldkM4f1g9HIanLGU1MLQs0qq4p7MDp,SpATywNh6bZuzm8s1ceuBUnMUAeoAHHw,7,4,3,0,3,0,2,0,12,1.7142857142857142,1,0.0,0,3,0,3,4,0,0,2,0,6,6,1
5535,74809,0UD2r7gmc85Ip6GdTUss7ocdGASnZDTz,7GRhBDsirIGkRZBtSMEzNTyDr2JQm4xx,14,15,8,8,6,0,7,0,44,6.285714285714286,2,0.0,2,8,6,6,13,0,2,7,0,22,22,1
5536,74818,knxAJpSFDgjN8jBmnCV7BB7s4fbgoTt1,7GRhBDsirIGkRZBtSMEzNTyDr2JQm4xx,7,3,2,4,0,1,6,0,16,2.2857142857142856,2,0.0,1,2,3,0,2,1,1,6,0,6,10,1
5537,74830,j4PVQUrpIpKorlkT4iYTyeVfeRGmPqGp,SpATywNh6bZuzm8s1ceuBUnMUAeoAHHw,5,2,1,0,1,0,2,0,6,0.8571428571428571,1,0.0,0,1,0,1,2,0,0,2,0,2,4,1
5538,74836,lFMbkCaY0FKfyGbh1VOL30jTZ1USVgB2,G8EPVSXsOYB5YQWZGiz1aVq5Pgr2GrQu,2,2,0,0,0,0,2,0,4,0.5714285714285714,2,0.0,0,0,0,0,2,0,0,2,0,0,4,1
5539,74838,Sje8JOaJAnSqtfzZ1Y40tJOmrRNipQT0,SpATywNh6bZuzm8s1ceuBUnMUAeoAHHw,10,7,6,0,6,0,1,0,20,2.857142857142857,1,0.0,0,6,0,6,7,0,0,1,0,12,8,1
5540,74841,lFMbkCaY0FKfyGbh1VOL30jTZ1USVgB2,RXDvfPUBYFlVdlueBFbLW0mhhAyGEqpt,30,31,20,16,16,6,3,0,92,13.142857142857142,5,0.0,8,20,16,16,23,6,0,3,0,60,32,0
5541,74857,IqTYyD7L0euRgN3diEzqrprrc2W9uyF6,5X6FeZozNMgE2VRi3MJYjkkFK8SETtu2,6,5,3,0,1,0,5,0,14,2.0,2,0.0,0,3,0,1,5,0,0,5,0,4,10,0
5542,74859,y2Imh6d65IyLlUtE9DWkdIauRQxTWtdJ,bWdj2GDclj5ofokWjzoa5jAwMkxCykd6,4,2,1,0,1,0,4,0,8,1.1428571428571428,2,0.0,0,1,0,1,2,0,0,4,0,2,6,1
5543,74881,user4NErzgNZOQPby0IMjoZc4clvyOrp,7GRhBDsirIGkRZBtSMEzNTyDr2JQm4xx,6,4,2,0,1,0,2,0,9,1.2857142857142858,1,0.0,1,2,0,1,3,0,0,2,0,4,5,1
5544,74882,uFxbwM61ZWFC5xnxVOlmiGXCTyHmK3HX,RXDvfPUBYFlVdlueBFbLW0mhhAyGEqpt,16,20,15,0,8,2,9,3,57,8.142857142857142,2,0.0,0,15,0,8,20,2,0,9,3,23,34,1
5545,74905,x29OOChdmJGXK62DnUpwKbwJurqULmnD,G8EPVSXsOYB5YQWZGiz1aVq5Pgr2GrQu,4,2,0,0,0,0,2,0,4,0.5714285714285714,1,0.0,0,0,0,0,2,0,0,2,0,0,4,1
5546,74915,1f1vpzICnoH8kVwL3WpPvvH9Fnzvagoq,7GRhBDsirIGkRZBtSMEzNTyDr2JQm4xx,5,3,1,0,0,0,3,0,7,1.0,1,0.0,0,1,0,0,3,0,0,3,0,1,6,1
5547,74918,Y0dbTriNAgSzbrnkzFHfTSZPt5kDzGfo,SpATywNh6bZuzm8s1ceuBUnMUAeoAHHw,38,55,3,36,3,5,9,0,111,15.857142857142858,6,0.0,10,3,30,3,45,5,6,9,0,46,65,0
5548,74928,Jnn7sdYOabtjWgIFBUHReK25x6A3dZtZ,SpATywNh6bZuzm8s1ceuBUnMUAeoAHHw,8,5,3,0,2,0,3,0,13,1.8571428571428572,1,0.0,0,3,0,2,5,0,0,3,0,5,8,1
5549,74935,7n6VTEPIznuedo1nynk3WFAbvlKYIs72,SpATywNh6bZuzm8s1ceuBUnMUAeoAHHw,39,34,24,19,13,0,10,0,100,14.285714285714286,6,0.0,2,24,16,13,32,0,3,10,0,55,45,0
5550,74981,Oa5Z9qxxvzPY6Y4pD2DPDPqyzdKPou5A,RXDvfPUBYFlVdlueBFbLW0mhhAyGEqpt,4,2,0,0,0,0,2,0,4,0.5714285714285714,2,0.0,0,0,0,0,2,0,0,2,0,0,4,1
5551,75011,CDVTgNquYdsNoldLURSKppemY0oOGcjg,SpATywNh6bZuzm8s1ceuBUnMUAeoAHHw,23,40,1,21,1,3,9,2,77,11.0,3,0.0,9,1,20,1,31,3,1,9,2,31,46,0
5552,75046,JxLtKAnMek98G5fWpyeTaKlh0zheuNnU,A3fsA9Zfv1X2fVEQhTw51lKENdNrEqT3,15,21,9,0,5,1,8,1,45,6.428571428571429,4,0.0,1,9,0,5,20,1,0,8,1,15,30,1
5553,75054,dtbXtMjPqeEvzoZBFe2y9uSDcjL0lnx2,RXDvfPUBYFlVdlueBFbLW0mhhAyGEqpt,41,93,16,0,8,46,15,0,178,25.428571428571427,8,0.0,14,16,0,8,79,46,0,15,0,38,140,0
5554,75107,40pBsSLPvPjLL6yRnjAUeGaxtQZ4QL41,G8EPVSXsOYB5YQWZGiz1aVq5Pgr2GrQu,18,6,3,52,0,0,3,0,64,9.142857142857142,1,0.0,0,3,42,0,6,0,10,3,0,45,19,0
5555,75113,5EOGhyHOLLtbW0eEa8Dnfl5My4kdYkdc,SpATywNh6bZuzm8s1ceuBUnMUAeoAHHw,60,73,40,31,23,1,18,2,188,26.857142857142858,10,0.0,16,40,31,23,57,1,0,18,2,110,78,0
5556,75124,531vsi7OXuLQll24T9I8HukbHEYIaMhq,5X6FeZozNMgE2VRi3MJYjkkFK8SETtu2,38,115,36,0,47,0,15,2,215,30.714285714285715,6,0.0,56,36,0,47,59,0,0,15,2,139,76,1
5557,75143,KKE8q8DWecTGi2Mp6eRnxhZGGD7eG4J3,SpATywNh6bZuzm8s1ceuBUnMUAeoAHHw,19,17,10,12,6,0,5,1,51,7.285714285714286,2,0.0,4,10,12,6,13,0,0,5,1,32,19,1
5558,75154,uaT99v8EKasFxQFGqwtqtcH5x05oT3wD,A3fsA9Zfv1X2fVEQhTw51lKENdNrEqT3,39,17,12,106,9,0,3,0,147,21.0,2,0.0,3,12,95,9,14,0,11,3,0,119,28,1
5559,75171,ncmpqlY7PLQpJ9wJX1Qi5Ff2s3Hx5jkY,SpATywNh6bZuzm8s1ceuBUnMUAeoAHHw,10,9,4,0,3,0,2,0,18,2.5714285714285716,1,0.0,0,4,0,3,9,0,0,2,0,7,11,0
5560,75177,QEb4WbyR4NDG0zRGDFN1M8r5HQfWJubr,SpATywNh6bZuzm8s1ceuBUnMUAeoAHHw,2,0,0,0,0,0,2,0,2,0.2857142857142857,1,0.0,0,0,0,0,0,0,0,2,0,0,2,1
5561,75185,QlvFciinGDGt7csjDmjYPPZqFlKAzfUP,bWdj2GDclj5ofokWjzoa5jAwMkxCykd6,1,0,0,0,0,0,1,0,1,0.14285714285714285,1,0.0,0,0,0,0,0,0,0,1,0,0,1,1
5562,75188,QlvFciinGDGt7csjDmjYPPZqFlKAzfUP,G8EPVSXsOYB5YQWZGiz1aVq5Pgr2GrQu,1,0,0,0,0,0,1,0,1,0.14285714285714285,1,0.0,0,0,0,0,0,0,0,1,0,0,1,1
5563,75194,VrOVkNqg4QPgl4uZ5ris338QuHMKoadT,A3fsA9Zfv1X2fVEQhTw51lKENdNrEqT3,10,10,2,0,2,0,4,0,18,2.5714285714285716,2,0.0,0,2,0,2,10,0,0,4,0,4,14,1
5564,75195,9zNI4EpVujSV8TU9o7NY46vrkl8qX3Ys,G8EPVSXsOYB5YQWZGiz1aVq5Pgr2GrQu,17,24,7,0,6,0,10,1,48,6.857142857142857,2,0.0,12,7,0,6,12,0,0,10,1,25,23,0
5565,75202,U3LNfYcdRIeU9qhiaPG7Yg8NuZRGOnSS,A3fsA9Zfv1X2fVEQhTw51lKENdNrEqT3,1,0,0,0,0,0,2,0,2,0.2857142857142857,1,0.0,0,0,0,0,0,0,0,2,0,0,2,1
5566,75206,ZXWRS3Ah3Q3TKxtUJXxAAlsPTxzCg1Vz,SpATywNh6bZuzm8s1ceuBUnMUAeoAHHw,22,34,15,32,1,9,13,1,105,15.0,5,0.0,10,15,30,1,24,9,2,13,1,56,49,0
5567,75215,Zi4TkBqsB6TMu9rM1cOGrFhYXBZRNO2C,5X6FeZozNMgE2VRi3MJYjkkFK8SETtu2,11,15,4,12,0,0,2,0,33,4.714285714285714,2,0.0,9,4,12,0,6,0,0,2,0,25,8,1
5568,75240,UHvuo1o7uLLkfJ8EjLzALZaYP37eI8Lz,SpATywNh6bZuzm8s1ceuBUnMUAeoAHHw,14,12,0,10,0,0,3,0,25,3.5714285714285716,1,0.0,3,0,9,0,9,0,1,3,0,12,13,1
5569,75259,ssAF4hr9aUQpAUC0wxSDumowVhiC0dd4,SpATywNh6bZuzm8s1ceuBUnMUAeoAHHw,46,48,23,54,13,9,11,3,161,23.0,1,0.0,13,23,46,13,35,9,8,11,3,95,66,1
5570,75271,qVDHsjIzoOtZnTwpJtbJGpvapy4sRYpW,bWdj2GDclj5ofokWjzoa5jAwMkxCykd6,5,6,3,0,0,0,1,0,10,1.4285714285714286,1,0.0,1,3,0,0,5,0,0,1,0,4,6,1
5571,75298,9oXrBkovZPfJ4ibbiV0HjplK7CRHY8mi,SpATywNh6bZuzm8s1ceuBUnMUAeoAHHw,7,6,4,0,2,0,3,0,15,2.142857142857143,1,0.0,0,4,0,2,6,0,0,3,0,6,9,1
5572,75350,mFNGHC6aCmhHmhRXFCDO0uvnGnNYaro0,7GRhBDsirIGkRZBtSMEzNTyDr2JQm4xx,4,2,1,0,1,0,1,0,5,0.7142857142857143,1,0.0,0,1,0,1,2,0,0,1,0,2,3,1
5573,75382,O0pFwh56sT4vz63TrFMWxlTyZHTENk1t,SpATywNh6bZuzm8s1ceuBUnMUAeoAHHw,42,67,2,46,1,34,13,0,163,23.285714285714285,6,0.0,23,2,43,1,44,34,3,13,0,69,94,0
5574,75410,qOdvQbvioEpbzeT9YpY834XPs5VGo10v,bWdj2GDclj5ofokWjzoa5jAwMkxCykd6,12,44,11,0,8,0,12,0,75,10.714285714285714,1,0.0,2,11,0,8,42,0,0,12,0,21,54,1
5575,75412,MYsCU1zkMrWxPhV1b7wSL5LZIo1zGyhU,5X6FeZozNMgE2VRi3MJYjkkFK8SETtu2,64,85,31,0,64,0,6,0,186,26.571428571428573,5,0.0,48,31,0,64,37,0,0,6,0,143,43,0
5576,75439,wQLt542srbWeB4HTlvAdzx5vfYyzvgLZ,SpATywNh6bZuzm8s1ceuBUnMUAeoAHHw,1,0,0,0,0,0,1,0,1,0.14285714285714285,1,0.0,0,0,0,0,0,0,0,1,0,0,1,1
5577,75440,0wpIasMdCfOA3dQLJWO9ecakBEpIFnbg,7GRhBDsirIGkRZBtSMEzNTyDr2JQm4xx,38,70,33,53,14,29,13,0,212,30.285714285714285,3,0.0,33,33,45,14,37,29,8,13,0,125,87,1
5578,75486,l7cIWSn2QdqLoOKMFO8yNQGKfk999nJh,7GRhBDsirIGkRZBtSMEzNTyDr2JQm4xx,13,18,7,0,3,3,8,1,40,5.714285714285714,2,0.0,8,7,0,3,10,3,0,8,1,18,22,0
5579,75496,Sp10s5NIaBhXFj443MxH6F0GWEmP333T,G8EPVSXsOYB5YQWZGiz1aVq5Pgr2GrQu,7,2,1,0,1,1,4,1,10,1.4285714285714286,1,0.0,0,1,0,1,2,1,0,4,1,2,8,1
5580,75508,RHl3DsvAX7TisJ7qBptmgrrtDAQvH7mr,bWdj2GDclj5ofokWjzoa5jAwMkxCykd6,13,23,16,0,4,5,7,0,55,7.857142857142857,2,0.0,1,16,0,4,22,5,0,7,0,21,34,1
5581,75509,Y7Pi7uKjChwCBFftO7ZsD2oE8A4VzjzU,A3fsA9Zfv1X2fVEQhTw51lKENdNrEqT3,9,4,3,0,3,3,4,0,17,2.4285714285714284,1,0.0,0,3,0,3,4,3,0,4,0,6,11,1
5582,75557,514TWhkGGUhLu2MdvTnb8eiBH3DCFHzg,SpATywNh6bZuzm8s1ceuBUnMUAeoAHHw,33,52,22,31,6,3,16,1,131,18.714285714285715,5,0.0,12,22,29,6,40,3,2,16,1,69,62,0
5583,75565,A8uNxAeXRi6PUyfK3nbO106vNrsfyDAv,SpATywNh6bZuzm8s1ceuBUnMUAeoAHHw,31,42,21,32,11,12,22,0,140,20.0,5,0.0,14,21,29,11,28,12,3,22,0,75,65,0
5584,75573,vBRB2wzjfLfTulqF3dU7hDmET3IzOawt,bWdj2GDclj5ofokWjzoa5jAwMkxCykd6,10,2,1,18,1,3,6,1,32,4.571428571428571,2,0.0,1,1,18,1,1,3,0,6,1,21,11,1
5585,75589,TMHqfvRh4sdR4QsSw1ieP3y9mhiCGpqQ,SpATywNh6bZuzm8s1ceuBUnMUAeoAHHw,8,7,0,6,0,0,1,0,14,2.0,2,0.0,0,0,5,0,7,0,1,1,0,5,9,1
5586,75599,yBKc8UQ3yoU6nYnfaJz62fH80CgKFtOX,SpATywNh6bZuzm8s1ceuBUnMUAeoAHHw,47,55,30,57,17,0,21,1,181,25.857142857142858,5,0.0,14,30,47,17,41,0,10,21,1,108,73,0
5587,75611,24ovPvI68P1C2dGG4gkqfUxBKf1IL89V,SpATywNh6bZuzm8s1ceuBUnMUAeoAHHw,11,21,9,0,6,0,7,2,45,6.428571428571429,2,0.0,0,9,0,6,21,0,0,7,2,15,30,1
5588,75619,qwKwEhJ5oWm5TB1Q6emluPsrjHPCR2z1,SpATywNh6bZuzm8s1ceuBUnMUAeoAHHw,33,37,23,20,11,0,10,0,101,14.428571428571429,2,0.0,4,23,17,11,33,0,3,10,0,55,46,1
5589,75648,XHMa1LBfQu91lFwoLLSBhVEMIFmosCzB,SpATywNh6bZuzm8s1ceuBUnMUAeoAHHw,1,0,0,0,0,1,0,0,1,0.14285714285714285,1,0.0,0,0,0,0,0,1,0,0,0,0,1,1
5590,75651,RhmWa0TYSXDmOaY5G85GAKnAuCxk1qKo,SpATywNh6bZuzm8s1ceuBUnMUAeoAHHw,4,3,0,0,0,0,2,0,5,0.7142857142857143,1,0.0,1,0,0,0,2,0,0,2,0,1,4,1
5591,75671,dMFoSIxUWk2fcxfoWi4OaQOdeGkifmCW,SpATywNh6bZuzm8s1ceuBUnMUAeoAHHw,5,3,1,0,1,0,4,1,10,1.4285714285714286,1,0.0,0,1,0,1,3,0,0,4,1,2,8,1
5592,75673,I6LvRAT5lrglfRc7HjtOiHjECPtrYMcD,SpATywNh6bZuzm8s1ceuBUnMUAeoAHHw,23,28,12,4,9,0,7,0,60,8.571428571428571,4,0.0,0,12,4,9,28,0,0,7,0,25,35,1
5593,75688,69sBnrnn4yw4d4R753Fg9iMe8dCubVq5,SpATywNh6bZuzm8s1ceuBUnMUAeoAHHw,1,0,0,0,0,2,0,0,2,0.2857142857142857,1,0.0,0,0,0,0,0,2,0,0,0,0,2,1
5594,75699,88AD1l4wNMBju3FfWmP2xvwRYAECtTFg,A3fsA9Zfv1X2fVEQhTw51lKENdNrEqT3,14,16,11,0,9,0,6,0,42,6.0,3,0.0,1,11,0,9,15,0,0,6,0,21,21,1
5595,75724,39HyRvZGGM2Q03BAuIzlN9IBewYhVnfo,7GRhBDsirIGkRZBtSMEzNTyDr2JQm4xx,9,8,2,2,4,0,5,0,21,3.0,1,0.0,6,2,2,4,2,0,0,5,0,14,7,0
5596,75741,3x63reHnPUEpxvneROppT18TTVHKvgH3,bWdj2GDclj5ofokWjzoa5jAwMkxCykd6,15,19,7,22,5,0,3,0,56,8.0,2,0.0,3,7,20,5,16,0,2,3,0,35,21,1
5597,75756,K6L1htYb2XLFpKYYjszwZ8APtHLo7llK,A3fsA9Zfv1X2fVEQhTw51lKENdNrEqT3,10,6,2,0,2,0,12,0,22,3.142857142857143,1,0.0,0,2,0,2,6,0,0,12,0,4,18,0
5598,75759,8wgkhDh9t3XtyzQtRpizifGx20DUK4F9,7GRhBDsirIGkRZBtSMEzNTyDr2JQm4xx,2,0,0,0,0,0,2,0,2,0.2857142857142857,1,0.0,0,0,0,0,0,0,0,2,0,0,2,1
5599,75770,FGD2s7sTUqsP3QU1o8nPIzNgmxXe4CYW,7GRhBDsirIGkRZBtSMEzNTyDr2JQm4xx,25,53,23,12,13,3,19,0,123,17.571428571428573,2,0.0,22,23,9,13,31,3,3,19,0,67,56,1
5600,75792,dhPF0MOUpHT5OZTFAONgRdkH1ZwnZtFz,SpATywNh6bZuzm8s1ceuBUnMUAeoAHHw,44,44,28,44,23,0,12,0,151,21.571428571428573,5,0.0,12,28,40,23,32,0,4,12,0,103,48,0
5601,75794,1e18v1lfFGXUg6bMvYW1VQwzbnQ49fgM,RXDvfPUBYFlVdlueBFbLW0mhhAyGEqpt,57,49,27,94,23,0,3,0,196,28.0,2,0.0,19,27,90,23,30,0,4,3,0,159,37,0
5602,75797,IvlwoG4PXINReT5X8sWXharZr5MVyyC3,SpATywNh6bZuzm8s1ceuBUnMUAeoAHHw,1,0,0,0,0,0,3,0,3,0.42857142857142855,1,0.0,0,0,0,0,0,0,0,3,0,0,3,1
5603,75811,rtqeFROD6qkcnco9ZNqDeOxQ39FXT7YO,5X6FeZozNMgE2VRi3MJYjkkFK8SETtu2,8,5,2,0,2,0,1,0,10,1.4285714285714286,1,0.0,0,2,0,2,5,0,0,1,0,4,6,1
5604,75819,q7Qa5My2QzcPtmlYo4s3YA0ocpkv6szX,SpATywNh6bZuzm8s1ceuBUnMUAeoAHHw,4,2,1,0,1,0,2,0,6,0.8571428571428571,1,0.0,0,1,0,1,2,0,0,2,0,2,4,1
5605,75832,kXWvTXCpsmsgWxo8yHGfBfacmUg5iCPe,A3fsA9Zfv1X2fVEQhTw51lKENdNrEqT3,21,10,7,54,4,0,8,1,84,12.0,1,0.0,2,7,46,4,8,0,8,8,1,59,25,1
5606,75833,BIODZjcB7SHUrj4P9eqU1KvIgG0hvgIb,5X6FeZozNMgE2VRi3MJYjkkFK8SETtu2,7,5,2,0,1,0,4,0,12,1.7142857142857142,1,0.0,0,2,0,1,5,0,0,4,0,3,9,1
5607,75835,MhPFQAgWNzlZ6Teq1DlKr26Z8E6wW1AP,SpATywNh6bZuzm8s1ceuBUnMUAeoAHHw,5,3,1,0,1,0,1,0,6,0.8571428571428571,1,0.0,0,1,0,1,3,0,0,1,0,2,4,1
5608,75890,Y89GJdSZUpoYFMgx00SCe6qFoYoXIpUj,7GRhBDsirIGkRZBtSMEzNTyDr2JQm4xx,1,0,0,0,0,0,1,0,1,0.14285714285714285,1,0.0,0,0,0,0,0,0,0,1,0,0,1,1
5609,75911,vuslHI1UxdeXKs1vDUvKXYQqg3X9k91E,bWdj2GDclj5ofokWjzoa5jAwMkxCykd6,7,5,3,0,0,0,5,0,13,1.8571428571428572,1,0.0,0,3,0,0,5,0,0,5,0,3,10,1
5610,75913,9Z0HPERi08W8BXnB1twUjHrPBLbHzKgR,SpATywNh6bZuzm8s1ceuBUnMUAeoAHHw,5,2,1,0,1,0,2,0,6,0.8571428571428571,1,0.0,0,1,0,1,2,0,0,2,0,2,4,1
5611,75914,HF98YPKzT8oi2j9flZW9kstZcvL3ZimG,5X6FeZozNMgE2VRi3MJYjkkFK8SETtu2,47,141,31,79,24,0,5,0,280,40.0,3,0.0,39,31,62,24,102,0,17,5,0,156,124,0
5612,75915,TfNQptQajWTQqzlzDAn72SRQxELYzNd4,bWdj2GDclj5ofokWjzoa5jAwMkxCykd6,1,0,0,0,0,0,1,0,1,0.14285714285714285,1,0.0,0,0,0,0,0,0,0,1,0,0,1,0
5613,75921,uCB5uEbohrhji79dydXW4G40PBAqm3fB,SpATywNh6bZuzm8s1ceuBUnMUAeoAHHw,4,2,1,0,1,0,1,0,5,0.7142857142857143,1,0.0,0,1,0,1,2,0,0,1,0,2,3,1
5614,75925,ADzA6LTxD4Ild5QEYX1CEp1PkDr0ZeEm,SpATywNh6bZuzm8s1ceuBUnMUAeoAHHw,2,0,0,0,0,0,2,0,2,0.2857142857142857,1,0.0,0,0,0,0,0,0,0,2,0,0,2,1
5615,75943,vcUiIaz3mBJL4s6AIIwTtvU1UwMpvaHI,A3fsA9Zfv1X2fVEQhTw51lKENdNrEqT3,6,3,0,0,0,0,3,2,8,1.1428571428571428,1,0.0,0,0,0,0,3,0,0,3,2,0,8,1
5616,75950,vRfp4R3Ka5ikFbaOY5bQDke3cTfTq6Oz,RXDvfPUBYFlVdlueBFbLW0mhhAyGEqpt,26,43,4,0,4,11,12,2,76,10.857142857142858,4,0.0,0,4,0,4,43,11,0,12,2,8,68,0
5617,75955,m1ZHf0Vy9SZyKEONoAW39ljflZCTH7Li,bWdj2GDclj5ofokWjzoa5jAwMkxCykd6,13,9,6,0,4,3,11,1,34,4.857142857142857,2,0.0,0,6,0,4,9,3,0,11,1,10,24,1
5618,75964,kiVzCvDoEqSB7iO0TU3ERoanC9pEAYCs,7GRhBDsirIGkRZBtSMEzNTyDr2JQm4xx,4,2,1,0,1,0,2,0,6,0.8571428571428571,1,0.0,0,1,0,1,2,0,0,2,0,2,4,1
5619,75969,8Dno8ERd119JayTOKlG7uDmGtkfLJOke,SpATywNh6bZuzm8s1ceuBUnMUAeoAHHw,6,3,2,0,2,0,3,0,10,1.4285714285714286,3,0.0,0,2,0,2,3,0,0,3,0,4,6,0
5620,75980,mDHr8WvVVX9KSvXMqxtLvZ6vP4uuNF6E,A3fsA9Zfv1X2fVEQhTw51lKENdNrEqT3,7,11,1,0,0,1,6,0,19,2.7142857142857144,4,0.0,2,1,0,0,9,1,0,6,0,3,16,1
5621,75992,YvdTgocCzBmHhfLuAH349Li5za8uToFU,7GRhBDsirIGkRZBtSMEzNTyDr2JQm4xx,9,5,0,0,0,2,5,1,13,1.8571428571428572,1,0.0,0,0,0,0,5,2,0,5,1,0,13,1
5622,76007,ttoFK5oOPrxtfVxJpGPFCiEs8J6AbuAg,5X6FeZozNMgE2VRi3MJYjkkFK8SETtu2,22,47,7,20,10,1,16,0,101,14.428571428571429,7,0.0,12,7,17,10,35,1,3,16,0,46,55,0
5623,76037,tRnGjKGiLuFimS9EZkzjSZra5GMl2o1g,SpATywNh6bZuzm8s1ceuBUnMUAeoAHHw,3,0,0,0,0,0,3,0,3,0.42857142857142855,1,0.0,0,0,0,0,0,0,0,3,0,0,3,1
5624,76038,6RuWsSvS3Ngnjl37PzNAaaGn8Jd9a1lW,bWdj2GDclj5ofokWjzoa5jAwMkxCykd6,22,76,15,0,14,1,27,0,133,19.0,8,0.0,2,15,0,14,74,1,0,27,0,31,102,0
5625,76056,XN63dEiQWhNWbJsINnN40CVdwEcsGjr2,SpATywNh6bZuzm8s1ceuBUnMUAeoAHHw,13,17,10,0,4,0,10,0,41,5.857142857142857,2,0.0,0,10,0,4,17,0,0,10,0,14,27,0
5626,76062,uS20ZmLoHmLQWbUhtUHWfWagVEF63NYz,bWdj2GDclj5ofokWjzoa5jAwMkxCykd6,6,2,1,0,1,0,4,0,8,1.1428571428571428,1,0.0,0,1,0,1,2,0,0,4,0,2,6,1
5627,76070,4rBJgH2pAgasw5ZtgiBnBNfRcNJLZp5J,7GRhBDsirIGkRZBtSMEzNTyDr2JQm4xx,9,2,1,0,1,4,7,1,16,2.2857142857142856,1,0.0,0,1,0,1,2,4,0,7,1,2,14,1
5628,76081,7Xbcyzr5w9UbFD6viSl5LziGgJLlGTSQ,bWdj2GDclj5ofokWjzoa5jAwMkxCykd6,15,8,1,46,3,0,2,0,60,8.571428571428571,1,0.0,2,1,46,3,6,0,0,2,0,52,8,1
5629,76084,guWBfmwWMYvgsjzJYUwSED8H7qksX2UV,SpATywNh6bZuzm8s1ceuBUnMUAeoAHHw,4,2,1,0,0,0,2,0,5,0.7142857142857143,1,0.0,0,1,0,0,2,0,0,2,0,1,4,1
5630,76090,Rqbm8kzAkzPtCEeD6EKvXOVzxPg0CACh,A3fsA9Zfv1X2fVEQhTw51lKENdNrEqT3,2,0,0,0,0,0,2,0,2,0.2857142857142857,1,0.0,0,0,0,0,0,0,0,2,0,0,2,1
5631,76095,Ok3OwUFvWjyWfSr7mibP3P1PetaYX4Au,5X6FeZozNMgE2VRi3MJYjkkFK8SETtu2,6,3,2,0,2,0,1,0,8,1.1428571428571428,1,0.0,0,2,0,2,3,0,0,1,0,4,4,1
5632,76119,FXen1VSms29mqypmBsJLgiCW5lwzRuUO,7GRhBDsirIGkRZBtSMEzNTyDr2JQm4xx,21,22,10,8,8,5,11,0,64,9.142857142857142,4,0.0,7,10,6,8,15,5,2,11,0,31,33,1
5633,76132,BPj9vbHlIMSVYvgR55UNazxp9lZNYkPR,5X6FeZozNMgE2VRi3MJYjkkFK8SETtu2,6,4,2,0,1,0,2,0,9,1.2857142857142858,1,0.0,1,2,0,1,3,0,0,2,0,4,5,1
5634,76140,Bn7S5b6FwWRas4u7d1h2YD3tnpE2VYTv,A3fsA9Zfv1X2fVEQhTw51lKENdNrEqT3,4,2,0,0,0,0,2,0,4,0.5714285714285714,1,0.0,0,0,0,0,2,0,0,2,0,0,4,1
5635,76152,GLC3kBoUw2roKtv7ldNh1bz31DGBmr9Y,bWdj2GDclj5ofokWjzoa5jAwMkxCykd6,2,0,0,0,0,0,2,0,2,0.2857142857142857,1,0.0,0,0,0,0,0,0,0,2,0,0,2,1
5636,76156,iJpmOShuYA1JTXBfbyoGmjolTr8PtDht,SpATywNh6bZuzm8s1ceuBUnMUAeoAHHw,1,0,0,0,0,0,1,0,1,0.14285714285714285,1,0.0,0,0,0,0,0,0,0,1,0,0,1,1
5637,76193,yhuEFjYPx53KuMNRSkVNQIkCv2xuEbeq,7GRhBDsirIGkRZBtSMEzNTyDr2JQm4xx,1,0,0,0,0,0,2,0,2,0.2857142857142857,1,0.0,0,0,0,0,0,0,0,2,0,0,2,1
5638,76197,509hMngiUm6zrKoE3SecqGuN8tx0I6r6,5X6FeZozNMgE2VRi3MJYjkkFK8SETtu2,1,0,0,0,0,0,1,0,1,0.14285714285714285,1,0.0,0,0,0,0,0,0,0,1,0,0,1,1
5639,76200,sDXyFyXccb2aUhA7HkeYGp29lIhqBqSo,G8EPVSXsOYB5YQWZGiz1aVq5Pgr2GrQu,6,1,1,0,1,0,3,0,6,0.8571428571428571,1,0.0,0,1,0,1,1,0,0,3,0,2,4,1
5640,76204,4J0kxAUfVeKtOX3m9APp3FIJE103B8gP,A3fsA9Zfv1X2fVEQhTw51lKENdNrEqT3,1,0,0,0,0,0,1,0,1,0.14285714285714285,1,0.0,0,0,0,0,0,0,0,1,0,0,1,1
5641,76219,PrDfsHArpCrtmsMMMZhp4he169gdCY7N,SpATywNh6bZuzm8s1ceuBUnMUAeoAHHw,1,0,0,0,0,0,1,0,1,0.14285714285714285,1,0.0,0,0,0,0,0,0,0,1,0,0,1,1
5642,76238,FYdTGqTHtRATfo802agJiucYRW9Mfn1L,RXDvfPUBYFlVdlueBFbLW0mhhAyGEqpt,11,12,1,0,2,0,1,0,16,2.2857142857142856,1,0.0,2,1,0,2,10,0,0,1,0,5,11,1
5643,76245,FYdTGqTHtRATfo802agJiucYRW9Mfn1L,7GRhBDsirIGkRZBtSMEzNTyDr2JQm4xx,1,0,0,0,0,0,1,0,1,0.14285714285714285,1,0.0,0,0,0,0,0,0,0,1,0,0,1,1
5644,76247,FYdTGqTHtRATfo802agJiucYRW9Mfn1L,A3fsA9Zfv1X2fVEQhTw51lKENdNrEqT3,1,0,0,0,0,0,1,0,1,0.14285714285714285,1,0.0,0,0,0,0,0,0,0,1,0,0,1,1
5645,76252,BCPhbcVTukJPsOtUJJbyOWvpso8GiEV1,A3fsA9Zfv1X2fVEQhTw51lKENdNrEqT3,12,7,4,0,3,0,6,0,20,2.857142857142857,2,0.0,0,4,0,3,7,0,0,6,0,7,13,1
5646,76261,wzJUcvl4LpGNAis186Xl9ztjI1WNWkac,bWdj2GDclj5ofokWjzoa5jAwMkxCykd6,8,10,1,0,2,1,21,1,36,5.142857142857143,5,0.0,5,1,0,2,5,1,0,21,1,8,28,1
5647,76307,59KrgCJlOEHQHzBNjsHoSd6BkQVArDrc,bWdj2GDclj5ofokWjzoa5jAwMkxCykd6,7,6,4,0,2,0,4,0,16,2.2857142857142856,2,0.0,0,4,0,2,6,0,0,4,0,6,10,1
5648,76314,0htS0wNp12VQ7YgJ628sRK5TB1tJHlRO,7GRhBDsirIGkRZBtSMEzNTyDr2JQm4xx,9,5,3,0,3,0,2,0,13,1.8571428571428572,2,0.0,1,3,0,3,4,0,0,2,0,7,6,1
5649,76317,E9EDiL5FdsaYLmbLpW4Gm4jZTeooFwDr,7GRhBDsirIGkRZBtSMEzNTyDr2JQm4xx,1,0,0,0,0,0,1,0,1,0.14285714285714285,1,0.0,0,0,0,0,0,0,0,1,0,0,1,1
5650,76321,1GdR4GHc7WTO0QsI1Bs0LMr9EaBXC7so,7GRhBDsirIGkRZBtSMEzNTyDr2JQm4xx,3,0,0,0,0,0,5,0,5,0.7142857142857143,1,0.0,0,0,0,0,0,0,0,5,0,0,5,1
5651,76330,uGMYI14ArIwBL21cXHEeuuGvmctFBZzg,7GRhBDsirIGkRZBtSMEzNTyDr2JQm4xx,1,0,0,0,0,0,1,0,1,0.14285714285714285,1,0.0,0,0,0,0,0,0,0,1,0,0,1,1
5652,76339,1QZw8OliUS350g6ycU0wsVijkhxnDnRS,7GRhBDsirIGkRZBtSMEzNTyDr2JQm4xx,1,0,0,0,0,0,1,0,1,0.14285714285714285,1,0.0,0,0,0,0,0,0,0,1,0,0,1,1
5653,76345,wUp74pHXepx3D052YhA66zL4rpbyPwEw,7GRhBDsirIGkRZBtSMEzNTyDr2JQm4xx,4,3,1,0,1,0,1,0,6,0.8571428571428571,1,0.0,0,1,0,1,3,0,0,1,0,2,4,1
5654,76370,LjHLegep3fnzz3EMIdyj4iJ3mzoK4FmA,7GRhBDsirIGkRZBtSMEzNTyDr2JQm4xx,15,11,6,0,5,0,8,0,30,4.285714285714286,4,0.0,2,6,0,5,9,0,0,8,0,13,17,1
5655,76374,DsHgWZRTJ1y1l15smwhB78ZQq3d8dyKP,7GRhBDsirIGkRZBtSMEzNTyDr2JQm4xx,1,0,0,0,0,0,2,0,2,0.2857142857142857,1,0.0,0,0,0,0,0,0,0,2,0,0,2,1
5656,76387,0BEjwSez7vKiynnyukTltmd8Na9BnWzy,5Gyp41oLVo7Gg7vF4vpmggWP5MU70QO6,1,0,0,0,0,0,1,0,1,0.14285714285714285,1,0.0,0,0,0,0,0,0,0,1,0,0,1,1
5657,76391,HQ6Oij7snrzV4x54wZo5vjyO2QZb8Y0Z,5Gyp41oLVo7Gg7vF4vpmggWP5MU70QO6,5,4,1,0,1,0,1,0,7,1.0,1,0.0,0,1,0,1,4,0,0,1,0,2,5,1
5658,76458,tb9QbEZD9qc7nDQo9yLy9jGuyLWLODk7,5Gyp41oLVo7Gg7vF4vpmggWP5MU70QO6,24,85,34,37,0,55,20,1,232,33.142857142857146,5,0.0,34,34,22,0,51,55,15,20,1,90,142,0
5659,76482,e3FZ4cy0BMFRPYHEGpC2DZzHOCgKNd5m,5Gyp41oLVo7Gg7vF4vpmggWP5MU70QO6,20,44,23,22,10,14,6,1,120,17.142857142857142,3,0.0,11,23,11,10,33,14,11,6,1,55,65,0
5660,76550,OQhykRRofImPS0jiCYxNywc0tLc7ikaM,5Gyp41oLVo7Gg7vF4vpmggWP5MU70QO6,6,4,2,0,2,0,1,0,9,1.2857142857142858,1,0.0,0,2,0,2,4,0,0,1,0,4,5,1
5661,76583,Hnsg2RdEy94EzQKO2WfhQn1bhDkIZpuP,5Gyp41oLVo7Gg7vF4vpmggWP5MU70QO6,19,43,16,2,14,0,9,0,84,12.0,5,0.0,17,16,1,14,26,0,1,9,0,48,36,0
5662,76593,8paXbOE4gObsOIM9rBBbCsc1bMlzuvtH,5Gyp41oLVo7Gg7vF4vpmggWP5MU70QO6,16,21,12,4,3,0,4,0,44,6.285714285714286,1,0.0,5,12,2,3,16,0,2,4,0,22,22,1
5663,76596,Nw53y0bWjQvb2zl999IyNN2G9MT9XOop,5Gyp41oLVo7Gg7vF4vpmggWP5MU70QO6,11,15,5,10,3,5,3,0,41,5.857142857142857,1,0.0,6,5,5,3,9,5,5,3,0,19,22,1
5664,76613,WbXBGjs8sOcGx4CLMFMe3JyADMNhLK2e,5Gyp41oLVo7Gg7vF4vpmggWP5MU70QO6,11,6,3,0,1,0,8,1,19,2.7142857142857144,1,0.0,0,3,0,1,6,0,0,8,1,4,15,0
5665,76640,FHXNJ1i7fXBkpQ5rOJBQER41F3GL5sKV,5Gyp41oLVo7Gg7vF4vpmggWP5MU70QO6,17,69,28,4,10,19,22,0,152,21.714285714285715,8,0.0,16,28,3,10,53,19,1,22,0,57,95,0
5666,76642,47uToBKcQtCVF2p3hcnSb3h9oSt1ZhSG,5Gyp41oLVo7Gg7vF4vpmggWP5MU70QO6,7,4,1,0,1,1,3,1,11,1.5714285714285714,1,0.0,0,1,0,1,4,1,0,3,1,2,9,1
5667,76647,1gk6fKIXti5rzjyDgWxKhuedyICV0p5X,5Gyp41oLVo7Gg7vF4vpmggWP5MU70QO6,12,11,5,4,2,1,8,2,33,4.714285714285714,2,0.0,4,5,2,2,7,1,2,8,2,13,20,1
5668,76665,Nr4xgaqWlp3GY7Luca1HZwWSVTgxpORh,5Gyp41oLVo7Gg7vF4vpmggWP5MU70QO6,24,39,17,30,5,14,10,1,116,16.571428571428573,3,0.0,16,17,15,5,23,14,15,10,1,53,63,0
5669,76682,V2erUkv5vzN8XdSa2UBX4Q5nQZ4WhwfM,5Gyp41oLVo7Gg7vF4vpmggWP5MU70QO6,7,3,2,0,2,0,2,0,9,1.2857142857142858,1,0.0,0,2,0,2,3,0,0,2,0,4,5,1
5670,76702,nj1PuY2gDNPPcTJQ2NAceOcYKhH7fwXk,5Gyp41oLVo7Gg7vF4vpmggWP5MU70QO6,13,11,6,8,1,0,4,0,30,4.285714285714286,2,0.0,1,6,4,1,10,0,4,4,0,12,18,1
5671,76753,alnogGpZqhBWQHh6ZLeZUIXk896ksLOu,5Gyp41oLVo7Gg7vF4vpmggWP5MU70QO6,1,0,0,0,0,0,2,0,2,0.2857142857142857,2,0.0,0,0,0,0,0,0,0,2,0,0,2,1
5672,76774,ytL2gjGFWHT8Kt6MdY9ZHORs13f68L7a,5Gyp41oLVo7Gg7vF4vpmggWP5MU70QO6,25,96,32,6,3,21,11,3,172,24.571428571428573,2,0.0,23,32,3,3,73,21,3,11,3,61,111,1
5673,76803,ifp0kFKVEjabvSUFUy1aEpz5TmZrm8tB,5Gyp41oLVo7Gg7vF4vpmggWP5MU70QO6,18,33,17,0,9,0,15,0,74,10.571428571428571,4,0.0,3,17,0,9,30,0,0,15,0,29,45,0
5674,76820,m0VKHGN6a79sZImpQa7H4uF4wJYbxAYi,5Gyp41oLVo7Gg7vF4vpmggWP5MU70QO6,1,0,0,0,0,0,1,0,1,0.14285714285714285,1,0.0,0,0,0,0,0,0,0,1,0,0,1,1
5675,76872,Jv27viGuUxRFb9UWcE6lp57hLy6cCG7A,5Gyp41oLVo7Gg7vF4vpmggWP5MU70QO6,19,20,13,12,5,1,8,1,60,8.571428571428571,2,0.0,3,13,6,5,17,1,6,8,1,27,33,1
5676,76879,wKAdhm3Zap3PKniBFWpslE0VTdwM0zmM,5Gyp41oLVo7Gg7vF4vpmggWP5MU70QO6,5,2,1,0,1,0,2,0,6,0.8571428571428571,1,0.0,0,1,0,1,2,0,0,2,0,2,4,1
5677,76883,NzOkvZmnsBJyJ2xXTHp6VjlL2eW3yjsX,5Gyp41oLVo7Gg7vF4vpmggWP5MU70QO6,13,17,8,0,1,0,6,0,32,4.571428571428571,3,0.0,0,8,0,1,17,0,0,6,0,9,23,1
5678,76965,RVwSAHxCpXjdqkEsoVeRRSWT7FKnXTih,7GRhBDsirIGkRZBtSMEzNTyDr2JQm4xx,5,2,1,0,1,0,3,0,7,1.0,1,0.0,0,1,0,1,2,0,0,3,0,2,5,1
5679,76990,OdMr7dE5UlAme9Tp979vREBvY5CV50po,7GRhBDsirIGkRZBtSMEzNTyDr2JQm4xx,34,27,21,2,21,0,4,0,75,10.714285714285714,2,0.0,3,21,2,21,24,0,0,4,0,47,28,1
5680,77027,BCR9Csw9e3gBBos2x8J4HYYW5Gara6WV,7GRhBDsirIGkRZBtSMEzNTyDr2JQm4xx,1,0,0,0,0,0,1,0,1,0.14285714285714285,1,0.0,0,0,0,0,0,0,0,1,0,0,1,1
5681,77032,KPMkMHpUZOSbFRkwKqywhwm1W34kGRsr,7GRhBDsirIGkRZBtSMEzNTyDr2JQm4xx,5,2,1,0,1,0,2,0,6,0.8571428571428571,1,0.0,0,1,0,1,2,0,0,2,0,2,4,1
5682,77044,bikkCYRyUxervPNSkXQBtcADPD3aMEN1,7GRhBDsirIGkRZBtSMEzNTyDr2JQm4xx,2,0,0,0,0,0,3,0,3,0.42857142857142855,2,0.0,0,0,0,0,0,0,0,3,0,0,3,1
5683,77126,qg6GOCuPcDwehPMMAEed7GZuAdyiaV9B,7GRhBDsirIGkRZBtSMEzNTyDr2JQm4xx,58,167,10,89,17,61,35,1,380,54.285714285714285,16,0.0,66,10,73,17,101,61,16,35,1,166,214,1
5684,77170,jOMPEpDTypAwtZP0adzz5Y6TGIr0Cgak,fbPkOYLVPtPgIt0MxizjfFJov3JbHyAi,6,10,1,1,4,0,1,0,17,2.4285714285714284,1,0.0,7,1,1,4,3,0,0,1,0,13,4,1
5685,77172,mI1vyeEbuUIxkGVi9aK5r9kjcaPF7SVi,fbPkOYLVPtPgIt0MxizjfFJov3JbHyAi,8,11,7,0,4,0,2,0,24,3.4285714285714284,1,0.0,0,7,0,4,11,0,0,2,0,11,13,1
5686,77173,GkJR3TNQR5bDjgiA7ByPHRWSb3vgtDKO,fbPkOYLVPtPgIt0MxizjfFJov3JbHyAi,9,10,5,0,3,6,4,1,29,4.142857142857143,1,0.0,1,5,0,3,9,6,0,4,1,9,20,1
5687,77176,hNJz0qbOhrUgajUkzqSdDbybHkuRglfs,fbPkOYLVPtPgIt0MxizjfFJov3JbHyAi,6,5,2,0,2,0,1,0,10,1.4285714285714286,1,0.0,0,2,0,2,5,0,0,1,0,4,6,1
5688,77177,NHGmMinB9WoQusKCx50F4M4nJF124Ms4,fbPkOYLVPtPgIt0MxizjfFJov3JbHyAi,4,2,1,0,1,0,1,0,5,0.7142857142857143,1,0.0,0,1,0,1,2,0,0,1,0,2,3,1
5689,77181,SFygdEesOWeEamKu8iZBsgHneiDiai0R,fbPkOYLVPtPgIt0MxizjfFJov3JbHyAi,4,5,0,0,0,0,2,0,7,1.0,2,0.0,0,0,0,0,5,0,0,2,0,0,7,1
5690,77182,kmeB6Kxx4KEk3yK7YODyZKeWU8kJfyJH,fbPkOYLVPtPgIt0MxizjfFJov3JbHyAi,4,2,1,0,1,0,1,0,5,0.7142857142857143,1,0.0,0,1,0,1,2,0,0,1,0,2,3,1
5691,77184,wf4sRCFbvakokDkU4vw1lmU1y8DrYHz0,fbPkOYLVPtPgIt0MxizjfFJov3JbHyAi,15,42,14,15,10,23,13,0,117,16.714285714285715,3,0.0,13,14,12,10,29,23,3,13,0,49,68,1
5692,77185,QQjzUMnFih1Op25f6SGBPhOGRMF8l0bA,fbPkOYLVPtPgIt0MxizjfFJov3JbHyAi,24,49,20,13,15,6,5,0,108,15.428571428571429,3,0.0,14,20,11,15,35,6,2,5,0,60,48,1
5693,77187,JGkH5G6iVBgcA8nzn9agd5N20Wo6tva5,fbPkOYLVPtPgIt0MxizjfFJov3JbHyAi,21,17,14,0,9,0,6,0,46,6.571428571428571,2,0.0,0,14,0,9,17,0,0,6,0,23,23,1
5694,77188,DiP7fLvMTHut4vp8IPCEmth5BO8Y3xyZ,fbPkOYLVPtPgIt0MxizjfFJov3JbHyAi,9,10,5,0,4,13,7,3,42,6.0,1,0.0,2,5,0,4,8,13,0,7,3,11,31,1
5695,77189,Qj3OHkTzcEQwSk4fOQ3gLUAEOg61tV0J,fbPkOYLVPtPgIt0MxizjfFJov3JbHyAi,6,4,2,0,2,0,2,0,10,1.4285714285714286,1,0.0,0,2,0,2,4,0,0,2,0,4,6,1
5696,77190,YK4AUh2swGXXiib7M9ur8qjJXCBGfumK,fbPkOYLVPtPgIt0MxizjfFJov3JbHyAi,1,0,0,0,0,0,1,0,1,0.14285714285714285,1,0.0,0,0,0,0,0,0,0,1,0,0,1,1
5697,77191,E4C4yZPrf8ephwcq1p7RUy4dbVmvF86s,fbPkOYLVPtPgIt0MxizjfFJov3JbHyAi,1,0,0,0,0,0,2,0,2,0.2857142857142857,1,0.0,0,0,0,0,0,0,0,2,0,0,2,1
5698,77194,uOfATV0WsL0BPHDdVyS70rl0sYjdudpd,fbPkOYLVPtPgIt0MxizjfFJov3JbHyAi,10,18,8,4,3,0,7,0,40,5.714285714285714,1,0.0,4,8,3,3,14,0,1,7,0,18,22,1
5699,77197,4UvxElQD05jrzT8uj3rOHyCF67vFPUKP,fbPkOYLVPtPgIt0MxizjfFJov3JbHyAi,16,36,21,7,14,5,4,0,87,12.428571428571429,5,0.0,9,21,6,14,27,5,1,4,0,50,37,1
5700,77198,nctrJ6DXEbLac5Q8LCtyQd0IItjuRIih,fbPkOYLVPtPgIt0MxizjfFJov3JbHyAi,10,21,4,0,4,3,27,3,62,8.857142857142858,2,0.0,3,4,0,4,18,3,0,27,3,11,51,1
5701,77200,rwyVxnMY0KdYFbt5Rt6BKFYkmT4l68h9,fbPkOYLVPtPgIt0MxizjfFJov3JbHyAi,5,2,1,0,1,0,2,0,6,0.8571428571428571,1,0.0,0,1,0,1,2,0,0,2,0,2,4,1
5702,77206,OE8YoNemuZxKuixEPGeEQM6Dw53MRjvX,fbPkOYLVPtPgIt0MxizjfFJov3JbHyAi,1,0,0,0,0,0,1,0,1,0.14285714285714285,1,0.0,0,0,0,0,0,0,0,1,0,0,1,1
5703,77208,H47G4l8xfadoi35VSQjLwEe5Da3Pfkds,fbPkOYLVPtPgIt0MxizjfFJov3JbHyAi,4,2,1,0,1,0,1,0,5,0.7142857142857143,1,0.0,0,1,0,1,2,0,0,1,0,2,3,1
5704,77249,u9jaziCv45aKAk6eSyae9cCaWxg1Ifs1,5Gyp41oLVo7Gg7vF4vpmggWP5MU70QO6,1,0,0,0,0,0,1,0,1,0.14285714285714285,1,0.0,0,0,0,0,0,0,0,1,0,0,1,1
5705,77261,LdWHb8FNIpHWtvU3SK0SLgspyLdHqtIM,5Gyp41oLVo7Gg7vF4vpmggWP5MU70QO6,5,2,1,0,1,0,2,0,6,0.8571428571428571,1,0.0,0,1,0,1,2,0,0,2,0,2,4,1
5706,77277,aHRdc7lsBBp8F9aMkgntONfsLpIf0i6y,fbPkOYLVPtPgIt0MxizjfFJov3JbHyAi,1,0,0,0,0,0,1,0,1,0.14285714285714285,1,0.0,0,0,0,0,0,0,0,1,0,0,1,1
5707,77278,y7yLjFt2yMwjL5qqPUFP5MHo49CCR80j,fbPkOYLVPtPgIt0MxizjfFJov3JbHyAi,28,19,9,34,7,4,12,1,86,12.285714285714286,2,0.0,8,9,29,7,11,4,5,12,1,53,33,0
5708,77281,5oCzuebE5sOiXyHq7QSKzWptS8CHUxep,fbPkOYLVPtPgIt0MxizjfFJov3JbHyAi,9,6,3,0,3,0,2,0,14,2.0,1,0.0,2,3,0,3,4,0,0,2,0,8,6,0
5709,77282,W4naaQuAv3aawg9lsjDcMFTQoI118ZQn,fbPkOYLVPtPgIt0MxizjfFJov3JbHyAi,1,0,0,0,0,0,1,0,1,0.14285714285714285,1,0.0,0,0,0,0,0,0,0,1,0,0,1,1
5710,77283,XDPvGyFLLEYwbNEQik2MM4yiADs5rrYJ,fbPkOYLVPtPgIt0MxizjfFJov3JbHyAi,23,38,22,10,12,0,4,0,86,12.285714285714286,2,0.0,11,22,9,12,27,0,1,4,0,54,32,0
5711,77285,BH3sq4av71sodHdOzBwY6UiwkUVXYWOx,fbPkOYLVPtPgIt0MxizjfFJov3JbHyAi,8,7,3,0,2,0,3,0,15,2.142857142857143,1,0.0,0,3,0,2,7,0,0,3,0,5,10,1
5712,77287,FCXkOVtASvwM4OqelAOjh7n6TzPCCzLb,fbPkOYLVPtPgIt0MxizjfFJov3JbHyAi,1,0,0,0,0,0,1,0,1,0.14285714285714285,1,0.0,0,0,0,0,0,0,0,1,0,0,1,1
5713,77288,p8VqUZMwo4dVi11PeKi9f5Uakn25Nqf5,fbPkOYLVPtPgIt0MxizjfFJov3JbHyAi,8,6,2,4,2,0,2,0,16,2.2857142857142856,1,0.0,1,2,4,2,5,0,0,2,0,9,7,0
5714,77289,OcFLLEI56U80V98vNeJ7LrlE5FWxkkpp,fbPkOYLVPtPgIt0MxizjfFJov3JbHyAi,9,8,3,0,2,0,3,0,16,2.2857142857142856,1,0.0,0,3,0,2,8,0,0,3,0,5,11,1
5715,77291,lQduia23vRF72bXB1H9gO7pdoAy9qGnz,fbPkOYLVPtPgIt0MxizjfFJov3JbHyAi,5,2,1,0,1,0,3,0,7,1.0,2,0.0,0,1,0,1,2,0,0,3,0,2,5,1
5716,77294,YFQErQbDsOlFAlTBuFeWAKVDvvEvYguk,fbPkOYLVPtPgIt0MxizjfFJov3JbHyAi,9,4,3,0,3,0,6,0,16,2.2857142857142856,1,0.0,0,3,0,3,4,0,0,6,0,6,10,0
5717,77297,q59kWYGMUTfJqmsqtRwBMfXE68tP6L48,fbPkOYLVPtPgIt0MxizjfFJov3JbHyAi,1,0,0,0,0,0,1,0,1,0.14285714285714285,1,0.0,0,0,0,0,0,0,0,1,0,0,1,1
5718,77298,OWM7Ktiez7wU7sodg9xzACIp4wv3kCc5,fbPkOYLVPtPgIt0MxizjfFJov3JbHyAi,5,2,1,0,1,0,2,0,6,0.8571428571428571,1,0.0,0,1,0,1,2,0,0,2,0,2,4,1
5719,77301,kcJYaSG2iDHPRMbR56Fp0LwYxyzgRAMf,fbPkOYLVPtPgIt0MxizjfFJov3JbHyAi,5,4,2,0,2,0,2,0,10,1.4285714285714286,1,0.0,0,2,0,2,4,0,0,2,0,4,6,1
5720,77302,KRi80h1uK84snC5HvtQKWlsjwt9i3oa5,fbPkOYLVPtPgIt0MxizjfFJov3JbHyAi,16,17,11,4,8,0,8,1,49,7.0,4,0.0,2,11,4,8,15,0,0,8,1,25,24,1
5721,77303,Hh6CQ9eQF89j5a5Oi2NUf2uAs2DZd4QT,fbPkOYLVPtPgIt0MxizjfFJov3JbHyAi,5,2,1,0,1,0,2,0,6,0.8571428571428571,1,0.0,0,1,0,1,2,0,0,2,0,2,4,0
5722,77308,7QxUkfg7QVTBIqdfOWyDlZ5XM4HOAGBi,fbPkOYLVPtPgIt0MxizjfFJov3JbHyAi,1,0,0,0,0,0,1,0,1,0.14285714285714285,1,0.0,0,0,0,0,0,0,0,1,0,0,1,1
5723,77309,mzUp1IeYnFf8cMiU7U7STGbGqEYTJKv7,fbPkOYLVPtPgIt0MxizjfFJov3JbHyAi,8,3,2,0,2,0,3,0,10,1.4285714285714286,1,0.0,0,2,0,2,3,0,0,3,0,4,6,1
5724,77850,embp7e5rTedl4SQPXvv0NKkthNGlazF4,SpATywNh6bZuzm8s1ceuBUnMUAeoAHHw,48,95,38,56,22,17,33,7,268,38.285714285714285,9,0.0,20,38,45,22,75,17,11,33,7,125,143,0
5725,77861,j6kVkVGKYZT7ozL2NE5rOIexD3a1ewYn,SpATywNh6bZuzm8s1ceuBUnMUAeoAHHw,23,40,16,23,3,68,14,3,167,23.857142857142858,7,0.0,11,16,23,3,29,68,0,14,3,53,114,1
5726,77866,oTQ81PqeruuETb6SukxAp0sOazRUpE32,5X6FeZozNMgE2VRi3MJYjkkFK8SETtu2,1,0,0,0,0,0,1,0,1,0.14285714285714285,1,0.0,0,0,0,0,0,0,0,1,0,0,1,1
5727,77887,H6fuaLg1W7r0yBwU0d54zcjFYdRqOb7F,G8EPVSXsOYB5YQWZGiz1aVq5Pgr2GrQu,3,0,0,0,0,2,3,0,5,0.7142857142857143,1,0.0,0,0,0,0,0,2,0,3,0,0,5,1
5728,77899,hzFAznB2sXwDzCFipnygLE0hHHIOs6xS,SpATywNh6bZuzm8s1ceuBUnMUAeoAHHw,5,4,2,0,1,0,2,0,9,1.2857142857142858,1,0.0,0,2,0,1,4,0,0,2,0,3,6,1
5729,77902,k6QLpQDqSxoScgN883dLN4OsoeXNCHXO,A3fsA9Zfv1X2fVEQhTw51lKENdNrEqT3,42,24,20,42,15,0,4,0,105,15.0,3,0.0,1,20,40,15,23,0,2,4,0,76,29,1
5730,77929,0RJFDjD2CVBIyw0gHM4auA9R2PVZlVls,A3fsA9Zfv1X2fVEQhTw51lKENdNrEqT3,1,0,0,0,0,0,2,0,2,0.2857142857142857,1,0.0,0,0,0,0,0,0,0,2,0,0,2,1
5731,77930,I0nVBKgpf6bHOhRUWavCqORVydlrPxcM,SpATywNh6bZuzm8s1ceuBUnMUAeoAHHw,30,52,26,50,12,67,30,3,240,34.285714285714285,4,0.0,19,26,38,12,33,67,12,30,3,95,145,1
5732,77938,OzLs7gFwYfouUVXwjEfaGoBWiTah7ale,SpATywNh6bZuzm8s1ceuBUnMUAeoAHHw,5,2,0,0,0,0,3,0,5,0.7142857142857143,1,0.0,0,0,0,0,2,0,0,3,0,0,5,1
5733,77948,HAqiq102XDB03bRDdmGODD1MUBTXSItL,G8EPVSXsOYB5YQWZGiz1aVq5Pgr2GrQu,13,15,7,8,6,0,7,0,43,6.142857142857143,3,0.0,5,7,4,6,10,0,4,7,0,22,21,1
5734,77985,2F24CPGRVpuuQV8bvAX6eV5uD1OH1Kpn,G8EPVSXsOYB5YQWZGiz1aVq5Pgr2GrQu,56,80,29,112,17,23,16,2,279,39.857142857142854,2,0.0,42,29,74,17,38,23,38,16,2,162,117,0
5735,78018,fy5xZE2F1NUrBRDmEbdeJaWR2l3rL5ig,SpATywNh6bZuzm8s1ceuBUnMUAeoAHHw,1,0,0,0,0,0,1,0,1,0.14285714285714285,1,0.0,0,0,0,0,0,0,0,1,0,0,1,1
5736,78031,6eF1373FWTXebI6SSmAHBYvERI9OPpVD,5X6FeZozNMgE2VRi3MJYjkkFK8SETtu2,4,2,1,0,0,0,6,0,9,1.2857142857142858,3,0.0,0,1,0,0,2,0,0,6,0,1,8,1
5737,78064,SfR30NvxnwHQ5GQOQOoN6OMoANxaB8dS,SpATywNh6bZuzm8s1ceuBUnMUAeoAHHw,15,20,11,18,4,0,6,0,59,8.428571428571429,3,0.0,5,11,15,4,15,0,3,6,0,35,24,0
5738,78070,QohXbMcmvW7RNSJxfmP5GzKeuaXyUolt,A3fsA9Zfv1X2fVEQhTw51lKENdNrEqT3,2,0,0,0,0,0,2,0,2,0.2857142857142857,1,0.0,0,0,0,0,0,0,0,2,0,0,2,1
5739,78073,ccbXVA4l2WmbAoIr2ZeJIfHBbUkKPKY8,SpATywNh6bZuzm8s1ceuBUnMUAeoAHHw,5,3,2,0,0,0,2,0,7,1.0,1,0.0,0,2,0,0,3,0,0,2,0,2,5,1
5740,78076,QohXbMcmvW7RNSJxfmP5GzKeuaXyUolt,bWdj2GDclj5ofokWjzoa5jAwMkxCykd6,2,0,0,0,0,0,2,0,2,0.2857142857142857,1,0.0,0,0,0,0,0,0,0,2,0,0,2,1
5741,78085,EBk1CmtgbTvc4xbs4Wf7K9jFvWEzLY93,SpATywNh6bZuzm8s1ceuBUnMUAeoAHHw,4,2,0,0,0,0,2,0,4,0.5714285714285714,1,0.0,0,0,0,0,2,0,0,2,0,0,4,1
5742,78106,hu8eak1Xmf8voE8pnxPzkSD2dZP9Sipf,bWdj2GDclj5ofokWjzoa5jAwMkxCykd6,8,9,0,20,0,4,23,0,56,8.0,9,0.0,2,0,18,0,7,4,2,23,0,20,36,0
5743,78107,UuDjs68Ty88iPLGMXsqZ9bEqUXmWG3bB,RXDvfPUBYFlVdlueBFbLW0mhhAyGEqpt,5,2,1,0,1,0,2,0,6,0.8571428571428571,1,0.0,0,1,0,1,2,0,0,2,0,2,4,1
5744,78131,TCKPmzjJvJ3IQnj25q0Ug4x7iyC4opM1,G8EPVSXsOYB5YQWZGiz1aVq5Pgr2GrQu,10,39,6,10,7,0,2,0,64,9.142857142857142,1,0.0,31,6,7,7,8,0,3,2,0,51,13,1
5745,78134,CNb0Sul2DOkX3VhMOeM6DWqvlrGgHagf,SpATywNh6bZuzm8s1ceuBUnMUAeoAHHw,42,63,28,59,16,1,10,1,178,25.428571428571427,5,0.0,18,28,51,16,45,1,8,10,1,113,65,1
5746,78144,GcwFf1WfRMSdZDYsPn5itkdYlvMUCmT9,SpATywNh6bZuzm8s1ceuBUnMUAeoAHHw,25,44,8,23,4,1,9,2,91,13.0,5,0.0,7,8,21,4,37,1,2,9,2,40,51,0
5747,78146,sFLCac725cSrEUin5pNRyKxt7gjQ6A4F,SpATywNh6bZuzm8s1ceuBUnMUAeoAHHw,1,0,0,0,0,0,1,0,1,0.14285714285714285,1,0.0,0,0,0,0,0,0,0,1,0,0,1,1
5748,78150,fohEc7UwYR3csB1Bpgdq1GKT1TmpT3GW,RXDvfPUBYFlVdlueBFbLW0mhhAyGEqpt,6,3,1,0,0,1,7,0,12,1.7142857142857142,1,0.0,0,1,0,0,3,1,0,7,0,1,11,1
5749,78171,wMCI1PhSc7dgaQ1Qp894BNH0MKlDhGE0,5X6FeZozNMgE2VRi3MJYjkkFK8SETtu2,1,0,0,0,0,0,1,0,1,0.14285714285714285,1,0.0,0,0,0,0,0,0,0,1,0,0,1,1
5750,78188,CNb0Sul2DOkX3VhMOeM6DWqvlrGgHagf,bWdj2GDclj5ofokWjzoa5jAwMkxCykd6,9,12,7,0,4,10,7,1,41,5.857142857142857,4,0.0,0,7,0,4,12,10,0,7,1,11,30,1
5751,78247,BLoa1RvSOgexbSH4hGzCihmBc8pXd0Db,A3fsA9Zfv1X2fVEQhTw51lKENdNrEqT3,52,73,13,66,10,6,15,5,188,26.857142857142858,4,0.0,1,13,56,10,72,6,10,15,5,80,108,1
5752,78252,CWfEuozBd4liyBTvOMVgNSWJo0S8l1jG,bWdj2GDclj5ofokWjzoa5jAwMkxCykd6,5,2,1,0,1,0,2,0,6,0.8571428571428571,1,0.0,0,1,0,1,2,0,0,2,0,2,4,1
5753,78259,qrEmM3cwwlnfXom63xX0BSDx8s5nHv9K,bWdj2GDclj5ofokWjzoa5jAwMkxCykd6,2,0,0,0,0,0,2,0,2,0.2857142857142857,1,0.0,0,0,0,0,0,0,0,2,0,0,2,1
5754,78275,FVKs2RoZnz9qxmMnghcMqKWH7KjgxJV1,RXDvfPUBYFlVdlueBFbLW0mhhAyGEqpt,7,4,3,0,2,0,1,0,10,1.4285714285714286,1,0.0,0,3,0,2,4,0,0,1,0,5,5,1
5755,78278,VtX4hhecWicdXYhNKnhWUU7LwsYiud5S,bWdj2GDclj5ofokWjzoa5jAwMkxCykd6,1,0,0,0,0,0,1,0,1,0.14285714285714285,1,0.0,0,0,0,0,0,0,0,1,0,0,1,1
5756,78291,eIz1QdRrhcYteukRLgOlTi2GZdnEpdtj,A3fsA9Zfv1X2fVEQhTw51lKENdNrEqT3,4,2,0,0,0,0,2,0,4,0.5714285714285714,1,0.0,0,0,0,0,2,0,0,2,0,0,4,1
5757,78294,kj5o7wMZl1s4q0cggcmipnm7O7L6g4Ps,bWdj2GDclj5ofokWjzoa5jAwMkxCykd6,25,34,17,122,12,7,10,0,202,28.857142857142858,4,0.0,10,17,117,12,24,7,5,10,0,156,46,0
5758,78326,VhJqWY1s8NggIUb1uIcah3mgkAeL4PFu,5X6FeZozNMgE2VRi3MJYjkkFK8SETtu2,1,0,0,0,0,0,1,0,1,0.14285714285714285,1,0.0,0,0,0,0,0,0,0,1,0,0,1,0
5759,78328,VhJqWY1s8NggIUb1uIcah3mgkAeL4PFu,G8EPVSXsOYB5YQWZGiz1aVq5Pgr2GrQu,1,0,0,0,0,0,1,0,1,0.14285714285714285,1,0.0,0,0,0,0,0,0,0,1,0,0,1,1
5760,78349,EfoxsYvaiqTPtWZL7NNMHTBPpoZQt5UK,5X6FeZozNMgE2VRi3MJYjkkFK8SETtu2,1,0,0,0,0,0,1,0,1,0.14285714285714285,1,0.0,0,0,0,0,0,0,0,1,0,0,1,1
5761,78356,l8Cml1vejHI8GVsgohdNxJJsxeTOpjUQ,SpATywNh6bZuzm8s1ceuBUnMUAeoAHHw,18,16,11,5,5,1,6,1,45,6.428571428571429,2,0.0,3,11,4,5,13,1,1,6,1,23,22,1
5762,78364,v6o58htBZfIjF729xn3THeVFCKiQP2tT,G8EPVSXsOYB5YQWZGiz1aVq5Pgr2GrQu,14,14,2,0,2,2,4,1,25,3.5714285714285716,2,0.0,1,2,0,2,13,2,0,4,1,5,20,1
5763,78367,DC7ZPAOAq4kNVVbfZX7lyJLqoL2DWXgr,SpATywNh6bZuzm8s1ceuBUnMUAeoAHHw,7,14,8,0,6,0,3,0,31,4.428571428571429,2,0.0,0,8,0,6,14,0,0,3,0,14,17,1
5764,78369,0IbJQ4JZw38po4OGlmKDFjW0GOhUHJWw,5X6FeZozNMgE2VRi3MJYjkkFK8SETtu2,4,3,1,0,0,0,3,0,7,1.0,1,0.0,0,1,0,0,3,0,0,3,0,1,6,1
5765,78377,prctO66liDrlGVTKAk1UIHOjT2rY6cZg,5X6FeZozNMgE2VRi3MJYjkkFK8SETtu2,9,8,2,11,4,0,3,0,28,4.0,2,0.0,5,2,9,4,3,0,2,3,0,20,8,1
5766,78379,J4Fo8v0uo0dR8AKSqg2SMkO8YLPwA09H,G8EPVSXsOYB5YQWZGiz1aVq5Pgr2GrQu,1,0,0,0,0,0,4,0,4,0.5714285714285714,1,0.0,0,0,0,0,0,0,0,4,0,0,4,1
5767,78385,dovSPYooNHmzLLH97Ddy4FG7Uxhw5XJl,SpATywNh6bZuzm8s1ceuBUnMUAeoAHHw,4,4,0,0,0,0,2,0,6,0.8571428571428571,1,0.0,0,0,0,0,4,0,0,2,0,0,6,1
5768,78406,fsn9YvLK8wuINxunCG4BkE8FOh4c3KxI,SpATywNh6bZuzm8s1ceuBUnMUAeoAHHw,7,8,0,0,0,0,1,0,9,1.2857142857142858,1,0.0,2,0,0,0,6,0,0,1,0,2,7,1
5769,78417,IA94V4Giz1ScEF7hFgZ0OnUwltaLmI18,5X6FeZozNMgE2VRi3MJYjkkFK8SETtu2,4,9,3,0,0,0,4,0,16,2.2857142857142856,3,0.0,0,3,0,0,9,0,0,4,0,3,13,1
5770,78429,HLfj9ZxtIK3gYbcHFCAqaNCGqWLq7h1g,SpATywNh6bZuzm8s1ceuBUnMUAeoAHHw,34,45,2,41,0,4,10,2,104,14.857142857142858,3,0.0,14,2,38,0,31,4,3,10,2,54,50,0
5771,78452,ukfWsseqqJzHHxAFnLMKYh1SZzExeQ1z,SpATywNh6bZuzm8s1ceuBUnMUAeoAHHw,5,5,1,0,0,0,4,0,10,1.4285714285714286,3,0.0,0,1,0,0,5,0,0,4,0,1,9,1
5772,78454,4N9xQarXAZMYyOjOJvMQmOHnVfoe0iL0,bWdj2GDclj5ofokWjzoa5jAwMkxCykd6,5,2,1,0,1,0,2,0,6,0.8571428571428571,1,0.0,0,1,0,1,2,0,0,2,0,2,4,1
5773,78462,4N9xQarXAZMYyOjOJvMQmOHnVfoe0iL0,A3fsA9Zfv1X2fVEQhTw51lKENdNrEqT3,2,0,0,0,0,0,4,0,4,0.5714285714285714,2,0.0,0,0,0,0,0,0,0,4,0,0,4,1
5774,78478,CVkN7W2203PPB4rzsX0i8SBpQ0bSRkaq,SpATywNh6bZuzm8s1ceuBUnMUAeoAHHw,13,14,9,0,5,0,5,0,33,4.714285714285714,3,0.0,2,9,0,5,12,0,0,5,0,16,17,1
5775,78546,Ckb71Ev9RlsIUvVDfkFS0AumQJilppvB,G8EPVSXsOYB5YQWZGiz1aVq5Pgr2GrQu,6,5,3,0,2,0,4,0,14,2.0,2,0.0,0,3,0,2,5,0,0,4,0,5,9,1
5776,78552,J3O8yjXr4pvdR3n8Y9AW4odHeMijwVD2,bWdj2GDclj5ofokWjzoa5jAwMkxCykd6,1,0,0,0,0,0,1,0,1,0.14285714285714285,1,0.0,0,0,0,0,0,0,0,1,0,0,1,1
5777,78554,byxGWUJV72XqYw0RcV5v8EuZ9oh6gief,A3fsA9Zfv1X2fVEQhTw51lKENdNrEqT3,5,2,1,0,1,0,2,0,6,0.8571428571428571,1,0.0,0,1,0,1,2,0,0,2,0,2,4,1
5778,78563,Q0vBzPj4VWPVd7xoAbS8zktOTeProdeI,SpATywNh6bZuzm8s1ceuBUnMUAeoAHHw,3,0,0,0,0,0,3,0,3,0.42857142857142855,1,0.0,0,0,0,0,0,0,0,3,0,0,3,1
5779,78566,5maEerTJ8LtZeFZwRiLIZfXoq0lcubLt,SpATywNh6bZuzm8s1ceuBUnMUAeoAHHw,6,1,0,0,0,1,5,1,8,1.1428571428571428,1,0.0,0,0,0,0,1,1,0,5,1,0,8,1
5780,78591,W7aaCFsYNegloRh1IlKOwq22jdh9r52p,bWdj2GDclj5ofokWjzoa5jAwMkxCykd6,6,3,2,0,2,0,1,0,8,1.1428571428571428,1,0.0,0,2,0,2,3,0,0,1,0,4,4,1
5781,78603,7u0QfTKQg4itZK9m8foLXkIGwUxxHMsT,SpATywNh6bZuzm8s1ceuBUnMUAeoAHHw,46,43,24,23,14,0,9,0,113,16.142857142857142,5,0.0,14,24,21,14,29,0,2,9,0,73,40,0
5782,78614,nMd49DSNNePu4Cd3bHT7FsqsTOmZl63t,SpATywNh6bZuzm8s1ceuBUnMUAeoAHHw,6,4,1,0,1,0,3,0,9,1.2857142857142858,1,0.0,0,1,0,1,4,0,0,3,0,2,7,1
5783,78624,QVaNdoLdCHk4HcXO8MB1JKVhy7nw6JiC,SpATywNh6bZuzm8s1ceuBUnMUAeoAHHw,6,4,2,0,2,0,2,0,10,1.4285714285714286,1,0.0,0,2,0,2,4,0,0,2,0,4,6,1
5784,78643,9QoP6HvypJsXUxtVuM29FbJymaoWAuTM,G8EPVSXsOYB5YQWZGiz1aVq5Pgr2GrQu,1,0,0,0,0,0,1,0,1,0.14285714285714285,1,0.0,0,0,0,0,0,0,0,1,0,0,1,1
5785,78648,fjIKsKO6rizBomnPFn2db56S1nui3RlN,A3fsA9Zfv1X2fVEQhTw51lKENdNrEqT3,50,29,21,68,13,9,11,1,152,21.714285714285715,2,0.0,3,21,58,13,26,9,10,11,1,95,57,1
5786,78663,4dVGo2nGpdhjYgYbTYmjlligu2kflHn7,5X6FeZozNMgE2VRi3MJYjkkFK8SETtu2,12,19,4,13,0,0,3,0,39,5.571428571428571,1,0.0,8,4,13,0,11,0,0,3,0,25,14,1
5787,78671,9keXBjwmh66adK5DT8X8J8K1A8xi7IUl,RXDvfPUBYFlVdlueBFbLW0mhhAyGEqpt,2,0,0,0,0,0,2,0,2,0.2857142857142857,1,0.0,0,0,0,0,0,0,0,2,0,0,2,1
5788,78673,Ufo4AkS2vTW82q9Kpcrkrp0gG0Us5zu9,A3fsA9Zfv1X2fVEQhTw51lKENdNrEqT3,6,3,1,0,1,0,2,0,7,1.0,1,0.0,0,1,0,1,3,0,0,2,0,2,5,1
5789,78682,nVXGW3QRysmVp7bseFXpH5xogt6vyuOe,SpATywNh6bZuzm8s1ceuBUnMUAeoAHHw,4,5,2,0,2,0,1,0,10,1.4285714285714286,1,0.0,0,2,0,2,5,0,0,1,0,4,6,1
5790,78705,xXEgWJZrqICodDuxWm4svOQTBLDSu5hO,SpATywNh6bZuzm8s1ceuBUnMUAeoAHHw,7,7,4,0,2,1,4,0,18,2.5714285714285716,1,0.0,1,4,0,2,6,1,0,4,0,7,11,1
5791,78715,5Zgwu2mRcsc21AmNDehMpm5vDwlgKfhs,SpATywNh6bZuzm8s1ceuBUnMUAeoAHHw,38,36,24,19,15,1,14,2,111,15.857142857142858,3,0.0,8,24,18,15,28,1,1,14,2,65,46,1
5792,78742,rcukprbmUUwwNHHsW6YmnM6VwI4ca3R8,A3fsA9Zfv1X2fVEQhTw51lKENdNrEqT3,14,10,7,0,4,0,6,0,27,3.857142857142857,1,0.0,0,7,0,4,10,0,0,6,0,11,16,0
5793,78786,r62e9eSPsszv1Iv2O1V4lcMcbaHlq1ob,SpATywNh6bZuzm8s1ceuBUnMUAeoAHHw,18,22,2,25,0,0,3,0,52,7.428571428571429,2,0.0,6,2,21,0,16,0,4,3,0,29,23,0
5794,78791,Jio2hP66Psjw6H7dqS3rSmz5gymQvwGj,SpATywNh6bZuzm8s1ceuBUnMUAeoAHHw,7,6,0,1,0,0,2,0,9,1.2857142857142858,1,0.0,1,0,1,0,5,0,0,2,0,2,7,1
5795,78797,5NRnaGcpNIGEuH61FLOcxB7Rjs6WPiNk,SpATywNh6bZuzm8s1ceuBUnMUAeoAHHw,49,72,40,23,17,1,28,1,182,26.0,6,0.0,15,40,21,17,57,1,2,28,1,93,89,0
5796,78801,jaHWKFBvrvFfPb0Pq50zaMZ2xpeRooXu,A3fsA9Zfv1X2fVEQhTw51lKENdNrEqT3,1,0,0,0,0,0,1,0,1,0.14285714285714285,1,0.0,0,0,0,0,0,0,0,1,0,0,1,0
5797,78827,BfP8PslkevtFenf019uAk6GhN9zhCFdJ,bWdj2GDclj5ofokWjzoa5jAwMkxCykd6,15,26,11,0,7,1,12,1,58,8.285714285714286,1,0.0,6,11,0,7,20,1,0,12,1,24,34,1
5798,78845,900ZMEgjiXT78JdNbM02wL3ugTz6vLs2,G8EPVSXsOYB5YQWZGiz1aVq5Pgr2GrQu,7,6,1,0,0,0,10,0,17,2.4285714285714284,2,0.0,0,1,0,0,6,0,0,10,0,1,16,1
5799,78848,oZKhsAromYlsN9MhR64yAv55dJDSDM8L,G8EPVSXsOYB5YQWZGiz1aVq5Pgr2GrQu,33,42,19,46,8,0,13,1,129,18.428571428571427,7,0.0,10,19,37,8,32,0,9,13,1,74,55,1
5800,78886,pgMwb3FHEjNb1xNpBTJ5ysmRdBbuUNFr,bWdj2GDclj5ofokWjzoa5jAwMkxCykd6,12,11,2,14,2,0,3,0,32,4.571428571428571,3,0.0,1,2,14,2,10,0,0,3,0,19,13,1
5801,78899,XKfrMCVtqlIZ8enVJyGd7DD1q7PXaYx0,RXDvfPUBYFlVdlueBFbLW0mhhAyGEqpt,12,7,1,0,1,1,8,2,20,2.857142857142857,1,0.0,0,1,0,1,7,1,0,8,2,2,18,1
5802,78910,R6RINUtJNooptLfHmBRIBRqFOknkjv0Y,A3fsA9Zfv1X2fVEQhTw51lKENdNrEqT3,32,79,32,0,34,6,31,0,182,26.0,7,0.0,0,32,0,34,79,6,0,31,0,66,116,1
5803,78918,8Sqo9fjyeTTkNJlQMuecsmvzSyQTiwcU,bWdj2GDclj5ofokWjzoa5jAwMkxCykd6,4,2,0,0,0,0,6,0,8,1.1428571428571428,1,0.0,0,0,0,0,2,0,0,6,0,0,8,1
5804,78924,E96VmAw6m1AOHRckdqiq2ASKbnHBlpAb,bWdj2GDclj5ofokWjzoa5jAwMkxCykd6,1,0,0,0,0,0,3,0,3,0.42857142857142855,3,0.0,0,0,0,0,0,0,0,3,0,0,3,1
5805,78930,E96VmAw6m1AOHRckdqiq2ASKbnHBlpAb,G8EPVSXsOYB5YQWZGiz1aVq5Pgr2GrQu,83,151,39,142,27,10,11,0,380,54.285714285714285,5,0.0,69,39,92,27,82,10,50,11,0,227,153,0
5806,78943,9V8VFOZzrHxUcwRnnOPkl8rtMgpamwhU,SpATywNh6bZuzm8s1ceuBUnMUAeoAHHw,21,12,9,10,6,0,2,0,39,5.571428571428571,2,0.0,2,9,9,6,10,0,1,2,0,26,13,1
5807,78953,AZZvRPcRkLSa6vwofzfwsEULTUhiKy0E,SpATywNh6bZuzm8s1ceuBUnMUAeoAHHw,38,122,40,27,11,83,61,3,347,49.57142857142857,13,0.0,28,40,24,11,94,83,3,61,3,103,244,0
5808,78954,NTiEDRwIJDqquqeFtNjQXUg4Zc46ytbZ,A3fsA9Zfv1X2fVEQhTw51lKENdNrEqT3,6,3,1,0,1,0,2,0,7,1.0,1,0.0,0,1,0,1,3,0,0,2,0,2,5,1
5809,78971,d1mccaMvv72HL0M2QdKzu9aosPAbZ4Jm,SpATywNh6bZuzm8s1ceuBUnMUAeoAHHw,35,55,5,24,4,7,4,1,100,14.285714285714286,5,0.0,8,5,23,4,47,7,1,4,1,40,60,0
5810,78976,lcVqjHqBHtoTMy2BSyBnlkYx5IiPAsSb,bWdj2GDclj5ofokWjzoa5jAwMkxCykd6,7,3,2,0,2,0,2,0,9,1.2857142857142858,1,0.0,0,2,0,2,3,0,0,2,0,4,5,1
5811,79024,PK7vOojKKM8ZMg0GtBGDF9d0jIW1oXVZ,RXDvfPUBYFlVdlueBFbLW0mhhAyGEqpt,28,35,23,41,11,4,7,2,123,17.571428571428573,2,0.0,6,23,36,11,29,4,5,7,2,76,47,1
5812,79034,BvXEJOM5AeibxeBR17cOLsAehRuv6EQw,SpATywNh6bZuzm8s1ceuBUnMUAeoAHHw,6,3,2,0,2,0,1,0,8,1.1428571428571428,1,0.0,0,2,0,2,3,0,0,1,0,4,4,1
5813,79037,RMjCtTkNaNDIV51mcacmsIEv4W4wGcOW,RXDvfPUBYFlVdlueBFbLW0mhhAyGEqpt,5,2,1,0,1,0,2,0,6,0.8571428571428571,1,0.0,0,1,0,1,2,0,0,2,0,2,4,1
5814,79065,0baA6sMZRRooPzlc3eqoVKOLHs7oBMf1,SpATywNh6bZuzm8s1ceuBUnMUAeoAHHw,1,0,0,0,0,0,1,0,1,0.14285714285714285,1,0.0,0,0,0,0,0,0,0,1,0,0,1,1
5815,79085,jByBG50ghoSer5UP92qpkAfDGFpraaH7,RXDvfPUBYFlVdlueBFbLW0mhhAyGEqpt,3,0,0,0,0,0,4,0,4,0.5714285714285714,3,0.0,0,0,0,0,0,0,0,4,0,0,4,1
5816,79088,oA5bEHkRJtiDJKnesmAjUtrhTVSOkHe2,SpATywNh6bZuzm8s1ceuBUnMUAeoAHHw,19,33,21,14,12,0,8,0,88,12.571428571428571,4,0.0,6,21,13,12,27,0,1,8,0,52,36,1
5817,79106,7Xbcyzr5w9UbFD6viSl5LziGgJLlGTSQ,5X6FeZozNMgE2VRi3MJYjkkFK8SETtu2,19,51,4,27,13,0,11,0,106,15.142857142857142,3,0.0,20,4,22,13,31,0,5,11,0,59,47,1
5818,79112,NCq7uMk20xis3HUzEQcWP2K284TvGGUT,5X6FeZozNMgE2VRi3MJYjkkFK8SETtu2,14,16,6,12,8,0,1,0,43,6.142857142857143,1,0.0,9,6,10,8,7,0,2,1,0,33,10,1
5819,79114,oBHfkEBZPsjUqPWXyw1yW9Gipn9KMPDQ,SpATywNh6bZuzm8s1ceuBUnMUAeoAHHw,10,19,8,0,4,0,5,0,36,5.142857142857143,3,0.0,0,8,0,4,19,0,0,5,0,12,24,1
5820,79115,DGHGkVhiaZ33J21HoxaqqxRbqavzVFGk,A3fsA9Zfv1X2fVEQhTw51lKENdNrEqT3,10,16,1,0,1,0,5,0,23,3.2857142857142856,1,0.0,0,1,0,1,16,0,0,5,0,2,21,1
5821,79116,oeEXBADlWmjYmDN9P4tzDfKaayj6OdaD,G8EPVSXsOYB5YQWZGiz1aVq5Pgr2GrQu,31,53,20,62,7,3,10,3,158,22.571428571428573,2,0.0,28,20,40,7,25,3,22,10,3,95,63,1
5822,79128,Ph6B1QAiUfnOFxg1hNL5nD7wXbSCaM6i,G8EPVSXsOYB5YQWZGiz1aVq5Pgr2GrQu,30,28,23,44,11,0,16,2,124,17.714285714285715,2,0.0,0,23,38,11,28,0,6,16,2,72,52,1
5823,79150,1anSA7G3nrsDO0JSarewPnqCvjcLjtpi,SpATywNh6bZuzm8s1ceuBUnMUAeoAHHw,25,46,16,16,7,1,9,0,95,13.571428571428571,5,0.0,7,16,15,7,39,1,1,9,0,45,50,0
5824,79164,wGfXRYqHkdAo1fVEEY9NvW8qy6M9m0mI,A3fsA9Zfv1X2fVEQhTw51lKENdNrEqT3,51,69,32,62,18,52,26,6,265,37.857142857142854,8,0.0,3,32,59,18,66,52,3,26,6,112,153,1
5825,79191,xjuSmklePl6doFxX117CjHgupR8gIiqr,G8EPVSXsOYB5YQWZGiz1aVq5Pgr2GrQu,6,5,1,0,1,0,3,0,10,1.4285714285714286,1,0.0,0,1,0,1,5,0,0,3,0,2,8,1
5826,79208,88xoeZRrDqjjjrf57zHp7JPU0EIVMG6O,SpATywNh6bZuzm8s1ceuBUnMUAeoAHHw,9,11,0,14,0,0,3,0,28,4.0,2,0.0,5,0,14,0,6,0,0,3,0,19,9,1
5827,79211,Ja905y236QEClSbNQNnPtVvburZ1SbjM,5X6FeZozNMgE2VRi3MJYjkkFK8SETtu2,9,16,6,0,6,0,3,0,31,4.428571428571429,1,0.0,4,6,0,6,12,0,0,3,0,16,15,1
5828,79213,kuV0mzlgGFUIK4wXcwcPFRatONM4P10L,SpATywNh6bZuzm8s1ceuBUnMUAeoAHHw,15,26,11,23,1,0,8,0,69,9.857142857142858,4,0.0,9,11,18,1,17,0,5,8,0,39,30,0
5829,79232,SSC60v48DtGYrHD9najK5BurQrkLKWXS,SpATywNh6bZuzm8s1ceuBUnMUAeoAHHw,1,0,0,0,0,0,1,0,1,0.14285714285714285,1,0.0,0,0,0,0,0,0,0,1,0,0,1,1
5830,79265,V1B34PKYcESnicIbQVUA4gpuU2uOqNWz,bWdj2GDclj5ofokWjzoa5jAwMkxCykd6,10,27,10,0,4,0,8,0,49,7.0,2,0.0,7,10,0,4,20,0,0,8,0,21,28,1
5831,79268,V1B34PKYcESnicIbQVUA4gpuU2uOqNWz,SpATywNh6bZuzm8s1ceuBUnMUAeoAHHw,18,18,16,0,8,4,10,1,57,8.142857142857142,3,0.0,0,16,0,8,18,4,0,10,1,24,33,1
5832,79269,1bKMONcV6Mq58szdlIajPdFyqaw4BvrA,bWdj2GDclj5ofokWjzoa5jAwMkxCykd6,5,2,1,0,1,0,2,0,6,0.8571428571428571,1,0.0,0,1,0,1,2,0,0,2,0,2,4,1
5833,79274,aS1MRv3e3cFJbWfbj7uedfCUW4ml1QfE,SpATywNh6bZuzm8s1ceuBUnMUAeoAHHw,18,29,20,6,8,0,8,0,71,10.142857142857142,3,0.0,2,20,5,8,27,0,1,8,0,35,36,0
5834,79296,q84ghl694GzSAMHfGeDgZUVdIow6vpJO,SpATywNh6bZuzm8s1ceuBUnMUAeoAHHw,13,19,9,4,6,0,1,0,39,5.571428571428571,2,0.0,8,9,4,6,11,0,0,1,0,27,12,1
5835,79317,9L22i5qdoV8PU8pyjQgR5HeuxRCoRVpK,SpATywNh6bZuzm8s1ceuBUnMUAeoAHHw,24,44,25,15,14,0,7,0,105,15.0,3,0.0,0,25,13,14,44,0,2,7,0,52,53,1
5836,79322,b9hN1tjIpM67gB8PuwPQ3u561lqo1V2f,RXDvfPUBYFlVdlueBFbLW0mhhAyGEqpt,13,13,10,0,6,0,14,3,46,6.571428571428571,4,0.0,0,10,0,6,13,0,0,14,3,16,30,0
5837,79339,PNuCKnyPWCRVxphTjJ1pIquyKu0dURK7,A3fsA9Zfv1X2fVEQhTw51lKENdNrEqT3,4,3,1,0,0,0,2,0,6,0.8571428571428571,1,0.0,0,1,0,0,3,0,0,2,0,1,5,1
5838,79340,UA8vU3s92g3lXc62U363PEO0xor6Mpeg,5X6FeZozNMgE2VRi3MJYjkkFK8SETtu2,9,21,6,0,12,0,4,0,43,6.142857142857143,4,0.0,11,6,0,12,10,0,0,4,0,29,14,0
5839,79353,SHRanMph56qnHJKMofxrIA8VyLg99gvL,bWdj2GDclj5ofokWjzoa5jAwMkxCykd6,4,4,0,0,0,0,2,0,6,0.8571428571428571,2,0.0,0,0,0,0,4,0,0,2,0,0,6,0
5840,79354,gBZ3DHDU78LvTtx2wVh6bkCOt1eL771m,A3fsA9Zfv1X2fVEQhTw51lKENdNrEqT3,11,11,1,0,1,0,5,0,18,2.5714285714285716,2,0.0,0,1,0,1,11,0,0,5,0,2,16,1
5841,79387,GCu64KhvD3k4ysmsfT3aBU2fTrWS3rtB,SpATywNh6bZuzm8s1ceuBUnMUAeoAHHw,5,5,0,0,0,0,2,0,7,1.0,1,0.0,0,0,0,0,5,0,0,2,0,0,7,1
5842,79391,Q3913BpDariYbEj8ZlFy9MQJV1rZlZAJ,SpATywNh6bZuzm8s1ceuBUnMUAeoAHHw,10,37,3,19,0,0,6,0,65,9.285714285714286,5,0.0,12,3,18,0,25,0,1,6,0,33,32,1
5843,79403,xWXhCGrW03YluuceUyewYdqXryhbgrdd,SpATywNh6bZuzm8s1ceuBUnMUAeoAHHw,9,4,1,0,1,5,6,1,18,2.5714285714285716,1,0.0,0,1,0,1,4,5,0,6,1,2,16,1
5844,79433,1WrKf0VE4OvwmI8ZMK9zpJFtYHCCItqb,SpATywNh6bZuzm8s1ceuBUnMUAeoAHHw,1,0,0,0,0,0,1,0,1,0.14285714285714285,1,0.0,0,0,0,0,0,0,0,1,0,0,1,1
5845,79439,crl3o7sxyMWLnKWiaz3BBw0rhIdF3cXr,bWdj2GDclj5ofokWjzoa5jAwMkxCykd6,19,26,1,54,2,12,17,1,113,16.142857142857142,2,0.0,13,1,53,2,13,12,1,17,1,69,44,1
5846,79442,mCWUqPjCgQQazWm9jyDsH7XslBjGoVeA,SpATywNh6bZuzm8s1ceuBUnMUAeoAHHw,18,12,9,0,7,0,5,0,33,4.714285714285714,1,0.0,0,9,0,7,12,0,0,5,0,16,17,1
5847,79449,qwFDXKt0M8f2bQWHQ9IwMnRpFGf93NNf,SpATywNh6bZuzm8s1ceuBUnMUAeoAHHw,16,20,11,23,4,1,12,1,72,10.285714285714286,6,0.0,2,11,18,4,18,1,5,12,1,35,37,1
5848,79450,IKVKcza5vT9JehCbhoro1CRnVpL575lj,SpATywNh6bZuzm8s1ceuBUnMUAeoAHHw,15,9,5,3,3,0,5,0,25,3.5714285714285716,2,0.0,3,5,3,3,6,0,0,5,0,14,11,1
5849,79465,se9ZVl8DNkiCW8i2nP0p3krrUcQqYC47,5X6FeZozNMgE2VRi3MJYjkkFK8SETtu2,5,3,2,0,1,0,1,0,7,1.0,1,0.0,0,2,0,1,3,0,0,1,0,3,4,1
5850,79466,fu60FMGFqAwgUp8glfVKZNcdqYonSFb4,A3fsA9Zfv1X2fVEQhTw51lKENdNrEqT3,12,11,3,0,2,0,7,0,23,3.2857142857142856,1,0.0,0,3,0,2,11,0,0,7,0,5,18,1
5851,79481,IHB272IdBeuDM3MeGjnOfHr8AhA89HNb,RXDvfPUBYFlVdlueBFbLW0mhhAyGEqpt,45,52,36,63,12,25,10,0,198,28.285714285714285,4,0.0,9,36,55,12,43,25,8,10,0,112,86,1
5852,79483,i39wrwOFUT4cBFVx9tMMQ3lQ2qJwZK9W,A3fsA9Zfv1X2fVEQhTw51lKENdNrEqT3,18,21,11,0,6,4,6,2,50,7.142857142857143,3,0.0,0,11,0,6,21,4,0,6,2,17,33,1
5853,79509,G0i0hCTwH2K62ld1aO6Hf5Ntp0ahokSh,SpATywNh6bZuzm8s1ceuBUnMUAeoAHHw,30,62,29,19,11,16,45,4,186,26.571428571428573,6,0.0,14,29,19,11,48,16,0,45,4,73,113,0
5854,79519,NUQJxbePNRtXQQBXCQFchv4ww5sWUrml,SpATywNh6bZuzm8s1ceuBUnMUAeoAHHw,31,54,1,41,2,3,31,1,133,19.0,8,0.0,15,1,35,2,39,3,6,31,1,53,80,0
5855,79526,iF24oNq097ygA95BwYxAfvpVnpWVn9EH,5X6FeZozNMgE2VRi3MJYjkkFK8SETtu2,1,0,0,0,0,0,1,0,1,0.14285714285714285,1,0.0,0,0,0,0,0,0,0,1,0,0,1,1
5856,79538,68aPv7D3ZE4JVkIRm8IjOcsEwxcFlwFO,A3fsA9Zfv1X2fVEQhTw51lKENdNrEqT3,3,3,0,0,0,0,1,0,4,0.5714285714285714,1,0.0,0,0,0,0,3,0,0,1,0,0,4,1
5857,79548,xt59FC0u82DgUh4CRpEaJwaXZlH1aLO1,SpATywNh6bZuzm8s1ceuBUnMUAeoAHHw,29,60,38,12,24,0,23,1,158,22.571428571428573,5,0.0,9,38,11,24,51,0,1,23,1,82,76,0
5858,79555,ygHFzUOzEqkLxFm5OclfxvG9i48BUAuT,SpATywNh6bZuzm8s1ceuBUnMUAeoAHHw,17,37,3,0,1,10,11,3,65,9.285714285714286,4,0.0,3,3,0,1,34,10,0,11,3,7,58,0
5859,79571,NpWI6qpknO723dhhdi9gGeQ3D9TLPFRi,5X6FeZozNMgE2VRi3MJYjkkFK8SETtu2,1,0,0,0,0,0,1,0,1,0.14285714285714285,1,0.0,0,0,0,0,0,0,0,1,0,0,1,1
5860,79576,w1E1CWgFfuFOCR0VzQkihC3ia5yrssmV,RXDvfPUBYFlVdlueBFbLW0mhhAyGEqpt,1,0,0,0,0,0,1,0,1,0.14285714285714285,1,0.0,0,0,0,0,0,0,0,1,0,0,1,1
5861,79592,D6jwUujWuVnAZzyPLog7cSVfWJ6qOkhT,SpATywNh6bZuzm8s1ceuBUnMUAeoAHHw,22,33,0,31,0,11,17,4,96,13.714285714285714,1,0.0,15,0,28,0,18,11,3,17,4,43,53,1
5862,79604,ZbdgVvxsxyG1aqBQ8n6eLVu27gWAZvhX,bWdj2GDclj5ofokWjzoa5jAwMkxCykd6,1,0,0,0,0,0,1,0,1,0.14285714285714285,1,0.0,0,0,0,0,0,0,0,1,0,0,1,1
5863,79619,Z21gQGlXtQP1JO0odoLDtH3q2Pa791DY,bWdj2GDclj5ofokWjzoa5jAwMkxCykd6,8,25,12,0,6,3,10,3,59,8.428571428571429,4,0.0,7,12,0,6,18,3,0,10,3,25,34,1
5864,79633,om6ZOCO8LNIrRrNbdISrPEP9oSUDMJl3,SpATywNh6bZuzm8s1ceuBUnMUAeoAHHw,21,15,11,18,8,1,8,1,62,8.857142857142858,1,0.0,2,11,16,8,13,1,2,8,1,37,25,1
5865,79634,rScZ8wYdCfayAwidHm4E5aYRTim0GnWj,bWdj2GDclj5ofokWjzoa5jAwMkxCykd6,6,11,3,0,5,0,5,0,24,3.4285714285714284,1,0.0,6,3,0,5,5,0,0,5,0,14,10,1
5866,79638,Ilrg7TMz0MlMLaAx4PALASUPnlbAGSuF,5X6FeZozNMgE2VRi3MJYjkkFK8SETtu2,19,34,11,24,9,2,11,1,92,13.142857142857142,1,0.0,18,11,21,9,16,2,3,11,1,59,33,1
5867,79647,y8iVrI2EkMZTkanlXaBHyxYcB0wN7UeI,SpATywNh6bZuzm8s1ceuBUnMUAeoAHHw,4,3,1,0,1,0,1,0,6,0.8571428571428571,1,0.0,0,1,0,1,3,0,0,1,0,2,4,1
5868,79661,yh14zaFitCUTgvBPqRXiaZ6cUijtktL4,bWdj2GDclj5ofokWjzoa5jAwMkxCykd6,5,2,1,0,1,0,2,0,6,0.8571428571428571,1,0.0,0,1,0,1,2,0,0,2,0,2,4,1
5869,79668,7nUtazUwwSnnXJpIKdQBJGpXV6Po42DQ,bWdj2GDclj5ofokWjzoa5jAwMkxCykd6,21,34,3,127,6,0,19,0,189,27.0,3,0.0,9,3,121,6,25,0,6,19,0,139,50,1
5870,79671,3njhidxBzYHOjpYDGROQcUAReorseJK1,RXDvfPUBYFlVdlueBFbLW0mhhAyGEqpt,1,0,0,0,0,0,1,0,1,0.14285714285714285,1,0.0,0,0,0,0,0,0,0,1,0,0,1,1
5871,79675,a8972vl53XxyEoK7iq5Ba0NkWofUNUyo,SpATywNh6bZuzm8s1ceuBUnMUAeoAHHw,5,3,0,0,0,0,2,0,5,0.7142857142857143,2,0.0,0,0,0,0,3,0,0,2,0,0,5,1
5872,79697,ZbdgVvxsxyG1aqBQ8n6eLVu27gWAZvhX,5X6FeZozNMgE2VRi3MJYjkkFK8SETtu2,1,0,0,0,0,0,1,0,1,0.14285714285714285,1,0.0,0,0,0,0,0,0,0,1,0,0,1,1
5873,79711,SUK7J6JSzTvdTuqtYmCn1wzdta5Gs77Z,SpATywNh6bZuzm8s1ceuBUnMUAeoAHHw,1,0,0,0,0,0,1,0,1,0.14285714285714285,1,0.0,0,0,0,0,0,0,0,1,0,0,1,1
5874,79712,840TvauCMn8hUpsV90vm3IXVVzLXLwLs,bWdj2GDclj5ofokWjzoa5jAwMkxCykd6,4,7,2,0,1,0,1,0,11,1.5714285714285714,1,0.0,0,2,0,1,7,0,0,1,0,3,8,1
5875,79735,e9EeV5SqA2AUMzzKRuYh9383pOYfTL5t,A3fsA9Zfv1X2fVEQhTw51lKENdNrEqT3,7,7,0,0,0,0,5,0,12,1.7142857142857142,2,0.0,0,0,0,0,7,0,0,5,0,0,12,1
5876,79743,uDLWNQEFPK65POXXo6bGzcLJ0lsyHLLH,SpATywNh6bZuzm8s1ceuBUnMUAeoAHHw,21,15,8,18,6,0,2,0,49,7.0,1,0.0,5,8,15,6,10,0,3,2,0,34,15,1
5877,79755,rfBYCgJ4870BiJSVIuZN0gKGiTat9rVl,SpATywNh6bZuzm8s1ceuBUnMUAeoAHHw,2,0,0,0,0,0,2,0,2,0.2857142857142857,1,0.0,0,0,0,0,0,0,0,2,0,0,2,1
5878,79756,1HYKmgHGaA0bHjLTmo1qNMwzAVv6AZom,5X6FeZozNMgE2VRi3MJYjkkFK8SETtu2,7,3,2,0,2,0,2,0,9,1.2857142857142858,1,0.0,0,2,0,2,3,0,0,2,0,4,5,1
5879,79761,ffg9VbmMkFKj2DfO61ClA5PDHr5Xa6gN,SpATywNh6bZuzm8s1ceuBUnMUAeoAHHw,13,25,15,2,8,0,8,0,58,8.285714285714286,6,0.0,0,15,2,8,25,0,0,8,0,25,33,0
5880,79768,WdB4AHM5Haltuxu4ztk7CYoMHww58fwR,SpATywNh6bZuzm8s1ceuBUnMUAeoAHHw,1,0,0,0,0,0,1,0,1,0.14285714285714285,1,0.0,0,0,0,0,0,0,0,1,0,0,1,1
5881,79801,Tdve80vJG7bg0NAfZoErDkCePh9ZdZtG,SpATywNh6bZuzm8s1ceuBUnMUAeoAHHw,9,10,6,0,3,0,5,1,25,3.5714285714285716,2,0.0,1,6,0,3,9,0,0,5,1,10,15,1
5882,79802,nVaguRnMzumbu6IYJqT40xfdj6StQFDm,bWdj2GDclj5ofokWjzoa5jAwMkxCykd6,4,4,1,0,1,0,2,0,8,1.1428571428571428,1,0.0,2,1,0,1,2,0,0,2,0,4,4,1
5883,79809,5tD3trtPQ6jzqFRimP1PMPhgvFtRmfA4,SpATywNh6bZuzm8s1ceuBUnMUAeoAHHw,15,27,6,9,1,3,12,0,58,8.285714285714286,3,0.0,7,6,9,1,20,3,0,12,0,23,35,1
5884,79818,dCAqk9uHiS99GMTcJQtThG8XWnwwbp5Q,SpATywNh6bZuzm8s1ceuBUnMUAeoAHHw,41,98,15,45,8,4,19,2,191,27.285714285714285,5,0.0,25,15,39,8,73,4,6,19,2,87,104,1
5885,79822,WUz9eKwwTabZi4dE6GkJ03kYfBXiol2h,A3fsA9Zfv1X2fVEQhTw51lKENdNrEqT3,2,0,0,0,0,9,6,0,15,2.142857142857143,3,0.0,0,0,0,0,0,9,0,6,0,0,15,1
5886,79831,7kTdvih7UMOiFKC9aXRp88JppGP4qSKH,SpATywNh6bZuzm8s1ceuBUnMUAeoAHHw,36,41,23,16,12,0,9,0,101,14.428571428571429,7,0.0,4,23,15,12,37,0,1,9,0,54,47,1
5887,79838,s5zDvm6xFFkPgy4oe8OGNGVHxFpWHGBV,SpATywNh6bZuzm8s1ceuBUnMUAeoAHHw,17,14,6,20,4,2,5,1,52,7.428571428571429,1,0.0,7,6,16,4,7,2,4,5,1,33,19,1
5888,79869,f3vfjinjwis5qk6FJAP4uRDxySTgo1bo,G8EPVSXsOYB5YQWZGiz1aVq5Pgr2GrQu,7,3,2,0,2,0,2,0,9,1.2857142857142858,1,0.0,0,2,0,2,3,0,0,2,0,4,5,1
5889,79878,ccvSRrE3qWZJWxhZblz5YcekpwGotPgS,SpATywNh6bZuzm8s1ceuBUnMUAeoAHHw,14,16,4,1,2,1,14,0,38,5.428571428571429,3,0.0,2,4,1,2,14,1,0,14,0,9,29,1
5890,79894,x3bTgsr7QSCiaq6OJXRLOfvMZYUxrJaI,bWdj2GDclj5ofokWjzoa5jAwMkxCykd6,10,5,4,0,4,0,1,0,14,2.0,1,0.0,0,4,0,4,5,0,0,1,0,8,6,1
5891,79907,Q2dKqJgalCRkN8Z90Lq1SNPa32DtEIlR,bWdj2GDclj5ofokWjzoa5jAwMkxCykd6,1,0,0,0,0,0,1,0,1,0.14285714285714285,1,0.0,0,0,0,0,0,0,0,1,0,0,1,1
5892,79942,og3zNDLl7XmMMAhbJtxTc4Nj33wztyot,SpATywNh6bZuzm8s1ceuBUnMUAeoAHHw,6,3,1,0,0,0,4,1,9,1.2857142857142858,1,0.0,0,1,0,0,3,0,0,4,1,1,8,1
5893,79956,hcKYo6bLhlANvHE0FxLuR4YY8jocfBwJ,A3fsA9Zfv1X2fVEQhTw51lKENdNrEqT3,9,14,0,0,0,28,3,0,45,6.428571428571429,2,0.0,0,0,0,0,14,28,0,3,0,0,45,1
5894,79975,Z3TCNncfxAFUErtBz9OqcQV0lBb4yIuz,SpATywNh6bZuzm8s1ceuBUnMUAeoAHHw,13,20,0,10,0,1,8,0,39,5.571428571428571,1,0.0,10,0,10,0,10,1,0,8,0,20,19,1
5895,79984,oKZwUGrYHqdyevQMbQx5wJjMj1yq2zA6,A3fsA9Zfv1X2fVEQhTw51lKENdNrEqT3,5,5,2,0,0,0,3,0,10,1.4285714285714286,2,0.0,0,2,0,0,5,0,0,3,0,2,8,1
5896,79995,vkOVdQ2Pc6HLkOn2fNIG8JE1qzNLpnwN,RXDvfPUBYFlVdlueBFbLW0mhhAyGEqpt,5,4,0,0,0,0,2,0,6,0.8571428571428571,1,0.0,0,0,0,0,4,0,0,2,0,0,6,1
5897,79998,q3XMARasETEzJyvJUxEAfFYsH6Z5s8Zv,bWdj2GDclj5ofokWjzoa5jAwMkxCykd6,8,13,5,0,1,6,11,0,36,5.142857142857143,4,0.0,0,5,0,1,13,6,0,11,0,6,30,0
5898,80019,YOBshYgk5gyR7XdL7ay26cecY2tdQtWp,SpATywNh6bZuzm8s1ceuBUnMUAeoAHHw,38,85,40,62,0,10,20,4,221,31.571428571428573,7,0.0,30,40,49,0,55,10,13,20,4,119,102,0
5899,80040,4AJWWnsd8QGDSRF4HLmdDQcz8kiBAcGz,SpATywNh6bZuzm8s1ceuBUnMUAeoAHHw,10,16,11,0,6,0,7,0,40,5.714285714285714,3,0.0,1,11,0,6,15,0,0,7,0,18,22,1
5900,80088,IAOTVxG7e06ArppQIZcVBCeppiZS52Zi,5X6FeZozNMgE2VRi3MJYjkkFK8SETtu2,1,0,0,0,0,0,1,0,1,0.14285714285714285,1,0.0,0,0,0,0,0,0,0,1,0,0,1,1
5901,80092,IAOTVxG7e06ArppQIZcVBCeppiZS52Zi,G8EPVSXsOYB5YQWZGiz1aVq5Pgr2GrQu,1,0,0,0,0,0,1,0,1,0.14285714285714285,1,0.0,0,0,0,0,0,0,0,1,0,0,1,1
5902,80093,IAOTVxG7e06ArppQIZcVBCeppiZS52Zi,RXDvfPUBYFlVdlueBFbLW0mhhAyGEqpt,1,0,0,0,0,0,1,0,1,0.14285714285714285,1,0.0,0,0,0,0,0,0,0,1,0,0,1,1
5903,80138,TcTuC5hiyHRmVc5qZWpzVJY3ugVLXB30,SpATywNh6bZuzm8s1ceuBUnMUAeoAHHw,4,2,0,0,0,0,5,0,7,1.0,2,0.0,0,0,0,0,2,0,0,5,0,0,7,1
5904,80163,qepVwgjKQRsdgtfeDxtXZatdyxHVESv4,SpATywNh6bZuzm8s1ceuBUnMUAeoAHHw,11,17,1,0,0,4,9,1,32,4.571428571428571,2,0.0,0,1,0,0,17,4,0,9,1,1,31,1
5905,80164,6iOLSqRTRABETCaDgzA6NufDV3dLbSSl,A3fsA9Zfv1X2fVEQhTw51lKENdNrEqT3,2,0,0,0,0,0,2,0,2,0.2857142857142857,1,0.0,0,0,0,0,0,0,0,2,0,0,2,1
5906,80177,BHKXnEVm5p8zUlT49NSc8LjGWmHUvROs,SpATywNh6bZuzm8s1ceuBUnMUAeoAHHw,7,2,1,0,1,0,6,0,10,1.4285714285714286,1,0.0,0,1,0,1,2,0,0,6,0,2,8,1
5907,80185,BHKXnEVm5p8zUlT49NSc8LjGWmHUvROs,RXDvfPUBYFlVdlueBFbLW0mhhAyGEqpt,1,0,0,0,0,0,1,0,1,0.14285714285714285,1,0.0,0,0,0,0,0,0,0,1,0,0,1,1
5908,80195,aZzurUzXBMxrnGRFBA3YxJsNpq6Cyxbm,SpATywNh6bZuzm8s1ceuBUnMUAeoAHHw,11,11,9,0,0,0,2,0,22,3.142857142857143,2,0.0,0,9,0,0,11,0,0,2,0,9,13,0
5909,80216,GkgOdr5534YC0rxEW6eOGTvUI1TnqsRC,SpATywNh6bZuzm8s1ceuBUnMUAeoAHHw,6,4,2,0,1,0,3,0,10,1.4285714285714286,2,0.0,0,2,0,1,4,0,0,3,0,3,7,1
5910,80236,V9sr2zgjH2joKkLVi0Sqvx5Qp7qYhjJ9,A3fsA9Zfv1X2fVEQhTw51lKENdNrEqT3,9,9,1,0,1,0,2,0,13,1.8571428571428572,2,0.0,0,1,0,1,9,0,0,2,0,2,11,1
5911,80247,eYRBHvvJOtQ80CX15zmkpE9dCWbRpi7K,SpATywNh6bZuzm8s1ceuBUnMUAeoAHHw,7,6,3,0,1,0,3,0,13,1.8571428571428572,2,0.0,1,3,0,1,5,0,0,3,0,5,8,0
5912,80251,P6CjwZWiHeS0SJlPQAf4bN1TR1u7fnyP,A3fsA9Zfv1X2fVEQhTw51lKENdNrEqT3,14,13,10,0,7,2,9,2,43,6.142857142857143,2,0.0,0,10,0,7,13,2,0,9,2,17,26,0
5913,80300,GUw906kJ57cW8NGG6UWBrUmH3fuOQE9A,SpATywNh6bZuzm8s1ceuBUnMUAeoAHHw,1,0,0,0,0,0,1,0,1,0.14285714285714285,1,0.0,0,0,0,0,0,0,0,1,0,0,1,1
5914,80319,4cRZxyVNjv13lU3nu2aK2rwyndExVCGa,SpATywNh6bZuzm8s1ceuBUnMUAeoAHHw,6,8,1,0,1,0,4,0,14,2.0,3,0.0,0,1,0,1,8,0,0,4,0,2,12,0
5915,80320,pz6FqQOVyf4J4lzlAfhLNtZDyqwAxEPh,A3fsA9Zfv1X2fVEQhTw51lKENdNrEqT3,12,9,6,0,5,0,3,0,23,3.2857142857142856,1,0.0,0,6,0,5,9,0,0,3,0,11,12,1
5916,80326,Y3w6vYVJTXZRYwblrdBFP6YHJ2PSSEq2,RXDvfPUBYFlVdlueBFbLW0mhhAyGEqpt,21,30,21,0,0,0,4,0,55,7.857142857142857,1,0.0,3,21,0,0,27,0,0,4,0,24,31,0
5917,80342,eq0DfIOiXorIpuNIOqxe4ooh3gnV5qKw,A3fsA9Zfv1X2fVEQhTw51lKENdNrEqT3,7,3,2,0,2,0,3,0,10,1.4285714285714286,1,0.0,0,2,0,2,3,0,0,3,0,4,6,1
5918,80366,0wJhtCWK60WPCeRF62m8T80DtNpWhRrg,bWdj2GDclj5ofokWjzoa5jAwMkxCykd6,1,0,0,0,0,0,1,0,1,0.14285714285714285,1,0.0,0,0,0,0,0,0,0,1,0,0,1,1
5919,80372,qrXtlHZ3b3drLfwVarPNRUa07Lp9hqJh,SpATywNh6bZuzm8s1ceuBUnMUAeoAHHw,2,0,0,0,0,0,2,0,2,0.2857142857142857,1,0.0,0,0,0,0,0,0,0,2,0,0,2,1
5920,80378,TkpjYbWxittbt5GHuJXRBWRI2DvksTLd,5X6FeZozNMgE2VRi3MJYjkkFK8SETtu2,15,26,8,16,7,0,5,0,62,8.857142857142858,3,0.0,13,8,15,7,13,0,1,5,0,43,19,1
5921,80386,RXKLhNquRsGdvYtQGHp0VVbeAvXlNqmn,SpATywNh6bZuzm8s1ceuBUnMUAeoAHHw,2,0,0,0,0,0,3,0,3,0.42857142857142855,1,0.0,0,0,0,0,0,0,0,3,0,0,3,1
5922,80393,S8OVDYMWVqlXct5SL79m7HIG5CpKKYZc,SpATywNh6bZuzm8s1ceuBUnMUAeoAHHw,12,21,9,1,4,0,11,0,46,6.571428571428571,4,0.0,4,9,1,4,17,0,0,11,0,18,28,0
5923,80401,HvSvcoWOvHQVexdtTmLoxzS1YOl5a4vw,5X6FeZozNMgE2VRi3MJYjkkFK8SETtu2,2,0,0,0,0,0,2,0,2,0.2857142857142857,1,0.0,0,0,0,0,0,0,0,2,0,0,2,1
5924,80411,GC4OF9yGz21AkcWehLa95SfLGyYuVKMP,SpATywNh6bZuzm8s1ceuBUnMUAeoAHHw,24,56,17,47,1,41,18,3,183,26.142857142857142,7,0.0,26,17,43,1,30,41,4,18,3,87,96,0
5925,80416,R6Y7ivYHIWSne9pzpaFDgE5diurqEzNu,5X6FeZozNMgE2VRi3MJYjkkFK8SETtu2,5,3,1,0,1,0,2,0,7,1.0,1,0.0,0,1,0,1,3,0,0,2,0,2,5,1
5926,80463,G4gv3psLUg6DraQbf90HcUcwjZl74koo,SpATywNh6bZuzm8s1ceuBUnMUAeoAHHw,3,2,1,0,0,0,1,0,4,0.5714285714285714,1,0.0,0,1,0,0,2,0,0,1,0,1,3,1
5927,80471,AZ8hE11Dcjz74P3tHeZJFdS8MoworAxL,G8EPVSXsOYB5YQWZGiz1aVq5Pgr2GrQu,49,140,0,51,3,21,20,6,241,34.42857142857143,4,0.0,13,0,43,3,127,21,8,20,6,59,182,0
5928,80472,2tSCGGcBbyusCnHqpGiQkgQi3re0uZxB,G8EPVSXsOYB5YQWZGiz1aVq5Pgr2GrQu,33,81,33,37,23,4,27,2,207,29.571428571428573,7,0.0,0,33,30,23,81,4,7,27,2,86,121,1
5929,80476,xIixYS0PTebuXuOSaEZKc4qh4BFu0Dqa,bWdj2GDclj5ofokWjzoa5jAwMkxCykd6,1,0,0,0,0,0,2,0,2,0.2857142857142857,1,0.0,0,0,0,0,0,0,0,2,0,0,2,1
5930,80490,SQsqundSwoyc0WsLMzMDq40PcZstmoDl,SpATywNh6bZuzm8s1ceuBUnMUAeoAHHw,7,4,3,0,3,0,2,0,12,1.7142857142857142,1,0.0,0,3,0,3,4,0,0,2,0,6,6,1
5931,80497,YotAwxbRJChtPJRmqiR2vpTmWxO7oSJ0,A3fsA9Zfv1X2fVEQhTw51lKENdNrEqT3,1,0,0,0,0,0,1,0,1,0.14285714285714285,1,0.0,0,0,0,0,0,0,0,1,0,0,1,1
5932,80499,YotAwxbRJChtPJRmqiR2vpTmWxO7oSJ0,bWdj2GDclj5ofokWjzoa5jAwMkxCykd6,1,0,0,0,0,0,2,0,2,0.2857142857142857,1,0.0,0,0,0,0,0,0,0,2,0,0,2,1
5933,80514,DdUTtw4QPNiBxHI38HgtVDIMn8onRmHc,A3fsA9Zfv1X2fVEQhTw51lKENdNrEqT3,10,12,5,0,3,0,4,0,24,3.4285714285714284,3,0.0,0,5,0,3,12,0,0,4,0,8,16,0
5934,80543,SJGYusQ5bKHgmVHB9ZU6VNixBNlg7610,SpATywNh6bZuzm8s1ceuBUnMUAeoAHHw,5,2,1,0,1,0,2,0,6,0.8571428571428571,1,0.0,0,1,0,1,2,0,0,2,0,2,4,1
5935,80577,LeM9PaeUEt6YxtDTcxg2tcMBc03CKGpH,G8EPVSXsOYB5YQWZGiz1aVq5Pgr2GrQu,1,0,0,0,0,0,1,0,1,0.14285714285714285,1,0.0,0,0,0,0,0,0,0,1,0,0,1,1
5936,80578,WCnGcaqoXPOoj0smksJ3AG2zfJ5bQ6q1,A3fsA9Zfv1X2fVEQhTw51lKENdNrEqT3,6,1,1,0,1,0,3,0,6,0.8571428571428571,1,0.0,0,1,0,1,1,0,0,3,0,2,4,1
5937,80593,z9sj5HIJml1DMOMfRKKBQ7IvS2IoE424,A3fsA9Zfv1X2fVEQhTw51lKENdNrEqT3,1,0,0,0,0,0,5,0,5,0.7142857142857143,3,0.0,0,0,0,0,0,0,0,5,0,0,5,1
5938,80603,iWBeIhxgRjHKtzWSQwKS5OP5OzUjqRhH,bWdj2GDclj5ofokWjzoa5jAwMkxCykd6,4,4,1,10,1,0,1,0,17,2.4285714285714284,1,0.0,2,1,9,1,2,0,1,1,0,13,4,1
5939,80606,2cQfWhwRUGUv48S47s2aDWYzSM5LRy6r,RXDvfPUBYFlVdlueBFbLW0mhhAyGEqpt,18,20,1,0,1,0,7,0,29,4.142857142857143,3,0.0,0,1,0,1,20,0,0,7,0,2,27,1
5940,80609,mDJsiogBkxNlOJSXjjSgpZwxWEVieV90,5X6FeZozNMgE2VRi3MJYjkkFK8SETtu2,8,7,3,0,1,8,9,3,31,4.428571428571429,1,0.0,0,3,0,1,7,8,0,9,3,4,27,1
5941,80610,XIynS55sKEeUm9UamMF9V3hYXLI7Q5XZ,bWdj2GDclj5ofokWjzoa5jAwMkxCykd6,6,1,1,0,1,0,3,0,6,0.8571428571428571,1,0.0,0,1,0,1,1,0,0,3,0,2,4,1
5942,80614,srJeJbIuD6nlvLtYdUFiQcvh7X1ghk8m,SpATywNh6bZuzm8s1ceuBUnMUAeoAHHw,1,0,0,0,0,0,1,0,1,0.14285714285714285,1,0.0,0,0,0,0,0,0,0,1,0,0,1,1
5943,80621,L5BsWcgN6IMgchaeVR0q3PWadEiOivUf,A3fsA9Zfv1X2fVEQhTw51lKENdNrEqT3,6,2,1,0,1,1,3,1,9,1.2857142857142858,1,0.0,0,1,0,1,2,1,0,3,1,2,7,1
5944,80646,1XuOICh6QrUFIc1MJAW7XRUBUSTY0RN7,SpATywNh6bZuzm8s1ceuBUnMUAeoAHHw,11,17,9,0,3,3,14,2,48,6.857142857142857,3,0.0,0,9,0,3,17,3,0,14,2,12,36,1
5945,80650,CViRSkXaB71kW0MpqfES8A240EKnhiKp,A3fsA9Zfv1X2fVEQhTw51lKENdNrEqT3,5,5,3,0,2,0,2,0,12,1.7142857142857142,1,0.0,0,3,0,2,5,0,0,2,0,5,7,1
5946,80653,hvadU2QyWcfZwJKaR7Pak0PcPESSEDA5,5X6FeZozNMgE2VRi3MJYjkkFK8SETtu2,17,51,14,16,7,0,7,0,95,13.571428571428571,4,0.0,30,14,15,7,21,0,1,7,0,66,29,1
5947,80685,SyrTnLXKpH34dNmIyW3n9ptk8gbsqg3F,bWdj2GDclj5ofokWjzoa5jAwMkxCykd6,1,0,0,0,0,0,1,0,1,0.14285714285714285,1,0.0,0,0,0,0,0,0,0,1,0,0,1,1
5948,80686,SyrTnLXKpH34dNmIyW3n9ptk8gbsqg3F,G8EPVSXsOYB5YQWZGiz1aVq5Pgr2GrQu,1,0,0,0,0,0,1,0,1,0.14285714285714285,1,0.0,0,0,0,0,0,0,0,1,0,0,1,1
5949,80695,oYTEOpmw5jxcBYfklhItyovgp6ogAm6R,5X6FeZozNMgE2VRi3MJYjkkFK8SETtu2,7,8,4,0,2,2,6,1,23,3.2857142857142856,1,0.0,0,4,0,2,8,2,0,6,1,6,17,1
5950,80718,a5enjFKHyOqV9BlzZwj7DoNQQjSWFxve,SpATywNh6bZuzm8s1ceuBUnMUAeoAHHw,6,7,3,0,1,0,2,0,13,1.8571428571428572,2,0.0,2,3,0,1,5,0,0,2,0,6,7,1
5951,80721,9pnVOC0WBepjoyI2qcaWMzrSP0RPnX7J,A3fsA9Zfv1X2fVEQhTw51lKENdNrEqT3,4,2,0,0,0,0,2,0,4,0.5714285714285714,1,0.0,0,0,0,0,2,0,0,2,0,0,4,1
5952,80725,eVZffGeL4uoEevrNNMdcmW6f0YwT8plW,bWdj2GDclj5ofokWjzoa5jAwMkxCykd6,5,5,3,0,2,0,3,0,13,1.8571428571428572,3,0.0,0,3,0,2,5,0,0,3,0,5,8,1
5953,80744,EGvZuk2o6udfOjbP1e9MeD8Ju07DscTY,A3fsA9Zfv1X2fVEQhTw51lKENdNrEqT3,1,0,0,0,0,0,3,0,3,0.42857142857142855,1,0.0,0,0,0,0,0,0,0,3,0,0,3,1
5954,80748,H6iwP0B7nHcYZaQbDpLJEx2H7FXYxL7S,RXDvfPUBYFlVdlueBFbLW0mhhAyGEqpt,49,61,27,122,12,4,21,2,249,35.57142857142857,7,0.0,23,27,95,12,38,4,27,21,2,157,92,0
5955,80761,xyhTJkgGghEribeWkvfmDO529PeI6BOD,bWdj2GDclj5ofokWjzoa5jAwMkxCykd6,19,17,15,0,16,0,5,0,53,7.571428571428571,1,0.0,2,15,0,16,15,0,0,5,0,33,20,1
5956,80777,Nn60hlJlXHP7n7M6lOuhaSQUkd1WY1lX,bWdj2GDclj5ofokWjzoa5jAwMkxCykd6,2,0,0,0,0,0,2,0,2,0.2857142857142857,1,0.0,0,0,0,0,0,0,0,2,0,0,2,1
5957,80797,OmF4aFe06TkjIpsTgGpQ4vBzMWi2jjQV,SpATywNh6bZuzm8s1ceuBUnMUAeoAHHw,7,6,3,0,2,0,3,0,14,2.0,1,0.0,0,3,0,2,6,0,0,3,0,5,9,1
5958,80800,a98Mt6r9LLCkAEPo2R3JVMN20OhIPoaG,SpATywNh6bZuzm8s1ceuBUnMUAeoAHHw,28,40,25,4,18,1,11,1,100,14.285714285714286,10,0.0,1,25,4,18,39,1,0,11,1,48,52,1
5959,80820,auTfNrVnLCOPJ3vRg0BBNLuEGlk6Jhzf,A3fsA9Zfv1X2fVEQhTw51lKENdNrEqT3,1,0,0,0,0,0,1,0,1,0.14285714285714285,1,0.0,0,0,0,0,0,0,0,1,0,0,1,1
5960,80828,7cqcexGmNTOg3kBfOTQxhsQAuLbRP0aP,SpATywNh6bZuzm8s1ceuBUnMUAeoAHHw,4,2,1,0,1,0,1,0,5,0.7142857142857143,1,0.0,0,1,0,1,2,0,0,1,0,2,3,1
5961,80862,JPgtg8QJos7Rq7D0ICcp60lZ9MEetv8V,RXDvfPUBYFlVdlueBFbLW0mhhAyGEqpt,5,2,1,0,1,0,2,0,6,0.8571428571428571,1,0.0,0,1,0,1,2,0,0,2,0,2,4,1
5962,80865,detHMtXeNBDLl1yfq61M11qScSHezCTa,fbPkOYLVPtPgIt0MxizjfFJov3JbHyAi,7,5,3,0,3,0,5,0,16,2.2857142857142856,1,0.0,1,3,0,3,4,0,0,5,0,7,9,1
5963,80866,lPCl89OkL3ywqPQ9tkoc7yQfPt2jOe8J,fbPkOYLVPtPgIt0MxizjfFJov3JbHyAi,11,22,8,6,9,27,15,4,91,13.0,1,0.0,12,8,4,9,10,27,2,15,4,33,58,1
5964,80872,pGAbpSQSqm8kO5KHqj1P91gbLxgxqLMR,fbPkOYLVPtPgIt0MxizjfFJov3JbHyAi,1,0,0,0,0,0,1,0,1,0.14285714285714285,1,0.0,0,0,0,0,0,0,0,1,0,0,1,1
5965,80874,tH916xRbn4bSZXJ6Z57PlnTAPQfz04PX,fbPkOYLVPtPgIt0MxizjfFJov3JbHyAi,13,10,5,3,4,0,3,0,25,3.5714285714285716,1,0.0,2,5,3,4,8,0,0,3,0,14,11,1
5966,80875,zgLhc8F17sS6o8GPDEBAA43SRssMOYHD,fbPkOYLVPtPgIt0MxizjfFJov3JbHyAi,8,7,3,0,1,1,7,1,20,2.857142857142857,3,0.0,0,3,0,1,7,1,0,7,1,4,16,1
5967,80876,yoqZagpPshUzxT5y74jKK6qgFqUHTRAQ,fbPkOYLVPtPgIt0MxizjfFJov3JbHyAi,7,4,2,0,2,0,3,0,11,1.5714285714285714,1,0.0,1,2,0,2,3,0,0,3,0,5,6,1
5968,80879,QRBHeXWoh4Eq5qFFGeXnL66X034DcN82,fbPkOYLVPtPgIt0MxizjfFJov3JbHyAi,7,5,4,0,3,0,2,0,14,2.0,1,0.0,0,4,0,3,5,0,0,2,0,7,7,1
5969,80880,nwSsR1adl0WQZ5D0MOHLkrBumdQn65bS,fbPkOYLVPtPgIt0MxizjfFJov3JbHyAi,1,0,0,0,0,0,1,0,1,0.14285714285714285,1,0.0,0,0,0,0,0,0,0,1,0,0,1,1
5970,80883,dl3uJviN00Na5GELdMJFr7DikNXKgldw,fbPkOYLVPtPgIt0MxizjfFJov3JbHyAi,12,13,4,8,4,0,11,1,41,5.857142857142857,1,0.0,5,4,6,4,8,0,2,11,1,19,22,1
5971,80885,OJ0LoXMYeoupgtCsqXPKoTXc19jkOfHU,fbPkOYLVPtPgIt0MxizjfFJov3JbHyAi,6,13,0,2,2,0,3,0,20,2.857142857142857,1,0.0,7,0,2,2,6,0,0,3,0,11,9,1
5972,80890,9iv095QjZS4Q7X9b663JhI4Y5VIooOZJ,fbPkOYLVPtPgIt0MxizjfFJov3JbHyAi,11,7,5,0,3,1,15,2,33,4.714285714285714,2,0.0,0,5,0,3,7,1,0,15,2,8,25,1
5973,80891,1IMOvf9v1bRH0tUTRkiIkzGe833lnAgf,fbPkOYLVPtPgIt0MxizjfFJov3JbHyAi,5,2,1,0,1,0,4,0,8,1.1428571428571428,3,0.0,0,1,0,1,2,0,0,4,0,2,6,0
5974,80892,OqzJYk2L0XqYLfMs4LljNI8HpBsCF1TU,fbPkOYLVPtPgIt0MxizjfFJov3JbHyAi,27,36,18,17,12,10,8,1,102,14.571428571428571,6,0.0,8,18,14,12,28,10,3,8,1,52,50,1
5975,80894,wa9yiDToqQTrEAjEFYLZvJZ6yii3aZEK,fbPkOYLVPtPgIt0MxizjfFJov3JbHyAi,9,3,3,0,3,3,9,2,23,3.2857142857142856,1,0.0,0,3,0,3,3,3,0,9,2,6,17,1
5976,80896,F7beo1Qs8FACPdfc8t0SncgEfDkdNWKi,fbPkOYLVPtPgIt0MxizjfFJov3JbHyAi,12,28,18,0,9,35,29,4,123,17.571428571428573,4,0.0,3,18,0,9,25,35,0,29,4,30,93,1
5977,80946,vjWysxVywi2MULjlX1Qte1HQfNPVqWDQ,5Gyp41oLVo7Gg7vF4vpmggWP5MU70QO6,1,0,0,0,0,0,1,0,1,0.14285714285714285,1,0.0,0,0,0,0,0,0,0,1,0,0,1,1
5978,80950,Ae7xevRD6ByEfUnyzvdQZ9mTmnPx254z,5Gyp41oLVo7Gg7vF4vpmggWP5MU70QO6,6,3,2,0,2,1,1,0,9,1.2857142857142858,1,0.0,0,2,0,2,3,1,0,1,0,4,5,1
5979,80962,CoVj6ijZvTIcDVOtOc471oXSuWKGkHMO,5Gyp41oLVo7Gg7vF4vpmggWP5MU70QO6,5,3,1,0,1,0,1,0,6,0.8571428571428571,1,0.0,0,1,0,1,3,0,0,1,0,2,4,1
5980,80995,MQ6AdIC7bHvsizvN9kYggZoqQjRC5tC3,5Gyp41oLVo7Gg7vF4vpmggWP5MU70QO6,5,0,0,0,0,0,4,1,5,0.7142857142857143,1,0.0,0,0,0,0,0,0,0,4,1,0,5,1
5981,80998,uKZ87zwhOlE6XjyVFr8vmJl9wOD1B9qQ,5Gyp41oLVo7Gg7vF4vpmggWP5MU70QO6,7,3,2,0,2,0,3,0,10,1.4285714285714286,1,0.0,0,2,0,2,3,0,0,3,0,4,6,1
5982,81040,Lq0T06X3CZi6ALtJCjo66DBN2OiVwbTv,5Gyp41oLVo7Gg7vF4vpmggWP5MU70QO6,3,0,0,0,0,0,3,0,3,0.42857142857142855,1,0.0,0,0,0,0,0,0,0,3,0,0,3,1
5983,81058,mo4Y7ec4CusrBe4cUkQewDgGhC6GhVtU,5Gyp41oLVo7Gg7vF4vpmggWP5MU70QO6,11,8,3,0,2,2,8,0,23,3.2857142857142856,2,0.0,0,3,0,2,8,2,0,8,0,5,18,1
5984,81072,U9j28kbZjF4W0VB5A2yieyyacPtOxvwt,5Gyp41oLVo7Gg7vF4vpmggWP5MU70QO6,22,89,56,6,2,0,12,1,166,23.714285714285715,3,0.0,21,56,3,2,68,0,3,12,1,82,84,0
5985,81080,lxeK6Le1R4xCd6kmC9TYS6QBdiNvyBxi,5Gyp41oLVo7Gg7vF4vpmggWP5MU70QO6,8,8,4,5,1,0,2,0,20,2.857142857142857,2,0.0,2,4,3,1,6,0,2,2,0,10,10,1
5986,81139,7oFdtO9FKJf8IdNZ1BS1BE66okU1XkZm,5Gyp41oLVo7Gg7vF4vpmggWP5MU70QO6,13,9,3,10,2,1,5,1,31,4.428571428571429,1,0.0,5,3,5,2,4,1,5,5,1,15,16,1
5987,81141,GYJjQ2lIayjypo2gIyakZnP2wWPyzF1D,5Gyp41oLVo7Gg7vF4vpmggWP5MU70QO6,1,0,0,0,0,0,1,0,1,0.14285714285714285,1,0.0,0,0,0,0,0,0,0,1,0,0,1,1
5988,81151,sRTon1VBBuP0uvdQE1lWLIce29YVBv8J,5Gyp41oLVo7Gg7vF4vpmggWP5MU70QO6,1,0,0,0,0,0,1,0,1,0.14285714285714285,1,0.0,0,0,0,0,0,0,0,1,0,0,1,1
5989,81211,oZKhsAromYlsN9MhR64yAv55dJDSDM8L,5Gyp41oLVo7Gg7vF4vpmggWP5MU70QO6,1,0,0,0,0,0,1,0,1,0.14285714285714285,1,0.0,0,0,0,0,0,0,0,1,0,0,1,1
5990,81225,k1Dqj4gjuYT6jK12QjlW65nZnFEwD9C2,5Gyp41oLVo7Gg7vF4vpmggWP5MU70QO6,3,0,0,0,0,0,3,0,3,0.42857142857142855,1,0.0,0,0,0,0,0,0,0,3,0,0,3,1
5991,81305,BNnfyIl3FBzkPpjJdH0jx7hkSuYPxmtm,5Gyp41oLVo7Gg7vF4vpmggWP5MU70QO6,10,5,3,0,2,1,5,0,16,2.2857142857142856,2,0.0,0,3,0,2,5,1,0,5,0,5,11,0
5992,81308,ymqaajgnjDJ2uzLF9mfDPmtZpL3ypXbN,5Gyp41oLVo7Gg7vF4vpmggWP5MU70QO6,7,3,2,0,2,0,3,0,10,1.4285714285714286,1,0.0,0,2,0,2,3,0,0,3,0,4,6,0
5993,81320,x5FLCm41jTiuXo4N8MtDfFRkxPsx9X7V,5Gyp41oLVo7Gg7vF4vpmggWP5MU70QO6,1,0,0,0,0,0,1,0,1,0.14285714285714285,1,0.0,0,0,0,0,0,0,0,1,0,0,1,1
5994,81329,VHwbRcPg3VDETaEVsJMANgQMwkomvLqN,5Gyp41oLVo7Gg7vF4vpmggWP5MU70QO6,30,85,45,27,1,53,18,3,232,33.142857142857146,7,0.0,20,45,22,1,65,53,5,18,3,88,144,0
5995,81341,ISRJxWtuG9U7GF6GcMl2UZgUHAWLyOgM,5Gyp41oLVo7Gg7vF4vpmggWP5MU70QO6,13,12,7,0,3,0,10,0,32,4.571428571428571,3,0.0,0,7,0,3,12,0,0,10,0,10,22,0
5996,81365,IbX9gv2vZSEMbkKys5TaEZGJbRA9UsC2,5Gyp41oLVo7Gg7vF4vpmggWP5MU70QO6,27,72,14,4,8,0,13,2,113,16.142857142857142,2,0.0,24,14,2,8,48,0,2,13,2,48,65,1
5997,81370,qmyjMBwztkMP5U1GBP3R4mtgUJIqaUcw,5Gyp41oLVo7Gg7vF4vpmggWP5MU70QO6,26,24,14,2,14,1,7,1,63,9.0,1,0.0,9,14,1,14,15,1,1,7,1,38,25,1
5998,81372,aeihE5fwFEllY8qfmQ5jU27rfKEU6Bkh,5Gyp41oLVo7Gg7vF4vpmggWP5MU70QO6,8,13,5,0,0,0,6,0,24,3.4285714285714284,3,0.0,0,5,0,0,13,0,0,6,0,5,19,1
5999,81375,MgBJbfRXH0QNEJmIiGY28SpmFvbhxSoF,5Gyp41oLVo7Gg7vF4vpmggWP5MU70QO6,37,93,32,8,21,2,21,1,178,25.428571428571427,4,0.0,19,32,4,21,74,2,4,21,1,76,102,0
6000,81388,aJMNcTer76nTaYZZR58xtdmLr8BYq1Op,5Gyp41oLVo7Gg7vF4vpmggWP5MU70QO6,1,0,0,0,0,0,1,0,1,0.14285714285714285,1,0.0,0,0,0,0,0,0,0,1,0,0,1,1
6001,81408,PHEq3ilhX7xFu8QukpW7ETpYepJHfFjo,5Gyp41oLVo7Gg7vF4vpmggWP5MU70QO6,26,51,26,20,6,23,24,14,164,23.428571428571427,7,0.0,14,26,13,6,37,23,7,24,14,59,105,0
6002,81417,S03j7b0vJ1rT6MN0S4HFY4GZTa97680X,5Gyp41oLVo7Gg7vF4vpmggWP5MU70QO6,16,41,16,0,10,63,21,4,155,22.142857142857142,5,0.0,10,16,0,10,31,63,0,21,4,36,119,1
6003,81425,la0M1c91h799fPQIw73JrRQfyaSu3lyA,5Gyp41oLVo7Gg7vF4vpmggWP5MU70QO6,7,3,2,0,2,0,5,0,12,1.7142857142857142,2,0.0,0,2,0,2,3,0,0,5,0,4,8,1
6004,81454,h48GX1o84DB4k0RmPuw70oay4JNlSZy6,5Gyp41oLVo7Gg7vF4vpmggWP5MU70QO6,4,0,0,0,0,0,6,0,6,0.8571428571428571,2,0.0,0,0,0,0,0,0,0,6,0,0,6,1
6005,81487,zXSweX2QVu58ribAOKB8UtMWETtQQw6R,5Gyp41oLVo7Gg7vF4vpmggWP5MU70QO6,7,3,2,0,2,0,2,0,9,1.2857142857142858,1,0.0,0,2,0,2,3,0,0,2,0,4,5,1
6006,81553,NNTbkWufZqd6OEZ4OfeDtmQCNI4vEzJo,5Gyp41oLVo7Gg7vF4vpmggWP5MU70QO6,8,5,3,0,0,1,12,1,22,3.142857142857143,2,0.0,0,3,0,0,5,1,0,12,1,3,19,0
6007,81580,MrbDYJV3aW9Xqd3Cf1F4pa7wKvEtnSNA,5Gyp41oLVo7Gg7vF4vpmggWP5MU70QO6,8,3,2,0,2,0,3,1,11,1.5714285714285714,1,0.0,0,2,0,2,3,0,0,3,1,4,7,1
6008,81592,UJda6rUqw07lTq8Jm7yRYWGaMX7fJVQp,5Gyp41oLVo7Gg7vF4vpmggWP5MU70QO6,1,0,0,0,0,0,1,0,1,0.14285714285714285,1,0.0,0,0,0,0,0,0,0,1,0,0,1,1
6009,81600,AZxIIh3OaBX0VeUwrvZCAokjIRSsH9yN,5Gyp41oLVo7Gg7vF4vpmggWP5MU70QO6,10,21,10,4,4,0,5,0,44,6.285714285714286,4,0.0,6,10,3,4,15,0,1,5,0,23,21,1
6010,81603,5VTFVrr5jpBcsZ05P95Kl903JuI71aZk,5Gyp41oLVo7Gg7vF4vpmggWP5MU70QO6,10,12,5,12,0,0,2,0,31,4.428571428571429,1,0.0,6,5,6,0,6,0,6,2,0,17,14,1
6011,81614,P9foP4jof7zTMN45RE5uaKtBnTwp6aMz,5Gyp41oLVo7Gg7vF4vpmggWP5MU70QO6,10,5,3,0,2,3,6,0,19,2.7142857142857144,1,0.0,0,3,0,2,5,3,0,6,0,5,14,1
6012,81632,TsVPbOaAsUuyIbJk2LJGJpINdbxfUBlF,5Gyp41oLVo7Gg7vF4vpmggWP5MU70QO6,10,12,5,2,4,10,13,0,46,6.571428571428571,2,0.0,6,5,1,4,6,10,1,13,0,16,30,1
6013,81646,7Uc4Whr2YqGTWUQ6jLjOCx7X8xoW6IGX,5Gyp41oLVo7Gg7vF4vpmggWP5MU70QO6,1,0,0,0,0,0,1,0,1,0.14285714285714285,1,0.0,0,0,0,0,0,0,0,1,0,0,1,1
6014,81669,2Cg2mHDWfiLELDYENQblfmUTX7x6Jf1J,5Gyp41oLVo7Gg7vF4vpmggWP5MU70QO6,23,40,20,13,7,4,15,1,100,14.285714285714286,4,0.0,10,20,12,7,30,4,1,15,1,49,51,1
6015,81687,DV9cmKY91lk8lKsMUmLIMP1KsHFcyZMK,5Gyp41oLVo7Gg7vF4vpmggWP5MU70QO6,5,1,0,0,0,0,3,1,5,0.7142857142857143,1,0.0,0,0,0,0,1,0,0,3,1,0,5,0
6016,81748,VDkowRNw2Ze5Lp3OFXVRaDJYFNTBDDQm,5Gyp41oLVo7Gg7vF4vpmggWP5MU70QO6,42,102,43,46,16,14,15,1,237,33.857142857142854,8,0.0,33,43,36,16,69,14,10,15,1,128,109,0
6017,81780,OH8WnAV2MBaaFDQHpnLQPXNjc3Qpxqk2,5Gyp41oLVo7Gg7vF4vpmggWP5MU70QO6,6,4,1,0,2,0,2,0,9,1.2857142857142858,1,0.0,1,1,0,2,3,0,0,2,0,4,5,1
6018,81799,45yfbnarXLY6Jtgynu1Xeg2zt9QQstcT,5Gyp41oLVo7Gg7vF4vpmggWP5MU70QO6,27,65,29,23,12,3,13,0,145,20.714285714285715,6,0.0,20,29,17,12,45,3,6,13,0,78,67,1
6019,81832,bN6kBVDkYHGdix1w3bk33yFgAVX3hMWw,5Gyp41oLVo7Gg7vF4vpmggWP5MU70QO6,1,0,0,0,0,0,1,0,1,0.14285714285714285,1,0.0,0,0,0,0,0,0,0,1,0,0,1,1
6020,81890,uQIdowlaeNEkKpZhFG9A3TFJBFgU4S0F,5Gyp41oLVo7Gg7vF4vpmggWP5MU70QO6,1,0,0,0,0,0,1,0,1,0.14285714285714285,1,0.0,0,0,0,0,0,0,0,1,0,0,1,1
6021,81901,TAJlYOA3wqCFdRnwld2vXU13SLIYwfc5,5Gyp41oLVo7Gg7vF4vpmggWP5MU70QO6,8,7,4,0,2,0,2,0,15,2.142857142857143,1,0.0,0,4,0,2,7,0,0,2,0,6,9,1
6022,81904,kgc4sYOGBLet1obN5653ebiNM8WxlTwl,5Gyp41oLVo7Gg7vF4vpmggWP5MU70QO6,2,0,0,0,0,0,2,0,2,0.2857142857142857,1,0.0,0,0,0,0,0,0,0,2,0,0,2,1
6023,81908,NcEpl157R9804FU8cPtpCcaWHzDDnaT9,5Gyp41oLVo7Gg7vF4vpmggWP5MU70QO6,11,7,4,0,4,0,2,0,17,2.4285714285714284,2,0.0,1,4,0,4,6,0,0,2,0,9,8,1
6024,81916,TzkQAoEYP1E815cLCMz9zInNnb8kYGLK,5Gyp41oLVo7Gg7vF4vpmggWP5MU70QO6,2,0,0,0,0,0,2,0,2,0.2857142857142857,1,0.0,0,0,0,0,0,0,0,2,0,0,2,1
6025,81919,HhgCtxOWA8hhcRNBS4AoxJTtsUvncdy2,5Gyp41oLVo7Gg7vF4vpmggWP5MU70QO6,13,11,7,0,4,3,4,0,29,4.142857142857143,3,0.0,1,7,0,4,10,3,0,4,0,12,17,1
6026,81939,lA0pTjAWZU3lRO7AFotws1B2CDNPLkh1,5Gyp41oLVo7Gg7vF4vpmggWP5MU70QO6,1,0,0,0,0,0,1,0,1,0.14285714285714285,1,0.0,0,0,0,0,0,0,0,1,0,0,1,1
6027,81944,IICLCU8feiN4Ddj1IniboUMZ0TdS44vO,5Gyp41oLVo7Gg7vF4vpmggWP5MU70QO6,13,16,6,0,3,0,6,0,31,4.428571428571429,2,0.0,8,6,0,3,8,0,0,6,0,17,14,0
6028,81981,k5oVYco32vQ3DmUE6ZDHecga51LfmXuY,5Gyp41oLVo7Gg7vF4vpmggWP5MU70QO6,1,0,0,0,0,0,1,0,1,0.14285714285714285,1,0.0,0,0,0,0,0,0,0,1,0,0,1,1
6029,81992,I0dPBQTgu6D9eXliUlbcjdGy6QSaLkYM,5Gyp41oLVo7Gg7vF4vpmggWP5MU70QO6,7,5,2,0,2,0,2,0,11,1.5714285714285714,1,0.0,0,2,0,2,5,0,0,2,0,4,7,1
6030,81996,Uf8FY0gZoVytp6K7SsDRXVZeOCL2hDEX,5Gyp41oLVo7Gg7vF4vpmggWP5MU70QO6,7,6,0,0,0,1,6,0,13,1.8571428571428572,2,0.0,0,0,0,0,6,1,0,6,0,0,13,0
6031,82001,Pqioqz8K6HnqHiY5C1wkqbUUaUlFBHvC,5Gyp41oLVo7Gg7vF4vpmggWP5MU70QO6,1,0,0,0,0,0,1,0,1,0.14285714285714285,1,0.0,0,0,0,0,0,0,0,1,0,0,1,1
6032,82003,yzBFB71TahEfYRhZug3yE5qLPzRJCqH9,5Gyp41oLVo7Gg7vF4vpmggWP5MU70QO6,9,7,3,0,0,3,18,3,34,4.857142857142857,1,0.0,2,3,0,0,5,3,0,18,3,5,29,1
6033,82010,ppKilowTGDD739bC3UNeZEuj8p6ssexh,5Gyp41oLVo7Gg7vF4vpmggWP5MU70QO6,11,10,6,0,4,0,9,0,29,4.142857142857143,1,0.0,2,6,0,4,8,0,0,9,0,12,17,1
6034,82030,dzYm1dRe7J2rj7JrdKLsOqkjQnJrIFXt,5Gyp41oLVo7Gg7vF4vpmggWP5MU70QO6,9,8,0,2,0,0,1,0,11,1.5714285714285714,1,0.0,1,0,1,0,7,0,1,1,0,2,9,1
6035,82054,njqa0JNTmCp6NkFmaSbsVlfwuihmQkk3,5Gyp41oLVo7Gg7vF4vpmggWP5MU70QO6,1,0,0,0,0,0,1,0,1,0.14285714285714285,1,0.0,0,0,0,0,0,0,0,1,0,0,1,1
6036,82072,gFgZpGYEekWdTED1EzQF6f6Wo7CuRRyn,5Gyp41oLVo7Gg7vF4vpmggWP5MU70QO6,6,4,2,0,1,1,2,0,10,1.4285714285714286,1,0.0,1,2,0,1,3,1,0,2,0,4,6,1
6037,82089,HuLHCkffx7NTEjFGXpjyYhc55925sZcQ,5Gyp41oLVo7Gg7vF4vpmggWP5MU70QO6,6,7,4,0,3,0,6,0,20,2.857142857142857,2,0.0,0,4,0,3,7,0,0,6,0,7,13,1
6038,82098,rXyS7LJgT9wTWohW72cqEKZVaojJdgOo,5Gyp41oLVo7Gg7vF4vpmggWP5MU70QO6,38,86,37,24,22,6,12,2,189,27.0,2,0.0,32,37,12,22,54,6,12,12,2,103,86,0
6039,82099,iLqxZ0n7bus10HRNLa55JPyT9ijWURXL,5Gyp41oLVo7Gg7vF4vpmggWP5MU70QO6,1,0,0,0,0,0,1,0,1,0.14285714285714285,1,0.0,0,0,0,0,0,0,0,1,0,0,1,1
6040,82103,LCMyKiD5XwFaOzPllkjjv2ZtPOIZ7Aze,5Gyp41oLVo7Gg7vF4vpmggWP5MU70QO6,1,0,0,0,0,0,1,0,1,0.14285714285714285,1,0.0,0,0,0,0,0,0,0,1,0,0,1,1
6041,82104,tTX1lbaFQ9AIQUV0Tqh2bCFjGLODMzEt,5Gyp41oLVo7Gg7vF4vpmggWP5MU70QO6,12,9,5,0,4,1,8,2,29,4.142857142857143,1,0.0,1,5,0,4,8,1,0,8,2,10,19,1
6042,82127,WNyPeYGhB3VWWEsNYr4aXv1YBtMhLTLV,5Gyp41oLVo7Gg7vF4vpmggWP5MU70QO6,2,0,0,0,0,0,2,0,2,0.2857142857142857,1,0.0,0,0,0,0,0,0,0,2,0,0,2,1
6043,82151,RPsysYLHG9V8ibC4agPmUkz49odzJ61i,5Gyp41oLVo7Gg7vF4vpmggWP5MU70QO6,16,22,9,11,5,22,13,1,83,11.857142857142858,5,0.0,7,9,8,5,15,22,3,13,1,29,54,1
6044,82154,KM1Xkrs286QEvxM8WAk4Jd10TrYlc7Rx,5Gyp41oLVo7Gg7vF4vpmggWP5MU70QO6,32,76,34,23,21,0,6,0,160,22.857142857142858,6,0.0,24,34,17,21,52,0,6,6,0,96,64,0
6045,82172,nISFYFLVxWXpIygYi9nQdNZcU3Bl9oR3,5Gyp41oLVo7Gg7vF4vpmggWP5MU70QO6,11,5,4,0,4,0,2,0,15,2.142857142857143,1,0.0,0,4,0,4,5,0,0,2,0,8,7,1
6046,82207,8DpbAnJnDX6ulNJx11NZ0LzLIVAWDea8,5Gyp41oLVo7Gg7vF4vpmggWP5MU70QO6,9,13,6,0,3,0,10,0,32,4.571428571428571,3,0.0,0,6,0,3,13,0,0,10,0,9,23,1
6047,82217,9Lei0nsIXUCzdSXtfo9QaQokApGicEaa,5Gyp41oLVo7Gg7vF4vpmggWP5MU70QO6,2,0,0,0,0,0,2,0,2,0.2857142857142857,1,0.0,0,0,0,0,0,0,0,2,0,0,2,1
6048,82228,htbkPO8S6I2SzX8h4P5Po5peKcu2DxE4,5Gyp41oLVo7Gg7vF4vpmggWP5MU70QO6,4,2,0,0,0,0,2,0,4,0.5714285714285714,1,0.0,0,0,0,0,2,0,0,2,0,0,4,0
6049,82240,ByV6tIWuv38n5iexvQLd8FEkPnLBxNOm,5Gyp41oLVo7Gg7vF4vpmggWP5MU70QO6,2,0,0,0,0,0,2,0,2,0.2857142857142857,1,0.0,0,0,0,0,0,0,0,2,0,0,2,1
6050,82278,6mJ65eKOiDJ0B2UMjBjMI3Dy4vxZcYQe,5Gyp41oLVo7Gg7vF4vpmggWP5MU70QO6,12,8,4,4,2,0,5,0,23,3.2857142857142856,1,0.0,3,4,2,2,5,0,2,5,0,11,12,1
6051,82290,ECYTLQ3E4TdzC2nQqMnkqHLn0MsC8UH2,5Gyp41oLVo7Gg7vF4vpmggWP5MU70QO6,4,3,1,0,0,0,2,0,6,0.8571428571428571,1,0.0,0,1,0,0,3,0,0,2,0,1,5,1
6052,82293,h7Gk9Pr4tHraGHEA4N989G6mMEttrQ7F,fbPkOYLVPtPgIt0MxizjfFJov3JbHyAi,4,2,1,0,1,0,1,0,5,0.7142857142857143,1,0.0,0,1,0,1,2,0,0,1,0,2,3,1
6053,82296,cRhYOWmRYGzfmTeQOfNoa47hIiXDh8uB,fbPkOYLVPtPgIt0MxizjfFJov3JbHyAi,8,7,3,0,2,3,4,0,19,2.7142857142857144,1,0.0,0,3,0,2,7,3,0,4,0,5,14,1
6054,82298,L39ZdOzVu52b5Nu8u3TuFdomCuDfGlbZ,fbPkOYLVPtPgIt0MxizjfFJov3JbHyAi,7,3,2,0,2,0,2,0,9,1.2857142857142858,1,0.0,0,2,0,2,3,0,0,2,0,4,5,1
6055,82300,W0m8271d1PwWD9jcR5ad8muDNmmDz2n0,fbPkOYLVPtPgIt0MxizjfFJov3JbHyAi,9,6,4,0,3,0,4,0,17,2.4285714285714284,2,0.0,0,4,0,3,6,0,0,4,0,7,10,1
6056,82306,SMcFR1tzrGAErGanrAOTaiQacFJ5UscL,fbPkOYLVPtPgIt0MxizjfFJov3JbHyAi,1,0,0,0,0,0,1,0,1,0.14285714285714285,1,0.0,0,0,0,0,0,0,0,1,0,0,1,1
6057,82320,PZsNp0sdZSh88V88314df0SFpq2hITu9,7GRhBDsirIGkRZBtSMEzNTyDr2JQm4xx,55,97,46,18,30,7,18,0,216,30.857142857142858,6,0.0,26,46,11,30,71,7,7,18,0,113,103,1
6058,82344,V9A9B2T9pRTU3AqvpqzuKs4MfRcAEte2,5X6FeZozNMgE2VRi3MJYjkkFK8SETtu2,7,6,4,0,3,0,2,0,15,2.142857142857143,2,0.0,0,4,0,3,6,0,0,2,0,7,8,1
6059,82355,4Kx1Tk1FEFaPAhJJ1qabZH7R2QRjZNC4,5X6FeZozNMgE2VRi3MJYjkkFK8SETtu2,1,0,0,0,0,0,1,0,1,0.14285714285714285,1,0.0,0,0,0,0,0,0,0,1,0,0,1,1
6060,82384,43E2rt302JULLcYiauLjUubEtMqnfHMM,7GRhBDsirIGkRZBtSMEzNTyDr2JQm4xx,1,0,0,0,0,0,1,0,1,0.14285714285714285,1,0.0,0,0,0,0,0,0,0,1,0,0,1,1
6061,82393,LEErhOa5boiziYl0X6XgUtaE9oegOl2r,7GRhBDsirIGkRZBtSMEzNTyDr2JQm4xx,1,0,0,0,0,0,1,0,1,0.14285714285714285,1,0.0,0,0,0,0,0,0,0,1,0,0,1,1
6062,82397,WS43utSG33bYCMf9KzrbX5AdwBBQGbjp,5X6FeZozNMgE2VRi3MJYjkkFK8SETtu2,3,0,0,0,0,0,3,0,3,0.42857142857142855,1,0.0,0,0,0,0,0,0,0,3,0,0,3,1
6063,82399,viuKt4GgrX0rYL5EpHoxJbsiC9TblSuk,7GRhBDsirIGkRZBtSMEzNTyDr2JQm4xx,13,27,9,0,1,8,6,1,52,7.428571428571429,2,0.0,16,9,0,1,11,8,0,6,1,26,26,1
6064,82405,TciQEzJA4hKxeo0Ve5JLByGDZHpNx3uy,7GRhBDsirIGkRZBtSMEzNTyDr2JQm4xx,7,6,2,0,0,10,12,0,30,4.285714285714286,2,0.0,0,2,0,0,6,10,0,12,0,2,28,1
6065,82416,skcEk7TV3jhSAknl5Kr7UawZFeqJNMzy,5X6FeZozNMgE2VRi3MJYjkkFK8SETtu2,7,4,2,0,2,0,4,0,12,1.7142857142857142,2,0.0,1,2,0,2,3,0,0,4,0,5,7,1
6066,82417,cYrWUXTiBgGjy3hGqmm3n1c0yjpEqf1w,7GRhBDsirIGkRZBtSMEzNTyDr2JQm4xx,11,6,3,0,4,1,6,0,20,2.857142857142857,1,0.0,2,3,0,4,4,1,0,6,0,9,11,1
6067,82418,uJax5vCFklO8HHpSUYT3Fz3R0owwtr35,7GRhBDsirIGkRZBtSMEzNTyDr2JQm4xx,1,0,0,0,0,0,1,0,1,0.14285714285714285,1,0.0,0,0,0,0,0,0,0,1,0,0,1,1
6068,82437,XivfOnvugBk6XlGIM6kdwKfGcR3nQxRm,7GRhBDsirIGkRZBtSMEzNTyDr2JQm4xx,7,3,2,0,2,0,2,0,9,1.2857142857142858,1,0.0,0,2,0,2,3,0,0,2,0,4,5,1
6069,82446,IlqVxR80wUI0K0Uw1aDlvKmr7WqFGjmy,5X6FeZozNMgE2VRi3MJYjkkFK8SETtu2,3,0,0,0,0,0,3,0,3,0.42857142857142855,2,0.0,0,0,0,0,0,0,0,3,0,0,3,1
6070,82453,vUKsMiJwv2QfsgGCTNCgcgyS6zvBvgBp,7GRhBDsirIGkRZBtSMEzNTyDr2JQm4xx,13,9,7,0,4,6,11,1,38,5.428571428571429,1,0.0,0,7,0,4,9,6,0,11,1,11,27,1
6071,82499,0OF3EYrcXkzgoCZbflhPO2AMF0v3ygiD,5X6FeZozNMgE2VRi3MJYjkkFK8SETtu2,12,9,5,0,6,0,3,0,23,3.2857142857142856,2,0.0,2,5,0,6,7,0,0,3,0,13,10,0
6072,82511,uGqq5Gc0yuBAXiGPLk4UFpV86PfbPpKt,7GRhBDsirIGkRZBtSMEzNTyDr2JQm4xx,23,52,11,14,10,0,1,0,88,12.571428571428571,1,0.0,8,11,7,10,44,0,7,1,0,36,52,1
6073,82519,RhKR05rzUu0u9Tu4D52krXN6Zpp20wSB,7GRhBDsirIGkRZBtSMEzNTyDr2JQm4xx,1,0,0,0,0,0,1,0,1,0.14285714285714285,1,0.0,0,0,0,0,0,0,0,1,0,0,1,1
6074,82538,T9Yj58iibT0MvC77ImCHQBcge8nlbEl0,5X6FeZozNMgE2VRi3MJYjkkFK8SETtu2,5,5,3,0,0,0,2,0,10,1.4285714285714286,2,0.0,0,3,0,0,5,0,0,2,0,3,7,0
6075,82549,LzZbSzxCF6j5IK4opjLkxGirHE6VTy2b,7GRhBDsirIGkRZBtSMEzNTyDr2JQm4xx,27,44,3,28,2,1,3,0,81,11.571428571428571,3,0.0,19,3,22,2,25,1,6,3,0,46,35,0
6076,82561,cO0cRAd5oEVU09nlVPmxoB7bdGQ326BX,5X6FeZozNMgE2VRi3MJYjkkFK8SETtu2,1,0,0,0,0,0,1,0,1,0.14285714285714285,1,0.0,0,0,0,0,0,0,0,1,0,0,1,1
6077,82606,ieYbeKnQ9Q6nxVAutigoFXyNAyGepcVf,SpATywNh6bZuzm8s1ceuBUnMUAeoAHHw,45,42,27,49,14,1,6,1,140,20.0,2,0.0,10,27,44,14,32,1,5,6,1,95,45,0
6078,82645,CSh5hGbaSFu2yCb31iVMOVwKocrH471Q,RXDvfPUBYFlVdlueBFbLW0mhhAyGEqpt,19,51,31,8,7,1,18,1,117,16.714285714285715,9,0.0,2,31,8,7,49,1,0,18,1,48,69,0
6079,82712,XDPvGyFLLEYwbNEQik2MM4yiADs5rrYJ,5X6FeZozNMgE2VRi3MJYjkkFK8SETtu2,4,2,1,0,1,0,2,0,6,0.8571428571428571,1,0.0,0,1,0,1,2,0,0,2,0,2,4,1
6080,82718,0ToFygcG0ie7U9Wejy2h2RyDoLh56OuH,SpATywNh6bZuzm8s1ceuBUnMUAeoAHHw,1,0,0,0,0,0,1,0,1,0.14285714285714285,1,0.0,0,0,0,0,0,0,0,1,0,0,1,1
6081,82797,BzvzyDIHLe9MZwFkiZf5BNkVkHrFZ1uP,SpATywNh6bZuzm8s1ceuBUnMUAeoAHHw,16,21,10,12,6,0,4,0,53,7.571428571428571,3,0.0,2,10,10,6,19,0,2,4,0,28,25,1
6082,82800,WufveCbPHF6lzhxB6Nzdvlmo0sd1ku5b,RXDvfPUBYFlVdlueBFbLW0mhhAyGEqpt,1,0,0,0,0,0,1,0,1,0.14285714285714285,1,0.0,0,0,0,0,0,0,0,1,0,0,1,1
6083,82809,CSh5hGbaSFu2yCb31iVMOVwKocrH471Q,bWdj2GDclj5ofokWjzoa5jAwMkxCykd6,9,14,7,0,4,0,10,0,35,5.0,4,0.0,0,7,0,4,14,0,0,10,0,11,24,1
6084,82815,IYjgMeQycDQkXIpTAZqsKVDfOfuGTmr6,G8EPVSXsOYB5YQWZGiz1aVq5Pgr2GrQu,39,39,5,136,2,2,7,0,191,27.285714285714285,5,0.0,9,5,116,2,30,2,20,7,0,132,59,1
6085,82825,PCDzowxElNLixXyfAFPkQqlbkMlIrEa9,bWdj2GDclj5ofokWjzoa5jAwMkxCykd6,1,0,0,0,0,0,1,0,1,0.14285714285714285,1,0.0,0,0,0,0,0,0,0,1,0,0,1,1
6086,82826,6PLrCNmfEwPk8NveiZ2kjz8b6TJ4tdFy,SpATywNh6bZuzm8s1ceuBUnMUAeoAHHw,26,50,1,34,1,9,26,6,127,18.142857142857142,5,0.0,18,1,28,1,32,9,6,26,6,48,79,1
6087,82839,0eZxP7v4dLkYnlOrNv9f440B7CYLqmGw,A3fsA9Zfv1X2fVEQhTw51lKENdNrEqT3,8,4,0,0,0,3,8,1,16,2.2857142857142856,1,0.0,0,0,0,0,4,3,0,8,1,0,16,0
6088,82917,pxOSZxPvXphO2EXTM2iH7EY4Bz2Gx8pL,RXDvfPUBYFlVdlueBFbLW0mhhAyGEqpt,3,0,0,0,0,3,2,0,5,0.7142857142857143,1,0.0,0,0,0,0,0,3,0,2,0,0,5,1
6089,82935,VZy08QiJfjzIhB9oyZbfkS8kOqdqXxGQ,SpATywNh6bZuzm8s1ceuBUnMUAeoAHHw,20,42,23,6,5,1,26,0,103,14.714285714285714,4,0.0,2,23,6,5,40,1,0,26,0,36,67,0
6090,82945,jMzDAkDrCqzTj207GrZXDfLQXbYc8WXP,SpATywNh6bZuzm8s1ceuBUnMUAeoAHHw,4,5,0,0,0,0,1,0,6,0.8571428571428571,1,0.0,0,0,0,0,5,0,0,1,0,0,6,1
6091,82980,KJHVgwvyEGSqeXuZ6P7l6YnOOdmnECg0,G8EPVSXsOYB5YQWZGiz1aVq5Pgr2GrQu,14,34,2,0,0,23,22,0,81,11.571428571428571,6,0.0,0,2,0,0,34,23,0,22,0,2,79,1
6092,83008,OifsLGRBGBgFFNsSrNDnK5W8Vbn9qLGX,bWdj2GDclj5ofokWjzoa5jAwMkxCykd6,6,9,0,0,0,0,1,0,10,1.4285714285714286,2,0.0,0,0,0,0,9,0,0,1,0,0,10,1
6093,83011,7IO6p4687fQRowFKh8aP2BRrTBz96sXF,SpATywNh6bZuzm8s1ceuBUnMUAeoAHHw,15,7,6,0,6,0,2,0,21,3.0,1,0.0,0,6,0,6,7,0,0,2,0,12,9,1
6094,83016,6nEFiLob034lX78wkreIicrVXormSdsR,SpATywNh6bZuzm8s1ceuBUnMUAeoAHHw,7,2,0,0,0,9,6,2,19,2.7142857142857144,1,0.0,0,0,0,0,2,9,0,6,2,0,19,1
6095,83024,xhSNxzAdJZ3UvqN1HWRUi586YbiFg3gP,SpATywNh6bZuzm8s1ceuBUnMUAeoAHHw,7,3,2,0,2,0,2,0,9,1.2857142857142858,1,0.0,0,2,0,2,3,0,0,2,0,4,5,1
6096,83034,JfftjOGdDbpgbrupi0Gwr899R0jzXikJ,RXDvfPUBYFlVdlueBFbLW0mhhAyGEqpt,28,42,27,0,13,0,13,0,95,13.571428571428571,9,0.0,0,27,0,13,42,0,0,13,0,40,55,1
6097,83050,8N1dftZZEH60qM7KC0I3DLQjIoLpq8rg,bWdj2GDclj5ofokWjzoa5jAwMkxCykd6,8,5,4,0,2,0,4,1,16,2.2857142857142856,1,0.0,0,4,0,2,5,0,0,4,1,6,10,1
6098,83051,5txttxupjDZ5RVkKM8mUX5AwlfTmH5yF,SpATywNh6bZuzm8s1ceuBUnMUAeoAHHw,9,3,2,0,2,1,4,0,12,1.7142857142857142,1,0.0,0,2,0,2,3,1,0,4,0,4,8,1
6099,83086,HDl6obmuly5u871WtIy4bB83rJ9ydWpb,SpATywNh6bZuzm8s1ceuBUnMUAeoAHHw,24,20,12,32,6,1,4,0,75,10.714285714285714,1,0.0,5,12,27,6,15,1,5,4,0,50,25,1
6100,83156,wSQurJctKIVWroKFEwLtZd7EI4FKyqnr,G8EPVSXsOYB5YQWZGiz1aVq5Pgr2GrQu,27,49,14,84,8,0,6,0,161,23.0,2,0.0,20,14,66,8,29,0,18,6,0,108,53,0
6101,83165,jqU1D59XEYqlC5xpuvwRL444Dk2gM9HE,bWdj2GDclj5ofokWjzoa5jAwMkxCykd6,1,0,0,0,0,0,1,0,1,0.14285714285714285,1,0.0,0,0,0,0,0,0,0,1,0,0,1,1
6102,83170,TOdJr6wpv1Do14qMOudEcAu5ZtPnzG5P,G8EPVSXsOYB5YQWZGiz1aVq5Pgr2GrQu,51,20,18,213,9,0,7,0,267,38.142857142857146,3,0.0,0,18,187,9,20,0,26,7,0,214,53,0
6103,83174,5A8qgesuumI82DPHv10fhG2s0pO5oVZR,A3fsA9Zfv1X2fVEQhTw51lKENdNrEqT3,6,4,0,0,0,0,5,0,9,1.2857142857142858,3,0.0,0,0,0,0,4,0,0,5,0,0,9,1
6104,83207,cpPSwRiyzrnBZYcFR4yyg60XVFgQxQi4,5X6FeZozNMgE2VRi3MJYjkkFK8SETtu2,2,0,0,0,0,0,2,0,2,0.2857142857142857,1,0.0,0,0,0,0,0,0,0,2,0,0,2,1
6105,83211,Wr4SmSlfffOCt9SGCoEYbe3u98RIz0dN,A3fsA9Zfv1X2fVEQhTw51lKENdNrEqT3,59,56,44,42,31,0,11,0,184,26.285714285714285,4,0.0,3,44,42,31,53,0,0,11,0,120,64,1
6106,83227,EUmZ5qzjwgko2PIWEnctkvYh7APnUrX9,bWdj2GDclj5ofokWjzoa5jAwMkxCykd6,13,37,5,0,3,0,12,0,57,8.142857142857142,6,0.0,0,5,0,3,37,0,0,12,0,8,49,0
6107,83234,amoOfSkysWrIhdnr1E3AIL1FF64JqedD,G8EPVSXsOYB5YQWZGiz1aVq5Pgr2GrQu,1,0,0,0,0,0,1,0,1,0.14285714285714285,1,0.0,0,0,0,0,0,0,0,1,0,0,1,1
6108,83270,nLSuRa1Xl0BD98Gi62KN22iPrqq32BXg,A3fsA9Zfv1X2fVEQhTw51lKENdNrEqT3,2,0,0,0,0,0,2,0,2,0.2857142857142857,1,0.0,0,0,0,0,0,0,0,2,0,0,2,1
6109,83277,dT92IjRcuruPiAlpqVUTtu3wNL9IIegT,SpATywNh6bZuzm8s1ceuBUnMUAeoAHHw,2,0,0,0,0,0,2,0,2,0.2857142857142857,2,0.0,0,0,0,0,0,0,0,2,0,0,2,1
6110,83283,PBR461hkZjzKwEmSOTgV69v6hIW4qt59,RXDvfPUBYFlVdlueBFbLW0mhhAyGEqpt,25,19,9,16,4,1,11,1,61,8.714285714285714,2,0.0,3,9,16,4,16,1,0,11,1,32,29,1
6111,83284,3CjVt7bXLLNxAWX8paG8Hg5eS8UkaYeH,A3fsA9Zfv1X2fVEQhTw51lKENdNrEqT3,9,6,0,0,0,2,5,1,14,2.0,1,0.0,0,0,0,0,6,2,0,5,1,0,14,1
6112,83290,V5AS4ngknDMHs5ddf49SxlAoYguZsiN3,SpATywNh6bZuzm8s1ceuBUnMUAeoAHHw,28,32,14,16,6,3,8,0,79,11.285714285714286,3,0.0,7,14,15,6,25,3,1,8,0,42,37,1
6113,83304,BQi6o3YIDMuHZg7pBKL2EQvhTIhuaxJ1,SpATywNh6bZuzm8s1ceuBUnMUAeoAHHw,1,0,0,0,0,0,1,0,1,0.14285714285714285,1,0.0,0,0,0,0,0,0,0,1,0,0,1,1
6114,83310,4NR9J7NrWx9P8bFiOFbZEGtYIezzdGum,A3fsA9Zfv1X2fVEQhTw51lKENdNrEqT3,11,5,4,0,4,0,2,0,15,2.142857142857143,1,0.0,0,4,0,4,5,0,0,2,0,8,7,0
6115,83331,tZgqnNO14y5iwFiuSmSN0mwYH2PCGkQ9,5X6FeZozNMgE2VRi3MJYjkkFK8SETtu2,2,0,0,0,0,0,2,0,2,0.2857142857142857,1,0.0,0,0,0,0,0,0,0,2,0,0,2,1
6116,83336,gFQthJ0fgeQ9ZBHD40PszFOUEAsK6l6q,SpATywNh6bZuzm8s1ceuBUnMUAeoAHHw,2,0,0,0,0,0,2,0,2,0.2857142857142857,1,0.0,0,0,0,0,0,0,0,2,0,0,2,1
6117,83343,gFQthJ0fgeQ9ZBHD40PszFOUEAsK6l6q,RXDvfPUBYFlVdlueBFbLW0mhhAyGEqpt,2,0,0,0,0,0,2,0,2,0.2857142857142857,1,0.0,0,0,0,0,0,0,0,2,0,0,2,1
6118,83380,cxfyjhDPSpiPao628A4EolvaTnOncviL,A3fsA9Zfv1X2fVEQhTw51lKENdNrEqT3,7,3,2,0,2,0,3,0,10,1.4285714285714286,1,0.0,0,2,0,2,3,0,0,3,0,4,6,1
6119,83382,yBjxhcDDJKIAjEmiiiesRzMTh8bRt1ah,A3fsA9Zfv1X2fVEQhTw51lKENdNrEqT3,2,0,0,0,0,0,2,0,2,0.2857142857142857,1,0.0,0,0,0,0,0,0,0,2,0,0,2,0
6120,83390,GRkdPFTbm7uYMggKfYKpZacMj3qggIR1,bWdj2GDclj5ofokWjzoa5jAwMkxCykd6,7,5,3,0,1,0,5,0,14,2.0,1,0.0,0,3,0,1,5,0,0,5,0,4,10,1
6121,83391,5lnG922UFflYKbVHck7tAuI1NLtyYgBb,A3fsA9Zfv1X2fVEQhTw51lKENdNrEqT3,2,0,0,0,0,0,2,0,2,0.2857142857142857,1,0.0,0,0,0,0,0,0,0,2,0,0,2,1
6122,83411,sw7EOsxnjfyxD0QxJsjO2WXRMXBWJD2E,bWdj2GDclj5ofokWjzoa5jAwMkxCykd6,12,16,5,0,4,0,3,0,28,4.0,5,0.0,0,5,0,4,16,0,0,3,0,9,19,1
6123,83414,YZ6ePHRxhdDlYW5sZ3zGIsdrka7l3wAZ,RXDvfPUBYFlVdlueBFbLW0mhhAyGEqpt,13,12,6,0,3,2,8,0,31,4.428571428571429,1,0.0,3,6,0,3,9,2,0,8,0,12,19,1
6124,83448,KRLjLXKoKEagD4g49Zuzvz0geq7JPqfn,5X6FeZozNMgE2VRi3MJYjkkFK8SETtu2,5,2,1,0,0,0,4,0,7,1.0,1,0.0,0,1,0,0,2,0,0,4,0,1,6,1
6125,83466,QuvCYikodbdRYaQkbLfEjRfwbs69qsbc,SpATywNh6bZuzm8s1ceuBUnMUAeoAHHw,1,0,0,0,0,0,1,0,1,0.14285714285714285,1,0.0,0,0,0,0,0,0,0,1,0,0,1,1
6126,83513,FN4Q8gUJQiuKtRiPQS3gBMUWwSnDptW4,SpATywNh6bZuzm8s1ceuBUnMUAeoAHHw,29,45,21,30,9,0,5,0,110,15.714285714285714,3,0.0,17,21,24,9,28,0,6,5,0,71,39,1
6127,83521,OmeHT0PntcI0ieBORzxyW3ukuMNHL2Uw,SpATywNh6bZuzm8s1ceuBUnMUAeoAHHw,1,0,0,0,0,0,1,0,1,0.14285714285714285,1,0.0,0,0,0,0,0,0,0,1,0,0,1,1
6128,83527,zAxSsEdPeUZGGnFIWSFOZ9V5E0hHlR0L,SpATywNh6bZuzm8s1ceuBUnMUAeoAHHw,5,4,1,0,1,0,1,0,7,1.0,1,0.0,1,1,0,1,3,0,0,1,0,3,4,1
6129,83528,HH0bgFZJUfJrK8yCEOD0HA8raoSrd2bR,SpATywNh6bZuzm8s1ceuBUnMUAeoAHHw,11,14,4,12,0,35,8,0,73,10.428571428571429,2,0.0,5,4,9,0,9,35,3,8,0,18,55,0
6130,83531,g1LVeBlQiVCOcKiTDDTy4PafQkGd4pbr,SpATywNh6bZuzm8s1ceuBUnMUAeoAHHw,15,16,8,13,2,0,3,0,42,6.0,2,0.0,3,8,13,2,13,0,0,3,0,26,16,1
6131,83557,VcIkh3vonmMTX4dPSjJiYVRsVaKRhYaU,SpATywNh6bZuzm8s1ceuBUnMUAeoAHHw,2,0,0,0,0,0,2,0,2,0.2857142857142857,1,0.0,0,0,0,0,0,0,0,2,0,0,2,1
6132,83577,ew5XZC7WSosl0QdXH45kYD3syMSGbOj6,A3fsA9Zfv1X2fVEQhTw51lKENdNrEqT3,42,51,24,64,20,0,4,0,163,23.285714285714285,3,0.0,5,24,54,20,46,0,10,4,0,103,60,1
6133,83602,Z1uIScALT37BtyCtbFy33E9DuvHO2hks,SpATywNh6bZuzm8s1ceuBUnMUAeoAHHw,1,0,0,0,0,0,1,0,1,0.14285714285714285,1,0.0,0,0,0,0,0,0,0,1,0,0,1,1
6134,83613,puN480TO3qbGXrXmM5qoOdmstQ51OC6E,bWdj2GDclj5ofokWjzoa5jAwMkxCykd6,26,47,23,50,10,32,55,5,222,31.714285714285715,6,0.0,6,23,47,10,41,32,3,55,5,86,136,0
6135,83623,H6I6nkJ6DtlIXdQ1opNRFdSYIFjksvYQ,SpATywNh6bZuzm8s1ceuBUnMUAeoAHHw,35,41,23,19,11,34,16,1,145,20.714285714285715,8,0.0,6,23,16,11,35,34,3,16,1,56,89,1
6136,83655,gGPwEyB8WM9RKY8d6MZCxjfZZkbEQNgr,5X6FeZozNMgE2VRi3MJYjkkFK8SETtu2,1,0,0,0,0,0,1,0,1,0.14285714285714285,1,0.0,0,0,0,0,0,0,0,1,0,0,1,1
6137,83684,MO75JAKfd03NfkJH3IgG154Ck5oA1Wzt,SpATywNh6bZuzm8s1ceuBUnMUAeoAHHw,12,15,8,0,4,1,11,1,40,5.714285714285714,1,0.0,2,8,0,4,13,1,0,11,1,14,26,0
6138,83717,O3LrBOriu4LFn5iIVlnw3bx3Q9TUIlm3,SpATywNh6bZuzm8s1ceuBUnMUAeoAHHw,1,0,0,0,0,0,1,0,1,0.14285714285714285,1,0.0,0,0,0,0,0,0,0,1,0,0,1,1
6139,83753,WxaYTMCI7yD8mE0osZVkZT9Orbo545LC,A3fsA9Zfv1X2fVEQhTw51lKENdNrEqT3,6,6,2,0,1,0,2,0,11,1.5714285714285714,1,0.0,0,2,0,1,6,0,0,2,0,3,8,1
6140,83765,YInPZ2NvQ1CvXlUb40X1VRvv4vqAWNKy,A3fsA9Zfv1X2fVEQhTw51lKENdNrEqT3,1,0,0,0,0,0,2,0,2,0.2857142857142857,1,0.0,0,0,0,0,0,0,0,2,0,0,2,1
6141,83776,1K0aEYcUjU3Omy9tzQvSoGMqsCiOBzQn,SpATywNh6bZuzm8s1ceuBUnMUAeoAHHw,5,2,1,0,1,0,2,0,6,0.8571428571428571,1,0.0,0,1,0,1,2,0,0,2,0,2,4,1
6142,83777,GYVy4Kw2IYTFaIZeLaixuEy0D5OoDjTn,A3fsA9Zfv1X2fVEQhTw51lKENdNrEqT3,1,0,0,0,0,0,1,0,1,0.14285714285714285,1,0.0,0,0,0,0,0,0,0,1,0,0,1,1
6143,83780,LUGJNGKKEXef9vp90U0uf3eBnGjvPHqY,bWdj2GDclj5ofokWjzoa5jAwMkxCykd6,5,1,0,0,1,0,3,0,5,0.7142857142857143,1,0.0,0,0,0,1,1,0,0,3,0,1,4,1
6144,83781,rwRg5VLLMifE3rBQ9ovBdMe754UeHyD2,SpATywNh6bZuzm8s1ceuBUnMUAeoAHHw,8,9,0,0,0,0,7,0,16,2.2857142857142856,1,0.0,5,0,0,0,4,0,0,7,0,5,11,1
6145,83783,VgSuhdH7aYuXsDcf74CEOycHQbwhkHBq,A3fsA9Zfv1X2fVEQhTw51lKENdNrEqT3,2,0,0,0,0,0,2,0,2,0.2857142857142857,1,0.0,0,0,0,0,0,0,0,2,0,0,2,1
6146,83793,YCIW1D7RWQYUKFuPMYan9yYkXr9VpOGv,G8EPVSXsOYB5YQWZGiz1aVq5Pgr2GrQu,11,13,8,0,7,4,6,1,39,5.571428571428571,1,0.0,4,8,0,7,9,4,0,6,1,19,20,1
6147,83811,svi8vAETiYnBPEWWZIRd4gAyZTcaxP58,bWdj2GDclj5ofokWjzoa5jAwMkxCykd6,1,0,0,0,0,0,1,0,1,0.14285714285714285,1,0.0,0,0,0,0,0,0,0,1,0,0,1,1
6148,83835,dTKOgYhMZbwlt2pFccvIYlq8JuGDHG7Q,RXDvfPUBYFlVdlueBFbLW0mhhAyGEqpt,4,3,0,0,0,0,2,0,5,0.7142857142857143,1,0.0,0,0,0,0,3,0,0,2,0,0,5,1
6149,83868,X4KSPkBIdPEeXdEy4Fa5NvixCQZdfNj3,bWdj2GDclj5ofokWjzoa5jAwMkxCykd6,1,0,0,0,0,0,1,0,1,0.14285714285714285,1,0.0,0,0,0,0,0,0,0,1,0,0,1,1
6150,83880,ZQE4YlSay0qfyoMsVO9k7S4IfrHuRzoo,A3fsA9Zfv1X2fVEQhTw51lKENdNrEqT3,1,0,0,0,0,0,1,0,1,0.14285714285714285,1,0.0,0,0,0,0,0,0,0,1,0,0,1,1
6151,83890,hkZJZMuEk3eRSgWhjH7jPcJrlgv2RTNl,bWdj2GDclj5ofokWjzoa5jAwMkxCykd6,15,15,7,40,3,5,3,0,73,10.428571428571429,2,0.0,5,7,39,3,10,5,1,3,0,54,19,1
6152,83895,e12uQn96OlYfknMdqSXCXdImglIj4IRR,RXDvfPUBYFlVdlueBFbLW0mhhAyGEqpt,1,0,0,0,0,0,1,0,1,0.14285714285714285,1,0.0,0,0,0,0,0,0,0,1,0,0,1,1
6153,83899,TB2wDsOo3kDLa90fD8fPr19ZM5ZS7ZAB,A3fsA9Zfv1X2fVEQhTw51lKENdNrEqT3,2,0,0,0,0,0,2,0,2,0.2857142857142857,1,0.0,0,0,0,0,0,0,0,2,0,0,2,1
6154,83902,9fqjCwCWiE2ZIs1HrK3mm4R5MSyOKac5,A3fsA9Zfv1X2fVEQhTw51lKENdNrEqT3,15,27,13,0,8,0,8,0,56,8.0,2,0.0,0,13,0,8,27,0,0,8,0,21,35,1
6155,83909,lQbf9gXsN1R7oTfmD8ApJzd1F5wN4xv1,RXDvfPUBYFlVdlueBFbLW0mhhAyGEqpt,16,9,8,0,6,1,6,0,30,4.285714285714286,2,0.0,0,8,0,6,9,1,0,6,0,14,16,1
6156,83919,mFpiELMd2y5tbkdxs4m8pKS7gXHb7bIO,RXDvfPUBYFlVdlueBFbLW0mhhAyGEqpt,18,22,13,16,12,0,3,0,66,9.428571428571429,3,0.0,3,13,13,12,19,0,3,3,0,41,25,1
6157,83928,wQsOYND6Uk5mviOI6mS6ntmifQ69LbeV,A3fsA9Zfv1X2fVEQhTw51lKENdNrEqT3,8,4,2,0,2,0,3,0,11,1.5714285714285714,1,0.0,0,2,0,2,4,0,0,3,0,4,7,1
6158,83938,oHe1wMZnf3Xtw691VYSqBDjM0Y2gPZAD,5X6FeZozNMgE2VRi3MJYjkkFK8SETtu2,2,0,0,0,0,0,2,0,2,0.2857142857142857,1,0.0,0,0,0,0,0,0,0,2,0,0,2,1
6159,83951,I6oJUzF1kneNCI5HLEngmj8oOrT8LAPo,A3fsA9Zfv1X2fVEQhTw51lKENdNrEqT3,1,0,0,0,0,0,1,0,1,0.14285714285714285,1,0.0,0,0,0,0,0,0,0,1,0,0,1,1
6160,83979,sTq9v868sPUgTaUUmCiFRadbl8t0UoCG,SpATywNh6bZuzm8s1ceuBUnMUAeoAHHw,28,31,14,22,7,2,7,0,83,11.857142857142858,2,0.0,12,14,19,7,19,2,3,7,0,52,31,1
6161,83991,HBNOGDmQrCA8ZCNHwMOm4mGR9448iscJ,5X6FeZozNMgE2VRi3MJYjkkFK8SETtu2,7,12,2,1,5,0,3,0,23,3.2857142857142856,1,0.0,7,2,1,5,5,0,0,3,0,15,8,1
6162,84010,Slef5w11bVkmRsTBBwhS62k507EfhwU6,SpATywNh6bZuzm8s1ceuBUnMUAeoAHHw,7,5,3,0,2,0,2,0,12,1.7142857142857142,1,0.0,1,3,0,2,4,0,0,2,0,6,6,1
6163,84030,0mQ8vyh0MNjPYyaHoBBFRDIFwsi9hZxK,G8EPVSXsOYB5YQWZGiz1aVq5Pgr2GrQu,6,6,3,0,0,0,2,0,11,1.5714285714285714,1,0.0,0,3,0,0,6,0,0,2,0,3,8,1
6164,84033,mFKbFysEV5gGAbHL9fgzkpXci6xFiaFe,bWdj2GDclj5ofokWjzoa5jAwMkxCykd6,3,3,1,0,0,0,2,0,6,0.8571428571428571,1,0.0,0,1,0,0,3,0,0,2,0,1,5,1
6165,84034,lDJqver3AFFUyXISNdqvZpmq6OeWVl0r,A3fsA9Zfv1X2fVEQhTw51lKENdNrEqT3,21,16,12,0,8,0,7,0,43,6.142857142857143,3,0.0,0,12,0,8,16,0,0,7,0,20,23,0
6166,84048,dhO2y8sIijAlPYlXxsHK1aEk6O7FL2Q2,A3fsA9Zfv1X2fVEQhTw51lKENdNrEqT3,1,0,0,0,0,0,1,0,1,0.14285714285714285,1,0.0,0,0,0,0,0,0,0,1,0,0,1,1
6167,84050,dhO2y8sIijAlPYlXxsHK1aEk6O7FL2Q2,bWdj2GDclj5ofokWjzoa5jAwMkxCykd6,1,0,0,0,0,0,1,0,1,0.14285714285714285,1,0.0,0,0,0,0,0,0,0,1,0,0,1,1
6168,84058,mMS5utPEE0kau31EdquwgaN1e0nxF2V4,SpATywNh6bZuzm8s1ceuBUnMUAeoAHHw,11,17,10,8,6,0,3,0,44,6.285714285714286,3,0.0,0,10,8,6,17,0,0,3,0,24,20,1
6169,84067,JA3GjaqmpFLtt1yojsnNXLqhMexKQ8aw,A3fsA9Zfv1X2fVEQhTw51lKENdNrEqT3,2,0,0,0,0,0,2,0,2,0.2857142857142857,1,0.0,0,0,0,0,0,0,0,2,0,0,2,1
6170,84083,bl8YOhounxXowMizQE2ibaM5H4dVfT77,SpATywNh6bZuzm8s1ceuBUnMUAeoAHHw,1,0,0,0,0,0,1,0,1,0.14285714285714285,1,0.0,0,0,0,0,0,0,0,1,0,0,1,1
6171,84112,m94Ln6mKwrTlZEJamxaNSzUQ9VRwHEQK,SpATywNh6bZuzm8s1ceuBUnMUAeoAHHw,5,1,1,0,1,0,2,0,5,0.7142857142857143,1,0.0,0,1,0,1,1,0,0,2,0,2,3,1
6172,84128,ZCUEihNB1w88UL2EoTplrSA9QYdknyaF,SpATywNh6bZuzm8s1ceuBUnMUAeoAHHw,7,4,1,0,1,1,4,2,13,1.8571428571428572,1,0.0,0,1,0,1,4,1,0,4,2,2,11,1
6173,84132,bVLtn3iBc4ibW8xWVzLLM3Hs9gCB0qb7,bWdj2GDclj5ofokWjzoa5jAwMkxCykd6,1,0,0,0,0,0,1,0,1,0.14285714285714285,1,0.0,0,0,0,0,0,0,0,1,0,0,1,1
6174,84134,KVl6nnI1zsPf8ekwqnmOATbcWkWGBTQA,SpATywNh6bZuzm8s1ceuBUnMUAeoAHHw,5,3,1,0,1,0,1,0,6,0.8571428571428571,1,0.0,0,1,0,1,3,0,0,1,0,2,4,1
6175,84144,XSeWDgxGevybVHeILVqIcSB7rPdA6Gvi,SpATywNh6bZuzm8s1ceuBUnMUAeoAHHw,1,0,0,0,0,0,1,0,1,0.14285714285714285,1,0.0,0,0,0,0,0,0,0,1,0,0,1,1
6176,84159,n51reZ5FTJkHLnQwBqURrmxGDzwEsEjy,SpATywNh6bZuzm8s1ceuBUnMUAeoAHHw,59,101,53,68,19,1,25,0,267,38.142857142857146,6,0.0,25,53,54,19,76,1,14,25,0,151,116,0
6177,84161,n51reZ5FTJkHLnQwBqURrmxGDzwEsEjy,G8EPVSXsOYB5YQWZGiz1aVq5Pgr2GrQu,6,2,0,0,0,0,4,0,6,0.8571428571428571,1,0.0,0,0,0,0,2,0,0,4,0,0,6,0
6178,84169,YTpSaD5WvcxnMj244x9U8tK7ZjCb9sw0,bWdj2GDclj5ofokWjzoa5jAwMkxCykd6,1,0,0,0,0,0,1,0,1,0.14285714285714285,1,0.0,0,0,0,0,0,0,0,1,0,0,1,1
6179,84176,Xv4cOEYZEExzsBdbjc8lrCLUZHXLo5uk,SpATywNh6bZuzm8s1ceuBUnMUAeoAHHw,28,46,17,39,8,48,16,1,175,25.0,5,0.0,21,17,32,8,25,48,7,16,1,78,97,0
6180,84180,tZMtcgGsCq7JvLpFL4lhYMv0agvGaZe2,bWdj2GDclj5ofokWjzoa5jAwMkxCykd6,5,2,1,0,1,0,2,0,6,0.8571428571428571,1,0.0,0,1,0,1,2,0,0,2,0,2,4,1
6181,84181,hmcgRc8JOAvEq0tlG5ocKNmIcTSbfNMw,5X6FeZozNMgE2VRi3MJYjkkFK8SETtu2,9,6,3,0,1,0,12,2,24,3.4285714285714284,2,0.0,0,3,0,1,6,0,0,12,2,4,20,1
6182,84183,xXxqqh9yVGi9oZiE57nohuMrqKDnoyIS,A3fsA9Zfv1X2fVEQhTw51lKENdNrEqT3,9,8,5,0,1,0,8,0,22,3.142857142857143,2,0.0,0,5,0,1,8,0,0,8,0,6,16,1
6183,84184,OsngIQPLVNsvztjbyMTR3Q1awEr69xBU,SpATywNh6bZuzm8s1ceuBUnMUAeoAHHw,3,2,0,0,0,0,1,0,3,0.42857142857142855,1,0.0,0,0,0,0,2,0,0,1,0,0,3,1
6184,84258,HOl7cCI0BgZTJ7INtqfMX4dKD4xHl51U,fbPkOYLVPtPgIt0MxizjfFJov3JbHyAi,14,29,6,12,7,0,1,0,55,7.857142857142857,1,0.0,15,6,9,7,14,0,3,1,0,37,18,1
6185,84259,xi2KO7WcXIB6LKlzLxLjQ5IcXn6cZQFV,fbPkOYLVPtPgIt0MxizjfFJov3JbHyAi,7,3,2,0,2,0,4,0,11,1.5714285714285714,1,0.0,0,2,0,2,3,0,0,4,0,4,7,1
6186,84261,lBljSQvIVCpw7S5SELQHg4JfMSTvCBRe,fbPkOYLVPtPgIt0MxizjfFJov3JbHyAi,10,13,1,0,1,0,3,0,18,2.5714285714285716,1,0.0,0,1,0,1,13,0,0,3,0,2,16,0
6187,84264,MSLYJeLT8SYZ3UpCzbTuM5WBLAn4P9C0,fbPkOYLVPtPgIt0MxizjfFJov3JbHyAi,5,2,1,0,1,0,2,0,6,0.8571428571428571,1,0.0,0,1,0,1,2,0,0,2,0,2,4,0
6188,84268,MaxCNnPaLK24RRWF9HKJTqddyOCcvhNc,fbPkOYLVPtPgIt0MxizjfFJov3JbHyAi,12,12,7,0,4,0,5,0,28,4.0,2,0.0,1,7,0,4,11,0,0,5,0,12,16,1
6189,84270,HRxHszLswfw468mOCwAnOXdKGRZhTUPo,fbPkOYLVPtPgIt0MxizjfFJov3JbHyAi,9,9,1,0,2,0,2,0,14,2.0,1,0.0,2,1,0,2,7,0,0,2,0,5,9,1
6190,84273,Mbzz4hCvkXsTjBUMTZvnUnOUU5DkeepD,fbPkOYLVPtPgIt0MxizjfFJov3JbHyAi,18,30,18,0,9,16,18,0,91,13.0,2,0.0,0,18,0,9,30,16,0,18,0,27,64,1
6191,84274,KSAnx8l7GLibIHVjfaVpoMytCY29O5jV,fbPkOYLVPtPgIt0MxizjfFJov3JbHyAi,14,10,7,0,6,0,6,0,29,4.142857142857143,1,0.0,0,7,0,6,10,0,0,6,0,13,16,1
6192,84276,FHZxLNKuH41dzVdZ6xZP53e1ChodL4Nf,fbPkOYLVPtPgIt0MxizjfFJov3JbHyAi,2,0,0,0,0,0,2,0,2,0.2857142857142857,1,0.0,0,0,0,0,0,0,0,2,0,0,2,1
6193,84277,2j1tzVxn26ffq0mMvPPBIt1027gHtJr2,fbPkOYLVPtPgIt0MxizjfFJov3JbHyAi,3,0,0,0,0,0,4,0,4,0.5714285714285714,1,0.0,0,0,0,0,0,0,0,4,0,0,4,1
6194,84278,sW5iKRsVcoKx4Fgip5uKQwojFhK3kh4H,fbPkOYLVPtPgIt0MxizjfFJov3JbHyAi,7,8,3,0,2,0,4,0,17,2.4285714285714284,1,0.0,3,3,0,2,5,0,0,4,0,8,9,1
6195,84279,IKnWhfStgn6HzF4rCtxpMA6vaE95bkoN,fbPkOYLVPtPgIt0MxizjfFJov3JbHyAi,41,58,32,28,21,7,7,0,153,21.857142857142858,2,0.0,18,32,23,21,40,7,5,7,0,94,59,1
6196,84281,E6x1c22fqqwc9Xq0TREOCZPgn8h5NZRY,fbPkOYLVPtPgIt0MxizjfFJov3JbHyAi,2,0,0,0,0,0,2,0,2,0.2857142857142857,1,0.0,0,0,0,0,0,0,0,2,0,0,2,1
6197,84282,oyKcbflIhFWjfv9zJsn9ws83l2i6sd8B,fbPkOYLVPtPgIt0MxizjfFJov3JbHyAi,5,0,0,0,0,0,4,1,5,0.7142857142857143,1,0.0,0,0,0,0,0,0,0,4,1,0,5,1
6198,84284,SfvT6FHCLeajKH96s2LkoIO8YQ9sAqIE,fbPkOYLVPtPgIt0MxizjfFJov3JbHyAi,1,0,0,0,0,0,1,0,1,0.14285714285714285,1,0.0,0,0,0,0,0,0,0,1,0,0,1,1
6199,84285,6dxWIDqaYjsp7lwDHFYen9IBERKYGMUl,fbPkOYLVPtPgIt0MxizjfFJov3JbHyAi,11,14,10,0,8,1,9,1,43,6.142857142857143,5,0.0,0,10,0,8,14,1,0,9,1,18,25,1
6200,84289,8a6lcOY5tqRSg2M4LEQLAhRHX2NBy9qe,fbPkOYLVPtPgIt0MxizjfFJov3JbHyAi,1,0,0,0,0,0,1,0,1,0.14285714285714285,1,0.0,0,0,0,0,0,0,0,1,0,0,1,1
6201,84291,8V79kzOnHwVk0Szz0Nr0pjOSCgEaC0bl,fbPkOYLVPtPgIt0MxizjfFJov3JbHyAi,1,0,0,0,0,0,1,0,1,0.14285714285714285,1,0.0,0,0,0,0,0,0,0,1,0,0,1,0
6202,84433,Vu8rN942EwDIOj6iE8IDqvSFXpvGHO9R,A3fsA9Zfv1X2fVEQhTw51lKENdNrEqT3,49,28,21,72,12,0,10,0,143,20.428571428571427,2,0.0,4,21,57,12,24,0,15,10,0,94,49,1
6203,84438,zo3To03Q5Rdok3x4Zu1wNdsKqNDBlzyd,SpATywNh6bZuzm8s1ceuBUnMUAeoAHHw,3,2,1,0,0,2,1,0,6,0.8571428571428571,2,0.0,0,1,0,0,2,2,0,1,0,1,5,1
6204,84439,lmCPiW6l0WNp9Ttn0lhwFDs7FfVubtvY,SpATywNh6bZuzm8s1ceuBUnMUAeoAHHw,27,63,7,48,3,0,9,2,132,18.857142857142858,5,0.0,33,7,43,3,30,0,5,9,2,86,46,0
6205,84443,d27sJazbqmVDzx5twhACbiEBxUXvQf2a,SpATywNh6bZuzm8s1ceuBUnMUAeoAHHw,8,4,1,0,1,0,6,0,12,1.7142857142857142,1,0.0,0,1,0,1,4,0,0,6,0,2,10,1
6206,84463,ROXnyv16zBgjdP3dwdWTQaFrI7qQfgov,bWdj2GDclj5ofokWjzoa5jAwMkxCykd6,3,0,0,0,0,0,3,0,3,0.42857142857142855,1,0.0,0,0,0,0,0,0,0,3,0,0,3,1
6207,84487,dlcs3mIk1dQaLsNVv2V1gEVdgllvLwJb,SpATywNh6bZuzm8s1ceuBUnMUAeoAHHw,8,10,4,0,1,1,5,0,21,3.0,2,0.0,2,4,0,1,8,1,0,5,0,7,14,1
6208,84488,Hb1qgsgjtdXdXqLzZUND7Apyl9dV7sNn,SpATywNh6bZuzm8s1ceuBUnMUAeoAHHw,15,26,1,18,1,0,2,0,48,6.857142857142857,1,0.0,6,1,15,1,20,0,3,2,0,23,25,1
6209,84493,yEniPsoZW8Rgn4eOpAbvQhjj6pD8iwKc,bWdj2GDclj5ofokWjzoa5jAwMkxCykd6,3,2,0,0,0,0,1,0,3,0.42857142857142855,1,0.0,0,0,0,0,2,0,0,1,0,0,3,1
6210,84511,IDZ1AkiRXaR9yEtXb4Bo4nmlcF9ha0Jw,A3fsA9Zfv1X2fVEQhTw51lKENdNrEqT3,11,10,1,0,1,0,2,0,14,2.0,1,0.0,0,1,0,1,10,0,0,2,0,2,12,1
6211,84515,7zovZ3nFJhhuFND78aqDkmZfLWj3rVkx,bWdj2GDclj5ofokWjzoa5jAwMkxCykd6,8,11,3,0,4,1,5,1,25,3.5714285714285716,1,0.0,5,3,0,4,6,1,0,5,1,12,13,1
6212,84531,UwNh19bGTGX7YEBtcKZFqxDpmh2gUs3A,SpATywNh6bZuzm8s1ceuBUnMUAeoAHHw,42,74,37,40,19,1,16,0,187,26.714285714285715,8,0.0,16,37,37,19,58,1,3,16,0,109,78,0
6213,84533,KYp9UMy6aThBgyjsQnGoWdfiTDRtgnUO,A3fsA9Zfv1X2fVEQhTw51lKENdNrEqT3,4,3,1,0,0,0,1,0,5,0.7142857142857143,1,0.0,0,1,0,0,3,0,0,1,0,1,4,1
6214,84562,k6RJ44LpfDefc4BqSfb5Ks3bqRLzpbPs,SpATywNh6bZuzm8s1ceuBUnMUAeoAHHw,3,2,0,0,0,0,1,0,3,0.42857142857142855,1,0.0,0,0,0,0,2,0,0,1,0,0,3,1
6215,84570,3ROVLcXTo6OjIxmsQ13CBJ7pM5RMLVRs,SpATywNh6bZuzm8s1ceuBUnMUAeoAHHw,1,0,0,0,0,0,1,0,1,0.14285714285714285,1,0.0,0,0,0,0,0,0,0,1,0,0,1,1
6216,84617,7QvV3hsa8puVP6u6wQJmusW3X0nL3GiJ,RXDvfPUBYFlVdlueBFbLW0mhhAyGEqpt,6,4,2,0,1,0,2,0,9,1.2857142857142858,1,0.0,0,2,0,1,4,0,0,2,0,3,6,1
6217,84622,UkZfNxIrXEzpCVrNVYStVn9ei74ROLV5,SpATywNh6bZuzm8s1ceuBUnMUAeoAHHw,9,4,3,0,3,0,2,0,12,1.7142857142857142,1,0.0,0,3,0,3,4,0,0,2,0,6,6,1
6218,84637,uqV3t3wNYphdy7WkOt07V9fSIpdy9v7v,SpATywNh6bZuzm8s1ceuBUnMUAeoAHHw,1,0,0,0,0,0,1,0,1,0.14285714285714285,1,0.0,0,0,0,0,0,0,0,1,0,0,1,1
6219,84650,rM6lHK7hiIUNX1NSrJxSbqLCGaqN5u1S,bWdj2GDclj5ofokWjzoa5jAwMkxCykd6,1,0,0,0,0,0,1,0,1,0.14285714285714285,1,0.0,0,0,0,0,0,0,0,1,0,0,1,1
6220,84655,fuprfcX49r5QcUYvMQnvvzEf76cx4sRp,A3fsA9Zfv1X2fVEQhTw51lKENdNrEqT3,1,0,0,0,0,0,1,0,1,0.14285714285714285,1,0.0,0,0,0,0,0,0,0,1,0,0,1,1
6221,84656,DA41CWRarbj2LaaLGDHgoyCQ99QpXH1z,SpATywNh6bZuzm8s1ceuBUnMUAeoAHHw,1,0,0,0,0,0,1,0,1,0.14285714285714285,1,0.0,0,0,0,0,0,0,0,1,0,0,1,1
6222,84687,LuY5FiD3zLZEjwGtpCcfkhMm5sUdJ1VF,RXDvfPUBYFlVdlueBFbLW0mhhAyGEqpt,1,0,0,0,0,0,1,0,1,0.14285714285714285,1,0.0,0,0,0,0,0,0,0,1,0,0,1,1
6223,84696,HDx7XT9cwQtHtGFe0Ylk6QLaCz2f0GRa,bWdj2GDclj5ofokWjzoa5jAwMkxCykd6,11,17,11,0,2,11,7,0,48,6.857142857142857,3,0.0,1,11,0,2,16,11,0,7,0,14,34,1
6224,84697,aaRUd5jlFUSCfSYwox8KYccyK9uFgesK,G8EPVSXsOYB5YQWZGiz1aVq5Pgr2GrQu,5,2,1,0,1,0,2,0,6,0.8571428571428571,1,0.0,0,1,0,1,2,0,0,2,0,2,4,1
6225,84712,rK4055OdlTymOWiwkxW7eIve09mowPhX,bWdj2GDclj5ofokWjzoa5jAwMkxCykd6,17,25,13,40,8,5,9,1,101,14.428571428571429,2,0.0,7,13,35,8,18,5,5,9,1,63,38,1
6226,84733,9WmzxyamLAgd2LnrO6zydiN7WV3MNZZt,SpATywNh6bZuzm8s1ceuBUnMUAeoAHHw,30,57,41,26,13,45,20,3,205,29.285714285714285,4,0.0,11,41,26,13,46,45,0,20,3,91,114,1
6227,84746,KyernIkPskZZLcEZuqJdIALK35DoR4YD,SpATywNh6bZuzm8s1ceuBUnMUAeoAHHw,9,7,4,7,3,0,1,0,22,3.142857142857143,1,0.0,1,4,6,3,6,0,1,1,0,14,8,0
6228,84764,l0LgYDne2SMH172pM6WtwTolJro40hEN,bWdj2GDclj5ofokWjzoa5jAwMkxCykd6,8,8,5,0,2,0,2,0,17,2.4285714285714284,1,0.0,0,5,0,2,8,0,0,2,0,7,10,1
6229,84768,DsHgWZRTJ1y1l15smwhB78ZQq3d8dyKP,bWdj2GDclj5ofokWjzoa5jAwMkxCykd6,12,73,5,24,7,2,17,0,128,18.285714285714285,8,0.0,8,5,23,7,65,2,1,17,0,43,85,1
6230,84773,pQdSl7i5ZuZeH9uPILgdHrvwskp4vc4V,RXDvfPUBYFlVdlueBFbLW0mhhAyGEqpt,2,0,0,0,0,0,2,0,2,0.2857142857142857,1,0.0,0,0,0,0,0,0,0,2,0,0,2,1
6231,84803,RijiZcjqs3Sau2onXuynGNDorKgFFeFF,A3fsA9Zfv1X2fVEQhTw51lKENdNrEqT3,1,0,0,0,0,0,1,0,1,0.14285714285714285,1,0.0,0,0,0,0,0,0,0,1,0,0,1,1
6232,84807,lBDP0bEGdpXmY1IAvAuALKqFWFlEuPft,A3fsA9Zfv1X2fVEQhTw51lKENdNrEqT3,1,0,0,0,0,0,1,0,1,0.14285714285714285,1,0.0,0,0,0,0,0,0,0,1,0,0,1,1
6233,84823,Wefj86tFjwJZnMq6IAWMjbzJgYWyoGE5,A3fsA9Zfv1X2fVEQhTw51lKENdNrEqT3,7,4,1,0,1,0,2,0,8,1.1428571428571428,1,0.0,0,1,0,1,4,0,0,2,0,2,6,1
6234,84824,CCr7XJJW4dK2W5QL9m4z2ZC42b4ulnok,SpATywNh6bZuzm8s1ceuBUnMUAeoAHHw,37,45,30,0,15,2,19,2,113,16.142857142857142,6,0.0,5,30,0,15,40,2,0,19,2,50,63,0
6235,84837,yv537v6H4lKuJBGFGcy0VRT6imwv3rrr,SpATywNh6bZuzm8s1ceuBUnMUAeoAHHw,1,0,0,0,0,0,2,0,2,0.2857142857142857,1,0.0,0,0,0,0,0,0,0,2,0,0,2,1
6236,84840,nMDev1avOgY53G2oqsCYhN7adTYqimPz,SpATywNh6bZuzm8s1ceuBUnMUAeoAHHw,20,20,10,13,7,0,4,0,54,7.714285714285714,3,0.0,6,10,12,7,14,0,1,4,0,35,19,1
6237,84856,IKpNQ2VJXcBrssoIsB3X4wtY2qE1YTKj,bWdj2GDclj5ofokWjzoa5jAwMkxCykd6,8,18,10,0,6,3,6,0,43,6.142857142857143,4,0.0,0,10,0,6,18,3,0,6,0,16,27,1
6238,84879,Wq9v1J863GLs0FXJcY6870pE4xwQWj9c,SpATywNh6bZuzm8s1ceuBUnMUAeoAHHw,7,6,3,0,2,1,5,0,17,2.4285714285714284,1,0.0,0,3,0,2,6,1,0,5,0,5,12,1
6239,84893,aXizpBfL2fbBc8SAHrmAdMBwyiDoIJ3v,SpATywNh6bZuzm8s1ceuBUnMUAeoAHHw,3,2,0,0,0,0,2,0,4,0.5714285714285714,1,0.0,0,0,0,0,2,0,0,2,0,0,4,1
6240,84898,BNaKyL5AxH5r8ATMyUD5dD2w9iqh31Mt,SpATywNh6bZuzm8s1ceuBUnMUAeoAHHw,8,6,4,0,3,0,4,0,17,2.4285714285714284,1,0.0,0,4,0,3,6,0,0,4,0,7,10,1
6241,84899,AMjnZTCZ82BDNCUbVBOLwJQKlTsIjteg,bWdj2GDclj5ofokWjzoa5jAwMkxCykd6,1,0,0,0,0,0,1,0,1,0.14285714285714285,1,0.0,0,0,0,0,0,0,0,1,0,0,1,1
6242,84914,CAJCBn0iJNYHHRrNYpaEyoUpQFaCqopf,SpATywNh6bZuzm8s1ceuBUnMUAeoAHHw,3,0,0,0,0,11,2,0,13,1.8571428571428572,1,0.0,0,0,0,0,0,11,0,2,0,0,13,1
6243,84920,P8HECw7bHyNqGqPTlWbv24tTg1SG6bAf,A3fsA9Zfv1X2fVEQhTw51lKENdNrEqT3,12,7,5,0,4,0,4,0,20,2.857142857142857,2,0.0,0,5,0,4,7,0,0,4,0,9,11,1
6244,84924,bkuP1EtN8mdTFJXvfsUwoFetipNOKV1x,A3fsA9Zfv1X2fVEQhTw51lKENdNrEqT3,6,4,0,0,0,2,3,0,9,1.2857142857142858,2,0.0,0,0,0,0,4,2,0,3,0,0,9,0
6245,84932,fpXwVrOW9HYGTHXhtLxKXSs2JRhI6VdQ,G8EPVSXsOYB5YQWZGiz1aVq5Pgr2GrQu,2,0,0,0,0,0,2,0,2,0.2857142857142857,1,0.0,0,0,0,0,0,0,0,2,0,0,2,1
6246,84933,u0SrW65Zdf0RG2PPgt52qf6MWWYZDmbZ,A3fsA9Zfv1X2fVEQhTw51lKENdNrEqT3,4,2,1,0,1,0,2,0,6,0.8571428571428571,1,0.0,0,1,0,1,2,0,0,2,0,2,4,0
6247,84941,wdyLBUXnKZHWy3hjP9iEUMTvoZlBkTI1,A3fsA9Zfv1X2fVEQhTw51lKENdNrEqT3,73,22,16,216,11,2,5,0,272,38.857142857142854,2,0.0,4,16,172,11,18,2,44,5,0,203,69,1
6248,84943,tqYPV9KH0m40QH4HM703oTrUL5BNNo84,bWdj2GDclj5ofokWjzoa5jAwMkxCykd6,3,3,0,0,0,0,2,0,5,0.7142857142857143,1,0.0,0,0,0,0,3,0,0,2,0,0,5,1
6249,84959,hkI32MAgHvJ4T3I3Up79daEJ8l4sKHaC,A3fsA9Zfv1X2fVEQhTw51lKENdNrEqT3,19,11,10,16,9,0,1,0,47,6.714285714285714,1,0.0,0,10,15,9,11,0,1,1,0,34,13,1
6250,84967,cnF5YfjX3CQt7JMSCL8P4leqdmCPbBni,A3fsA9Zfv1X2fVEQhTw51lKENdNrEqT3,8,8,1,0,1,0,2,0,12,1.7142857142857142,2,0.0,1,1,0,1,7,0,0,2,0,3,9,1
6251,84969,AhGz4Es1bWdEWhXy7JGcFI2vY1lHgQNv,A3fsA9Zfv1X2fVEQhTw51lKENdNrEqT3,11,14,7,0,4,0,9,0,34,4.857142857142857,1,0.0,0,7,0,4,14,0,0,9,0,11,23,1
6252,84982,KogrHROquIJLSXIZqzhYU9Hcb9zVebwT,A3fsA9Zfv1X2fVEQhTw51lKENdNrEqT3,68,28,21,134,13,39,12,1,248,35.42857142857143,3,0.0,3,21,108,13,25,39,26,12,1,145,103,1
6253,85000,7ZT5u11YEDTZhD4NZDPzOcLz6uLhq9Bd,RXDvfPUBYFlVdlueBFbLW0mhhAyGEqpt,14,12,8,8,3,0,3,0,34,4.857142857142857,2,0.0,1,8,7,3,11,0,1,3,0,19,15,1
6254,85006,tj54X35V4FNci4Kh3LQpxJqVKMwouLiV,SpATywNh6bZuzm8s1ceuBUnMUAeoAHHw,1,0,0,0,0,0,1,0,1,0.14285714285714285,1,0.0,0,0,0,0,0,0,0,1,0,0,1,1
6255,85036,Dieqd8f4UcwVzwl01TlWitYgH9I2P4ID,SpATywNh6bZuzm8s1ceuBUnMUAeoAHHw,14,16,5,15,3,0,2,0,41,5.857142857142857,1,0.0,10,5,12,3,6,0,3,2,0,30,11,1
6256,85058,aIIHBjdeRcv9jhajcTkxD39vpVMqF1ri,SpATywNh6bZuzm8s1ceuBUnMUAeoAHHw,1,0,0,0,0,0,1,0,1,0.14285714285714285,1,0.0,0,0,0,0,0,0,0,1,0,0,1,1
6257,85071,aO0LEwjTmeNegVPIDdxnfGASlS2PDBPM,bWdj2GDclj5ofokWjzoa5jAwMkxCykd6,4,2,0,0,0,0,2,0,4,0.5714285714285714,1,0.0,0,0,0,0,2,0,0,2,0,0,4,1
6258,85074,DxH75iZ2vwK7RWdx8JWNqysBZPhRedJP,SpATywNh6bZuzm8s1ceuBUnMUAeoAHHw,14,9,7,0,6,0,4,0,26,3.7142857142857144,1,0.0,0,7,0,6,9,0,0,4,0,13,13,1
6259,85101,eUiPnt4yNOhbT6A4YKzKQWtxymmKMqK8,SpATywNh6bZuzm8s1ceuBUnMUAeoAHHw,6,4,3,0,2,0,4,0,13,1.8571428571428572,3,0.0,0,3,0,2,4,0,0,4,0,5,8,0
6260,85143,cnF5YfjX3CQt7JMSCL8P4leqdmCPbBni,SpATywNh6bZuzm8s1ceuBUnMUAeoAHHw,19,28,5,19,3,1,11,2,69,9.857142857142858,4,0.0,2,5,17,3,26,1,2,11,2,27,42,1
6261,85147,Yce7TA6zcxabzTyAHw2EdJ3TEisyjXyi,G8EPVSXsOYB5YQWZGiz1aVq5Pgr2GrQu,1,0,0,0,0,0,1,0,1,0.14285714285714285,1,0.0,0,0,0,0,0,0,0,1,0,0,1,1
6262,85159,t5GAapz2qu7QW3ZA52Mo1qG5gvWMLT4H,G8EPVSXsOYB5YQWZGiz1aVq5Pgr2GrQu,11,23,9,0,8,0,1,0,41,5.857142857142857,1,0.0,13,9,0,8,10,0,0,1,0,30,11,1
6263,85161,bjM6n8DVZxyRbCs3zMbeKGW5iCOjCuf2,SpATywNh6bZuzm8s1ceuBUnMUAeoAHHw,48,56,33,53,17,20,11,1,191,27.285714285714285,9,0.0,14,33,44,17,42,20,9,11,1,108,83,0
6264,85163,W8y6AnXsJBrDnPij0rvHOisz3iKgMu0I,A3fsA9Zfv1X2fVEQhTw51lKENdNrEqT3,1,0,0,0,0,0,1,0,1,0.14285714285714285,1,0.0,0,0,0,0,0,0,0,1,0,0,1,1
6265,85203,9WmzxyamLAgd2LnrO6zydiN7WV3MNZZt,A3fsA9Zfv1X2fVEQhTw51lKENdNrEqT3,20,40,37,0,19,4,6,1,107,15.285714285714286,1,0.0,0,37,0,19,40,4,0,6,1,56,51,1
6266,85211,aCaozGkyCsn54GVTA7Zc8fb6f5Q5mLe0,G8EPVSXsOYB5YQWZGiz1aVq5Pgr2GrQu,2,0,0,0,0,0,2,0,2,0.2857142857142857,1,0.0,0,0,0,0,0,0,0,2,0,0,2,1
6267,85214,t5GAapz2qu7QW3ZA52Mo1qG5gvWMLT4H,SpATywNh6bZuzm8s1ceuBUnMUAeoAHHw,21,27,13,0,8,0,4,0,52,7.428571428571429,3,0.0,12,13,0,8,15,0,0,4,0,33,19,0
6268,85217,LgWCkAUxSRrYwIgyk3EiLrbm8VtT63oN,SpATywNh6bZuzm8s1ceuBUnMUAeoAHHw,5,3,0,0,0,0,2,0,5,0.7142857142857143,1,0.0,0,0,0,0,3,0,0,2,0,0,5,1
6269,85224,1DHzwL80UljY6lJVpTYvYIaqwxFV4OAM,A3fsA9Zfv1X2fVEQhTw51lKENdNrEqT3,4,4,0,0,0,0,2,0,6,0.8571428571428571,1,0.0,0,0,0,0,4,0,0,2,0,0,6,1
6270,85249,p6TgFJdLQMaMzbR16kycIPcRPnBj3paK,A3fsA9Zfv1X2fVEQhTw51lKENdNrEqT3,4,2,1,0,1,0,1,0,5,0.7142857142857143,1,0.0,0,1,0,1,2,0,0,1,0,2,3,1
6271,85253,XJf8gYhDJm1hrkVJvLQ4HKEnvPd3mIMq,G8EPVSXsOYB5YQWZGiz1aVq5Pgr2GrQu,22,41,2,50,0,3,5,0,101,14.428571428571429,3,0.0,19,2,33,0,22,3,17,5,0,54,47,1
6272,85262,F2owRK2SDPW5FCDK4TxmBVHsTtJ44Nxq,A3fsA9Zfv1X2fVEQhTw51lKENdNrEqT3,12,19,2,0,2,0,3,0,26,3.7142857142857144,2,0.0,0,2,0,2,19,0,0,3,0,4,22,1
6273,85271,pMl3OskiuqgHNgKCqbUXUq2PDmPkrU2r,bWdj2GDclj5ofokWjzoa5jAwMkxCykd6,5,2,1,0,1,0,2,0,6,0.8571428571428571,1,0.0,0,1,0,1,2,0,0,2,0,2,4,1
6274,85283,9WmzxyamLAgd2LnrO6zydiN7WV3MNZZt,RXDvfPUBYFlVdlueBFbLW0mhhAyGEqpt,9,12,10,0,5,0,6,0,33,4.714285714285714,3,0.0,0,10,0,5,12,0,0,6,0,15,18,1
6275,85284,Ws4jgichwsX0H8doBZ8nJsfB9pxtw9wh,SpATywNh6bZuzm8s1ceuBUnMUAeoAHHw,1,0,0,0,0,0,1,0,1,0.14285714285714285,1,0.0,0,0,0,0,0,0,0,1,0,0,1,1
6276,85286,pMl3OskiuqgHNgKCqbUXUq2PDmPkrU2r,A3fsA9Zfv1X2fVEQhTw51lKENdNrEqT3,2,0,0,0,0,0,2,0,2,0.2857142857142857,1,0.0,0,0,0,0,0,0,0,2,0,0,2,1
6277,85295,Zp1ZZPWn2kKT7nmilqO0Enc4rubJRG8n,SpATywNh6bZuzm8s1ceuBUnMUAeoAHHw,19,50,2,0,1,1,45,0,99,14.142857142857142,8,0.0,0,2,0,1,50,1,0,45,0,3,96,0
6278,85297,4VgoVQWGOr2mBZAQVNzDshzPrpqcYbQA,SpATywNh6bZuzm8s1ceuBUnMUAeoAHHw,5,4,0,0,0,0,3,0,7,1.0,2,0.0,0,0,0,0,4,0,0,3,0,0,7,1
6279,85328,VZ5o45Yr5Bm8WANLZeoMpkPB24du6vYe,SpATywNh6bZuzm8s1ceuBUnMUAeoAHHw,1,0,0,0,0,0,1,0,1,0.14285714285714285,1,0.0,0,0,0,0,0,0,0,1,0,0,1,1
6280,85331,RZI7KROUR7i2T6MB71TuoKGbXE5WXiwO,SpATywNh6bZuzm8s1ceuBUnMUAeoAHHw,5,10,0,0,0,0,5,0,15,2.142857142857143,2,0.0,0,0,0,0,10,0,0,5,0,0,15,1
6281,85337,176ILS8J1NMmZsoc0RxEg8JQJcz6ksLo,SpATywNh6bZuzm8s1ceuBUnMUAeoAHHw,1,0,0,0,0,0,1,0,1,0.14285714285714285,1,0.0,0,0,0,0,0,0,0,1,0,0,1,1
6282,85351,4E7spFhBfl0gEqkMBOstVjR5pQXkTXaF,SpATywNh6bZuzm8s1ceuBUnMUAeoAHHw,1,0,0,0,0,0,1,0,1,0.14285714285714285,1,0.0,0,0,0,0,0,0,0,1,0,0,1,1
6283,85376,tO135VWcqma21HvgPTdpgoHPq5kDsz9m,SpATywNh6bZuzm8s1ceuBUnMUAeoAHHw,4,2,1,0,1,0,2,0,6,0.8571428571428571,1,0.0,0,1,0,1,2,0,0,2,0,2,4,1
6284,85377,tO135VWcqma21HvgPTdpgoHPq5kDsz9m,A3fsA9Zfv1X2fVEQhTw51lKENdNrEqT3,4,2,1,0,1,0,1,0,5,0.7142857142857143,1,0.0,0,1,0,1,2,0,0,1,0,2,3,1
6285,85434,NcEpl157R9804FU8cPtpCcaWHzDDnaT9,3VkHkmOtom3jM2wCu94xgzzu1d6Dn7or,18,11,7,0,9,0,2,0,29,4.142857142857143,1,0.0,3,7,0,9,8,0,0,2,0,19,10,1
6286,85529,FGDAOKCQeh2COlf4gWhhsBCjdm5IkOal,3VkHkmOtom3jM2wCu94xgzzu1d6Dn7or,15,27,1,14,4,6,6,3,61,8.714285714285714,2,0.0,5,1,11,4,22,6,3,6,3,21,40,1
6287,85532,2n3uQwvGODQH4qmEUpmLUpr9RcDmEzfa,3VkHkmOtom3jM2wCu94xgzzu1d6Dn7or,16,13,7,0,6,0,7,0,33,4.714285714285714,1,0.0,4,7,0,6,9,0,0,7,0,17,16,1
6288,85566,y0ATBl8yDJnpmNzHNjpBIQ57CPs3LH6g,3VkHkmOtom3jM2wCu94xgzzu1d6Dn7or,8,6,1,4,2,1,1,0,15,2.142857142857143,1,0.0,1,1,3,2,5,1,1,1,0,7,8,1
6289,85609,daRNgrfSmtLtouStkwCortm8nv14xS31,3VkHkmOtom3jM2wCu94xgzzu1d6Dn7or,13,21,14,0,0,1,7,3,46,6.571428571428571,6,0.0,0,14,0,0,21,1,0,7,3,14,32,1
6290,85622,nn6jPlyrAIUIfYmerqepUfWdtAla0t7z,3VkHkmOtom3jM2wCu94xgzzu1d6Dn7or,1,0,0,0,0,0,1,0,1,0.14285714285714285,1,0.0,0,0,0,0,0,0,0,1,0,0,1,1
6291,85647,adsofsgiOwHfX7QscwvevqNp9Uv4CLo9,3VkHkmOtom3jM2wCu94xgzzu1d6Dn7or,7,2,1,0,1,0,6,0,10,1.4285714285714286,2,0.0,0,1,0,1,2,0,0,6,0,2,8,1
6292,85655,TusMPaNX8e6lAdKqrk2YZunhumeGuKss,3VkHkmOtom3jM2wCu94xgzzu1d6Dn7or,9,14,6,0,3,1,11,1,36,5.142857142857143,1,0.0,1,6,0,3,13,1,0,11,1,10,26,1
6293,85682,9W0hzIqg3d3SzHPxHA9rdc1qeF58DGnz,3VkHkmOtom3jM2wCu94xgzzu1d6Dn7or,55,75,24,44,34,0,20,0,197,28.142857142857142,3,0.0,44,24,35,34,31,0,9,20,0,137,60,1
6294,85706,0bRU3XUyuTRq2qF8MuiGBvstwQnWOcTL,3VkHkmOtom3jM2wCu94xgzzu1d6Dn7or,14,15,4,8,2,5,13,0,47,6.714285714285714,2,0.0,8,4,6,2,7,5,2,13,0,20,27,1
6295,85709,qhmgArW8a15UOGQrFTosGi03wE1TjPeN,3VkHkmOtom3jM2wCu94xgzzu1d6Dn7or,5,7,1,0,3,0,2,0,13,1.8571428571428572,1,0.0,5,1,0,3,2,0,0,2,0,9,4,1
6296,85765,BxzeEtLTtyqT2N1wOyGgAZOqrYSFmc9w,3VkHkmOtom3jM2wCu94xgzzu1d6Dn7or,10,33,11,3,6,2,10,0,65,9.285714285714286,2,0.0,17,11,3,6,16,2,0,10,0,37,28,0
6297,85785,5GVGPrErUniOXoCARApOCu7A41eMjYCN,3VkHkmOtom3jM2wCu94xgzzu1d6Dn7or,9,15,8,0,3,0,4,0,30,4.285714285714286,2,0.0,0,8,0,3,15,0,0,4,0,11,19,1
6298,85814,wy2vY5aiYwg0C5zglGAXrG2vaWLSbGC9,3VkHkmOtom3jM2wCu94xgzzu1d6Dn7or,1,0,0,0,0,0,1,0,1,0.14285714285714285,1,0.0,0,0,0,0,0,0,0,1,0,0,1,0
6299,85823,QBVMiTddprVHVCuwpdN5G4YkLbvf6jNG,3VkHkmOtom3jM2wCu94xgzzu1d6Dn7or,14,44,20,0,4,0,7,0,75,10.714285714285714,3,0.0,3,20,0,4,41,0,0,7,0,27,48,1
6300,85838,tU02Y4LN7vwr546RBpAZKZPf8ZcDxVkR,3VkHkmOtom3jM2wCu94xgzzu1d6Dn7or,1,0,0,0,0,0,1,0,1,0.14285714285714285,1,0.0,0,0,0,0,0,0,0,1,0,0,1,1
6301,85894,GhT3L3BlZcRJQklHCjpGRwGxiZWYsOhL,3VkHkmOtom3jM2wCu94xgzzu1d6Dn7or,64,131,40,46,54,4,12,0,287,41.0,8,0.0,70,40,44,54,61,4,2,12,0,208,79,0
6302,85942,rkXypKKijSCgNkdsUitujuud51W3iT9z,3VkHkmOtom3jM2wCu94xgzzu1d6Dn7or,32,34,19,20,14,8,9,1,105,15.0,2,0.0,8,19,18,14,26,8,2,9,1,59,46,0
6303,85959,v5AGeSJAXp4KXlmz8iqonrrJtCVn5C1s,3VkHkmOtom3jM2wCu94xgzzu1d6Dn7or,1,0,0,0,0,0,1,0,1,0.14285714285714285,1,0.0,0,0,0,0,0,0,0,1,0,0,1,1
6304,85965,eVsh2PvhGosDbgLKjO5vTcXmt553P6t2,3VkHkmOtom3jM2wCu94xgzzu1d6Dn7or,37,50,14,32,20,7,5,1,129,18.428571428571427,2,0.0,34,14,32,20,16,7,0,5,1,100,29,1
6305,85982,kqDqbU5eyXy2rfhHbl8FwFgfUq7w77zy,3VkHkmOtom3jM2wCu94xgzzu1d6Dn7or,7,5,3,0,2,0,5,0,15,2.142857142857143,2,0.0,0,3,0,2,5,0,0,5,0,5,10,0
6306,85998,LSNtbovTcgFnEMpuzvsjNhH7WJWF5QKQ,3VkHkmOtom3jM2wCu94xgzzu1d6Dn7or,15,24,4,6,9,0,10,0,53,7.571428571428571,2,0.0,19,4,6,9,5,0,0,10,0,38,15,1
6307,86087,0B5UC4zYQ9vCeDhBDIKJCGXVsyRds3Qg,3VkHkmOtom3jM2wCu94xgzzu1d6Dn7or,1,0,0,0,0,0,1,0,1,0.14285714285714285,1,0.0,0,0,0,0,0,0,0,1,0,0,1,1
6308,86212,HbSMY2nbJO0smuDvXqFVrZ4a2ObiucPS,3VkHkmOtom3jM2wCu94xgzzu1d6Dn7or,68,241,54,47,99,9,48,4,502,71.71428571428571,5,0.0,165,54,40,99,76,9,7,48,4,358,144,0
6309,86292,4kkWjBt7B7bmXLtwav57q4XM0lEHf94s,3VkHkmOtom3jM2wCu94xgzzu1d6Dn7or,1,0,0,0,0,0,2,0,2,0.2857142857142857,1,0.0,0,0,0,0,0,0,0,2,0,0,2,1
6310,86308,rSv3OR7jCKwfSFp62c6q16303WTPlIxJ,3VkHkmOtom3jM2wCu94xgzzu1d6Dn7or,4,3,2,0,2,0,1,0,8,1.1428571428571428,1,0.0,0,2,0,2,3,0,0,1,0,4,4,1
6311,86312,H7N61Yol2XG6wyMnfL2nuTS8QWac9JzQ,3VkHkmOtom3jM2wCu94xgzzu1d6Dn7or,64,120,31,67,34,37,53,7,349,49.857142857142854,8,0.0,49,31,54,34,71,37,13,53,7,168,181,0
6312,86467,FjCtMN4WglGS4lMQQqXj5JLoBzJsvRvD,3VkHkmOtom3jM2wCu94xgzzu1d6Dn7or,16,9,6,0,8,0,5,0,28,4.0,1,0.0,2,6,0,8,7,0,0,5,0,16,12,1
6313,86488,ZGyMg7rbLHWRogBAey2xT34v9UyIo90H,3VkHkmOtom3jM2wCu94xgzzu1d6Dn7or,1,0,0,0,0,0,1,0,1,0.14285714285714285,1,0.0,0,0,0,0,0,0,0,1,0,0,1,1
6314,86516,nJMJoh9Afu7XIAXPPKQYptCnctYQcc7F,3VkHkmOtom3jM2wCu94xgzzu1d6Dn7or,69,132,48,64,41,20,28,0,333,47.57142857142857,6,0.0,59,48,63,41,73,20,1,28,0,211,122,0
6315,86521,4UpTY7turz6kUjS8aIK7ZcBu6trtflcP,3VkHkmOtom3jM2wCu94xgzzu1d6Dn7or,5,3,0,0,1,0,3,0,7,1.0,1,0.0,1,0,0,1,2,0,0,3,0,2,5,1
6316,86565,CvLT3YILCbLXFQ58IMX32bp5ZEG9n5SA,3VkHkmOtom3jM2wCu94xgzzu1d6Dn7or,1,0,0,0,0,0,1,0,1,0.14285714285714285,1,0.0,0,0,0,0,0,0,0,1,0,0,1,1
6317,86697,o8kHR47syKKEbYoWQpVJ0TZ0kXlfuaxo,3VkHkmOtom3jM2wCu94xgzzu1d6Dn7or,20,40,15,12,10,9,14,3,103,14.714285714285714,4,0.0,10,15,11,10,30,9,1,14,3,46,57,1
6318,86701,WDS64nhmHwlf65CqTzFkZi8usz3vW8uG,3VkHkmOtom3jM2wCu94xgzzu1d6Dn7or,26,56,22,12,23,21,18,2,154,22.0,6,0.0,28,22,11,23,28,21,1,18,2,84,70,1
6319,86716,88xEaCKi28LUY3tcrbwFpAmHOL0vcOsT,3VkHkmOtom3jM2wCu94xgzzu1d6Dn7or,5,2,1,0,1,0,4,0,8,1.1428571428571428,1,0.0,0,1,0,1,2,0,0,4,0,2,6,1
6320,86718,7FjZmoBV65DUuLOO4Ql2IC3wfSwmf2yZ,3VkHkmOtom3jM2wCu94xgzzu1d6Dn7or,3,0,0,0,0,0,6,0,6,0.8571428571428571,1,0.0,0,0,0,0,0,0,0,6,0,0,6,1
6321,86746,laZtrdxzAU1QbcDNiYt367rO7zb5NT6r,3VkHkmOtom3jM2wCu94xgzzu1d6Dn7or,43,43,3,15,27,4,12,0,104,14.857142857142858,4,0.0,10,3,13,27,33,4,2,12,0,53,51,1
6322,86838,ajNOW5AXfH78DqTXcU1iD05dzS5R5r68,3VkHkmOtom3jM2wCu94xgzzu1d6Dn7or,5,2,1,0,1,2,2,0,8,1.1428571428571428,1,0.0,0,1,0,1,2,2,0,2,0,2,6,1
6323,86920,dlY4SLb04pXb8FpioE0PFiOnxRP0zsB6,bWdj2GDclj5ofokWjzoa5jAwMkxCykd6,18,24,12,28,10,0,12,0,86,12.285714285714286,1,0.0,7,12,27,10,17,0,1,12,0,56,30,0
6324,86924,azWWltiu0kGq6xVNQvuXbRB1jFWFhQiW,SpATywNh6bZuzm8s1ceuBUnMUAeoAHHw,8,2,1,0,1,9,8,1,22,3.142857142857143,1,0.0,0,1,0,1,2,9,0,8,1,2,20,1
6325,86925,dNB9ZoXQ4IxShr9VGNYfbvHSzaJrjM2G,SpATywNh6bZuzm8s1ceuBUnMUAeoAHHw,6,2,1,0,1,0,3,0,7,1.0,1,0.0,0,1,0,1,2,0,0,3,0,2,5,1
6326,86959,hnwcoA7O4v4hJGof4lKuyaYl8MzIunje,RXDvfPUBYFlVdlueBFbLW0mhhAyGEqpt,1,0,0,0,0,0,1,0,1,0.14285714285714285,1,0.0,0,0,0,0,0,0,0,1,0,0,1,1
6327,86978,w4c5I9GnSWI6sLkTNrP2S1NFytPszceZ,SpATywNh6bZuzm8s1ceuBUnMUAeoAHHw,8,6,4,0,3,0,4,0,17,2.4285714285714284,3,0.0,0,4,0,3,6,0,0,4,0,7,10,1
6328,86996,hXvrvs517Cljnw9n8TIqf0EZFGKj5tLN,5X6FeZozNMgE2VRi3MJYjkkFK8SETtu2,1,0,0,0,0,0,1,0,1,0.14285714285714285,1,0.0,0,0,0,0,0,0,0,1,0,0,1,1
6329,87014,7rP408Gy6dVEeyQ5Me3hr5GFRnqOotmL,5X6FeZozNMgE2VRi3MJYjkkFK8SETtu2,14,15,6,17,8,0,1,0,47,6.714285714285714,1,0.0,8,6,16,8,7,0,1,1,0,38,9,1
6330,87018,puN480TO3qbGXrXmM5qoOdmstQ51OC6E,A3fsA9Zfv1X2fVEQhTw51lKENdNrEqT3,27,30,21,0,14,3,25,1,94,13.428571428571429,4,0.0,1,21,0,14,29,3,0,25,1,36,58,0
6331,87025,VjwlU2NuV92v39dW9G2CTHWhjQLOkz09,SpATywNh6bZuzm8s1ceuBUnMUAeoAHHw,6,2,1,6,0,0,4,0,13,1.8571428571428572,1,0.0,1,1,5,0,1,0,1,4,0,7,6,1
6332,87033,zvew9uiEAc86Yp9YluqFrNFVBMozMu7i,A3fsA9Zfv1X2fVEQhTw51lKENdNrEqT3,1,0,0,0,0,0,1,0,1,0.14285714285714285,1,0.0,0,0,0,0,0,0,0,1,0,0,1,1
6333,87041,CyaWOS6YRjNFYn2xWAzIcRZhnN3MiwBK,bWdj2GDclj5ofokWjzoa5jAwMkxCykd6,2,0,0,0,0,0,3,0,3,0.42857142857142855,1,0.0,0,0,0,0,0,0,0,3,0,0,3,1
6334,87044,BcU9hDrDz2F2xEd3tqF67ZptaAdextzP,SpATywNh6bZuzm8s1ceuBUnMUAeoAHHw,9,6,3,0,2,0,4,0,15,2.142857142857143,2,0.0,0,3,0,2,6,0,0,4,0,5,10,1
6335,87057,SWjmkEB4DVctTeY4CrwF2QrGDf4olJAZ,RXDvfPUBYFlVdlueBFbLW0mhhAyGEqpt,107,166,85,143,43,47,20,2,506,72.28571428571429,3,0.0,53,85,133,43,113,47,10,20,2,314,192,0
6336,87082,w37wSK655FONLskeVHZ1T8H2i8llhkAq,G8EPVSXsOYB5YQWZGiz1aVq5Pgr2GrQu,4,2,1,0,1,0,1,0,5,0.7142857142857143,1,0.0,0,1,0,1,2,0,0,1,0,2,3,1
6337,87092,cvLRW70I7pg14FqJq72xv9mGj0ykphI3,RXDvfPUBYFlVdlueBFbLW0mhhAyGEqpt,2,0,0,0,0,0,2,0,2,0.2857142857142857,1,0.0,0,0,0,0,0,0,0,2,0,0,2,1
6338,87111,fDs5TBVrvPHEIMLkBACIVQ2YkCdHCFLD,SpATywNh6bZuzm8s1ceuBUnMUAeoAHHw,36,29,21,36,14,0,4,0,104,14.857142857142858,3,0.0,4,21,30,14,25,0,6,4,0,69,35,1
6339,87127,dNFEIzn0depAU4oAUIlHxTqSNcin3JsM,SpATywNh6bZuzm8s1ceuBUnMUAeoAHHw,42,116,44,57,12,21,33,4,287,41.0,8,0.0,14,44,49,12,102,21,8,33,4,119,168,0
6340,87133,O6WL6sxvoPCZnvTLyTPxdXbnpOz3wcJ4,A3fsA9Zfv1X2fVEQhTw51lKENdNrEqT3,17,18,4,0,2,0,3,0,27,3.857142857142857,2,0.0,0,4,0,2,18,0,0,3,0,6,21,0
6341,87172,2IZplhFWCKQEDbE9J9WJIgAOtpboZ9NN,SpATywNh6bZuzm8s1ceuBUnMUAeoAHHw,9,6,2,16,0,0,2,0,26,3.7142857142857144,1,0.0,2,2,13,0,4,0,3,2,0,17,9,0
6342,87198,BPhS68WnBhNHxaKVrJj2k4cMtvSG9MHx,A3fsA9Zfv1X2fVEQhTw51lKENdNrEqT3,1,0,0,0,0,0,1,0,1,0.14285714285714285,1,0.0,0,0,0,0,0,0,0,1,0,0,1,1
6343,87239,A2D3C1FcNOBr8y076zlBriwfkHqZpxS1,bWdj2GDclj5ofokWjzoa5jAwMkxCykd6,5,4,1,0,1,0,3,0,9,1.2857142857142858,1,0.0,0,1,0,1,4,0,0,3,0,2,7,1
6344,87256,d1MkRkjya7ojtBlNRk0Ce9ymSIOXU3g7,5X6FeZozNMgE2VRi3MJYjkkFK8SETtu2,2,0,0,0,0,0,2,0,2,0.2857142857142857,1,0.0,0,0,0,0,0,0,0,2,0,0,2,1
6345,87268,D8OsqlH4HwBA4SgJzaxGlNrfcU5wwsM1,A3fsA9Zfv1X2fVEQhTw51lKENdNrEqT3,8,4,1,0,1,0,5,0,11,1.5714285714285714,1,0.0,0,1,0,1,4,0,0,5,0,2,9,1
6346,87281,8fWrC0LYUq5E0gzy0gw2GD73h6o6q5AG,SpATywNh6bZuzm8s1ceuBUnMUAeoAHHw,18,62,7,16,4,1,9,0,99,14.142857142857142,7,0.0,25,7,14,4,37,1,2,9,0,50,49,0
6347,87290,VMnSHKgiFqLTglPUaPUtMkU91MLAPOwr,A3fsA9Zfv1X2fVEQhTw51lKENdNrEqT3,1,0,0,0,0,0,1,0,1,0.14285714285714285,1,0.0,0,0,0,0,0,0,0,1,0,0,1,1
6348,87299,FAoxohux4KAbCMqDQtj7sPQxwJsqSUyC,SpATywNh6bZuzm8s1ceuBUnMUAeoAHHw,9,7,4,0,2,0,3,0,16,2.2857142857142856,1,0.0,1,4,0,2,6,0,0,3,0,7,9,1
6349,87340,wZ8eZfOlrtOXqI3tTYpJnSmt7Os4oaRx,RXDvfPUBYFlVdlueBFbLW0mhhAyGEqpt,5,4,2,0,0,2,2,1,11,1.5714285714285714,1,0.0,0,2,0,0,4,2,0,2,1,2,9,1
6350,87349,FrSJpsrFHBf3i9duciIn6pd6hWdG8OCf,SpATywNh6bZuzm8s1ceuBUnMUAeoAHHw,14,13,10,0,8,0,5,0,36,5.142857142857143,3,0.0,0,10,0,8,13,0,0,5,0,18,18,1
6351,87383,7zKNYNlQe19MsOrdmzXSTtaqDWKHEPlA,SpATywNh6bZuzm8s1ceuBUnMUAeoAHHw,5,5,1,0,0,0,3,0,9,1.2857142857142858,2,0.0,0,1,0,0,5,0,0,3,0,1,8,0
6352,87421,lWBSCWTjFeDriAjRZOz3KVaFyBg77dro,bWdj2GDclj5ofokWjzoa5jAwMkxCykd6,1,0,0,0,0,0,2,0,2,0.2857142857142857,1,0.0,0,0,0,0,0,0,0,2,0,0,2,1
6353,87440,MvkQjmVQSq3aFQKnqlTw1GsAe1sz0UUt,RXDvfPUBYFlVdlueBFbLW0mhhAyGEqpt,17,15,10,0,7,0,5,1,38,5.428571428571429,2,0.0,1,10,0,7,14,0,0,5,1,18,20,1
6354,87477,aFTPPSrpKJeQuDqH9FpABVz42ARJX2Kq,SpATywNh6bZuzm8s1ceuBUnMUAeoAHHw,8,4,2,0,2,1,7,0,16,2.2857142857142856,1,0.0,0,2,0,2,4,1,0,7,0,4,12,0
6355,87491,FlceAJAIuFEY4b8DElr16vmZGD1aqVDJ,A3fsA9Zfv1X2fVEQhTw51lKENdNrEqT3,2,0,0,0,0,0,2,0,2,0.2857142857142857,1,0.0,0,0,0,0,0,0,0,2,0,0,2,1
6356,87508,xXDqyIqXIbFjQafgcDr19GZJ6qivDzJJ,SpATywNh6bZuzm8s1ceuBUnMUAeoAHHw,1,0,0,0,0,0,1,0,1,0.14285714285714285,1,0.0,0,0,0,0,0,0,0,1,0,0,1,1
6357,87512,BZDgBaeH4hpBLNYHUpEIDhiLF0fTz03H,SpATywNh6bZuzm8s1ceuBUnMUAeoAHHw,1,0,0,0,0,0,1,0,1,0.14285714285714285,1,0.0,0,0,0,0,0,0,0,1,0,0,1,1
6358,87534,NLUFE7ndaVQ8A2tkIa8xBpPqWZbahAYT,RXDvfPUBYFlVdlueBFbLW0mhhAyGEqpt,1,0,0,0,0,0,1,0,1,0.14285714285714285,1,0.0,0,0,0,0,0,0,0,1,0,0,1,1
6359,87577,D5tphcPtrm2Mbn1NpKk68I5EI1kP65wT,SpATywNh6bZuzm8s1ceuBUnMUAeoAHHw,1,0,0,0,0,0,1,0,1,0.14285714285714285,1,0.0,0,0,0,0,0,0,0,1,0,0,1,0
6360,87583,HNexnUMIVuihEumD8iCCcXwKN5sDVlaT,SpATywNh6bZuzm8s1ceuBUnMUAeoAHHw,5,2,1,0,1,0,2,0,6,0.8571428571428571,1,0.0,0,1,0,1,2,0,0,2,0,2,4,1
6361,87584,NtOBKvqn4kjpyBFY5EbWAhwnHWFAQxgf,A3fsA9Zfv1X2fVEQhTw51lKENdNrEqT3,2,0,0,0,0,0,5,0,5,0.7142857142857143,3,0.0,0,0,0,0,0,0,0,5,0,0,5,1
6362,87596,omogDjehriHed7WOB06lowOCzWJT5HFG,SpATywNh6bZuzm8s1ceuBUnMUAeoAHHw,2,0,0,0,0,0,4,0,4,0.5714285714285714,2,0.0,0,0,0,0,0,0,0,4,0,0,4,1
6363,87630,IUn6MADAjAYkGlJisA1WiDvCeNlJd5Xd,A3fsA9Zfv1X2fVEQhTw51lKENdNrEqT3,6,3,1,0,1,0,5,0,10,1.4285714285714286,2,0.0,0,1,0,1,3,0,0,5,0,2,8,1
6364,87652,CeA39yEXem4lTmymvIZvr20kWcsmIjJE,SpATywNh6bZuzm8s1ceuBUnMUAeoAHHw,23,30,12,43,3,0,3,0,91,13.0,2,0.0,14,12,41,3,16,0,2,3,0,70,21,0
6365,87653,nMHyPhMUwBV2X9BZYL9XoLMstUlTViSe,RXDvfPUBYFlVdlueBFbLW0mhhAyGEqpt,48,59,38,116,23,13,18,11,278,39.714285714285715,2,0.0,13,38,103,23,46,13,13,18,11,177,101,1
6366,87671,4x6GtPVJRzG6NeLl0iwOroVi4VyJ90BC,5X6FeZozNMgE2VRi3MJYjkkFK8SETtu2,11,19,6,0,13,0,3,0,41,5.857142857142857,1,0.0,12,6,0,13,7,0,0,3,0,31,10,1
6367,87686,Qan5qFXAXs8GLcj3GbJmOFAYcVVfTLN4,G8EPVSXsOYB5YQWZGiz1aVq5Pgr2GrQu,6,4,1,0,1,0,2,0,8,1.1428571428571428,1,0.0,0,1,0,1,4,0,0,2,0,2,6,1
6368,87691,9vlKLLRVHTgTa2OMtndxw1oJeJABVSGY,RXDvfPUBYFlVdlueBFbLW0mhhAyGEqpt,49,80,34,144,17,15,8,2,300,42.857142857142854,3,0.0,14,34,123,17,66,15,21,8,2,188,112,0
6369,87695,oL1G89Phk4nduULmJ17br7A4xddcHdc4,A3fsA9Zfv1X2fVEQhTw51lKENdNrEqT3,8,6,4,0,3,0,6,0,19,2.7142857142857144,4,0.0,0,4,0,3,6,0,0,6,0,7,12,0
6370,87724,LC5o73xONnaYfCUJGUgN0IxEKcRaag3p,SpATywNh6bZuzm8s1ceuBUnMUAeoAHHw,10,10,3,0,2,0,5,0,20,2.857142857142857,3,0.0,0,3,0,2,10,0,0,5,0,5,15,1
6371,87747,3eCrefA6S0GFWcJo3ZhXIr7YDAOe11ar,SpATywNh6bZuzm8s1ceuBUnMUAeoAHHw,10,24,6,0,4,0,9,0,43,6.142857142857143,1,0.0,0,6,0,4,24,0,0,9,0,10,33,1
6372,87751,Yz0bwUTqexNxC4HobmGskCKKLAbIJfs7,SpATywNh6bZuzm8s1ceuBUnMUAeoAHHw,7,9,3,0,2,0,3,0,17,2.4285714285714284,1,0.0,0,3,0,2,9,0,0,3,0,5,12,0
6373,87775,Tk65NSEWZoGK32sB9eYUeC558zBlLPIW,RXDvfPUBYFlVdlueBFbLW0mhhAyGEqpt,23,35,21,0,14,0,4,0,74,10.571428571428571,2,0.0,4,21,0,14,31,0,0,4,0,39,35,0
6374,87778,XRprdFoWtySQSNhPZow4aE4x8DdY6QhU,5X6FeZozNMgE2VRi3MJYjkkFK8SETtu2,1,0,0,0,0,0,1,0,1,0.14285714285714285,1,0.0,0,0,0,0,0,0,0,1,0,0,1,1
6375,87799,1RoXT5oo7vXl8wsABrWJayraZG4Kbt0j,G8EPVSXsOYB5YQWZGiz1aVq5Pgr2GrQu,7,6,1,0,1,0,2,0,10,1.4285714285714286,1,0.0,0,1,0,1,6,0,0,2,0,2,8,1
6376,87801,ybCLsk9Msj6dJWTi2FpV3ALPCproUUQQ,SpATywNh6bZuzm8s1ceuBUnMUAeoAHHw,37,85,37,17,22,0,5,0,166,23.714285714285715,2,0.0,0,37,15,22,85,0,2,5,0,74,92,1
6377,87802,3JEt0I9b0JhZhM0RD2D5jI5S8zjjeHFo,SpATywNh6bZuzm8s1ceuBUnMUAeoAHHw,11,29,2,0,1,1,14,2,49,7.0,4,0.0,3,2,0,1,26,1,0,14,2,6,43,0
6378,87810,LUqnLB6pHqixI8DskOSCGDCSJG5xMI09,5X6FeZozNMgE2VRi3MJYjkkFK8SETtu2,1,0,0,0,0,0,1,0,1,0.14285714285714285,1,0.0,0,0,0,0,0,0,0,1,0,0,1,1
6379,87829,VfnlXxgrKiV5S4yyfjofuTKy4kFmuejg,G8EPVSXsOYB5YQWZGiz1aVq5Pgr2GrQu,12,14,5,0,4,1,2,1,27,3.857142857142857,1,0.0,8,5,0,4,6,1,0,2,1,17,10,1
6380,87845,px7NQdp7hj15LfG8wdonX24QornqR4Mh,A3fsA9Zfv1X2fVEQhTw51lKENdNrEqT3,4,5,1,0,0,0,1,0,7,1.0,1,0.0,0,1,0,0,5,0,0,1,0,1,6,1
6381,87847,1fleh7lPd7aghMITlPRITTq0TKiljgoj,SpATywNh6bZuzm8s1ceuBUnMUAeoAHHw,5,2,1,0,1,0,2,0,6,0.8571428571428571,1,0.0,0,1,0,1,2,0,0,2,0,2,4,1
6382,87850,6jOnaSO84O48bNZ0vcTgSwev3DFkgwRP,SpATywNh6bZuzm8s1ceuBUnMUAeoAHHw,26,20,10,43,4,12,3,1,93,13.285714285714286,2,0.0,9,10,39,4,11,12,4,3,1,62,31,1
6383,87855,lDTrM1jNBMje9jFcFb97CQaIN7Du94MZ,SpATywNh6bZuzm8s1ceuBUnMUAeoAHHw,5,5,1,0,1,0,1,0,8,1.1428571428571428,1,0.0,1,1,0,1,4,0,0,1,0,3,5,1
6384,87858,0LERVBlr0s6pvZPTHfS8Y74dmJWxJhcj,A3fsA9Zfv1X2fVEQhTw51lKENdNrEqT3,101,55,36,230,21,3,42,7,394,56.285714285714285,4,0.0,5,36,223,21,50,3,7,42,7,285,109,0
6385,87860,Uggn85R7OMhc9c2ThQoRc9ji4ASPnsWa,SpATywNh6bZuzm8s1ceuBUnMUAeoAHHw,50,125,51,44,24,15,29,2,290,41.42857142857143,10,0.0,48,51,40,24,77,15,4,29,2,163,127,0
6386,87862,u451eR3YoMJd6QtNuJrcpr5u8rFRmkMn,5X6FeZozNMgE2VRi3MJYjkkFK8SETtu2,52,69,18,98,20,0,16,0,221,31.571428571428573,3,0.0,45,18,81,20,24,0,17,16,0,164,57,0
6387,87885,6pqyTvtsNsVOIJ2FRrlzuEgPKDTZeNek,A3fsA9Zfv1X2fVEQhTw51lKENdNrEqT3,2,0,0,0,0,0,2,0,2,0.2857142857142857,1,0.0,0,0,0,0,0,0,0,2,0,0,2,1
6388,87896,sUisvEEUk43TysdqdEKz0DR2Te843pgb,A3fsA9Zfv1X2fVEQhTw51lKENdNrEqT3,4,7,1,0,0,0,2,0,10,1.4285714285714286,1,0.0,0,1,0,0,7,0,0,2,0,1,9,1
6389,87908,QpmV03oJO6WK2YZdkJ97NR0SlUMknV6U,5X6FeZozNMgE2VRi3MJYjkkFK8SETtu2,2,0,0,0,0,0,2,0,2,0.2857142857142857,1,0.0,0,0,0,0,0,0,0,2,0,0,2,1
6390,87909,QpmV03oJO6WK2YZdkJ97NR0SlUMknV6U,bWdj2GDclj5ofokWjzoa5jAwMkxCykd6,2,0,0,0,0,0,2,0,2,0.2857142857142857,1,0.0,0,0,0,0,0,0,0,2,0,0,2,1
6391,87912,j9L0wsMRR1iguKEo2FSLNGEw5WM5csHy,SpATywNh6bZuzm8s1ceuBUnMUAeoAHHw,17,26,10,11,1,3,8,1,60,8.571428571428571,3,0.0,4,10,11,1,22,3,0,8,1,26,34,0
6392,88021,6SxHc7KyNhODmzDiMYRH8E1DtbUhu3YG,5X6FeZozNMgE2VRi3MJYjkkFK8SETtu2,5,2,1,0,1,0,2,0,6,0.8571428571428571,1,0.0,0,1,0,1,2,0,0,2,0,2,4,1
6393,88034,DZjkP3yl2SFuyGy8c50KQgIUMnSURcDF,RXDvfPUBYFlVdlueBFbLW0mhhAyGEqpt,1,0,0,0,0,0,1,0,1,0.14285714285714285,1,0.0,0,0,0,0,0,0,0,1,0,0,1,1
6394,88040,VLhzRXmIp41Zu0NqJ5vPW4W5QyiaokHv,SpATywNh6bZuzm8s1ceuBUnMUAeoAHHw,5,7,0,0,0,0,2,0,9,1.2857142857142858,1,0.0,2,0,0,0,5,0,0,2,0,2,7,1
6395,88051,x44blDMbARj16T0tLu8ojXSHZTWR98Zp,bWdj2GDclj5ofokWjzoa5jAwMkxCykd6,9,7,3,12,4,0,4,0,30,4.285714285714286,1,0.0,3,3,11,4,4,0,1,4,0,21,9,1
6396,88068,Cggympwsvs9lEOL8A1q6sfs1arXxKmUB,5X6FeZozNMgE2VRi3MJYjkkFK8SETtu2,1,0,0,0,0,0,1,0,1,0.14285714285714285,1,0.0,0,0,0,0,0,0,0,1,0,0,1,1
6397,88076,qBuydljzKIRip5ZglverOwggslbNziA6,A3fsA9Zfv1X2fVEQhTw51lKENdNrEqT3,1,0,0,0,0,0,5,0,5,0.7142857142857143,1,0.0,0,0,0,0,0,0,0,5,0,0,5,1
6398,88080,p1UnKsqDeljdQieYNfT9XXKdwcveIfRm,SpATywNh6bZuzm8s1ceuBUnMUAeoAHHw,8,3,1,0,1,0,8,0,13,1.8571428571428572,1,0.0,0,1,0,1,3,0,0,8,0,2,11,1
6399,88096,dCAqk9uHiS99GMTcJQtThG8XWnwwbp5Q,RXDvfPUBYFlVdlueBFbLW0mhhAyGEqpt,1,0,0,0,0,0,1,0,1,0.14285714285714285,1,0.0,0,0,0,0,0,0,0,1,0,0,1,1
6400,88097,dCAqk9uHiS99GMTcJQtThG8XWnwwbp5Q,A3fsA9Zfv1X2fVEQhTw51lKENdNrEqT3,11,26,0,0,0,0,6,0,32,4.571428571428571,2,0.0,0,0,0,0,26,0,0,6,0,0,32,1
6401,88118,syeSTCgAAH8tJhWRmtnRajndKM83APue,SpATywNh6bZuzm8s1ceuBUnMUAeoAHHw,8,13,3,0,1,3,6,0,26,3.7142857142857144,1,0.0,0,3,0,1,13,3,0,6,0,4,22,1
6402,88162,OOFBOlM6ZaTILAeCWdXI68slSU6cTlKl,bWdj2GDclj5ofokWjzoa5jAwMkxCykd6,5,2,1,0,1,0,2,0,6,0.8571428571428571,1,0.0,0,1,0,1,2,0,0,2,0,2,4,1
6403,88166,fVHUMs4z7aTjXofyWNn8EBPM3SN6fL56,A3fsA9Zfv1X2fVEQhTw51lKENdNrEqT3,1,0,0,0,0,0,1,0,1,0.14285714285714285,1,0.0,0,0,0,0,0,0,0,1,0,0,1,1
6404,88172,mB36rXDIKgGQROGEKlrDrvsLRYA6xyWr,A3fsA9Zfv1X2fVEQhTw51lKENdNrEqT3,72,59,28,190,13,10,34,8,342,48.857142857142854,5,0.0,5,28,165,13,54,10,25,34,8,211,131,0
6405,88193,aQvvfNyOjWznHFpUuaLIM1cVrgSp2dSp,SpATywNh6bZuzm8s1ceuBUnMUAeoAHHw,29,63,0,34,0,0,11,2,110,15.714285714285714,2,0.0,19,0,27,0,44,0,7,11,2,46,64,0
6406,88197,Gvc7BFl5Q4FP2VRb1ZvRJI4nuqv9yacP,SpATywNh6bZuzm8s1ceuBUnMUAeoAHHw,16,28,11,15,4,0,16,0,74,10.571428571428571,4,0.0,12,11,13,4,16,0,2,16,0,40,34,0
6407,88213,6mJ65eKOiDJ0B2UMjBjMI3Dy4vxZcYQe,A3fsA9Zfv1X2fVEQhTw51lKENdNrEqT3,18,20,13,0,6,4,3,0,46,6.571428571428571,3,0.0,0,13,0,6,20,4,0,3,0,19,27,0
6408,88216,M8C9BDFICk4ida59GU0jjp556zazDEi1,RXDvfPUBYFlVdlueBFbLW0mhhAyGEqpt,53,65,38,101,25,4,10,0,243,34.714285714285715,5,0.0,22,38,98,25,43,4,3,10,0,183,60,1
6409,88240,G143rLMrX7l1MbfJDLLZvhDYBv8wXrHZ,SpATywNh6bZuzm8s1ceuBUnMUAeoAHHw,11,19,0,0,0,0,2,0,21,3.0,2,0.0,0,0,0,0,19,0,0,2,0,0,21,1
6410,88254,1YjqOVdQNZSxHR5EL885UCWZImOftZfX,A3fsA9Zfv1X2fVEQhTw51lKENdNrEqT3,9,5,1,0,0,5,18,4,33,4.714285714285714,2,0.0,1,1,0,0,4,5,0,18,4,2,31,1
6411,88270,Vnhhp2QbBiDiUTTHmXkksXuO8NCNMbjj,5X6FeZozNMgE2VRi3MJYjkkFK8SETtu2,6,5,3,0,1,0,4,0,13,1.8571428571428572,3,0.0,0,3,0,1,5,0,0,4,0,4,9,1
6412,88330,73QuojUN1r54MVaUa0AAHmlRM5mMnLEl,5X6FeZozNMgE2VRi3MJYjkkFK8SETtu2,7,2,1,0,1,1,7,1,13,1.8571428571428572,2,0.0,0,1,0,1,2,1,0,7,1,2,11,1
6413,88356,6XBUPIMF9YyCO5fIWCayNsSq26b3yJ4M,5X6FeZozNMgE2VRi3MJYjkkFK8SETtu2,1,0,0,0,0,0,1,0,1,0.14285714285714285,1,0.0,0,0,0,0,0,0,0,1,0,0,1,1
6414,88366,HaeOUOjzB2fPZhdNdMNjxk0y1liPSCWx,5X6FeZozNMgE2VRi3MJYjkkFK8SETtu2,5,25,10,0,1,44,0,0,80,11.428571428571429,5,0.0,6,10,0,1,19,44,0,0,0,17,63,1
6415,88378,Re4UOQXOMU2zm8GKuNadx9755IwHNGSX,7GRhBDsirIGkRZBtSMEzNTyDr2JQm4xx,2,0,0,0,0,0,4,0,4,0.5714285714285714,1,0.0,0,0,0,0,0,0,0,4,0,0,4,1
6416,88379,uXRfDeihF0hkAkJm7sgGsGBDRqSDq177,7GRhBDsirIGkRZBtSMEzNTyDr2JQm4xx,9,15,6,0,3,1,5,0,30,4.285714285714286,1,0.0,1,6,0,3,14,1,0,5,0,10,20,1
6417,88421,QOc3KAKkR4oB1aPHWnnoHskpc1gxhWoJ,7GRhBDsirIGkRZBtSMEzNTyDr2JQm4xx,5,2,1,0,0,0,6,2,11,1.5714285714285714,2,0.0,0,1,0,0,2,0,0,6,2,1,10,0
6418,88448,mxddHclG25pfuH7gTFa9o1qSfjDhR7YF,5X6FeZozNMgE2VRi3MJYjkkFK8SETtu2,1,0,0,0,0,0,1,0,1,0.14285714285714285,1,0.0,0,0,0,0,0,0,0,1,0,0,1,0
6419,88481,N2FuIOQxHi4oGMJNbbYINfgS8eLaVkEY,7GRhBDsirIGkRZBtSMEzNTyDr2JQm4xx,2,0,0,0,0,0,2,0,2,0.2857142857142857,1,0.0,0,0,0,0,0,0,0,2,0,0,2,1
6420,88499,e1tGkDeO91uaKlWrCNpqIEILyijCT8bK,5X6FeZozNMgE2VRi3MJYjkkFK8SETtu2,2,0,0,0,0,0,2,0,2,0.2857142857142857,1,0.0,0,0,0,0,0,0,0,2,0,0,2,1
6421,88527,VwAQN5jl3pwsYKyGQTMhCoHGJ3YHi87f,7GRhBDsirIGkRZBtSMEzNTyDr2JQm4xx,2,0,0,0,0,0,2,0,2,0.2857142857142857,1,0.0,0,0,0,0,0,0,0,2,0,0,2,1
6422,88536,8gfCGxZ6lFjZr89RwPF8oXZs1Qn6Pq6X,7GRhBDsirIGkRZBtSMEzNTyDr2JQm4xx,5,1,1,0,0,0,4,0,6,0.8571428571428571,1,0.0,0,1,0,0,1,0,0,4,0,1,5,1
6423,88562,LLVsvExZGFAkPOPauc0mDK88Em0n3cCC,7GRhBDsirIGkRZBtSMEzNTyDr2JQm4xx,6,8,4,0,0,0,7,0,19,2.7142857142857144,1,0.0,0,4,0,0,8,0,0,7,0,4,15,1
6424,88585,I45Q3yivyiRN2kHVhbV8bUCfrXvtpUvU,7GRhBDsirIGkRZBtSMEzNTyDr2JQm4xx,6,4,2,0,2,0,2,0,10,1.4285714285714286,1,0.0,0,2,0,2,4,0,0,2,0,4,6,1
6425,88625,tWlnNsUcyPPaUr4wTjyNOcGM9Bihy4wT,7GRhBDsirIGkRZBtSMEzNTyDr2JQm4xx,1,0,0,0,0,0,1,0,1,0.14285714285714285,1,0.0,0,0,0,0,0,0,0,1,0,0,1,1
6426,88656,dehhpoRrM4rg7t676Y7qCiumWRV2WOzS,7GRhBDsirIGkRZBtSMEzNTyDr2JQm4xx,32,42,18,79,13,12,2,0,166,23.714285714285715,1,0.0,22,18,76,13,20,12,3,2,0,129,37,1
6427,88673,IxMkPCHATmDvTKBlflfVXyQShfliRdlM,5X6FeZozNMgE2VRi3MJYjkkFK8SETtu2,5,2,1,0,1,0,2,0,6,0.8571428571428571,1,0.0,0,1,0,1,2,0,0,2,0,2,4,1
6428,88719,pg03VLobZ1zAAslEUdBaTgGu7kih28vz,5Gyp41oLVo7Gg7vF4vpmggWP5MU70QO6,4,2,1,0,1,0,1,0,5,0.7142857142857143,1,0.0,0,1,0,1,2,0,0,1,0,2,3,1
6429,88723,8jXdpNwELe6zYEmw5Rus9z5EN32mrGga,5Gyp41oLVo7Gg7vF4vpmggWP5MU70QO6,9,8,5,5,3,0,2,0,23,3.2857142857142856,2,0.0,1,5,3,3,7,0,2,2,0,12,11,1
6430,88737,BLJFHLXwnjQQljzDRwovyptBBJZjkDcS,5Gyp41oLVo7Gg7vF4vpmggWP5MU70QO6,13,11,6,1,4,3,11,2,38,5.428571428571429,2,0.0,1,6,1,4,10,3,0,11,2,12,26,1
6431,88740,7ptXQapperKtaGrSTwmS9x9gqTb4bTDI,5Gyp41oLVo7Gg7vF4vpmggWP5MU70QO6,10,6,5,0,2,2,2,0,17,2.4285714285714284,1,0.0,0,5,0,2,6,2,0,2,0,7,10,1
6432,88765,caCvefNLGLcBW48WUUaJPgAfWsyggEZb,5Gyp41oLVo7Gg7vF4vpmggWP5MU70QO6,1,0,0,0,0,0,1,0,1,0.14285714285714285,1,0.0,0,0,0,0,0,0,0,1,0,0,1,1
6433,88773,UO55TBSgJfKr60l5scHuOub5iflx3Maf,5Gyp41oLVo7Gg7vF4vpmggWP5MU70QO6,10,15,3,2,1,0,4,0,25,3.5714285714285716,2,0.0,7,3,1,1,8,0,1,4,0,12,13,1
6434,88774,bu1uIofAEXp6y759RqllOrvBV32SRihX,fbPkOYLVPtPgIt0MxizjfFJov3JbHyAi,6,7,2,0,3,0,1,0,13,1.8571428571428572,1,0.0,2,2,0,3,5,0,0,1,0,7,6,1
6435,88776,vYczGhgY6hRrqG3zxTp11QHECk2atn6B,fbPkOYLVPtPgIt0MxizjfFJov3JbHyAi,1,0,0,0,0,0,1,0,1,0.14285714285714285,1,0.0,0,0,0,0,0,0,0,1,0,0,1,1
6436,88779,iNn3GY2iMNNtDv4o6NBexjhb9hKLROis,fbPkOYLVPtPgIt0MxizjfFJov3JbHyAi,8,3,2,0,2,1,7,0,15,2.142857142857143,1,0.0,0,2,0,2,3,1,0,7,0,4,11,1
6437,88781,qWMwjLnEJjczF5VTHIYJc2IYsIWCauLR,fbPkOYLVPtPgIt0MxizjfFJov3JbHyAi,1,0,0,0,0,0,1,0,1,0.14285714285714285,1,0.0,0,0,0,0,0,0,0,1,0,0,1,1
6438,88786,vSChBkDKZDj0rGwM1GtwFmYGnjiDkIOW,fbPkOYLVPtPgIt0MxizjfFJov3JbHyAi,7,3,2,0,2,0,3,0,10,1.4285714285714286,1,0.0,0,2,0,2,3,0,0,3,0,4,6,1
6439,88792,iSqOqP6glvJYYgjvVVmRA8ZoUSLDsK6d,fbPkOYLVPtPgIt0MxizjfFJov3JbHyAi,10,17,0,0,0,4,4,0,25,3.5714285714285716,1,0.0,0,0,0,0,17,4,0,4,0,0,25,1
6440,88794,kkbu1cG9inVmqEkdKJKJuXBK4YtOWY9c,fbPkOYLVPtPgIt0MxizjfFJov3JbHyAi,12,17,11,0,7,31,18,2,86,12.285714285714286,2,0.0,0,11,0,7,17,31,0,18,2,18,68,1
6441,88795,0Ak7DRLBwBUTJguUJwEJj8xSRI6vwPPn,fbPkOYLVPtPgIt0MxizjfFJov3JbHyAi,1,0,0,0,0,0,1,0,1,0.14285714285714285,1,0.0,0,0,0,0,0,0,0,1,0,0,1,1
6442,88796,UiiOcn6NP18L6Qa9IVzPK487RvBT0lsx,fbPkOYLVPtPgIt0MxizjfFJov3JbHyAi,9,7,2,2,3,0,6,0,20,2.857142857142857,2,0.0,3,2,2,3,4,0,0,6,0,10,10,1
6443,88798,ve5RU3FKgJWxFE29I7niN6ycQVJrJFg4,fbPkOYLVPtPgIt0MxizjfFJov3JbHyAi,1,0,0,0,0,0,1,0,1,0.14285714285714285,1,0.0,0,0,0,0,0,0,0,1,0,0,1,0
6444,88801,o7nB1nybhMcFgLy31X3R6RDOK94b1Iaa,fbPkOYLVPtPgIt0MxizjfFJov3JbHyAi,1,0,0,0,0,0,1,0,1,0.14285714285714285,1,0.0,0,0,0,0,0,0,0,1,0,0,1,1
6445,88807,7NFw5LeL3eVsvkPDcb0VUxu8lVItKrJ1,fbPkOYLVPtPgIt0MxizjfFJov3JbHyAi,6,1,1,0,1,0,3,0,6,0.8571428571428571,1,0.0,0,1,0,1,1,0,0,3,0,2,4,1
6446,88812,PeUQJJiLjuIkI3TtwdkKlVprakOI9tf7,fbPkOYLVPtPgIt0MxizjfFJov3JbHyAi,11,14,9,2,5,12,5,0,47,6.714285714285714,3,0.0,1,9,2,5,13,12,0,5,0,17,30,1
6447,88816,X6obkU5FlEZFIiOk6MXrjhBqZaDGxW04,fbPkOYLVPtPgIt0MxizjfFJov3JbHyAi,5,5,2,0,0,0,4,0,11,1.5714285714285714,1,0.0,2,2,0,0,3,0,0,4,0,4,7,1
6448,88817,8fvsCrC8dcOje6DxrGntnTxmufYXJCrq,fbPkOYLVPtPgIt0MxizjfFJov3JbHyAi,5,3,2,0,2,3,0,0,10,1.4285714285714286,1,0.0,0,2,0,2,3,3,0,0,0,4,6,1
6449,88819,b0RJDCT6ztjQgqXKC4k3XnnVgTiN1Yo8,fbPkOYLVPtPgIt0MxizjfFJov3JbHyAi,7,4,2,0,2,0,3,0,11,1.5714285714285714,1,0.0,1,2,0,2,3,0,0,3,0,5,6,1
6450,88827,HRqYDSGbWA4dSXQsJ8hpWgRfS7ylZUt3,fbPkOYLVPtPgIt0MxizjfFJov3JbHyAi,1,0,0,0,0,0,1,0,1,0.14285714285714285,1,0.0,0,0,0,0,0,0,0,1,0,0,1,1
6451,88829,Wz7BSBOI9rzgAwf2xVcld90BewMcWv25,fbPkOYLVPtPgIt0MxizjfFJov3JbHyAi,6,4,2,0,1,0,3,0,10,1.4285714285714286,3,0.0,0,2,0,1,4,0,0,3,0,3,7,1
6452,88830,OH8WnAV2MBaaFDQHpnLQPXNjc3Qpxqk2,fbPkOYLVPtPgIt0MxizjfFJov3JbHyAi,5,2,1,0,1,0,2,0,6,0.8571428571428571,1,0.0,0,1,0,1,2,0,0,2,0,2,4,1
6453,88831,54BZa2PEVowNqI6EO6NzeCnkR49ry3oS,fbPkOYLVPtPgIt0MxizjfFJov3JbHyAi,15,11,7,0,6,0,3,1,28,4.0,2,0.0,0,7,0,6,11,0,0,3,1,13,15,0
6454,88836,Q5WIg2xkKAnXbT25kMzwfPcqhoeXQ6O6,fbPkOYLVPtPgIt0MxizjfFJov3JbHyAi,5,4,1,0,0,0,6,0,11,1.5714285714285714,1,0.0,0,1,0,0,4,0,0,6,0,1,10,1
6455,88842,gqL1AoJbIkLDCmEi1SGH37fAu1Zdec1f,fbPkOYLVPtPgIt0MxizjfFJov3JbHyAi,4,2,1,0,1,1,2,0,7,1.0,1,0.0,0,1,0,1,2,1,0,2,0,2,5,1
6456,88844,ZDHeqiQjfEk7rIDSgnURnMSZOtUwJ10H,fbPkOYLVPtPgIt0MxizjfFJov3JbHyAi,2,0,0,0,0,0,5,0,5,0.7142857142857143,1,0.0,0,0,0,0,0,0,0,5,0,0,5,1
6457,88845,eIlDqSEsjE2VA3vAbhP1Z42JoYB6Ak2T,fbPkOYLVPtPgIt0MxizjfFJov3JbHyAi,5,2,1,0,1,0,6,0,10,1.4285714285714286,1,0.0,0,1,0,1,2,0,0,6,0,2,8,1
6458,88848,QNLtuhI0bPryV8RMsGGTDcbcPdbX4kMs,fbPkOYLVPtPgIt0MxizjfFJov3JbHyAi,2,0,0,0,0,0,3,0,3,0.42857142857142855,1,0.0,0,0,0,0,0,0,0,3,0,0,3,1
6459,88849,LSAqQ9qRJ6IA5mDIPLRj3aw5O17rNapz,fbPkOYLVPtPgIt0MxizjfFJov3JbHyAi,9,15,8,0,3,12,6,1,45,6.428571428571429,3,0.0,0,8,0,3,15,12,0,6,1,11,34,1
6460,88854,1kjyC7ahZCsVlNSBwjZNyonjDeeXb2jh,fbPkOYLVPtPgIt0MxizjfFJov3JbHyAi,9,16,7,0,5,103,9,3,143,20.428571428571427,4,0.0,4,7,0,5,12,103,0,9,3,16,127,0
6461,88857,bw9UxZPjqLSacLegO6BK4IbuCk1Em4xv,fbPkOYLVPtPgIt0MxizjfFJov3JbHyAi,8,5,2,0,3,3,4,1,18,2.5714285714285716,1,0.0,2,2,0,3,3,3,0,4,1,7,11,1
6462,88913,VqFdL7sovT6KD4YxyAdkx4XloDErf9k9,3VkHkmOtom3jM2wCu94xgzzu1d6Dn7or,23,40,11,18,13,5,5,0,92,13.142857142857142,3,0.0,25,11,17,13,15,5,1,5,0,66,26,0
6463,88920,sdqc2y9DWl93NKMvbx9lW9R0YYYxepka,3VkHkmOtom3jM2wCu94xgzzu1d6Dn7or,1,0,0,0,0,0,1,0,1,0.14285714285714285,1,0.0,0,0,0,0,0,0,0,1,0,0,1,1
6464,88939,D8J1nI1EMIfxo0mlTd1mZqxYvHDgdtVN,3VkHkmOtom3jM2wCu94xgzzu1d6Dn7or,1,0,0,0,0,0,1,0,1,0.14285714285714285,1,0.0,0,0,0,0,0,0,0,1,0,0,1,1
6465,88942,ruRvK6xh08hM5obkIdTVFj8V6xKv9gAQ,3VkHkmOtom3jM2wCu94xgzzu1d6Dn7or,1,0,0,0,0,0,4,0,4,0.5714285714285714,3,0.0,0,0,0,0,0,0,0,4,0,0,4,1
6466,88957,MsfGrNrzFeYLyfgHv6fE9lzMoRZiYs4m,3VkHkmOtom3jM2wCu94xgzzu1d6Dn7or,1,0,0,0,0,0,1,0,1,0.14285714285714285,1,0.0,0,0,0,0,0,0,0,1,0,0,1,1
6467,88960,vZILdgB6chBV3sIhY57RY2DipE34OVxR,3VkHkmOtom3jM2wCu94xgzzu1d6Dn7or,5,2,1,0,1,0,2,0,6,0.8571428571428571,1,0.0,0,1,0,1,2,0,0,2,0,2,4,1
6468,88962,rPKaOWNl9cYkLvtQk035CJPYGwPAMUtv,3VkHkmOtom3jM2wCu94xgzzu1d6Dn7or,5,3,1,0,1,0,2,0,7,1.0,1,0.0,0,1,0,1,3,0,0,2,0,2,5,1
6469,88965,gdcobmieC3Ff6Q7hc3dCmmYDsI9EpdmQ,3VkHkmOtom3jM2wCu94xgzzu1d6Dn7or,2,0,0,0,0,0,2,0,2,0.2857142857142857,1,0.0,0,0,0,0,0,0,0,2,0,0,2,1
6470,88971,mYcxP1C6GzqDzJNSFsSIMcFhAxyoYhvK,3VkHkmOtom3jM2wCu94xgzzu1d6Dn7or,5,2,1,0,1,0,2,0,6,0.8571428571428571,1,0.0,0,1,0,1,2,0,0,2,0,2,4,1
6471,88978,QkdU1z3YFvdeUK9lKehYyofsDutrm196,3VkHkmOtom3jM2wCu94xgzzu1d6Dn7or,5,2,1,0,0,0,9,0,12,1.7142857142857142,3,0.0,0,1,0,0,2,0,0,9,0,1,11,1
6472,88980,tYGYApAbiouSDaBs5DxcmJXHZSECIczt,3VkHkmOtom3jM2wCu94xgzzu1d6Dn7or,12,12,4,7,5,4,10,1,43,6.142857142857143,1,0.0,6,4,5,5,6,4,2,10,1,20,23,1
6473,88987,xEO4GPJebjg7xhxiGuwc39UYVbG4emqY,3VkHkmOtom3jM2wCu94xgzzu1d6Dn7or,8,14,5,2,5,3,3,0,32,4.571428571428571,3,0.0,5,5,1,5,9,3,1,3,0,16,16,0
6474,89006,oFV3lZVV98jNWr0uxjR1vxGfYSIB6mGU,3VkHkmOtom3jM2wCu94xgzzu1d6Dn7or,46,109,37,29,28,20,29,4,256,36.57142857142857,8,0.0,54,37,26,28,55,20,3,29,4,145,111,0
6475,89008,PLpsHvMijSqOKJuUu2T2zn0qTwgJZotU,3VkHkmOtom3jM2wCu94xgzzu1d6Dn7or,13,9,6,0,4,0,5,0,24,3.4285714285714284,2,0.0,0,6,0,4,9,0,0,5,0,10,14,1
6476,89017,xzTqSrdjtUHkgaGbesHv186lResjuXWp,3VkHkmOtom3jM2wCu94xgzzu1d6Dn7or,12,21,6,4,6,6,10,5,58,8.285714285714286,1,0.0,7,6,4,6,14,6,0,10,5,23,35,1
6477,89020,aFeyHJPu8zSmMmTziyeMNC1i70M5I2vP,3VkHkmOtom3jM2wCu94xgzzu1d6Dn7or,1,0,0,0,0,0,2,0,2,0.2857142857142857,1,0.0,0,0,0,0,0,0,0,2,0,0,2,1
6478,89022,0EA3uMknftqYxSVx43ou0vCzaSu2ZG24,3VkHkmOtom3jM2wCu94xgzzu1d6Dn7or,76,228,57,38,81,62,25,7,498,71.14285714285714,9,0.0,137,57,36,81,91,62,2,25,7,311,187,0
6479,89024,Z5NfPb4561WriHAzyAXkrN83hjTYfERn,3VkHkmOtom3jM2wCu94xgzzu1d6Dn7or,3,2,0,0,0,0,1,0,3,0.42857142857142855,1,0.0,0,0,0,0,2,0,0,1,0,0,3,1
6480,89026,eLW5o2pwNW5Z1WJm2PfI2FWflrW07F9T,3VkHkmOtom3jM2wCu94xgzzu1d6Dn7or,6,6,3,0,3,0,1,0,13,1.8571428571428572,1,0.0,0,3,0,3,6,0,0,1,0,6,7,1
6481,89027,rcSMC4zEWtftoShgGrNBnYyLIVFbdZAy,3VkHkmOtom3jM2wCu94xgzzu1d6Dn7or,5,2,0,0,0,0,4,0,6,0.8571428571428571,1,0.0,0,0,0,0,2,0,0,4,0,0,6,1
6482,89030,GZEmn2jDYiPNelTXdP84Wl4gxgVXz7UQ,3VkHkmOtom3jM2wCu94xgzzu1d6Dn7or,11,18,10,4,8,1,2,0,43,6.142857142857143,1,0.0,6,10,4,8,12,1,0,2,0,28,15,1
6483,89039,f7gUgesfNWd7PesJ9pRzAOW79Rfl1Nuf,3VkHkmOtom3jM2wCu94xgzzu1d6Dn7or,1,0,0,0,0,0,1,0,1,0.14285714285714285,1,0.0,0,0,0,0,0,0,0,1,0,0,1,1
6484,89042,EmyQCcrU6TABDlKEh2qs1MjprmbM3Cy7,3VkHkmOtom3jM2wCu94xgzzu1d6Dn7or,7,3,2,0,2,0,2,0,9,1.2857142857142858,1,0.0,0,2,0,2,3,0,0,2,0,4,5,1
6485,89047,z9vRp0iWPqmwk23agQn4gv9jKJ6FsTPG,3VkHkmOtom3jM2wCu94xgzzu1d6Dn7or,5,3,1,0,1,0,2,0,7,1.0,1,0.0,1,1,0,1,2,0,0,2,0,3,4,1
6486,89056,GDEKKJX6Db0GPPQtzslZZNCyRC2mvNvT,3VkHkmOtom3jM2wCu94xgzzu1d6Dn7or,1,0,0,0,0,0,1,0,1,0.14285714285714285,1,0.0,0,0,0,0,0,0,0,1,0,0,1,1
6487,89057,F66gWtRl6Obe8acgieKHbkqG0sRobxl7,3VkHkmOtom3jM2wCu94xgzzu1d6Dn7or,8,7,4,0,2,0,8,0,21,3.0,1,0.0,0,4,0,2,7,0,0,8,0,6,15,1
6488,89061,x3VqeY3osMgmSkOXJP5ZgpjwHRUese7H,3VkHkmOtom3jM2wCu94xgzzu1d6Dn7or,1,0,0,0,0,0,1,0,1,0.14285714285714285,1,0.0,0,0,0,0,0,0,0,1,0,0,1,1
6489,89062,qnUAuPnj6DwltWzjBartDw9eofEGHaaS,3VkHkmOtom3jM2wCu94xgzzu1d6Dn7or,10,15,1,0,0,1,8,4,29,4.142857142857143,1,0.0,0,1,0,0,15,1,0,8,4,1,28,1
6490,89079,fu0f20KU28Bd4xE03nYnaxnydSL4s6JV,3VkHkmOtom3jM2wCu94xgzzu1d6Dn7or,23,68,24,18,17,26,14,1,168,24.0,3,0.0,28,24,16,17,40,26,2,14,1,85,83,1
6491,89083,Ap3Bj4ZOZRonAHU28sY8JyQfpdwv4c0W,3VkHkmOtom3jM2wCu94xgzzu1d6Dn7or,70,112,32,49,43,52,23,2,313,44.714285714285715,4,0.0,49,32,49,43,63,52,0,23,2,173,140,0
6492,89087,CrCSKbuHhWd6DSDGUirLXpNaUBFOcIKn,3VkHkmOtom3jM2wCu94xgzzu1d6Dn7or,7,4,1,0,2,0,10,1,18,2.5714285714285716,1,0.0,0,1,0,2,4,0,0,10,1,3,15,1
6493,89088,ytSSVOcAZTgFAsRYUxOPt2SQ2Vi2FToh,3VkHkmOtom3jM2wCu94xgzzu1d6Dn7or,6,5,4,0,4,0,2,0,15,2.142857142857143,1,0.0,0,4,0,4,5,0,0,2,0,8,7,1
6494,89094,nDo1MAGdksnvqTNyWgHF0jKf62RVJeoU,3VkHkmOtom3jM2wCu94xgzzu1d6Dn7or,9,5,2,1,3,0,3,0,14,2.0,1,0.0,3,2,1,3,2,0,0,3,0,9,5,1
6495,89104,c8bYDsPDbQZnRsC1UfWB7pa6WYwE7c3G,3VkHkmOtom3jM2wCu94xgzzu1d6Dn7or,27,53,26,9,17,1,32,4,142,20.285714285714285,5,0.0,17,26,9,17,36,1,0,32,4,69,73,1
6496,89131,mW6yRunZZHpqfDbYPXDkbbBYilBG5bIS,3VkHkmOtom3jM2wCu94xgzzu1d6Dn7or,7,12,5,0,0,1,7,1,26,3.7142857142857144,1,0.0,5,5,0,0,7,1,0,7,1,10,16,1
6497,89133,uLR6x2fVRcTH9Bp0FaJwa31x1uL6PpTF,3VkHkmOtom3jM2wCu94xgzzu1d6Dn7or,5,6,1,0,1,0,2,0,10,1.4285714285714286,2,0.0,0,1,0,1,6,0,0,2,0,2,8,0
6498,89138,FTJVq9TWMdAK3okD5xbyDXGZ8r3m7Y4p,3VkHkmOtom3jM2wCu94xgzzu1d6Dn7or,25,74,15,39,3,7,28,12,178,25.428571428571427,3,0.0,21,15,32,3,53,7,7,28,12,71,107,0
6499,89146,CPts08aA0DaKXFMj3CNw4GA7s6LvsTi1,3VkHkmOtom3jM2wCu94xgzzu1d6Dn7or,1,0,0,0,0,0,2,0,2,0.2857142857142857,1,0.0,0,0,0,0,0,0,0,2,0,0,2,1
6500,89192,qdtUflOgjNtEwAQs5kfj08fBL21x3VNU,SpATywNh6bZuzm8s1ceuBUnMUAeoAHHw,1,0,0,0,0,0,2,0,2,0.2857142857142857,1,0.0,0,0,0,0,0,0,0,2,0,0,2,1
6501,89200,KgPlJUOxzo6K50clHm6VhLAZdTWxAeXA,bWdj2GDclj5ofokWjzoa5jAwMkxCykd6,9,10,4,0,4,0,6,0,24,3.4285714285714284,1,0.0,4,4,0,4,6,0,0,6,0,12,12,1
6502,89203,Uu9HJTuPU1AJpa1Ej1uv2nh5k9DxfLwn,SpATywNh6bZuzm8s1ceuBUnMUAeoAHHw,1,0,0,0,0,0,1,0,1,0.14285714285714285,1,0.0,0,0,0,0,0,0,0,1,0,0,1,1
6503,89218,7LucM9vSYQRj5WElUEHVyxCSXUCCbwlX,SpATywNh6bZuzm8s1ceuBUnMUAeoAHHw,10,12,0,0,0,0,12,1,25,3.5714285714285716,2,0.0,0,0,0,0,12,0,0,12,1,0,25,1
6504,89223,BWy2motGgrgIUCZ4P1YohdMfi2tPp47Y,RXDvfPUBYFlVdlueBFbLW0mhhAyGEqpt,5,5,2,0,1,0,1,0,9,1.2857142857142858,1,0.0,0,2,0,1,5,0,0,1,0,3,6,1
6505,89228,1ZTeBIrbRrFVlBGh19J78zN1bkBytKqn,SpATywNh6bZuzm8s1ceuBUnMUAeoAHHw,2,0,0,0,0,0,2,0,2,0.2857142857142857,1,0.0,0,0,0,0,0,0,0,2,0,0,2,1
6506,89233,8eAdemzlZoqb3LPXg3UGAyOaCroYfZmg,RXDvfPUBYFlVdlueBFbLW0mhhAyGEqpt,20,21,12,11,8,0,4,0,56,8.0,4,0.0,1,12,10,8,20,0,1,4,0,31,25,1
6507,89236,QM2pO4xP1MmCGymVeJBe4Ub355o8EWcr,bWdj2GDclj5ofokWjzoa5jAwMkxCykd6,5,3,1,0,1,0,2,0,7,1.0,1,0.0,0,1,0,1,3,0,0,2,0,2,5,1
6508,89237,h9qmMnJv0qklBUNKS7VMrlLJy4CMBo05,SpATywNh6bZuzm8s1ceuBUnMUAeoAHHw,5,4,2,0,0,0,3,0,9,1.2857142857142858,1,0.0,0,2,0,0,4,0,0,3,0,2,7,1
6509,89239,UGMWl4hUVp9QjwcWkjjH1sbPQBgn5xrQ,SpATywNh6bZuzm8s1ceuBUnMUAeoAHHw,3,1,0,0,0,0,2,0,3,0.42857142857142855,1,0.0,0,0,0,0,1,0,0,2,0,0,3,1
6510,89241,wegnaf6UPYTo0llSdU8mAv6LbtaJoiyd,SpATywNh6bZuzm8s1ceuBUnMUAeoAHHw,2,1,0,0,0,0,2,0,3,0.42857142857142855,1,0.0,0,0,0,0,1,0,0,2,0,0,3,1
6511,89250,RKKZYIeeZxcb4bVVzfjEMLxVYtQktlhB,G8EPVSXsOYB5YQWZGiz1aVq5Pgr2GrQu,1,0,0,0,0,0,1,0,1,0.14285714285714285,1,0.0,0,0,0,0,0,0,0,1,0,0,1,1
6512,89251,gleoXCfE3tA6f5uM3pUTeqQbfFckrfVd,RXDvfPUBYFlVdlueBFbLW0mhhAyGEqpt,1,0,0,0,0,0,1,0,1,0.14285714285714285,1,0.0,0,0,0,0,0,0,0,1,0,0,1,1
6513,89256,ChYzFAABctmbTCcKox1jjUslr0LvrjbV,SpATywNh6bZuzm8s1ceuBUnMUAeoAHHw,4,1,0,0,0,1,5,0,7,1.0,1,0.0,0,0,0,0,1,1,0,5,0,0,7,1
6514,89270,gEfSYt3WBpt849T4WTB0FbXbrRt5CLQv,SpATywNh6bZuzm8s1ceuBUnMUAeoAHHw,11,21,8,0,0,15,19,3,66,9.428571428571429,1,0.0,4,8,0,0,17,15,0,19,3,12,54,1
6515,89281,yKv3mdAWukUWum1t61vTABExIrvKJ0AU,SpATywNh6bZuzm8s1ceuBUnMUAeoAHHw,7,3,1,0,1,1,8,1,15,2.142857142857143,1,0.0,0,1,0,1,3,1,0,8,1,2,13,1
6516,89299,jBvTFD7LxuGGBRz8wehp1f9k2WItIuV7,SpATywNh6bZuzm8s1ceuBUnMUAeoAHHw,8,3,1,0,1,10,6,1,22,3.142857142857143,1,0.0,0,1,0,1,3,10,0,6,1,2,20,1
6517,89306,5NHJ5bwX3OLzU7LroLiUkr7DhCqHm7Yd,G8EPVSXsOYB5YQWZGiz1aVq5Pgr2GrQu,1,0,0,0,0,0,1,0,1,0.14285714285714285,1,0.0,0,0,0,0,0,0,0,1,0,0,1,1
6518,89318,gBSqr7imZMe4VvRAJjAvzXdfEDgvP8wY,SpATywNh6bZuzm8s1ceuBUnMUAeoAHHw,5,2,1,0,1,0,2,0,6,0.8571428571428571,1,0.0,0,1,0,1,2,0,0,2,0,2,4,1
6519,89324,BOna3ORacJGhjt4FcGMkKNwkDYsEjcvt,SpATywNh6bZuzm8s1ceuBUnMUAeoAHHw,14,22,12,0,6,0,7,0,47,6.714285714285714,3,0.0,0,12,0,6,22,0,0,7,0,18,29,1
6520,89326,wNXelOaGj6HkY91hCddHRdOCiLagph7q,SpATywNh6bZuzm8s1ceuBUnMUAeoAHHw,40,39,5,66,4,0,15,0,129,18.428571428571427,5,0.0,11,5,57,4,28,0,9,15,0,77,52,0
6521,89332,orWLR4UhuJawyT3Ov1vj8DpKoW3alfLI,SpATywNh6bZuzm8s1ceuBUnMUAeoAHHw,7,5,1,0,1,1,4,0,12,1.7142857142857142,1,0.0,0,1,0,1,5,1,0,4,0,2,10,1
6522,89333,NkHKHGQ1t9WfF0WY6b3ThoMuQiXODoZm,SpATywNh6bZuzm8s1ceuBUnMUAeoAHHw,27,52,14,30,8,0,39,2,145,20.714285714285715,3,0.0,8,14,27,8,44,0,3,39,2,57,88,1
6523,89336,Pmww0SJUHaKN8gulRmzkCa5ajmPTXJLo,SpATywNh6bZuzm8s1ceuBUnMUAeoAHHw,15,14,5,10,4,1,5,0,39,5.571428571428571,1,0.0,5,5,9,4,9,1,1,5,0,23,16,1
6524,89342,HkLybTJ0rEPGE4JvzzYK050V4PCx14xg,SpATywNh6bZuzm8s1ceuBUnMUAeoAHHw,12,18,10,4,4,0,9,0,45,6.428571428571429,2,0.0,0,10,4,4,18,0,0,9,0,18,27,1
6525,89366,DswbrMY6sPJD5b1m5ODFx580irKlb07k,SpATywNh6bZuzm8s1ceuBUnMUAeoAHHw,3,2,0,0,0,0,1,0,3,0.42857142857142855,1,0.0,0,0,0,0,2,0,0,1,0,0,3,1
6526,89369,aulAQhL9pTbme70JKMz61j88uhAKeUZs,SpATywNh6bZuzm8s1ceuBUnMUAeoAHHw,1,0,0,0,0,0,1,0,1,0.14285714285714285,1,0.0,0,0,0,0,0,0,0,1,0,0,1,1
6527,89373,PqxW0fs8xtO0oqw8MXcVBsN6WdOuPEkP,SpATywNh6bZuzm8s1ceuBUnMUAeoAHHw,16,15,8,8,5,1,9,1,47,6.714285714285714,1,0.0,6,8,7,5,9,1,1,9,1,26,21,1
6528,89380,5rjYFuFo5D0yRo1dV2LjaXf9wIi8Axa0,SpATywNh6bZuzm8s1ceuBUnMUAeoAHHw,3,2,0,0,0,2,5,0,9,1.2857142857142858,1,0.0,0,0,0,0,2,2,0,5,0,0,9,1
6529,89381,Ryr7edEzpzXZS735AEqOzJJJwXWQPdd0,SpATywNh6bZuzm8s1ceuBUnMUAeoAHHw,4,2,1,0,0,0,2,0,5,0.7142857142857143,1,0.0,0,1,0,0,2,0,0,2,0,1,4,1
6530,89383,bEdF35UbCc85Bz4pUhhoEkUONzXdnpDg,SpATywNh6bZuzm8s1ceuBUnMUAeoAHHw,11,6,0,14,0,8,5,1,34,4.857142857142857,1,0.0,2,0,11,0,4,8,3,5,1,13,21,1
6531,89390,3Ks5QZGHTPRjC7k0qconLYz2L7E6QNo7,SpATywNh6bZuzm8s1ceuBUnMUAeoAHHw,7,2,1,0,1,0,9,0,13,1.8571428571428572,1,0.0,0,1,0,1,2,0,0,9,0,2,11,1
6532,89393,ishZb4e9jFXg2QviC2ko889EaUZeTZU9,SpATywNh6bZuzm8s1ceuBUnMUAeoAHHw,15,40,15,28,8,19,21,1,132,18.857142857142858,4,0.0,20,15,23,8,20,19,5,21,1,66,66,1
6533,89395,3bFfBpBuKdxav891YoVnpf8j830LveoM,SpATywNh6bZuzm8s1ceuBUnMUAeoAHHw,8,10,8,0,7,0,3,0,28,4.0,1,0.0,0,8,0,7,10,0,0,3,0,15,13,1
6534,89407,5dwj8tU2wkUoDpYyu0cC8IGAIxW1A4P6,SpATywNh6bZuzm8s1ceuBUnMUAeoAHHw,13,7,4,15,3,0,2,0,31,4.428571428571429,1,0.0,2,4,13,3,5,0,2,2,0,22,9,1
6535,89411,xSMp0r4oxogHBl1WzBSO421fVgDtvwXN,SpATywNh6bZuzm8s1ceuBUnMUAeoAHHw,16,11,6,12,3,12,9,1,54,7.714285714285714,3,0.0,2,6,9,3,9,12,3,9,1,20,34,1
6536,89415,mzOGsK1l4jUAAFEU0Ebe2O2EryG7sXnC,SpATywNh6bZuzm8s1ceuBUnMUAeoAHHw,9,5,1,0,0,4,17,1,28,4.0,3,0.0,0,1,0,0,5,4,0,17,1,1,27,1
6537,89424,QwfRZLEwZGuNcU9jWD0umpLbrwVdhurg,bWdj2GDclj5ofokWjzoa5jAwMkxCykd6,2,0,0,0,0,0,2,0,2,0.2857142857142857,1,0.0,0,0,0,0,0,0,0,2,0,0,2,1
6538,89425,pp1wOcFtHNfcc3zqTz1uxK4VRHQ4zZyX,SpATywNh6bZuzm8s1ceuBUnMUAeoAHHw,6,6,4,0,3,0,3,0,16,2.2857142857142856,1,0.0,0,4,0,3,6,0,0,3,0,7,9,1
6539,89444,KxE6jjAaHiS10lURgTs1mFbTR6SMOswm,SpATywNh6bZuzm8s1ceuBUnMUAeoAHHw,9,11,5,0,4,0,5,0,25,3.5714285714285716,1,0.0,0,5,0,4,11,0,0,5,0,9,16,1
6540,89452,uqXaJBjlB2fR1jGFPXdDLi7hSsdUaco6,bWdj2GDclj5ofokWjzoa5jAwMkxCykd6,5,2,1,0,1,0,3,0,7,1.0,2,0.0,0,1,0,1,2,0,0,3,0,2,5,1
6541,89453,13KVd5Q0kPTyZsaU7eMkcHJocQWxd1Ax,SpATywNh6bZuzm8s1ceuBUnMUAeoAHHw,6,3,1,0,1,0,2,0,7,1.0,1,0.0,0,1,0,1,3,0,0,2,0,2,5,1
6542,89458,iIWDWKAN8CRJ0yZ5zDSccFCRQRwFgxP8,SpATywNh6bZuzm8s1ceuBUnMUAeoAHHw,10,18,4,0,2,0,5,0,29,4.142857142857143,4,0.0,0,4,0,2,18,0,0,5,0,6,23,1
6543,89462,bX1EJ8H8O7LvPaK2JoRVQC0BaLpmhHE6,SpATywNh6bZuzm8s1ceuBUnMUAeoAHHw,18,29,11,10,4,14,23,2,93,13.285714285714286,7,0.0,7,11,9,4,22,14,1,23,2,31,62,0
6544,89463,lV4ifbsehEXWBwQOY9bU762jcRSMFY5M,G8EPVSXsOYB5YQWZGiz1aVq5Pgr2GrQu,4,3,1,0,1,0,1,0,6,0.8571428571428571,1,0.0,0,1,0,1,3,0,0,1,0,2,4,1
6545,89466,IQDJ7vNX3TboLO3MBJIrKiI8pMYx3UfV,SpATywNh6bZuzm8s1ceuBUnMUAeoAHHw,3,0,0,0,0,2,3,0,5,0.7142857142857143,2,0.0,0,0,0,0,0,2,0,3,0,0,5,1
6546,89468,mqlH8gZPP9MOgmB9cgrLKBfSrQuIKKN0,SpATywNh6bZuzm8s1ceuBUnMUAeoAHHw,11,9,6,0,4,1,12,2,34,4.857142857142857,1,0.0,0,6,0,4,9,1,0,12,2,10,24,1
6547,89473,1xcKG4Eeqo6PRlQtqz4lRNBDzvKhe7qL,RXDvfPUBYFlVdlueBFbLW0mhhAyGEqpt,1,0,0,0,0,0,1,0,1,0.14285714285714285,1,0.0,0,0,0,0,0,0,0,1,0,0,1,1
6548,89474,4d7nO3w6797t7DH3QeDnTWHOfNO2pqQC,bWdj2GDclj5ofokWjzoa5jAwMkxCykd6,6,3,1,0,1,3,4,0,12,1.7142857142857142,1,0.0,0,1,0,1,3,3,0,4,0,2,10,1
6549,89476,rX7gdFv8DKFX0CCz7kGKG6ViXpNH34BO,SpATywNh6bZuzm8s1ceuBUnMUAeoAHHw,3,2,0,0,0,0,1,0,3,0.42857142857142855,1,0.0,0,0,0,0,2,0,0,1,0,0,3,0
6550,89489,yxJSlYQPHVk2OJMV54ToOtJy9WMHex3A,SpATywNh6bZuzm8s1ceuBUnMUAeoAHHw,9,8,6,0,5,0,3,0,22,3.142857142857143,1,0.0,0,6,0,5,8,0,0,3,0,11,11,1
6551,89495,5pjAdY5K4FfgQPLSzQKwXaKF78ph9a0y,SpATywNh6bZuzm8s1ceuBUnMUAeoAHHw,5,12,6,0,4,0,4,0,26,3.7142857142857144,2,0.0,0,6,0,4,12,0,0,4,0,10,16,1
6552,89507,mR9Awu9GGhq6cpZDsN1vhsOMBBjHJTwu,RXDvfPUBYFlVdlueBFbLW0mhhAyGEqpt,5,2,1,0,1,0,2,0,6,0.8571428571428571,1,0.0,0,1,0,1,2,0,0,2,0,2,4,1
6553,89516,EzpgLqOBulY4ZVl8QROIPzKxMW9zpKpw,RXDvfPUBYFlVdlueBFbLW0mhhAyGEqpt,1,0,0,0,0,0,1,0,1,0.14285714285714285,1,0.0,0,0,0,0,0,0,0,1,0,0,1,1
6554,89532,8irCUZa4UAKsYYFeHrY9ttb5xgcL2ou7,SpATywNh6bZuzm8s1ceuBUnMUAeoAHHw,8,4,3,0,3,0,1,0,11,1.5714285714285714,1,0.0,0,3,0,3,4,0,0,1,0,6,5,1
6555,89534,k9cA91Q0OJFR9AY1JvRoKP3p8rLkgPCD,bWdj2GDclj5ofokWjzoa5jAwMkxCykd6,18,33,2,82,5,0,16,1,139,19.857142857142858,1,0.0,12,2,73,5,21,0,9,16,1,92,47,1
6556,89540,rHj6Vmp3P9JbmX7QWrSBu45DuiDb8koF,SpATywNh6bZuzm8s1ceuBUnMUAeoAHHw,10,17,2,0,1,1,11,0,32,4.571428571428571,3,0.0,0,2,0,1,17,1,0,11,0,3,29,1
6557,89560,fUNdgzfWSE4HzsYQQ7FDu5pyDUIMQ40m,G8EPVSXsOYB5YQWZGiz1aVq5Pgr2GrQu,38,113,46,72,25,4,6,0,266,38.0,3,0.0,32,46,53,25,81,4,19,6,0,156,110,1
6558,89561,4t1KNzzepvalCibuzOk5JUX041jKqU9v,SpATywNh6bZuzm8s1ceuBUnMUAeoAHHw,6,3,1,0,1,0,2,0,7,1.0,1,0.0,0,1,0,1,3,0,0,2,0,2,5,1
6559,89566,EDtcftLQ1x638xVsHSB1SBOPZ3SKRCar,G8EPVSXsOYB5YQWZGiz1aVq5Pgr2GrQu,18,69,0,42,8,0,4,0,123,17.571428571428573,2,0.0,33,0,30,8,36,0,12,4,0,71,52,1
6560,89571,YuqMJYvTgiTQGQOAOb2fKJpGas8AG3Wr,SpATywNh6bZuzm8s1ceuBUnMUAeoAHHw,11,13,2,0,2,0,5,0,22,3.142857142857143,4,0.0,0,2,0,2,13,0,0,5,0,4,18,0
6561,89574,EJIkk1z1GAyTxouBU8smmsjhIBwzBhn1,G8EPVSXsOYB5YQWZGiz1aVq5Pgr2GrQu,1,0,0,0,0,0,1,0,1,0.14285714285714285,1,0.0,0,0,0,0,0,0,0,1,0,0,1,1
6562,89578,2fyY2ZIcA0PnrwGuxHsgvHzUiuyeQCT0,bWdj2GDclj5ofokWjzoa5jAwMkxCykd6,5,9,1,0,0,0,7,0,17,2.4285714285714284,2,0.0,0,1,0,0,9,0,0,7,0,1,16,1
6563,89579,Jeu98URtKOymkXqWZxWi1Dpseg2MOPzv,SpATywNh6bZuzm8s1ceuBUnMUAeoAHHw,8,3,2,0,2,1,4,0,12,1.7142857142857142,1,0.0,0,2,0,2,3,1,0,4,0,4,8,1
6564,89580,UhOcaLqs0mKdRyLwomBmAslkjoePthdJ,SpATywNh6bZuzm8s1ceuBUnMUAeoAHHw,6,0,0,0,0,1,5,1,7,1.0,1,0.0,0,0,0,0,0,1,0,5,1,0,7,1
6565,89584,oiThQK6e6zf4TZYBDNHB9rtiG2PNPeXO,SpATywNh6bZuzm8s1ceuBUnMUAeoAHHw,19,49,23,7,10,1,25,1,116,16.571428571428573,6,0.0,15,23,7,10,34,1,0,25,1,55,61,1
6566,89588,kbrfSPxlM4KkcRw6pTtSThBRf28etAVC,SpATywNh6bZuzm8s1ceuBUnMUAeoAHHw,11,7,1,0,1,2,7,1,19,2.7142857142857144,1,0.0,0,1,0,1,7,2,0,7,1,2,17,1
6567,89591,O6XTfrmBXPHHKFN07CLCPWqyMP9NsQuf,bWdj2GDclj5ofokWjzoa5jAwMkxCykd6,10,10,7,0,4,1,13,0,35,5.0,1,0.0,0,7,0,4,10,1,0,13,0,11,24,1
6568,89592,IkodCQwdqpqIcCcUv2ohgHFT9sJ1SLin,SpATywNh6bZuzm8s1ceuBUnMUAeoAHHw,5,2,1,0,1,0,2,0,6,0.8571428571428571,1,0.0,0,1,0,1,2,0,0,2,0,2,4,1
6569,89593,D8IYaZZCq2kwCopNPookpH1TvQs8o6b0,SpATywNh6bZuzm8s1ceuBUnMUAeoAHHw,11,8,3,0,2,4,8,1,26,3.7142857142857144,1,0.0,0,3,0,2,8,4,0,8,1,5,21,1
6570,89595,6OfXNoCI7Waq7DTFUWFiUcQXC3Cg0WKC,SpATywNh6bZuzm8s1ceuBUnMUAeoAHHw,16,13,5,18,4,0,2,0,42,6.0,2,0.0,2,5,15,4,11,0,3,2,0,26,16,1
6571,89598,ApFdQQBcLqTLoA4wIvtlnnwFs4FrlVS1,bWdj2GDclj5ofokWjzoa5jAwMkxCykd6,7,4,2,0,0,1,8,1,16,2.2857142857142856,3,0.0,0,2,0,0,4,1,0,8,1,2,14,1
6572,89602,a2CgRiICJuj7paJToANbolKFuh4xahGM,SpATywNh6bZuzm8s1ceuBUnMUAeoAHHw,1,0,0,0,0,0,1,0,1,0.14285714285714285,1,0.0,0,0,0,0,0,0,0,1,0,0,1,1
6573,89612,tYV9adHfuBbrO1GuvSyU9WLWt5LNmPTX,SpATywNh6bZuzm8s1ceuBUnMUAeoAHHw,11,11,4,0,2,8,7,1,33,4.714285714285714,2,0.0,1,4,0,2,10,8,0,7,1,7,26,1
6574,89618,q1qea15PiUc6DOfucwnleCxcnYIfvxHK,SpATywNh6bZuzm8s1ceuBUnMUAeoAHHw,5,6,0,0,0,0,4,1,11,1.5714285714285714,1,0.0,0,0,0,0,6,0,0,4,1,0,11,1
6575,89619,s6NTLcoRryN4aDfvO1qsCQXhze6kEfOl,G8EPVSXsOYB5YQWZGiz1aVq5Pgr2GrQu,6,0,0,0,0,0,7,1,8,1.1428571428571428,1,0.0,0,0,0,0,0,0,0,7,1,0,8,1
6576,89625,LUfJKoRDjcYKUaxb5bwr7doPqmv3K3xe,SpATywNh6bZuzm8s1ceuBUnMUAeoAHHw,31,33,18,39,9,0,9,0,108,15.428571428571429,3,0.0,11,18,33,9,22,0,6,9,0,71,37,1
6577,89628,K34V3e7xSbcwBnfPQw1X6hTJl6udnY0r,RXDvfPUBYFlVdlueBFbLW0mhhAyGEqpt,6,6,3,0,2,1,2,0,14,2.0,1,0.0,0,3,0,2,6,1,0,2,0,5,9,1
6578,89630,Z86ZMxsvWnnyZOKQGNVOWlv60hWLfFNN,G8EPVSXsOYB5YQWZGiz1aVq5Pgr2GrQu,8,10,1,0,1,1,4,0,17,2.4285714285714284,1,0.0,0,1,0,1,10,1,0,4,0,2,15,1
6579,89643,162MrslUTKGd3KlPrbeWS5Qw6KVPvj8q,SpATywNh6bZuzm8s1ceuBUnMUAeoAHHw,5,7,3,0,2,0,3,0,15,2.142857142857143,2,0.0,0,3,0,2,7,0,0,3,0,5,10,1
6580,89645,162MrslUTKGd3KlPrbeWS5Qw6KVPvj8q,bWdj2GDclj5ofokWjzoa5jAwMkxCykd6,6,7,3,0,2,1,2,0,15,2.142857142857143,1,0.0,0,3,0,2,7,1,0,2,0,5,10,1
6581,89655,Ev3g9egQXLhml9mOEMZMdMQN5Z5Fjc5k,G8EPVSXsOYB5YQWZGiz1aVq5Pgr2GrQu,6,3,2,0,2,0,2,0,9,1.2857142857142858,1,0.0,0,2,0,2,3,0,0,2,0,4,5,1
6582,89662,g8m22R7W0Wo8v9RXY0TMbj5qf5RFgvht,bWdj2GDclj5ofokWjzoa5jAwMkxCykd6,7,4,2,0,1,0,6,0,13,1.8571428571428572,2,0.0,0,2,0,1,4,0,0,6,0,3,10,1
6583,89668,EDtcftLQ1x638xVsHSB1SBOPZ3SKRCar,bWdj2GDclj5ofokWjzoa5jAwMkxCykd6,3,4,0,0,1,0,1,0,6,0.8571428571428571,1,0.0,2,0,0,1,2,0,0,1,0,3,3,1
6584,89671,wJC86gc3viBGM4vTuYg8647vhYAtlLLc,G8EPVSXsOYB5YQWZGiz1aVq5Pgr2GrQu,6,3,2,0,2,0,2,0,9,1.2857142857142858,1,0.0,0,2,0,2,3,0,0,2,0,4,5,1
6585,89673,I3y8UhgjOmrKX2NiYCp9q6amv1bHjqBJ,SpATywNh6bZuzm8s1ceuBUnMUAeoAHHw,2,0,0,0,0,0,2,0,2,0.2857142857142857,1,0.0,0,0,0,0,0,0,0,2,0,0,2,1
6586,89674,X1EwqmDy4MdORdVb79oGgVGVtNlVZgX3,SpATywNh6bZuzm8s1ceuBUnMUAeoAHHw,11,11,7,0,3,4,13,3,41,5.857142857142857,1,0.0,0,7,0,3,11,4,0,13,3,10,31,0
6587,89679,8MQx62NrM26CEa5RRkhFUh36AiGGNx6S,bWdj2GDclj5ofokWjzoa5jAwMkxCykd6,1,0,0,0,0,0,1,0,1,0.14285714285714285,1,0.0,0,0,0,0,0,0,0,1,0,0,1,1
6588,89680,xOGjXyyeq87fCMSZ9z7Yuds9sMvR7Ohh,bWdj2GDclj5ofokWjzoa5jAwMkxCykd6,7,5,1,0,2,1,4,2,15,2.142857142857143,1,0.0,3,1,0,2,2,1,0,4,2,6,9,1
6589,89683,JGkH5G6iVBgcA8nzn9agd5N20Wo6tva5,SpATywNh6bZuzm8s1ceuBUnMUAeoAHHw,7,7,4,0,2,0,4,0,17,2.4285714285714284,2,0.0,0,4,0,2,7,0,0,4,0,6,11,1
6590,89701,BawZLFtQaV6cG6ZH5ggA2jwB1HVUhop0,SpATywNh6bZuzm8s1ceuBUnMUAeoAHHw,5,5,2,0,1,0,2,0,10,1.4285714285714286,2,0.0,1,2,0,1,4,0,0,2,0,4,6,1
6591,89702,jsOwPYXTKA5LkdsyLdqfrvO6hpqy63Mk,SpATywNh6bZuzm8s1ceuBUnMUAeoAHHw,6,2,1,0,0,0,4,1,8,1.1428571428571428,1,0.0,0,1,0,0,2,0,0,4,1,1,7,1
6592,89711,Jm4nQ05ndX10jbofbWx6S0r9VXrqia6S,RXDvfPUBYFlVdlueBFbLW0mhhAyGEqpt,19,17,12,23,4,0,5,0,61,8.714285714285714,3,0.0,2,12,20,4,15,0,3,5,0,38,23,0
6593,89717,oyvbie49Qmum2sCNKvrecvOzGpEvkIP4,SpATywNh6bZuzm8s1ceuBUnMUAeoAHHw,16,52,13,16,4,6,8,1,100,14.285714285714286,2,0.0,19,13,13,4,33,6,3,8,1,49,51,1
6594,89722,TvtAHA9SMsJXnMoIbE5m05sk6M63p1ir,SpATywNh6bZuzm8s1ceuBUnMUAeoAHHw,16,14,5,22,3,44,7,1,96,13.714285714285714,1,0.0,8,5,19,3,6,44,3,7,1,35,61,1
6595,89732,pdAqVvKgeCIaihAcxhTXOYjPQxxjaa8K,RXDvfPUBYFlVdlueBFbLW0mhhAyGEqpt,17,33,17,0,9,0,6,0,65,9.285714285714286,2,0.0,0,17,0,9,33,0,0,6,0,26,39,1
6596,89751,CFwBanDE4eguHX9lcM62Yx5Bex6437kC,G8EPVSXsOYB5YQWZGiz1aVq5Pgr2GrQu,8,8,3,0,1,0,6,0,18,2.5714285714285716,2,0.0,1,3,0,1,7,0,0,6,0,5,13,0
6597,89756,5NinyROX9yWmUO2bbNeT57UVFrKKhh1e,bWdj2GDclj5ofokWjzoa5jAwMkxCykd6,8,3,2,0,2,7,7,1,22,3.142857142857143,1,0.0,0,2,0,2,3,7,0,7,1,4,18,1
6598,89761,z7RFKPeiml5DwwuxMd7W3zDeb96W3IO0,RXDvfPUBYFlVdlueBFbLW0mhhAyGEqpt,10,6,1,0,0,4,6,1,18,2.5714285714285716,1,0.0,0,1,0,0,6,4,0,6,1,1,17,1
6599,89768,F9x8grjHwXdHsc7U2XmuUJNLu8xnTwnR,bWdj2GDclj5ofokWjzoa5jAwMkxCykd6,6,2,1,0,1,0,3,0,7,1.0,2,0.0,0,1,0,1,2,0,0,3,0,2,5,1
6600,89769,CSJLoVtcCokkcrypV6hcHsBSCZUBCpjE,bWdj2GDclj5ofokWjzoa5jAwMkxCykd6,1,0,0,0,0,0,1,0,1,0.14285714285714285,1,0.0,0,0,0,0,0,0,0,1,0,0,1,1
6601,89790,TY6sQZiKCIo3eegNCTkjQ3fisPy9bRK1,SpATywNh6bZuzm8s1ceuBUnMUAeoAHHw,14,14,6,13,4,0,4,0,41,5.857142857142857,1,0.0,6,6,10,4,8,0,3,4,0,26,15,1
6602,89794,4Veu3UF7DzwSpX1OH30ULcMtQdVZ7ynq,SpATywNh6bZuzm8s1ceuBUnMUAeoAHHw,2,0,0,0,0,0,2,0,2,0.2857142857142857,1,0.0,0,0,0,0,0,0,0,2,0,0,2,1
6603,89803,md5EYhUly1ZvdBwm1DSKfst7q3ukcqZb,G8EPVSXsOYB5YQWZGiz1aVq5Pgr2GrQu,13,5,4,26,1,0,7,0,43,6.142857142857143,1,0.0,0,4,21,1,5,0,5,7,0,26,17,1
6604,89805,aLRP3ahB5SIcOn5vpM1VPEh9ib2QIioX,RXDvfPUBYFlVdlueBFbLW0mhhAyGEqpt,7,7,0,0,0,0,3,0,10,1.4285714285714286,1,0.0,0,0,0,0,7,0,0,3,0,0,10,1
6605,89815,hAvRuLAx7AEDY4wHRae0fvokMiSUSODR,SpATywNh6bZuzm8s1ceuBUnMUAeoAHHw,12,9,5,0,3,1,7,1,26,3.7142857142857144,1,0.0,0,5,0,3,9,1,0,7,1,8,18,1
6606,89820,9q1YIqGYM9tyKLlkxbnN8O6FbjsGmlHe,SpATywNh6bZuzm8s1ceuBUnMUAeoAHHw,12,10,0,6,0,0,4,2,22,3.142857142857143,1,0.0,4,0,6,0,6,0,0,4,2,10,12,1
6607,89821,hOSvBRM2cv2WmjSd4f7WDA9Dp5KsacO1,RXDvfPUBYFlVdlueBFbLW0mhhAyGEqpt,2,0,0,0,0,0,2,0,2,0.2857142857142857,1,0.0,0,0,0,0,0,0,0,2,0,0,2,1
6608,89834,lt4iWOuay8QhJ4JJzXkh1WtUiAfTTub9,G8EPVSXsOYB5YQWZGiz1aVq5Pgr2GrQu,30,42,9,10,8,2,18,2,91,13.0,3,0.0,12,9,9,8,30,2,1,18,2,38,53,0
6609,89848,aM0OXe9fMQycCDgfZRBso2FFVWDCpMzh,SpATywNh6bZuzm8s1ceuBUnMUAeoAHHw,6,3,2,0,2,0,1,0,8,1.1428571428571428,1,0.0,0,2,0,2,3,0,0,1,0,4,4,1
6610,89860,Hie5jI1V7aqUGyRciLGioIx6C3WNaVxM,SpATywNh6bZuzm8s1ceuBUnMUAeoAHHw,4,2,0,0,0,0,4,0,6,0.8571428571428571,2,0.0,0,0,0,0,2,0,0,4,0,0,6,1
6611,89862,0K4xNLo4N99mMtk7G0MOnorF2w7z0D9v,SpATywNh6bZuzm8s1ceuBUnMUAeoAHHw,7,4,0,0,0,4,4,1,13,1.8571428571428572,1,0.0,0,0,0,0,4,4,0,4,1,0,13,1
6612,89879,MfeGN5negD9kI6SBc6Puji7S43aQKdkb,SpATywNh6bZuzm8s1ceuBUnMUAeoAHHw,12,13,4,11,3,0,1,0,32,4.571428571428571,1,0.0,8,4,10,3,5,0,1,1,0,25,7,1
6613,89882,eCrgnRWcbj9qFyB1Y7Sof16QQaB01Zyn,SpATywNh6bZuzm8s1ceuBUnMUAeoAHHw,5,2,0,0,0,1,6,2,11,1.5714285714285714,1,0.0,0,0,0,0,2,1,0,6,2,0,11,1
6614,89884,V8mzud5EnZ6pyyl8PZ8V5xSQioudW4lS,SpATywNh6bZuzm8s1ceuBUnMUAeoAHHw,17,21,10,28,5,12,17,5,98,14.0,1,0.0,7,10,20,5,14,12,8,17,5,42,56,1
6615,89888,RFyhyx4ydAt8kwrNtnUfQ8908pWCv8M5,SpATywNh6bZuzm8s1ceuBUnMUAeoAHHw,5,2,1,0,1,4,2,0,10,1.4285714285714286,1,0.0,0,1,0,1,2,4,0,2,0,2,8,1
6616,89891,MrptC6k13DRD7ZeJDHvlsVV8mT19fxZF,SpATywNh6bZuzm8s1ceuBUnMUAeoAHHw,29,42,10,36,7,2,16,3,116,16.571428571428573,3,0.0,21,10,29,7,21,2,7,16,3,67,49,1
6617,89894,0aBA3ELzBRvBOUi1HyR68fXgk8gRhEIU,SpATywNh6bZuzm8s1ceuBUnMUAeoAHHw,10,7,4,0,1,1,8,5,26,3.7142857142857144,1,0.0,0,4,0,1,7,1,0,8,5,5,21,1
6618,89904,zOr0niRplBKfkwpPHNykN96u1FhzegfK,RXDvfPUBYFlVdlueBFbLW0mhhAyGEqpt,7,5,4,0,2,0,1,0,12,1.7142857142857142,1,0.0,0,4,0,2,5,0,0,1,0,6,6,1
6619,89905,5a50T7ZMXA2vPYLquN0RqbmeQaCoB8BF,SpATywNh6bZuzm8s1ceuBUnMUAeoAHHw,9,15,3,0,1,1,8,1,29,4.142857142857143,1,0.0,0,3,0,1,15,1,0,8,1,4,25,1
6620,89915,5JgomgwKuM4fVZ9Q4k6YVCtNM8AozehT,G8EPVSXsOYB5YQWZGiz1aVq5Pgr2GrQu,1,0,0,0,0,0,4,0,4,0.5714285714285714,1,0.0,0,0,0,0,0,0,0,4,0,0,4,1
6621,89924,W3ZCbN2PXgpguBAgrApub7dxzAkot7du,G8EPVSXsOYB5YQWZGiz1aVq5Pgr2GrQu,5,2,1,0,1,0,2,0,6,0.8571428571428571,1,0.0,0,1,0,1,2,0,0,2,0,2,4,1
6622,89934,SHyeADEp9dBkknD932WIgfilEMsUK5Yp,SpATywNh6bZuzm8s1ceuBUnMUAeoAHHw,12,18,1,10,0,15,22,2,68,9.714285714285714,3,0.0,0,1,7,0,18,15,3,22,2,8,60,0
6623,89936,PmZJAFj6wJkOD163WkhaJjRHdYOMjBZW,G8EPVSXsOYB5YQWZGiz1aVq5Pgr2GrQu,6,1,1,0,1,0,3,0,6,0.8571428571428571,1,0.0,0,1,0,1,1,0,0,3,0,2,4,1
6624,89949,dumOcYgAwS6Z3oz3fspRWkVIy9xvyAHF,RXDvfPUBYFlVdlueBFbLW0mhhAyGEqpt,18,21,17,0,2,2,5,4,51,7.285714285714286,1,0.0,0,17,0,2,21,2,0,5,4,19,32,0
6625,89958,3nOS3JEH08BgwunQqioyEFfja4qIND4p,RXDvfPUBYFlVdlueBFbLW0mhhAyGEqpt,13,12,10,0,4,2,1,0,29,4.142857142857143,1,0.0,0,10,0,4,12,2,0,1,0,14,15,1
6626,89974,NrKjQ2TY0jNxjlxFQqBMk613jEN7v6dJ,G8EPVSXsOYB5YQWZGiz1aVq5Pgr2GrQu,28,21,1,50,0,7,5,8,92,13.142857142857142,1,0.0,1,1,45,0,20,7,5,5,8,47,45,1
6627,89981,bjtjAbfCAjoDC0dQv8FIuhfAxmQlWFXq,SpATywNh6bZuzm8s1ceuBUnMUAeoAHHw,1,0,0,0,0,0,1,0,1,0.14285714285714285,1,0.0,0,0,0,0,0,0,0,1,0,0,1,1
6628,89989,SkGcRN6XF7Ju1v3VtnK0PLpmtvUvO3VU,SpATywNh6bZuzm8s1ceuBUnMUAeoAHHw,12,10,5,0,4,0,6,1,26,3.7142857142857144,1,0.0,0,5,0,4,10,0,0,6,1,9,17,1
6629,90001,7slcWSRDm7z3xCcURvkPzfUA6HpEf1rv,SpATywNh6bZuzm8s1ceuBUnMUAeoAHHw,13,8,6,0,4,1,11,3,33,4.714285714285714,1,0.0,0,6,0,4,8,1,0,11,3,10,23,1
6630,90007,LSvU72CFq1TrHd9SCZOiKQ0qcV2oa2Ok,bWdj2GDclj5ofokWjzoa5jAwMkxCykd6,8,10,1,0,1,0,5,0,17,2.4285714285714284,3,0.0,0,1,0,1,10,0,0,5,0,2,15,1
6631,90018,bjoQsxzy5xWbIlWJOK88FLxI1KzCehRN,bWdj2GDclj5ofokWjzoa5jAwMkxCykd6,1,0,0,0,0,0,1,0,1,0.14285714285714285,1,0.0,0,0,0,0,0,0,0,1,0,0,1,1
6632,90026,RyilkQdPLBJZ4lFr5oZI0Ei4sfkfiESh,SpATywNh6bZuzm8s1ceuBUnMUAeoAHHw,21,36,26,20,21,0,3,0,106,15.142857142857142,3,0.0,8,26,17,21,28,0,3,3,0,72,34,0
6633,90031,4dfnEKxHCmGabkBCiKHt5nKr3H7Bwo1x,SpATywNh6bZuzm8s1ceuBUnMUAeoAHHw,7,18,8,0,0,0,5,0,31,4.428571428571429,4,0.0,3,8,0,0,15,0,0,5,0,11,20,0
6634,90036,FSLbHGHYGlPWdXBDC9WjMUDDSGRCqhaq,SpATywNh6bZuzm8s1ceuBUnMUAeoAHHw,5,6,1,0,0,0,1,0,8,1.1428571428571428,1,0.0,0,1,0,0,6,0,0,1,0,1,7,0
6635,90037,vXbuazCIyAq6baj5We5wdO94RIfbomSS,SpATywNh6bZuzm8s1ceuBUnMUAeoAHHw,11,11,7,0,4,0,5,1,28,4.0,1,0.0,0,7,0,4,11,0,0,5,1,11,17,1
6636,90038,fxZYes73ffCsV30TZKy38cwDGRpz9rUn,RXDvfPUBYFlVdlueBFbLW0mhhAyGEqpt,9,9,5,0,0,0,8,1,23,3.2857142857142856,1,0.0,2,5,0,0,7,0,0,8,1,7,16,0
6637,90043,lm5ZaZLPfaDrtGky2mMb4F6wcz9jTJq6,SpATywNh6bZuzm8s1ceuBUnMUAeoAHHw,5,3,1,0,1,0,1,0,6,0.8571428571428571,1,0.0,0,1,0,1,3,0,0,1,0,2,4,1
6638,90046,xAsW6FY0K65CydYHAmfVcUYiwrdudkde,RXDvfPUBYFlVdlueBFbLW0mhhAyGEqpt,12,11,9,0,7,0,1,0,28,4.0,1,0.0,1,9,0,7,10,0,0,1,0,17,11,1
6639,90048,Vn131dD12fh0kapodbBhio0q4dV4IYmG,G8EPVSXsOYB5YQWZGiz1aVq5Pgr2GrQu,4,2,1,0,1,0,1,0,5,0.7142857142857143,1,0.0,0,1,0,1,2,0,0,1,0,2,3,1
6640,90050,zKJi4lYCojHniGlUzfyvIjevdGsHA6Tj,RXDvfPUBYFlVdlueBFbLW0mhhAyGEqpt,1,0,0,0,0,0,1,0,1,0.14285714285714285,1,0.0,0,0,0,0,0,0,0,1,0,0,1,1
6641,90053,Fz2fUb8uF4DthRTOepts8mTN1u7KYtSZ,SpATywNh6bZuzm8s1ceuBUnMUAeoAHHw,10,7,3,0,3,0,5,0,18,2.5714285714285716,1,0.0,0,3,0,3,7,0,0,5,0,6,12,1
6642,90056,JaIi02fnjAZfoUxjYtpyJ7uZYWKdC5yF,bWdj2GDclj5ofokWjzoa5jAwMkxCykd6,10,32,1,52,4,1,6,1,97,13.857142857142858,1,0.0,10,1,50,4,22,1,2,6,1,65,32,1
6643,90058,OFJM9gLiEJFta7GOEBOgZlB17rEajfDQ,G8EPVSXsOYB5YQWZGiz1aVq5Pgr2GrQu,16,9,1,40,1,0,6,0,57,8.142857142857142,2,0.0,1,1,36,1,8,0,4,6,0,39,18,0
6644,90075,K9KQOSU4fRa8yZTo6p3wgevh5IisB83T,RXDvfPUBYFlVdlueBFbLW0mhhAyGEqpt,2,0,0,0,0,0,2,0,2,0.2857142857142857,1,0.0,0,0,0,0,0,0,0,2,0,0,2,1
6645,90095,pplAmbuLk2c8g7K4eYBlhKFfYSpZgbNo,G8EPVSXsOYB5YQWZGiz1aVq5Pgr2GrQu,1,0,0,0,0,0,1,0,1,0.14285714285714285,1,0.0,0,0,0,0,0,0,0,1,0,0,1,1
6646,90102,GN70rVGXob8SU4MUwDOnczNAPbVNEJYJ,SpATywNh6bZuzm8s1ceuBUnMUAeoAHHw,14,17,2,9,1,1,11,2,43,6.142857142857143,2,0.0,0,2,7,1,17,1,2,11,2,10,33,1
6647,90116,T7izEMyckZ14Dpb0HXCCbCEgRCtemG2v,RXDvfPUBYFlVdlueBFbLW0mhhAyGEqpt,39,57,7,0,5,24,12,14,119,17.0,7,0.0,3,7,0,5,54,24,0,12,14,15,104,1
6648,90121,PD0QXI0Ip2PVwJ6kJaKkkINkj7BvGZMC,bWdj2GDclj5ofokWjzoa5jAwMkxCykd6,43,33,2,302,3,6,23,1,370,52.857142857142854,3,0.0,15,2,274,3,18,6,28,23,1,294,76,1
6649,90124,NlgFEWO87VQbCzq3S6FQjH7bzvdUhuql,bWdj2GDclj5ofokWjzoa5jAwMkxCykd6,10,12,5,44,3,0,6,0,70,10.0,1,0.0,4,5,43,3,8,0,1,6,0,55,15,1
6650,90126,Q1m0mfQJyZWS3bGl8oxr6Sp3MEPl2r6y,RXDvfPUBYFlVdlueBFbLW0mhhAyGEqpt,10,7,5,0,2,2,9,2,27,3.857142857142857,2,0.0,0,5,0,2,7,2,0,9,2,7,20,1
6651,90127,8inbpMs7MgzODmQl3BpmuUuKMVmeoVgB,RXDvfPUBYFlVdlueBFbLW0mhhAyGEqpt,4,0,0,0,0,0,9,0,9,1.2857142857142858,1,0.0,0,0,0,0,0,0,0,9,0,0,9,1
6652,90129,ErRtUnOkAfZfIgzAYrZFJqhMiEZstwA2,G8EPVSXsOYB5YQWZGiz1aVq5Pgr2GrQu,1,0,0,0,0,0,1,0,1,0.14285714285714285,1,0.0,0,0,0,0,0,0,0,1,0,0,1,1
6653,90133,s1Khmx0UXmesPVY2G1JDbBc7N2AstlLy,bWdj2GDclj5ofokWjzoa5jAwMkxCykd6,1,0,0,0,0,0,1,0,1,0.14285714285714285,1,0.0,0,0,0,0,0,0,0,1,0,0,1,1
6654,90140,jNfz1HF8kGQzQgXHBSG4Wy17SyrpVswM,RXDvfPUBYFlVdlueBFbLW0mhhAyGEqpt,19,30,18,0,12,1,11,1,73,10.428571428571429,1,0.0,0,18,0,12,30,1,0,11,1,30,43,1
6655,90144,clUDzV1xLWOCz6yJz1NXsCWqgZVFuU6d,SpATywNh6bZuzm8s1ceuBUnMUAeoAHHw,16,26,9,0,6,0,6,0,47,6.714285714285714,3,0.0,0,9,0,6,26,0,0,6,0,15,32,0
6656,90145,vFTyJ5TiVtOMNTDle7WFtHDAgvur1Shs,RXDvfPUBYFlVdlueBFbLW0mhhAyGEqpt,81,98,64,121,37,11,12,0,343,49.0,6,0.0,19,64,110,37,79,11,11,12,0,230,113,1
6657,90154,pBNN08SB8Xk0wCmBzmhWqayfqNGQdsD0,G8EPVSXsOYB5YQWZGiz1aVq5Pgr2GrQu,5,2,1,0,1,0,3,0,7,1.0,1,0.0,0,1,0,1,2,0,0,3,0,2,5,1
6658,90159,uhbUne0Zqx7l0LKNWrxxR44WistJmxKI,G8EPVSXsOYB5YQWZGiz1aVq5Pgr2GrQu,6,9,1,0,0,0,7,0,17,2.4285714285714284,3,0.0,0,1,0,0,9,0,0,7,0,1,16,1
6659,90163,oSabIe7L5topw6hwV4H4ZV0Ug7ZVNxfV,SpATywNh6bZuzm8s1ceuBUnMUAeoAHHw,7,19,2,0,1,0,8,0,30,4.285714285714286,4,0.0,2,2,0,1,17,0,0,8,0,5,25,0
6660,90164,EJkZzukbCIAgIlh7QDQUWfa1bYDEcyN6,SpATywNh6bZuzm8s1ceuBUnMUAeoAHHw,9,5,3,0,2,0,6,0,16,2.2857142857142856,2,0.0,0,3,0,2,5,0,0,6,0,5,11,1
6661,90171,5rZEwm9dIq2r0OGFOO4xuxIdyDM4ihsM,G8EPVSXsOYB5YQWZGiz1aVq5Pgr2GrQu,4,3,0,0,0,0,4,0,7,1.0,1,0.0,0,0,0,0,3,0,0,4,0,0,7,1
6662,90181,dtnFILXxHCPYki6VgARxaWrGiWunvtDQ,bWdj2GDclj5ofokWjzoa5jAwMkxCykd6,3,3,0,0,0,0,1,0,4,0.5714285714285714,1,0.0,0,0,0,0,3,0,0,1,0,0,4,1
6663,90186,BizISzUat4hEvOv57S0DwyJf8vib0NUf,G8EPVSXsOYB5YQWZGiz1aVq5Pgr2GrQu,17,25,13,22,9,0,6,0,75,10.714285714285714,2,0.0,10,13,15,9,15,0,7,6,0,47,28,1
6664,90191,rb0bCeAP0PjUKM6QZmb5eDbdcmhSPRHl,bWdj2GDclj5ofokWjzoa5jAwMkxCykd6,1,0,0,0,0,0,1,0,1,0.14285714285714285,1,0.0,0,0,0,0,0,0,0,1,0,0,1,1
6665,90193,8DMqMykxY7va5LQM1D9Brc3KIasQ5uaX,SpATywNh6bZuzm8s1ceuBUnMUAeoAHHw,9,5,2,0,1,1,5,1,15,2.142857142857143,1,0.0,2,2,0,1,3,1,0,5,1,5,10,1
6666,90195,kS1KejA8lXABafXOlB6Mjw2acU9s1o0J,G8EPVSXsOYB5YQWZGiz1aVq5Pgr2GrQu,9,5,4,0,3,0,1,0,13,1.8571428571428572,2,0.0,0,4,0,3,5,0,0,1,0,7,6,1
6667,90197,W0qiE6YA9tIRl3nKsDWz4QDyI0fyNkAl,G8EPVSXsOYB5YQWZGiz1aVq5Pgr2GrQu,5,7,1,2,2,0,1,0,13,1.8571428571428572,1,0.0,5,1,1,2,2,0,1,1,0,9,4,1
6668,90198,EfKEF8uyLDaJrFfOiyHDnHogAmFLFMEz,SpATywNh6bZuzm8s1ceuBUnMUAeoAHHw,16,18,8,21,5,4,6,0,62,8.857142857142858,1,0.0,8,8,17,5,10,4,4,6,0,38,24,1
6669,90202,mb1hbQ7DEVC7kPqNe1ZOaERjsdGO9KG6,SpATywNh6bZuzm8s1ceuBUnMUAeoAHHw,6,1,1,0,1,0,3,0,6,0.8571428571428571,1,0.0,0,1,0,1,1,0,0,3,0,2,4,1
6670,90204,iwXjEgqbyIO3u8ruP2aohYqr4OGu36oj,bWdj2GDclj5ofokWjzoa5jAwMkxCykd6,1,0,0,0,0,0,1,0,1,0.14285714285714285,1,0.0,0,0,0,0,0,0,0,1,0,0,1,1
6671,90205,CDMI3gQZrAOAZ9Cf4jB5NzA4daPYwjjn,RXDvfPUBYFlVdlueBFbLW0mhhAyGEqpt,45,20,12,77,8,2,6,12,137,19.571428571428573,1,0.0,7,12,70,8,13,2,7,6,12,97,40,1
6672,90208,1oBn81XXDSWJtnCZIRPmhZcBWe7qP0iB,bWdj2GDclj5ofokWjzoa5jAwMkxCykd6,15,19,9,30,4,0,5,0,67,9.571428571428571,1,0.0,5,9,28,4,14,0,2,5,0,46,21,1
6673,90210,J3voZmUSvdysAYoBmB8pkqxDgJNK9RLm,SpATywNh6bZuzm8s1ceuBUnMUAeoAHHw,10,8,4,0,3,0,5,0,20,2.857142857142857,1,0.0,1,4,0,3,7,0,0,5,0,8,12,1
6674,90212,Kc2ZLOGfjK9xNvMUO1HfN3eAcuOUNA78,bWdj2GDclj5ofokWjzoa5jAwMkxCykd6,4,2,1,0,1,0,1,0,5,0.7142857142857143,1,0.0,0,1,0,1,2,0,0,1,0,2,3,0
6675,90213,flscvDNEOPPNPzScLBbNDP0ZzEaAlrV7,SpATywNh6bZuzm8s1ceuBUnMUAeoAHHw,3,2,1,0,0,0,1,0,4,0.5714285714285714,1,0.0,0,1,0,0,2,0,0,1,0,1,3,1
6676,90216,2YneJEOhCqieo20wPFwWEVhM7PP0cUkK,SpATywNh6bZuzm8s1ceuBUnMUAeoAHHw,6,5,2,0,1,0,3,0,11,1.5714285714285714,1,0.0,0,2,0,1,5,0,0,3,0,3,8,1
6677,90231,5rZEwm9dIq2r0OGFOO4xuxIdyDM4ihsM,SpATywNh6bZuzm8s1ceuBUnMUAeoAHHw,6,3,1,0,1,0,4,0,9,1.2857142857142858,1,0.0,0,1,0,1,3,0,0,4,0,2,7,1
6678,90234,TWBh4mQwoOKN7YTAA8WBkn32Y1dNu7yV,SpATywNh6bZuzm8s1ceuBUnMUAeoAHHw,3,3,1,0,0,0,1,0,5,0.7142857142857143,1,0.0,0,1,0,0,3,0,0,1,0,1,4,1
6679,90236,MqKzIfAUNs7agMDut61Vb2gr4UeXiv4L,SpATywNh6bZuzm8s1ceuBUnMUAeoAHHw,14,13,4,18,3,4,4,0,46,6.571428571428571,1,0.0,8,4,16,3,5,4,2,4,0,31,15,1
6680,90237,RkMMgfrDoCy0k6xciXBqfQqum2o9XEow,bWdj2GDclj5ofokWjzoa5jAwMkxCykd6,8,9,5,0,1,2,10,0,27,3.857142857142857,2,0.0,0,5,0,1,9,2,0,10,0,6,21,0
6681,90243,ufAesqkQpYzEnUzTTmFCVE5lhPwgEzNz,bWdj2GDclj5ofokWjzoa5jAwMkxCykd6,7,4,1,0,1,2,4,1,13,1.8571428571428572,1,0.0,1,1,0,1,3,2,0,4,1,3,10,1
6682,90257,ZPbUovw1YoDeaWUVrbGEj5A5WdIXTYjf,bWdj2GDclj5ofokWjzoa5jAwMkxCykd6,5,2,1,0,1,0,2,0,6,0.8571428571428571,1,0.0,0,1,0,1,2,0,0,2,0,2,4,1
6683,90264,SFTx34tVIUz5DNNfU98ofZLPwnaVsmDt,bWdj2GDclj5ofokWjzoa5jAwMkxCykd6,2,0,0,0,0,0,4,0,4,0.5714285714285714,1,0.0,0,0,0,0,0,0,0,4,0,0,4,1
6684,90265,BjHFvQWQadfUNfwyKUemgxPvpTYl6Oeu,SpATywNh6bZuzm8s1ceuBUnMUAeoAHHw,16,25,9,16,4,0,11,0,65,9.285714285714286,2,0.0,7,9,15,4,18,0,1,11,0,35,30,1
6685,90273,1A7feF5h8rReJF4PIjze7GoTvueVZhno,bWdj2GDclj5ofokWjzoa5jAwMkxCykd6,2,0,0,0,0,0,3,0,3,0.42857142857142855,1,0.0,0,0,0,0,0,0,0,3,0,0,3,1
6686,90281,0nJUVE3hT3v1fqbd9NpHDszm9KS6NNTn,SpATywNh6bZuzm8s1ceuBUnMUAeoAHHw,13,21,14,0,4,2,11,0,52,7.428571428571429,4,0.0,2,14,0,4,19,2,0,11,0,20,32,1
6687,90284,fhq6eq9rBvb40aWEwDCQV6m3MUswh0wF,SpATywNh6bZuzm8s1ceuBUnMUAeoAHHw,6,4,2,1,1,0,2,0,10,1.4285714285714286,1,0.0,1,2,1,1,3,0,0,2,0,5,5,1
6688,90299,iysEaAaeQU9ULnAIVWQxyonskhHfsgrB,bWdj2GDclj5ofokWjzoa5jAwMkxCykd6,1,0,0,0,0,0,1,0,1,0.14285714285714285,1,0.0,0,0,0,0,0,0,0,1,0,0,1,1
6689,90300,5w7iVX59M3R4nFK1Ak0et8WYZIQEnE4r,SpATywNh6bZuzm8s1ceuBUnMUAeoAHHw,5,4,1,0,1,1,8,0,15,2.142857142857143,3,0.0,2,1,0,1,2,1,0,8,0,4,11,1
6690,90301,nNRUhTxrQUyQlj0B4LUbcGCoMBsVhXak,SpATywNh6bZuzm8s1ceuBUnMUAeoAHHw,22,67,26,21,6,3,16,3,142,20.285714285714285,6,0.0,21,26,18,6,46,3,3,16,3,71,71,1
6691,90307,YSoWzxWxgklu4RCnOacbfcJC3S3J8kdF,bWdj2GDclj5ofokWjzoa5jAwMkxCykd6,4,2,1,0,0,0,2,0,5,0.7142857142857143,1,0.0,0,1,0,0,2,0,0,2,0,1,4,1
6692,90308,mf7XL5Qu5rUTCHBZ2HgPEiHdci32GQxj,SpATywNh6bZuzm8s1ceuBUnMUAeoAHHw,5,2,1,0,1,0,2,0,6,0.8571428571428571,1,0.0,0,1,0,1,2,0,0,2,0,2,4,1
6693,90319,BnT6Uo8UffnhlvQEwsGCaHRftIbYh6of,SpATywNh6bZuzm8s1ceuBUnMUAeoAHHw,9,13,5,0,3,0,2,0,23,3.2857142857142856,1,0.0,2,5,0,3,11,0,0,2,0,10,13,1
6694,90322,xnhot3CAENInz6vjTxOmSNIIldllQEtz,bWdj2GDclj5ofokWjzoa5jAwMkxCykd6,4,2,1,0,1,0,1,0,5,0.7142857142857143,1,0.0,0,1,0,1,2,0,0,1,0,2,3,1
6695,90328,ytG2DdLhfkfx34dUnTrzjRTBamVwR6Tt,G8EPVSXsOYB5YQWZGiz1aVq5Pgr2GrQu,4,2,0,0,0,0,2,0,4,0.5714285714285714,1,0.0,0,0,0,0,2,0,0,2,0,0,4,1
6696,90331,gSg4PIaWl0hBhOgVlpN9o8YrQn4pTOeq,RXDvfPUBYFlVdlueBFbLW0mhhAyGEqpt,3,0,0,0,0,9,2,0,11,1.5714285714285714,2,0.0,0,0,0,0,0,9,0,2,0,0,11,0
6697,90334,gSg4PIaWl0hBhOgVlpN9o8YrQn4pTOeq,bWdj2GDclj5ofokWjzoa5jAwMkxCykd6,5,2,1,0,1,0,2,0,6,0.8571428571428571,2,0.0,0,1,0,1,2,0,0,2,0,2,4,0
6698,90338,FniFp3wFmWOPWRnBcExVHfzUs5yEbBTd,G8EPVSXsOYB5YQWZGiz1aVq5Pgr2GrQu,1,0,0,0,0,0,1,0,1,0.14285714285714285,1,0.0,0,0,0,0,0,0,0,1,0,0,1,1
6699,90341,MSmZzIC0hTqFynGLQ4hbcd9aVVVROmvE,RXDvfPUBYFlVdlueBFbLW0mhhAyGEqpt,43,22,14,95,7,22,3,4,167,23.857142857142858,1,0.0,7,14,88,7,15,22,7,3,4,116,51,1
6700,90363,4GMbKnTV7f2uA3paM09GNAdyVnypDTbs,bWdj2GDclj5ofokWjzoa5jAwMkxCykd6,7,1,1,0,1,0,10,0,13,1.8571428571428572,1,0.0,0,1,0,1,1,0,0,10,0,2,11,1
6701,90365,XnbCTPxDHPmE6f3SM7gG3S4zRIik2pF4,SpATywNh6bZuzm8s1ceuBUnMUAeoAHHw,1,0,0,0,0,0,1,0,1,0.14285714285714285,1,0.0,0,0,0,0,0,0,0,1,0,0,1,1
6702,90368,aVj2n54Hek70fJUdNTLLf71YkfuWdwdm,bWdj2GDclj5ofokWjzoa5jAwMkxCykd6,10,18,8,0,6,0,6,0,38,5.428571428571429,3,0.0,2,8,0,6,16,0,0,6,0,16,22,1
6703,90370,1cbn6mbdbvkgaRHmtNkyztYkaJcKUMeq,bWdj2GDclj5ofokWjzoa5jAwMkxCykd6,15,20,8,50,6,0,11,0,95,13.571428571428571,3,0.0,7,8,44,6,13,0,6,11,0,65,30,0
6704,90384,HOZheAyAGMSpb5Rm4jAeFCDd0CkpsnTU,SpATywNh6bZuzm8s1ceuBUnMUAeoAHHw,25,65,0,43,0,158,27,1,294,42.0,7,0.0,24,0,39,0,41,158,4,27,1,63,231,1
6705,90388,af1GfUKSTAzLFQRgO3DNnNJQEXmJbieP,SpATywNh6bZuzm8s1ceuBUnMUAeoAHHw,25,25,9,28,6,0,8,0,76,10.857142857142858,2,0.0,14,9,26,6,11,0,2,8,0,55,21,0
6706,90390,gZ5Dz1At6qO7ZUvRyINA6LQ2UEYea4Ji,SpATywNh6bZuzm8s1ceuBUnMUAeoAHHw,4,2,1,0,0,0,2,0,5,0.7142857142857143,1,0.0,0,1,0,0,2,0,0,2,0,1,4,0
6707,90398,U4FGCuNkJ0sAAh4fnj0EDvRbz5l6NaeB,RXDvfPUBYFlVdlueBFbLW0mhhAyGEqpt,5,4,1,0,1,0,1,0,7,1.0,1,0.0,0,1,0,1,4,0,0,1,0,2,5,1
6708,90401,U8woUOpngQnqlgGzBG9Q1wRVWIkAfJH5,bWdj2GDclj5ofokWjzoa5jAwMkxCykd6,7,17,0,0,0,14,9,0,40,5.714285714285714,5,0.0,0,0,0,0,17,14,0,9,0,0,40,0
6709,90406,eAZCjo0LfDvIGTflBEZPo5MmANUFycim,G8EPVSXsOYB5YQWZGiz1aVq5Pgr2GrQu,1,0,0,0,0,0,1,0,1,0.14285714285714285,1,0.0,0,0,0,0,0,0,0,1,0,0,1,1
6710,90415,ZYv52Mbq7iLq8T3oy7c5ln6ts5h7dtMY,bWdj2GDclj5ofokWjzoa5jAwMkxCykd6,2,0,0,0,0,0,2,0,2,0.2857142857142857,1,0.0,0,0,0,0,0,0,0,2,0,0,2,1
6711,90424,DtwqebReG8Q4J8W1z8GMg58bM2jjZyjN,SpATywNh6bZuzm8s1ceuBUnMUAeoAHHw,5,2,0,0,0,0,3,0,5,0.7142857142857143,1,0.0,0,0,0,0,2,0,0,3,0,0,5,1
6712,90427,MffUlJKjo94UllFioq799jfMhgBUKfBS,RXDvfPUBYFlVdlueBFbLW0mhhAyGEqpt,22,18,11,29,8,0,2,0,68,9.714285714285714,1,0.0,5,11,27,8,13,0,2,2,0,51,17,1
6713,90434,ajSnZNRHXRc8Lp3Apzl9jhBHJ93vaNPi,SpATywNh6bZuzm8s1ceuBUnMUAeoAHHw,8,6,1,0,1,14,5,0,27,3.857142857142857,1,0.0,0,1,0,1,6,14,0,5,0,2,25,1
6714,90438,h70SV9keTNnvlQQ1p9K83AbbtQXt9ALt,SpATywNh6bZuzm8s1ceuBUnMUAeoAHHw,11,18,12,0,9,0,7,0,46,6.571428571428571,1,0.0,4,12,0,9,14,0,0,7,0,25,21,1
6715,90441,QJPLyO9GsNSTHpL4UletoFcKnrwBbT1T,SpATywNh6bZuzm8s1ceuBUnMUAeoAHHw,15,27,13,23,6,0,3,0,72,10.285714285714286,2,0.0,10,13,18,6,17,0,5,3,0,47,25,1
6716,90447,SF4fH5sh7kP5eYY1hHp8Un6FMFdPAYUn,RXDvfPUBYFlVdlueBFbLW0mhhAyGEqpt,15,14,11,0,3,4,6,2,40,5.714285714285714,1,0.0,0,11,0,3,14,4,0,6,2,14,26,1
6717,90465,ZJZvmc4yPSLW7LhJST5KGAXq34PSa4bN,SpATywNh6bZuzm8s1ceuBUnMUAeoAHHw,9,6,4,0,2,1,5,1,19,2.7142857142857144,1,0.0,1,4,0,2,5,1,0,5,1,7,12,1
6718,90475,nA22SpKv9tvgwIZ0mm2k7ziqx1NGMQHb,SpATywNh6bZuzm8s1ceuBUnMUAeoAHHw,4,1,0,0,0,0,5,0,6,0.8571428571428571,1,0.0,0,0,0,0,1,0,0,5,0,0,6,1
6719,90476,Pr9ourxtng5DzY47on8h7xABMdbE3A0L,SpATywNh6bZuzm8s1ceuBUnMUAeoAHHw,2,0,0,0,0,0,2,0,2,0.2857142857142857,1,0.0,0,0,0,0,0,0,0,2,0,0,2,1
6720,90481,8cTpnP5XMC7urAa32DMaQfZt2CABz0xm,SpATywNh6bZuzm8s1ceuBUnMUAeoAHHw,2,0,0,0,0,0,2,0,2,0.2857142857142857,1,0.0,0,0,0,0,0,0,0,2,0,0,2,1
6721,90496,Xs5JYGOD3p8qnunCvDbRtmUT4YrLSZAt,G8EPVSXsOYB5YQWZGiz1aVq5Pgr2GrQu,2,0,0,0,0,0,2,0,2,0.2857142857142857,1,0.0,0,0,0,0,0,0,0,2,0,0,2,1
6722,90505,GQ6O8zYgypKOWgEHgpHaUgffzhyPlA4a,SpATywNh6bZuzm8s1ceuBUnMUAeoAHHw,11,23,9,0,5,0,10,0,47,6.714285714285714,2,0.0,0,9,0,5,23,0,0,10,0,14,33,1
6723,90509,6DhqODqzoN3QpHDTGOfm1J0Z2tXsvw8Q,RXDvfPUBYFlVdlueBFbLW0mhhAyGEqpt,11,9,5,0,1,1,6,1,23,3.2857142857142856,1,0.0,2,5,0,1,7,1,0,6,1,8,15,1
6724,90510,RI0pRWsSeNWCFuNbvYcUkrnZSxgLkzXM,G8EPVSXsOYB5YQWZGiz1aVq5Pgr2GrQu,4,2,1,0,1,0,1,0,5,0.7142857142857143,1,0.0,0,1,0,1,2,0,0,1,0,2,3,1
6725,90512,v5nYdsvl6GCjyW7kGrOo9PXd3XM536ac,bWdj2GDclj5ofokWjzoa5jAwMkxCykd6,8,7,3,36,3,0,1,0,50,7.142857142857143,1,0.0,3,3,36,3,4,0,0,1,0,45,5,1
6726,90522,SrT5cEoKhuuDcaYDitYZtr8rudf3aNHn,RXDvfPUBYFlVdlueBFbLW0mhhAyGEqpt,5,3,0,0,0,1,2,0,6,0.8571428571428571,1,0.0,0,0,0,0,3,1,0,2,0,0,6,1
6727,90533,979T9akr0rVByN7anKgrxGgT1cwuQ4G0,bWdj2GDclj5ofokWjzoa5jAwMkxCykd6,1,0,0,0,0,0,2,0,2,0.2857142857142857,1,0.0,0,0,0,0,0,0,0,2,0,0,2,1
6728,90536,87BoPwsFRJc93Ed9Le7qjm6Wu8pcwGb4,SpATywNh6bZuzm8s1ceuBUnMUAeoAHHw,14,13,8,15,5,0,7,0,48,6.857142857142857,1,0.0,4,8,12,5,9,0,3,7,0,29,19,1
6729,90541,f3Or6Lei7Xsh5kVuWwAXKtVQvHetVASw,SpATywNh6bZuzm8s1ceuBUnMUAeoAHHw,7,2,1,0,1,0,7,1,12,1.7142857142857142,1,0.0,0,1,0,1,2,0,0,7,1,2,10,1
6730,90542,oBmksukoqTKiKpWhco7hv7dHpVNhiTm0,RXDvfPUBYFlVdlueBFbLW0mhhAyGEqpt,2,0,0,0,0,0,2,0,2,0.2857142857142857,1,0.0,0,0,0,0,0,0,0,2,0,0,2,1
6731,90544,Wn0YHSgI2frE5VS0ME4PMnw7OIRxxODE,bWdj2GDclj5ofokWjzoa5jAwMkxCykd6,14,12,6,32,5,0,4,0,59,8.428571428571429,1,0.0,4,6,32,5,8,0,0,4,0,47,12,1
6732,90552,isJvm2sBgrZmIVBqIVzAr4eLhAZMDuWI,SpATywNh6bZuzm8s1ceuBUnMUAeoAHHw,2,0,0,0,0,4,1,0,5,0.7142857142857143,1,0.0,0,0,0,0,0,4,0,1,0,0,5,1
6733,90555,tn5nSlJLNdxx4Uni5Dn3S8nwDR8GJibq,bWdj2GDclj5ofokWjzoa5jAwMkxCykd6,20,41,21,114,10,16,15,2,219,31.285714285714285,3,0.0,7,21,109,10,34,16,5,15,2,147,72,1
6734,90557,86vaLs6Psnmr3RZvUAsRR8mS9F0SSYDy,RXDvfPUBYFlVdlueBFbLW0mhhAyGEqpt,1,0,0,0,0,0,1,0,1,0.14285714285714285,1,0.0,0,0,0,0,0,0,0,1,0,0,1,1
6735,90561,zoNJrqU9R3rbwqXOfdPMHYJWQ1mfYn8B,SpATywNh6bZuzm8s1ceuBUnMUAeoAHHw,9,6,3,0,3,0,4,0,16,2.2857142857142856,1,0.0,0,3,0,3,6,0,0,4,0,6,10,1
6736,90573,mnrOB2joseu3XXqZgB40ASUizDwax7xs,SpATywNh6bZuzm8s1ceuBUnMUAeoAHHw,16,23,7,22,4,1,9,0,66,9.428571428571429,1,0.0,12,7,18,4,11,1,4,9,0,41,25,1
6737,90574,SaJRa20OXDY1LCrTPWwAL4qw1OJoFlxd,SpATywNh6bZuzm8s1ceuBUnMUAeoAHHw,2,0,0,0,0,0,2,0,2,0.2857142857142857,1,0.0,0,0,0,0,0,0,0,2,0,0,2,1
6738,90580,lk8VGt0yosXmu7XbHzsqLBKwzzzp9GK0,SpATywNh6bZuzm8s1ceuBUnMUAeoAHHw,5,3,1,0,0,5,6,0,15,2.142857142857143,1,0.0,0,1,0,0,3,5,0,6,0,1,14,1
6739,90587,LdmiXWzPIjxgi3vXfrG7UNuf9aR1t25A,G8EPVSXsOYB5YQWZGiz1aVq5Pgr2GrQu,2,0,0,0,0,1,1,0,2,0.2857142857142857,1,0.0,0,0,0,0,0,1,0,1,0,0,2,1
6740,90591,dVnTQl9ANUhHsXIPIWBdmTgLVkOgcfeV,SpATywNh6bZuzm8s1ceuBUnMUAeoAHHw,8,5,0,0,0,1,6,1,13,1.8571428571428572,1,0.0,0,0,0,0,5,1,0,6,1,0,13,1
6741,90601,OA2ppL3NBxQQN7UDC41vrrAGRoypzEU8,SpATywNh6bZuzm8s1ceuBUnMUAeoAHHw,6,2,1,0,1,0,4,0,8,1.1428571428571428,1,0.0,0,1,0,1,2,0,0,4,0,2,6,1
6742,90602,OCAzb1VfLGBRFoguhxZLxVaO4EgntnGi,bWdj2GDclj5ofokWjzoa5jAwMkxCykd6,1,0,0,0,0,0,1,0,1,0.14285714285714285,1,0.0,0,0,0,0,0,0,0,1,0,0,1,1
6743,90606,k0hnEE00KysC1NJbTPcs2Jo2pXfE8XJY,RXDvfPUBYFlVdlueBFbLW0mhhAyGEqpt,8,6,1,0,1,0,3,0,11,1.5714285714285714,1,0.0,0,1,0,1,6,0,0,3,0,2,9,1
6744,90615,YfZkWYeVjjwTERIBF4VpFk8mjgVdzlCM,SpATywNh6bZuzm8s1ceuBUnMUAeoAHHw,9,7,4,0,1,5,14,1,32,4.571428571428571,1,0.0,0,4,0,1,7,5,0,14,1,5,27,1
6745,90621,RX2I20RYdT3gZCbZOCxQyWjgnFxuLLo0,SpATywNh6bZuzm8s1ceuBUnMUAeoAHHw,6,3,2,0,2,0,1,0,8,1.1428571428571428,1,0.0,0,2,0,2,3,0,0,1,0,4,4,1
6746,90623,yZoviGGxgr5NFf9klHeC5PfXfdVd14QP,bWdj2GDclj5ofokWjzoa5jAwMkxCykd6,11,9,6,0,4,0,9,0,28,4.0,3,0.0,0,6,0,4,9,0,0,9,0,10,18,1
6747,90626,mYdiJuyvQQSE4J489nl9NbGaNmN8t5fJ,SpATywNh6bZuzm8s1ceuBUnMUAeoAHHw,5,3,1,0,1,0,1,0,6,0.8571428571428571,1,0.0,0,1,0,1,3,0,0,1,0,2,4,1
6748,90629,7y90Jaoh9A6ecz0W5HFrSOzo0GUJhND0,bWdj2GDclj5ofokWjzoa5jAwMkxCykd6,5,3,1,0,0,1,4,0,9,1.2857142857142858,1,0.0,0,1,0,0,3,1,0,4,0,1,8,1
6749,90633,gIghghMxU1G3VEKF49uuB975s41nqI8g,SpATywNh6bZuzm8s1ceuBUnMUAeoAHHw,16,20,11,14,5,13,7,0,70,10.0,2,0.0,6,11,13,5,14,13,1,7,0,35,35,0
6750,90646,yZoviGGxgr5NFf9klHeC5PfXfdVd14QP,RXDvfPUBYFlVdlueBFbLW0mhhAyGEqpt,13,7,6,0,4,0,2,0,19,2.7142857142857144,1,0.0,0,6,0,4,7,0,0,2,0,10,9,1
6751,90648,Ct4CYJV4ldK3GNAcCiI1V5iy769QQWR5,RXDvfPUBYFlVdlueBFbLW0mhhAyGEqpt,8,16,0,0,0,0,5,0,21,3.0,1,0.0,3,0,0,0,13,0,0,5,0,3,18,1
6752,90651,4vJSIQ5zmHwvN98SbnaURZ3kwY3XSM5D,SpATywNh6bZuzm8s1ceuBUnMUAeoAHHw,1,0,0,0,0,0,1,0,1,0.14285714285714285,1,0.0,0,0,0,0,0,0,0,1,0,0,1,1
6753,90654,bA5X6ch4ADNfhanzi2mM69bwbihODbQ4,G8EPVSXsOYB5YQWZGiz1aVq5Pgr2GrQu,107,155,61,291,22,8,19,3,559,79.85714285714286,3,0.0,83,61,235,22,72,8,56,19,3,401,158,0
6754,90659,07a6x7KN30qug4fofBdEl2HySgB5YdgR,bWdj2GDclj5ofokWjzoa5jAwMkxCykd6,5,5,2,0,1,0,2,0,10,1.4285714285714286,2,0.0,0,2,0,1,5,0,0,2,0,3,7,1
6755,90660,YUNLPiSOifGnuGgTqdDXRMjnI0RJBa0e,bWdj2GDclj5ofokWjzoa5jAwMkxCykd6,10,11,6,0,4,3,9,0,33,4.714285714285714,1,0.0,2,6,0,4,9,3,0,9,0,12,21,1
6756,90667,XFmrH2WQYMYLXRE1Jm7VValFt236PUJr,G8EPVSXsOYB5YQWZGiz1aVq5Pgr2GrQu,10,13,1,10,1,0,1,0,26,3.7142857142857144,1,0.0,8,1,6,1,5,0,4,1,0,16,10,1
6757,90684,gBZJD6jZRMZdZxyaZgCjGPROu8WcWTne,G8EPVSXsOYB5YQWZGiz1aVq5Pgr2GrQu,13,25,10,8,8,17,6,2,76,10.857142857142858,1,0.0,12,10,6,8,13,17,2,6,2,36,40,0
6758,90686,tKsi1lDahv8YDRhfKnuEFzTSYneTazEo,RXDvfPUBYFlVdlueBFbLW0mhhAyGEqpt,10,9,5,0,5,3,4,0,26,3.7142857142857144,1,0.0,0,5,0,5,9,3,0,4,0,10,16,1
6759,90688,j8vYdYwa9gvt7hkF8dykZR2D4h75QsII,RXDvfPUBYFlVdlueBFbLW0mhhAyGEqpt,39,39,32,0,15,5,15,3,109,15.571428571428571,6,0.0,0,32,0,15,39,5,0,15,3,47,62,1
6760,90699,tKsi1lDahv8YDRhfKnuEFzTSYneTazEo,SpATywNh6bZuzm8s1ceuBUnMUAeoAHHw,4,1,1,0,1,0,1,0,4,0.5714285714285714,1,0.0,0,1,0,1,1,0,0,1,0,2,2,1
6761,90704,84Ouo0RSw7BvmNUER147KiTqxaHgRaR6,SpATywNh6bZuzm8s1ceuBUnMUAeoAHHw,7,5,3,0,2,0,6,0,16,2.2857142857142856,2,0.0,0,3,0,2,5,0,0,6,0,5,11,1
6762,90710,7fC3V6ivG07wUIMOmiYFzSlyjWvbYnYf,RXDvfPUBYFlVdlueBFbLW0mhhAyGEqpt,11,10,0,0,0,4,5,0,19,2.7142857142857144,1,0.0,0,0,0,0,10,4,0,5,0,0,19,0
6763,90715,BJT6wOznqaiCipmbeEqX4tC1TuhKxC7c,SpATywNh6bZuzm8s1ceuBUnMUAeoAHHw,14,34,14,0,6,3,13,1,71,10.142857142857142,3,0.0,3,14,0,6,31,3,0,13,1,23,48,1
6764,90717,Vmvdv9k8S1ONPkUHSdXPEenyx7UNVISW,bWdj2GDclj5ofokWjzoa5jAwMkxCykd6,19,35,4,68,2,50,18,2,179,25.571428571428573,4,0.0,8,4,61,2,27,50,7,18,2,75,104,1
6765,90719,5KhUU1d5DOX9YzVEFt1mBdZffexByyEY,SpATywNh6bZuzm8s1ceuBUnMUAeoAHHw,13,8,6,0,4,0,6,2,26,3.7142857142857144,1,0.0,0,6,0,4,8,0,0,6,2,10,16,1
6766,90724,5vkNIYp2bYY1LtZU7tLxethQegJYgNo1,bWdj2GDclj5ofokWjzoa5jAwMkxCykd6,16,13,7,84,3,0,8,0,115,16.428571428571427,3,0.0,3,7,77,3,10,0,7,8,0,90,25,1
6767,90731,Kq1HFxeACwjg0zmXbvWkQZ7IB9SIFprl,G8EPVSXsOYB5YQWZGiz1aVq5Pgr2GrQu,14,9,7,0,4,1,7,1,29,4.142857142857143,1,0.0,0,7,0,4,9,1,0,7,1,11,18,1
6768,90734,lHTZAvBbd0zcUoZ0ZCqy0WxYTp3sveXN,RXDvfPUBYFlVdlueBFbLW0mhhAyGEqpt,23,44,17,1,12,3,12,1,90,12.857142857142858,3,0.0,10,17,1,12,34,3,0,12,1,40,50,1
6769,90738,GvWa7qIm5RkYdVcaG192SG5MlRfjDYSk,SpATywNh6bZuzm8s1ceuBUnMUAeoAHHw,5,1,1,0,1,0,2,0,5,0.7142857142857143,1,0.0,0,1,0,1,1,0,0,2,0,2,3,1
6770,90744,2viub6InFwMLthqb8hJjmGF9NgF8w6Xs,bWdj2GDclj5ofokWjzoa5jAwMkxCykd6,4,9,3,0,2,0,1,0,15,2.142857142857143,3,0.0,0,3,0,2,9,0,0,1,0,5,10,1
6771,90745,3VPAWlfwG5nkf9ioSIdd0yq9SoYaPOsq,bWdj2GDclj5ofokWjzoa5jAwMkxCykd6,3,2,0,0,0,0,1,0,3,0.42857142857142855,1,0.0,0,0,0,0,2,0,0,1,0,0,3,1
6772,90751,LrnqEdfBj0D0yEwqlIwYFq7gG4yeMv2F,SpATywNh6bZuzm8s1ceuBUnMUAeoAHHw,12,26,9,19,3,1,5,0,63,9.0,1,0.0,15,9,17,3,11,1,2,5,0,44,19,1
6773,90759,ap9egrEAtqnjEf8GN2Q0V7LnZMXCwsuh,RXDvfPUBYFlVdlueBFbLW0mhhAyGEqpt,9,8,5,0,2,9,4,0,28,4.0,2,0.0,0,5,0,2,8,9,0,4,0,7,21,1
6774,90763,KLWMzt2lbmi8onKYKX9eWLl5lpM0wx0M,SpATywNh6bZuzm8s1ceuBUnMUAeoAHHw,3,2,1,0,0,0,2,0,5,0.7142857142857143,1,0.0,0,1,0,0,2,0,0,2,0,1,4,1
6775,90766,ypPkmbHBKQqVHaDjkpbJ8CKEoLgDbQlR,SpATywNh6bZuzm8s1ceuBUnMUAeoAHHw,6,3,1,0,1,0,3,0,8,1.1428571428571428,1,0.0,0,1,0,1,3,0,0,3,0,2,6,1
6776,90783,bpxaFadaQixJuWRVtAAq5miKiBM3zC6u,RXDvfPUBYFlVdlueBFbLW0mhhAyGEqpt,1,0,0,0,0,0,2,0,2,0.2857142857142857,2,0.0,0,0,0,0,0,0,0,2,0,0,2,1
6777,90793,5yUesVpQg6VbfIA01sOzitb9Qf8no8xc,bWdj2GDclj5ofokWjzoa5jAwMkxCykd6,4,2,1,0,1,0,1,0,5,0.7142857142857143,1,0.0,0,1,0,1,2,0,0,1,0,2,3,1
6778,90797,xkhW0o7SPQFIOs4D7mnb6RH3kX3k2QhW,SpATywNh6bZuzm8s1ceuBUnMUAeoAHHw,6,2,0,0,0,0,5,0,7,1.0,1,0.0,0,0,0,0,2,0,0,5,0,0,7,1
6779,90798,V95Tt6b4Z06nKuvQsXC9kpbsyH3YIGk4,SpATywNh6bZuzm8s1ceuBUnMUAeoAHHw,3,2,0,0,0,6,1,0,9,1.2857142857142858,1,0.0,0,0,0,0,2,6,0,1,0,0,9,1
6780,90807,DYC2TKuAWipp9UNJIdqFLJgrkLj9mdOD,SpATywNh6bZuzm8s1ceuBUnMUAeoAHHw,17,36,12,16,4,7,23,6,104,14.857142857142858,3,0.0,12,12,13,4,24,7,3,23,6,41,63,0
6781,90814,EzH5vTFvKXPmDbmZZs9qDP4fhOA2tS8t,SpATywNh6bZuzm8s1ceuBUnMUAeoAHHw,15,29,5,12,5,7,7,2,67,9.571428571428571,1,0.0,18,5,11,5,11,7,1,7,2,39,28,1
6782,90827,Nu895EVx5N8YMgmc6Rsn4OVZESOkiczT,bWdj2GDclj5ofokWjzoa5jAwMkxCykd6,4,3,1,0,1,0,1,0,6,0.8571428571428571,1,0.0,0,1,0,1,3,0,0,1,0,2,4,1
6783,90829,r1uzabdEU8Xrw9e89SInzZPTwxnUupS6,SpATywNh6bZuzm8s1ceuBUnMUAeoAHHw,19,18,11,22,8,2,15,1,77,11.0,2,0.0,4,11,17,8,14,2,5,15,1,40,37,1
6784,90834,FajLS6BmkKgqb4XY9XPhCU4sFK1uRQ8Y,SpATywNh6bZuzm8s1ceuBUnMUAeoAHHw,6,2,1,0,1,0,3,0,7,1.0,1,0.0,1,1,0,1,1,0,0,3,0,3,4,1
6785,90838,J5zz2fAd7wtYMISsvWzFdYy7sZtBfDuG,SpATywNh6bZuzm8s1ceuBUnMUAeoAHHw,11,17,7,0,3,7,9,1,44,6.285714285714286,1,0.0,8,7,0,3,9,7,0,9,1,18,26,1
6786,90840,b1jxzfFtNrlmaMGoYNWOYfEAHOoLdx2j,bWdj2GDclj5ofokWjzoa5jAwMkxCykd6,7,6,2,4,1,0,7,0,20,2.857142857142857,1,0.0,2,2,4,1,4,0,0,7,0,9,11,1
6787,90860,JNtIRj6hnKiaMOhcBlcWRjLc0QwYKSxo,RXDvfPUBYFlVdlueBFbLW0mhhAyGEqpt,5,2,1,0,1,0,2,0,6,0.8571428571428571,1,0.0,0,1,0,1,2,0,0,2,0,2,4,1
6788,90871,pS71kwyejWdfiaeMEH40zntKPU95klQC,SpATywNh6bZuzm8s1ceuBUnMUAeoAHHw,6,3,0,0,0,0,3,1,7,1.0,1,0.0,0,0,0,0,3,0,0,3,1,0,7,1
6789,90873,LoEfaid2dOKAK1Vb6WcaGJbgN3PRNGde,SpATywNh6bZuzm8s1ceuBUnMUAeoAHHw,4,2,1,0,1,0,2,0,6,0.8571428571428571,1,0.0,0,1,0,1,2,0,0,2,0,2,4,1
6790,90886,U6j39msbwkx5j8wcgHIrrZSEw6jir138,SpATywNh6bZuzm8s1ceuBUnMUAeoAHHw,5,4,2,0,2,0,2,0,10,1.4285714285714286,1,0.0,1,2,0,2,3,0,0,2,0,5,5,1
6791,90895,TRCrdidmG6eXWyA1xpJbOiCViWff58Ia,bWdj2GDclj5ofokWjzoa5jAwMkxCykd6,5,2,1,0,1,0,2,0,6,0.8571428571428571,1,0.0,0,1,0,1,2,0,0,2,0,2,4,1
6792,90898,KuNFtG4l08F89uoxUeo0jGAYIKWrBRbs,SpATywNh6bZuzm8s1ceuBUnMUAeoAHHw,11,8,4,5,3,0,2,0,22,3.142857142857143,2,0.0,1,4,4,3,7,0,1,2,0,12,10,1
6793,90900,ZlJV9a7edMx2HyEVyPzwwfS7y67dq8Ki,SpATywNh6bZuzm8s1ceuBUnMUAeoAHHw,7,6,4,0,4,0,2,0,16,2.2857142857142856,1,0.0,1,4,0,4,5,0,0,2,0,9,7,1
6794,90917,nazeZS8BdRMOGGuVriyb5M21Pn5Qng36,bWdj2GDclj5ofokWjzoa5jAwMkxCykd6,7,18,9,0,17,0,9,0,53,7.571428571428571,3,0.0,0,9,0,17,18,0,0,9,0,26,27,1
6795,90924,8dce3jvQILzvCt2gqdxC1GXJeAlwT2XG,SpATywNh6bZuzm8s1ceuBUnMUAeoAHHw,5,2,1,0,1,0,3,0,7,1.0,1,0.0,0,1,0,1,2,0,0,3,0,2,5,1
6796,90931,MhTSP1UwQzeoqedkBfla3LYw7KA6P5RM,bWdj2GDclj5ofokWjzoa5jAwMkxCykd6,3,2,0,0,0,0,2,0,4,0.5714285714285714,1,0.0,0,0,0,0,2,0,0,2,0,0,4,1
6797,90935,T6uKBu9byfRvxDh9TTWa54gKMCltkicT,G8EPVSXsOYB5YQWZGiz1aVq5Pgr2GrQu,4,4,3,0,3,0,1,0,11,1.5714285714285714,2,0.0,0,3,0,3,4,0,0,1,0,6,5,1
6798,90936,ElLz2aBJCCMb80RAglralkX1EvljkdsQ,SpATywNh6bZuzm8s1ceuBUnMUAeoAHHw,5,3,1,0,1,0,2,0,7,1.0,1,0.0,0,1,0,1,3,0,0,2,0,2,5,1
6799,90941,XTcsDe1fuCzXOnCFHuWkz7K8gAjPZJM4,bWdj2GDclj5ofokWjzoa5jAwMkxCykd6,2,0,0,0,0,0,5,0,5,0.7142857142857143,1,0.0,0,0,0,0,0,0,0,5,0,0,5,1
6800,90942,oh70wjHZNiJm6YMEO2zTeIrDQMUiqmDd,bWdj2GDclj5ofokWjzoa5jAwMkxCykd6,8,14,2,0,2,0,3,0,21,3.0,2,0.0,4,2,0,2,10,0,0,3,0,8,13,1
6801,90943,iz51PdaMdn80ICs5ffsXdIXAEkxQQqv2,SpATywNh6bZuzm8s1ceuBUnMUAeoAHHw,17,9,5,16,3,2,9,1,45,6.428571428571429,1,0.0,3,5,15,3,6,2,1,9,1,26,19,1
6802,90944,Sz8jNgPmKJ1IbqEEVQqTtQlVUDGarqh2,bWdj2GDclj5ofokWjzoa5jAwMkxCykd6,11,8,3,0,4,0,11,1,27,3.857142857142857,1,0.0,3,3,0,4,5,0,0,11,1,10,17,1
6803,90950,FwoYWsRBSR2prQ90dYeOBoYOgqUPkA0R,G8EPVSXsOYB5YQWZGiz1aVq5Pgr2GrQu,2,0,0,0,0,0,3,0,3,0.42857142857142855,2,0.0,0,0,0,0,0,0,0,3,0,0,3,1
6804,90952,YQuE8HipF2FTxF6yilCc6Hjt2hO1hf9q,bWdj2GDclj5ofokWjzoa5jAwMkxCykd6,7,5,1,0,2,2,6,2,18,2.5714285714285716,1,0.0,3,1,0,2,2,2,0,6,2,6,12,1
6805,90965,1YzhwwWLdVM4bzJMYH49O7nplNitMAxK,bWdj2GDclj5ofokWjzoa5jAwMkxCykd6,4,2,1,0,1,0,2,0,6,0.8571428571428571,1,0.0,0,1,0,1,2,0,0,2,0,2,4,1
6806,90971,0Any9bve5RgMfxHre7giBaaR9aLeQ2Lh,G8EPVSXsOYB5YQWZGiz1aVq5Pgr2GrQu,31,27,9,48,5,1,6,1,97,13.857142857142858,2,0.0,10,9,36,5,17,1,12,6,1,60,37,1
6807,90972,zZsHSLX7Hk1sqhZYCfBgGlYJnqetGIKf,RXDvfPUBYFlVdlueBFbLW0mhhAyGEqpt,7,6,2,0,2,4,2,0,16,2.2857142857142856,2,0.0,0,2,0,2,6,4,0,2,0,4,12,1
6808,90977,54WxhKjSN8T9wal7LR6RLgJ4OJYZ4MI7,SpATywNh6bZuzm8s1ceuBUnMUAeoAHHw,7,2,1,0,1,0,4,2,10,1.4285714285714286,1,0.0,0,1,0,1,2,0,0,4,2,2,8,1
6809,90981,WaDGEoZt5VlIPyIkYuUem7AfSknoei62,SpATywNh6bZuzm8s1ceuBUnMUAeoAHHw,5,3,2,0,2,0,2,0,9,1.2857142857142858,1,0.0,0,2,0,2,3,0,0,2,0,4,5,1
6810,90983,6bHj9PZ0VE3b8eSJI8u4oP72tokPXLXO,G8EPVSXsOYB5YQWZGiz1aVq5Pgr2GrQu,1,0,0,0,0,0,1,0,1,0.14285714285714285,1,0.0,0,0,0,0,0,0,0,1,0,0,1,1
6811,90985,1fUklgl0Md6ScDLqDSo4HCeoLeD6eKIu,SpATywNh6bZuzm8s1ceuBUnMUAeoAHHw,4,2,1,0,1,0,1,0,5,0.7142857142857143,1,0.0,0,1,0,1,2,0,0,1,0,2,3,1
6812,90988,088SASUPOVYUGhoEly8vlrkGvRBJoNwp,bWdj2GDclj5ofokWjzoa5jAwMkxCykd6,1,0,0,0,0,0,1,0,1,0.14285714285714285,1,0.0,0,0,0,0,0,0,0,1,0,0,1,1
6813,90993,o9jg8F69R1QHiPj2Cseo8eHEbgUVa0SI,SpATywNh6bZuzm8s1ceuBUnMUAeoAHHw,14,12,7,8,3,0,4,0,34,4.857142857142857,1,0.0,3,7,8,3,9,0,0,4,0,21,13,1
6814,90994,aRm0bLcx1zhfrL1xTMfT090YII1zkLc3,SpATywNh6bZuzm8s1ceuBUnMUAeoAHHw,9,7,3,0,0,9,7,1,27,3.857142857142857,1,0.0,0,3,0,0,7,9,0,7,1,3,24,1
6815,90999,CwyOL3RMOVLomxrxyN9D4jPa9R0iWrS5,G8EPVSXsOYB5YQWZGiz1aVq5Pgr2GrQu,24,34,20,22,17,7,8,0,108,15.428571428571429,6,0.0,7,20,19,17,27,7,3,8,0,63,45,0
6816,91026,MjeqDLbJZr4I90t51p6C9NVAFWnc6WKs,SpATywNh6bZuzm8s1ceuBUnMUAeoAHHw,4,2,1,0,1,0,1,0,5,0.7142857142857143,1,0.0,0,1,0,1,2,0,0,1,0,2,3,1
6817,91034,QFBztpG3zDUpKNEaUDnlRETY3MvJRJAi,SpATywNh6bZuzm8s1ceuBUnMUAeoAHHw,5,2,1,0,1,0,2,0,6,0.8571428571428571,1,0.0,0,1,0,1,2,0,0,2,0,2,4,1
6818,91042,NkVQGteS9t3nbfagAzHcxD3mnVkb9mPC,bWdj2GDclj5ofokWjzoa5jAwMkxCykd6,18,22,12,54,6,10,13,0,117,16.714285714285715,4,0.0,4,12,46,6,18,10,8,13,0,68,49,1
6819,91048,niLMw8MCObO7SSR2V1jNg9WQt5oSjDFJ,bWdj2GDclj5ofokWjzoa5jAwMkxCykd6,6,5,3,0,2,0,3,0,13,1.8571428571428572,2,0.0,0,3,0,2,5,0,0,3,0,5,8,1
6820,91051,xl5sOWFbG0Tv8T4ljEfZxFv4R7vezkE6,SpATywNh6bZuzm8s1ceuBUnMUAeoAHHw,7,1,1,0,1,0,5,1,9,1.2857142857142858,1,0.0,0,1,0,1,1,0,0,5,1,2,7,1
6821,91052,OoFskl7apYDC7BHDdb3sEQXj1CchwYwD,bWdj2GDclj5ofokWjzoa5jAwMkxCykd6,2,0,0,0,0,0,2,0,2,0.2857142857142857,1,0.0,0,0,0,0,0,0,0,2,0,0,2,1
6822,91056,Iji9dmQW7A2gOcEtvLASbynNxhfIM21F,bWdj2GDclj5ofokWjzoa5jAwMkxCykd6,6,5,2,0,1,0,4,0,12,1.7142857142857142,2,0.0,0,2,0,1,5,0,0,4,0,3,9,1
6823,91069,YYUyHWUcinXU8cifTlXoJnuPjgxGAJi5,SpATywNh6bZuzm8s1ceuBUnMUAeoAHHw,1,0,0,0,0,0,1,0,1,0.14285714285714285,1,0.0,0,0,0,0,0,0,0,1,0,0,1,1
6824,91074,JpAMTeX7S86zOjUKZJzvXPct8ySEHYBj,G8EPVSXsOYB5YQWZGiz1aVq5Pgr2GrQu,6,3,1,0,1,0,4,0,9,1.2857142857142858,1,0.0,0,1,0,1,3,0,0,4,0,2,7,1
6825,91077,6LSxEzHekfBjzdBuVJRrkvGn3CBVWXBO,SpATywNh6bZuzm8s1ceuBUnMUAeoAHHw,12,14,6,0,4,1,5,1,31,4.428571428571429,1,0.0,2,6,0,4,12,1,0,5,1,12,19,1
6826,91085,WzyxlFqmZtRh9gdD2KRH7ykffyZqisUy,SpATywNh6bZuzm8s1ceuBUnMUAeoAHHw,13,26,2,17,1,2,9,0,57,8.142857142857142,1,0.0,9,2,15,1,17,2,2,9,0,27,30,1
6827,91091,UlE0oj4kFfHwymOFgqOZSWzrZZdGbIRC,SpATywNh6bZuzm8s1ceuBUnMUAeoAHHw,9,5,1,0,1,1,6,1,15,2.142857142857143,1,0.0,0,1,0,1,5,1,0,6,1,2,13,1
6828,91092,mXfwwTIVjHMqoVKAh2iEQbinKUCJHwTp,SpATywNh6bZuzm8s1ceuBUnMUAeoAHHw,10,32,16,0,10,6,14,0,78,11.142857142857142,4,0.0,0,16,0,10,32,6,0,14,0,26,52,1
6829,91113,LDDV5GLR4T4AoJ4swm7PTuKciMVwXQ01,G8EPVSXsOYB5YQWZGiz1aVq5Pgr2GrQu,38,50,10,22,9,7,27,1,126,18.0,8,0.0,8,10,19,9,42,7,3,27,1,46,80,0
6830,91123,b49trtJTjAjBwZY0yqpUQlVmAVV99Apg,SpATywNh6bZuzm8s1ceuBUnMUAeoAHHw,12,14,7,4,5,1,5,0,36,5.142857142857143,1,0.0,2,7,4,5,12,1,0,5,0,18,18,1
6831,91133,eYnqJ330oueH4EH7KeCLJxm6knixAbKs,SpATywNh6bZuzm8s1ceuBUnMUAeoAHHw,10,7,5,0,4,0,4,0,20,2.857142857142857,2,0.0,0,5,0,4,7,0,0,4,0,9,11,1
6832,91136,IVuLX03K95bXWOSaQ9TjOxhrrnD2P8LK,SpATywNh6bZuzm8s1ceuBUnMUAeoAHHw,16,14,7,11,4,0,6,1,43,6.142857142857143,1,0.0,4,7,11,4,10,0,0,6,1,26,17,1
6833,91139,Dw8R0agU0UT0CHCyap3lEB834WRdn2Bl,G8EPVSXsOYB5YQWZGiz1aVq5Pgr2GrQu,9,5,3,0,3,0,2,0,13,1.8571428571428572,1,0.0,1,3,0,3,4,0,0,2,0,7,6,1
6834,91149,SOPkGQWWnRmFTO7wOQhPDwNSzqEUHcJN,RXDvfPUBYFlVdlueBFbLW0mhhAyGEqpt,9,6,5,0,3,0,1,0,15,2.142857142857143,1,0.0,0,5,0,3,6,0,0,1,0,8,7,1
6835,91152,ogzXep3azQvjQ2uIPIxw4TZLNiUXYlgD,RXDvfPUBYFlVdlueBFbLW0mhhAyGEqpt,22,14,9,16,4,16,11,6,76,10.857142857142858,3,0.0,2,9,15,4,12,16,1,11,6,30,46,1
6836,91175,5q13Swk6MXZ4N9xLOgcxgjrrx1DdXb4Y,G8EPVSXsOYB5YQWZGiz1aVq5Pgr2GrQu,2,0,0,0,0,0,2,0,2,0.2857142857142857,1,0.0,0,0,0,0,0,0,0,2,0,0,2,1
6837,91177,CwCqnH1O0RObsR0eBW9cv5anjwotHyXi,SpATywNh6bZuzm8s1ceuBUnMUAeoAHHw,8,4,3,0,3,0,1,0,11,1.5714285714285714,1,0.0,0,3,0,3,4,0,0,1,0,6,5,1
6838,91180,MBIWth5fpiCntqhZOrmXyFENe8IPo1si,G8EPVSXsOYB5YQWZGiz1aVq5Pgr2GrQu,5,2,1,0,1,0,3,0,7,1.0,1,0.0,0,1,0,1,2,0,0,3,0,2,5,1
6839,91185,bUI06hErQBLCI8IpvZBPVsO5ApTPyNZ8,bWdj2GDclj5ofokWjzoa5jAwMkxCykd6,7,6,2,0,1,0,3,0,12,1.7142857142857142,3,0.0,0,2,0,1,6,0,0,3,0,3,9,1
6840,91186,N3cFMZkDkwJjlqfThZ0MJktu3s2FDQhu,SpATywNh6bZuzm8s1ceuBUnMUAeoAHHw,14,12,6,10,4,0,5,0,37,5.285714285714286,1,0.0,2,6,10,4,10,0,0,5,0,22,15,1
6841,91195,sD1p5VuSw3mE3A3cEGdX778feL3umtle,G8EPVSXsOYB5YQWZGiz1aVq5Pgr2GrQu,1,0,0,0,0,0,2,0,2,0.2857142857142857,1,0.0,0,0,0,0,0,0,0,2,0,0,2,1
6842,91197,MfRaHJKkD3QtNBNxriSuNn50bOkDWFU2,G8EPVSXsOYB5YQWZGiz1aVq5Pgr2GrQu,4,4,1,0,2,0,1,0,8,1.1428571428571428,1,0.0,2,1,0,2,2,0,0,1,0,5,3,0
6843,91200,Zw1bdKbgaMzUzlqlieQSaucEQ8wggZlx,RXDvfPUBYFlVdlueBFbLW0mhhAyGEqpt,7,6,4,0,2,0,2,0,14,2.0,1,0.0,0,4,0,2,6,0,0,2,0,6,8,1
6844,91211,YlWJRLkP5QIlBcoTrKDrquHDRSLUHmOs,SpATywNh6bZuzm8s1ceuBUnMUAeoAHHw,37,55,1,46,1,38,18,15,174,24.857142857142858,7,0.0,20,1,41,1,35,38,5,18,15,63,111,0
6845,91224,0b8coo9JZwKqcLwikgVi0uCa0HK4ngVT,SpATywNh6bZuzm8s1ceuBUnMUAeoAHHw,7,7,3,0,3,0,2,0,15,2.142857142857143,1,0.0,2,3,0,3,5,0,0,2,0,8,7,1
6846,91227,wrG2kznqDzNLV2b2BDLa9oNAZZomHWM1,bWdj2GDclj5ofokWjzoa5jAwMkxCykd6,5,3,0,0,0,0,2,0,5,0.7142857142857143,1,0.0,0,0,0,0,3,0,0,2,0,0,5,1
6847,91234,Zw1bdKbgaMzUzlqlieQSaucEQ8wggZlx,SpATywNh6bZuzm8s1ceuBUnMUAeoAHHw,8,10,7,0,5,0,4,0,26,3.7142857142857144,2,0.0,0,7,0,5,10,0,0,4,0,12,14,1
6848,91237,JLChl7mOWMB1KaATZ4zO6thYfhhSEMFx,bWdj2GDclj5ofokWjzoa5jAwMkxCykd6,4,2,0,0,0,2,3,0,7,1.0,1,0.0,0,0,0,0,2,2,0,3,0,0,7,1
6849,91248,20Kk6BKHam3XYBZHLn3cb7mbeQ3wjB0A,SpATywNh6bZuzm8s1ceuBUnMUAeoAHHw,5,3,1,0,1,0,2,0,7,1.0,1,0.0,0,1,0,1,3,0,0,2,0,2,5,1
6850,91288,il7MvONte06QnYiXs4eT4KVZhcQaTvCn,bWdj2GDclj5ofokWjzoa5jAwMkxCykd6,2,0,0,0,0,0,2,0,2,0.2857142857142857,1,0.0,0,0,0,0,0,0,0,2,0,0,2,1
6851,91290,4BCWVZMgSyk2ZEk4MHhm6b7lpgXWTd1k,SpATywNh6bZuzm8s1ceuBUnMUAeoAHHw,16,27,21,10,11,12,13,1,95,13.571428571428571,3,0.0,0,21,7,11,27,12,3,13,1,39,56,0
6852,91292,f6cpMj2XDptMqY9BMDiLiCW1lYt1B5HJ,bWdj2GDclj5ofokWjzoa5jAwMkxCykd6,2,0,0,0,0,2,2,0,4,0.5714285714285714,1,0.0,0,0,0,0,0,2,0,2,0,0,4,1
6853,91295,R0mUc8n4TzKl7Gj3gQcARJOPoEK9YWes,SpATywNh6bZuzm8s1ceuBUnMUAeoAHHw,9,10,4,0,2,0,9,1,26,3.7142857142857144,1,0.0,0,4,0,2,10,0,0,9,1,6,20,1
6854,91298,q4LihsiR4OZ2DrDNHviQwvJKphS7fKLx,SpATywNh6bZuzm8s1ceuBUnMUAeoAHHw,5,3,1,0,1,0,3,0,8,1.1428571428571428,1,0.0,0,1,0,1,3,0,0,3,0,2,6,1
6855,91308,aUncRjNtcPfHDYIbstir1RL5J34mNVnM,SpATywNh6bZuzm8s1ceuBUnMUAeoAHHw,1,0,0,0,0,0,1,0,1,0.14285714285714285,1,0.0,0,0,0,0,0,0,0,1,0,0,1,1
6856,91309,i0UAMwrjj2eXydsjRtQeHBmAMB3Ngwx3,SpATywNh6bZuzm8s1ceuBUnMUAeoAHHw,3,3,1,0,0,0,1,0,5,0.7142857142857143,1,0.0,0,1,0,0,3,0,0,1,0,1,4,1
6857,91311,StzJzmbhGW7cEyMLQz7mJx8nKnB6WL4m,bWdj2GDclj5ofokWjzoa5jAwMkxCykd6,1,0,0,0,0,0,1,0,1,0.14285714285714285,1,0.0,0,0,0,0,0,0,0,1,0,0,1,1
6858,91313,SHYKz4VRgTlESEEhjzd6VibUsZchMKQH,G8EPVSXsOYB5YQWZGiz1aVq5Pgr2GrQu,6,5,2,0,2,0,3,0,12,1.7142857142857142,2,0.0,0,2,0,2,5,0,0,3,0,4,8,0
6859,91318,p1lN44XlRZ80wopUQc4ZNciWVb9r8nPI,RXDvfPUBYFlVdlueBFbLW0mhhAyGEqpt,18,26,10,26,3,0,4,0,69,9.857142857142858,2,0.0,4,10,22,3,22,0,4,4,0,39,30,1
6860,91321,qRCFXu9SKQXvPlpvjvNkgxm9VD5k2SNq,SpATywNh6bZuzm8s1ceuBUnMUAeoAHHw,15,19,8,17,3,1,9,0,57,8.142857142857142,3,0.0,8,8,15,3,11,1,2,9,0,34,23,1
6861,91342,za2dBkPPLD9IPRBjooK7GJit2ulI5UgN,bWdj2GDclj5ofokWjzoa5jAwMkxCykd6,1,0,0,0,0,0,1,0,1,0.14285714285714285,1,0.0,0,0,0,0,0,0,0,1,0,0,1,1
6862,91366,fE7crtUj4hDSQo6ITE7OJYFi4AN2F95M,RXDvfPUBYFlVdlueBFbLW0mhhAyGEqpt,9,7,0,9,1,0,1,0,18,2.5714285714285716,1,0.0,2,0,9,1,5,0,0,1,0,12,6,1
6863,91383,BcJnhjzA1hw0WNze9uWUZQ49uBAiBHyH,SpATywNh6bZuzm8s1ceuBUnMUAeoAHHw,18,44,3,6,4,7,10,0,74,10.571428571428571,4,0.0,7,3,6,4,37,7,0,10,0,20,54,0
6864,91385,2GLZl96ZIgoKdw26t6xniq9LngPm9HvA,SpATywNh6bZuzm8s1ceuBUnMUAeoAHHw,8,3,2,0,2,0,3,0,10,1.4285714285714286,1,0.0,0,2,0,2,3,0,0,3,0,4,6,1
6865,91386,Id4UmIRRQiLXHoJYSjh5OCO1CRaFgQ2K,bWdj2GDclj5ofokWjzoa5jAwMkxCykd6,4,2,1,0,1,0,1,0,5,0.7142857142857143,1,0.0,0,1,0,1,2,0,0,1,0,2,3,1
6866,91389,j6Gbqu7tKtq8czp36zzxzHhI2ZEexibX,RXDvfPUBYFlVdlueBFbLW0mhhAyGEqpt,5,5,3,0,0,0,4,0,12,1.7142857142857142,2,0.0,0,3,0,0,5,0,0,4,0,3,9,1
6867,91393,pIUtN3HLfZAw0y37LPvuW9XkUHMVBvrO,bWdj2GDclj5ofokWjzoa5jAwMkxCykd6,1,0,0,0,0,0,1,0,1,0.14285714285714285,1,0.0,0,0,0,0,0,0,0,1,0,0,1,1
6868,91394,E7lyNwGYkG4o0UtCNjPSm6tmdy5hs4Mj,SpATywNh6bZuzm8s1ceuBUnMUAeoAHHw,7,1,1,0,1,0,5,0,8,1.1428571428571428,1,0.0,0,1,0,1,1,0,0,5,0,2,6,1
6869,91395,NzJuOfalEsOT54AavPrqSe3rsSE0cQkZ,bWdj2GDclj5ofokWjzoa5jAwMkxCykd6,1,0,0,0,0,0,1,0,1,0.14285714285714285,1,0.0,0,0,0,0,0,0,0,1,0,0,1,1
6870,91401,iM4WoC15lD8jmFLbUdaT8GwiDe76pgOg,G8EPVSXsOYB5YQWZGiz1aVq5Pgr2GrQu,2,0,0,0,0,0,2,0,2,0.2857142857142857,2,0.0,0,0,0,0,0,0,0,2,0,0,2,1
6871,91404,pSX4Dt8N2zVP05X1Tx0KEKzwWiZKDmer,SpATywNh6bZuzm8s1ceuBUnMUAeoAHHw,6,4,1,0,0,0,4,0,9,1.2857142857142858,2,0.0,0,1,0,0,4,0,0,4,0,1,8,1
6872,91405,piFN5eqEaJK1fUd2Yaiy8tquOTQSgzuN,RXDvfPUBYFlVdlueBFbLW0mhhAyGEqpt,2,0,0,0,0,0,3,0,3,0.42857142857142855,1,0.0,0,0,0,0,0,0,0,3,0,0,3,1
6873,91408,ov4pd0r7G3aHxyRJ3zd0jj3VwbkwbsuS,SpATywNh6bZuzm8s1ceuBUnMUAeoAHHw,8,2,1,0,1,2,11,1,18,2.5714285714285716,1,0.0,0,1,0,1,2,2,0,11,1,2,16,1
6874,91410,sEqMP3dTCfBAru35lgG6C0VuJq3LG5mE,SpATywNh6bZuzm8s1ceuBUnMUAeoAHHw,6,4,1,0,1,3,5,0,14,2.0,3,0.0,0,1,0,1,4,3,0,5,0,2,12,1
6875,91414,HSyljcmKCDSksgg7xJb6gUib0wBvYjVv,G8EPVSXsOYB5YQWZGiz1aVq5Pgr2GrQu,32,44,26,46,10,13,12,1,152,21.714285714285715,3,0.0,12,26,32,10,32,13,14,12,1,80,72,1
6876,91423,g6UH67YbvJtewLNXQNVZTYui0XC1Hxpo,bWdj2GDclj5ofokWjzoa5jAwMkxCykd6,7,12,7,0,1,5,6,0,31,4.428571428571429,1,0.0,1,7,0,1,11,5,0,6,0,9,22,1
6877,91429,Ocd58hpNcygqCXglTTmZd1ZSNvH3SCps,RXDvfPUBYFlVdlueBFbLW0mhhAyGEqpt,6,6,4,0,1,0,1,0,12,1.7142857142857142,1,0.0,0,4,0,1,6,0,0,1,0,5,7,1
6878,91430,vrpzudIR4dEiVdhwxbfDnInMv3JRRfJv,SpATywNh6bZuzm8s1ceuBUnMUAeoAHHw,5,3,1,0,1,0,1,0,6,0.8571428571428571,1,0.0,0,1,0,1,3,0,0,1,0,2,4,1
6879,91434,0CSUGuJXm53wz281T7wy30wWcjmP6Jhd,bWdj2GDclj5ofokWjzoa5jAwMkxCykd6,1,0,0,0,0,0,1,0,1,0.14285714285714285,1,0.0,0,0,0,0,0,0,0,1,0,0,1,1
6880,91438,FUkw8gvbqykqbH4tdSuG6VwP03f4pQvB,RXDvfPUBYFlVdlueBFbLW0mhhAyGEqpt,1,0,0,0,0,0,1,0,1,0.14285714285714285,1,0.0,0,0,0,0,0,0,0,1,0,0,1,1
6881,91442,XR5Z5kfmQ9E4GIPtNaMkJo2oa530uh94,SpATywNh6bZuzm8s1ceuBUnMUAeoAHHw,11,6,4,0,3,0,5,1,19,2.7142857142857144,1,0.0,0,4,0,3,6,0,0,5,1,7,12,1
6882,91456,pIUtN3HLfZAw0y37LPvuW9XkUHMVBvrO,SpATywNh6bZuzm8s1ceuBUnMUAeoAHHw,5,2,1,0,1,0,2,0,6,0.8571428571428571,1,0.0,0,1,0,1,2,0,0,2,0,2,4,1
6883,91460,qzjZHUzfivuSEB3h2CxO69AUVaBX51Ki,bWdj2GDclj5ofokWjzoa5jAwMkxCykd6,3,0,0,0,0,1,7,0,8,1.1428571428571428,2,0.0,0,0,0,0,0,1,0,7,0,0,8,1
6884,91474,XDng1mliVGDk6IontbBqBdoGZnODrUp1,SpATywNh6bZuzm8s1ceuBUnMUAeoAHHw,1,0,0,0,0,0,1,0,1,0.14285714285714285,1,0.0,0,0,0,0,0,0,0,1,0,0,1,0
6885,91477,Rhpf6lbWeFbBg91LchhBc713YgETI2ib,SpATywNh6bZuzm8s1ceuBUnMUAeoAHHw,11,10,0,14,0,2,6,2,34,4.857142857142857,1,0.0,4,0,13,0,6,2,1,6,2,17,17,1
6886,91478,mB7kFNAvy0IlvYKinAyQDJ9wbSStqolr,SpATywNh6bZuzm8s1ceuBUnMUAeoAHHw,9,3,1,0,1,15,7,6,33,4.714285714285714,1,0.0,0,1,0,1,3,15,0,7,6,2,31,1
6887,91480,3NG42RQfrkx04BX4rgjNYVd7JioduuEW,SpATywNh6bZuzm8s1ceuBUnMUAeoAHHw,45,142,63,38,20,12,30,1,306,43.714285714285715,12,0.0,26,63,37,20,116,12,1,30,1,146,160,0
6888,91484,Ja9aSTrbcYBJIk0knND32MhX73YVzDja,SpATywNh6bZuzm8s1ceuBUnMUAeoAHHw,15,33,7,19,3,5,8,1,76,10.857142857142858,2,0.0,23,7,17,3,10,5,2,8,1,50,26,1
6889,91498,Hh0poBt7neEeproKcOr3UwYd1l0mAkdY,SpATywNh6bZuzm8s1ceuBUnMUAeoAHHw,3,2,0,0,0,0,1,0,3,0.42857142857142855,1,0.0,0,0,0,0,2,0,0,1,0,0,3,1
6890,91499,MpyJrzGdf4KkfpgI13J4Ob9OCNumnSCn,G8EPVSXsOYB5YQWZGiz1aVq5Pgr2GrQu,19,22,8,38,8,0,4,1,81,11.571428571428571,3,0.0,1,8,34,8,21,0,4,4,1,51,30,1
6891,91503,Zx58r1nZicPZKjfYD5NgFYMSoAobbtxC,SpATywNh6bZuzm8s1ceuBUnMUAeoAHHw,12,11,7,0,5,0,5,0,28,4.0,1,0.0,1,7,0,5,10,0,0,5,0,13,15,1
6892,91510,NjgQeSBBMWIwQySsR5ymtqiugkMaOyYh,RXDvfPUBYFlVdlueBFbLW0mhhAyGEqpt,1,0,0,0,0,0,1,0,1,0.14285714285714285,1,0.0,0,0,0,0,0,0,0,1,0,0,1,1
6893,91512,IOj0PjWZoY0P8vGiPElep0GUuIa0VzfB,SpATywNh6bZuzm8s1ceuBUnMUAeoAHHw,8,2,1,0,1,0,5,1,10,1.4285714285714286,2,0.0,0,1,0,1,2,0,0,5,1,2,8,1
6894,91513,mlU6Sa4kvQqDwrJTiTVy3DXIlsysw3Tt,bWdj2GDclj5ofokWjzoa5jAwMkxCykd6,7,2,1,0,1,2,6,1,13,1.8571428571428572,1,0.0,0,1,0,1,2,2,0,6,1,2,11,0
6895,91521,1wUGa0IVsURQxQCvq0df7PLHs6Y2zNr7,bWdj2GDclj5ofokWjzoa5jAwMkxCykd6,5,5,0,0,0,0,7,0,12,1.7142857142857142,1,0.0,0,0,0,0,5,0,0,7,0,0,12,1
6896,91534,QM4BAIMqANq73zFQSTCtWv7Gn7ptHHhB,SpATywNh6bZuzm8s1ceuBUnMUAeoAHHw,7,3,2,0,1,0,6,0,12,1.7142857142857142,1,0.0,0,2,0,1,3,0,0,6,0,3,9,1
6897,91537,OiZVspQp0F9iJRMGMp4WIKFfxCHFzZhd,SpATywNh6bZuzm8s1ceuBUnMUAeoAHHw,1,0,0,0,0,0,1,0,1,0.14285714285714285,1,0.0,0,0,0,0,0,0,0,1,0,0,1,1
6898,91542,gpepovLBdtRKFzmC4QxqUbBL1lSM59qa,G8EPVSXsOYB5YQWZGiz1aVq5Pgr2GrQu,6,5,2,0,1,0,2,0,10,1.4285714285714286,1,0.0,0,2,0,1,5,0,0,2,0,3,7,1
6899,91555,nQTEVD6AAIYz8tW67vxXg9EsDxe19v25,SpATywNh6bZuzm8s1ceuBUnMUAeoAHHw,1,0,0,0,0,0,1,0,1,0.14285714285714285,1,0.0,0,0,0,0,0,0,0,1,0,0,1,1
6900,91558,JaxQCd7UV5o1rvWxAibMy6iOMU3fCV5H,SpATywNh6bZuzm8s1ceuBUnMUAeoAHHw,5,2,1,0,1,0,2,0,6,0.8571428571428571,1,0.0,0,1,0,1,2,0,0,2,0,2,4,1
6901,91574,Utp3WJ8WUPD5DMyG8PNbE11goCMql2Z7,SpATywNh6bZuzm8s1ceuBUnMUAeoAHHw,7,3,2,0,2,0,3,0,10,1.4285714285714286,2,0.0,0,2,0,2,3,0,0,3,0,4,6,1
6902,91587,gGccjvdbrNrajnyHrtaox144rWbV1SPy,SpATywNh6bZuzm8s1ceuBUnMUAeoAHHw,14,31,15,21,7,3,6,0,83,11.857142857142858,3,0.0,4,15,18,7,27,3,3,6,0,44,39,0
6903,91598,7T9YIDVeH18g5BhUfy7opy4UBmEqkepp,bWdj2GDclj5ofokWjzoa5jAwMkxCykd6,2,0,0,0,0,0,3,0,3,0.42857142857142855,1,0.0,0,0,0,0,0,0,0,3,0,0,3,1
6904,91603,OrOKqOyaP0czIUaPleazM6NqAyXT5eRh,5Gyp41oLVo7Gg7vF4vpmggWP5MU70QO6,19,18,13,0,4,5,5,0,45,6.428571428571429,1,0.0,5,13,0,4,13,5,0,5,0,22,23,1
6905,91605,dNMg8HqASFn9pIW9ZR7BiQy6ZwZupOce,5Gyp41oLVo7Gg7vF4vpmggWP5MU70QO6,7,5,3,0,2,0,1,0,11,1.5714285714285714,2,0.0,1,3,0,2,4,0,0,1,0,6,5,0
6906,91624,lxP21JAeoGw4N8j8NgjQVcD64XYgvMHQ,5Gyp41oLVo7Gg7vF4vpmggWP5MU70QO6,6,4,3,0,0,0,3,0,10,1.4285714285714286,2,0.0,0,3,0,0,4,0,0,3,0,3,7,1
6907,91628,zMEKIcvm3yoz2YgvYxTVeyAzLndjTkwj,5Gyp41oLVo7Gg7vF4vpmggWP5MU70QO6,5,3,1,0,1,0,2,0,7,1.0,1,0.0,0,1,0,1,3,0,0,2,0,2,5,1
6908,91637,fsCIF7QhnxjK2RaGiibg5w66TDPP1pF7,5Gyp41oLVo7Gg7vF4vpmggWP5MU70QO6,4,2,0,0,0,0,2,0,4,0.5714285714285714,1,0.0,0,0,0,0,2,0,0,2,0,0,4,1
6909,91669,MRhqA2nXZ6Bkpg88Ka2eWnXnKoeC7n0Y,5Gyp41oLVo7Gg7vF4vpmggWP5MU70QO6,6,3,2,0,2,0,1,0,8,1.1428571428571428,1,0.0,0,2,0,2,3,0,0,1,0,4,4,1
6910,91690,uhHENxmla59SMNiIiDg6NjH3hc1bZQJz,5Gyp41oLVo7Gg7vF4vpmggWP5MU70QO6,13,30,0,2,2,0,4,0,38,5.428571428571429,3,0.0,4,0,1,2,26,0,1,4,0,7,31,1
6911,91715,74WSVlQKxYvszzuF50fKag40iRLOP9cx,5Gyp41oLVo7Gg7vF4vpmggWP5MU70QO6,28,78,31,8,8,0,9,3,137,19.571428571428573,4,0.0,25,31,4,8,53,0,4,9,3,68,69,1
6912,91719,n7WRFuvONxPzIz6h3G7EbhWA5QePb4uZ,5Gyp41oLVo7Gg7vF4vpmggWP5MU70QO6,12,11,8,0,6,0,3,0,28,4.0,3,0.0,0,8,0,6,11,0,0,3,0,14,14,0
6913,91735,jyKgXj3mAd5dyUJrfpYQZpBWgDXWTcbw,5Gyp41oLVo7Gg7vF4vpmggWP5MU70QO6,5,2,1,0,1,0,2,0,6,0.8571428571428571,1,0.0,0,1,0,1,2,0,0,2,0,2,4,1
6914,91773,0artPLh8IkCTAf124kxiUrz2J9bSLV97,5Gyp41oLVo7Gg7vF4vpmggWP5MU70QO6,2,0,0,0,0,0,2,0,2,0.2857142857142857,1,0.0,0,0,0,0,0,0,0,2,0,0,2,0
6915,91777,lfRqSKrZDdqhfB8Fp83G9pBOvFDy0kAs,5Gyp41oLVo7Gg7vF4vpmggWP5MU70QO6,8,18,9,0,2,6,11,0,46,6.571428571428571,7,0.0,0,9,0,2,18,6,0,11,0,11,35,0
6916,91798,dDzkrJVHCsvOOmSt9G6FWEYBUJ2tIHDw,5Gyp41oLVo7Gg7vF4vpmggWP5MU70QO6,14,9,7,8,2,3,12,1,42,6.0,2,0.0,0,7,6,2,9,3,2,12,1,15,27,1
6917,91807,ntnoRdM6rDaqd1odDyhFp4fAU79Gu4an,5Gyp41oLVo7Gg7vF4vpmggWP5MU70QO6,10,19,5,8,3,0,1,0,36,5.142857142857143,1,0.0,7,5,4,3,12,0,4,1,0,19,17,1
6918,91823,Tt8rzXFwAosNigtX0xm5nR0SMGNRi2Kk,5Gyp41oLVo7Gg7vF4vpmggWP5MU70QO6,6,2,1,0,1,0,3,0,7,1.0,1,0.0,0,1,0,1,2,0,0,3,0,2,5,1
6919,91826,V44Q36yyz0HxZhlrCwrLJjYwv8UzqoCn,5Gyp41oLVo7Gg7vF4vpmggWP5MU70QO6,26,28,17,0,12,0,5,0,62,8.857142857142858,2,0.0,3,17,0,12,25,0,0,5,0,32,30,1
6920,91853,jQSZrKmukoAGdD1PsGnzsjQnImWdBkqA,5Gyp41oLVo7Gg7vF4vpmggWP5MU70QO6,22,34,15,8,6,3,10,7,83,11.857142857142858,2,0.0,11,15,4,6,23,3,4,10,7,36,47,1
6921,91864,5ehf4EFN8WhDbvmb2WvfZwpaBD0cj1oj,5Gyp41oLVo7Gg7vF4vpmggWP5MU70QO6,2,0,0,0,0,0,3,0,3,0.42857142857142855,1,0.0,0,0,0,0,0,0,0,3,0,0,3,1
6922,91879,XpB3605ywsIMWFpcEpdm73TORVPiMuYf,5Gyp41oLVo7Gg7vF4vpmggWP5MU70QO6,4,3,2,0,0,0,1,0,6,0.8571428571428571,1,0.0,0,2,0,0,3,0,0,1,0,2,4,1
6923,91892,tlqjd2GOMGyjV0WHX1kZcOYXZIhFMnzY,5Gyp41oLVo7Gg7vF4vpmggWP5MU70QO6,6,3,1,0,1,0,2,0,7,1.0,1,0.0,0,1,0,1,3,0,0,2,0,2,5,1
6924,91895,3zntAItqSvNfO7Qv4LVxV45RnL0KWMa7,5Gyp41oLVo7Gg7vF4vpmggWP5MU70QO6,1,0,0,0,0,0,1,0,1,0.14285714285714285,1,0.0,0,0,0,0,0,0,0,1,0,0,1,1
6925,91904,Z9As9pIqQc1shsmV7QPe0LhImYacdXo2,5Gyp41oLVo7Gg7vF4vpmggWP5MU70QO6,8,3,2,0,2,0,3,1,11,1.5714285714285714,1,0.0,0,2,0,2,3,0,0,3,1,4,7,1
6926,91908,XYvhn7FKYwBLHO6LnI73nj3pDqSLOeJp,5Gyp41oLVo7Gg7vF4vpmggWP5MU70QO6,4,5,1,0,0,0,2,0,8,1.1428571428571428,1,0.0,3,1,0,0,2,0,0,2,0,4,4,1
6927,91935,sNbuAEBvvCL9s1FspvGXLJVjQkFzxwpw,5Gyp41oLVo7Gg7vF4vpmggWP5MU70QO6,23,40,24,13,9,10,15,1,112,16.0,6,0.0,5,24,8,9,35,10,5,15,1,46,66,1
6928,91938,1Xc4n8u7ThoxZMaQ0iucIboQyIl4jSHq,5Gyp41oLVo7Gg7vF4vpmggWP5MU70QO6,17,32,18,8,11,22,14,8,113,16.142857142857142,3,0.0,6,18,4,11,26,22,4,14,8,39,74,1
6929,91950,V5AS4ngknDMHs5ddf49SxlAoYguZsiN3,5Gyp41oLVo7Gg7vF4vpmggWP5MU70QO6,18,28,6,5,7,4,11,1,62,8.857142857142858,4,0.0,4,6,4,7,24,4,1,11,1,21,41,1
6930,92067,u4wFfZnbsYhKH8Kj4PUHUKy301RbBINb,3VkHkmOtom3jM2wCu94xgzzu1d6Dn7or,1,0,0,0,0,0,1,0,1,0.14285714285714285,1,0.0,0,0,0,0,0,0,0,1,0,0,1,1
6931,92113,hwyfFUZaszlgzhQ0A8GM8jJZSkMg0szI,3VkHkmOtom3jM2wCu94xgzzu1d6Dn7or,4,2,1,0,1,0,2,0,6,0.8571428571428571,1,0.0,0,1,0,1,2,0,0,2,0,2,4,1
6932,92142,ANTZV9I3pvsw3UZvyJti5aBzyESopoxF,3VkHkmOtom3jM2wCu94xgzzu1d6Dn7or,8,7,3,0,2,0,2,0,14,2.0,1,0.0,0,3,0,2,7,0,0,2,0,5,9,1
6933,92150,rAtBVPfi6wGHmo9go039lvWtKolaTQH4,3VkHkmOtom3jM2wCu94xgzzu1d6Dn7or,74,151,68,28,42,58,18,1,366,52.285714285714285,11,0.0,46,68,28,42,105,58,0,18,1,184,182,0
6934,92161,fCjzUD7j2qaTRuZP23QBRuNrEm9lCAvx,3VkHkmOtom3jM2wCu94xgzzu1d6Dn7or,3,2,0,0,0,0,1,0,3,0.42857142857142855,1,0.0,0,0,0,0,2,0,0,1,0,0,3,1
6935,92163,YVWYprrD49kz6eRpc0V63TWwuTo8nH9t,3VkHkmOtom3jM2wCu94xgzzu1d6Dn7or,10,9,4,22,0,2,2,0,39,5.571428571428571,1,0.0,4,4,19,0,5,2,3,2,0,27,12,1
6936,92178,qPy3iBoPzSROdvTXJHBPRLMGPMlGfgit,3VkHkmOtom3jM2wCu94xgzzu1d6Dn7or,1,0,0,0,0,0,1,0,1,0.14285714285714285,1,0.0,0,0,0,0,0,0,0,1,0,0,1,1
6937,92188,TKni4XynpXoISkd4OYGZxkhhQF48YfLJ,3VkHkmOtom3jM2wCu94xgzzu1d6Dn7or,5,3,1,0,1,0,2,0,7,1.0,1,0.0,0,1,0,1,3,0,0,2,0,2,5,1
6938,92196,m3riDkeaP3qLddM2Qy9128A1o8BoTU63,3VkHkmOtom3jM2wCu94xgzzu1d6Dn7or,1,0,0,0,0,0,1,0,1,0.14285714285714285,1,0.0,0,0,0,0,0,0,0,1,0,0,1,1
6939,92223,C839Pw1k25lShX6OME8tsROGVFmKHsQj,3VkHkmOtom3jM2wCu94xgzzu1d6Dn7or,13,16,11,0,0,0,7,0,34,4.857142857142857,3,0.0,2,11,0,0,14,0,0,7,0,13,21,1
6940,92271,2ACry9yVQLDO9NzG6c6rzYJoZ71i5zub,3VkHkmOtom3jM2wCu94xgzzu1d6Dn7or,5,2,1,0,1,0,2,0,6,0.8571428571428571,1,0.0,0,1,0,1,2,0,0,2,0,2,4,1
6941,92321,mBxJVmcIB5QiI5q4IOOyIq2i5l94DEiQ,3VkHkmOtom3jM2wCu94xgzzu1d6Dn7or,1,0,0,0,0,0,1,0,1,0.14285714285714285,1,0.0,0,0,0,0,0,0,0,1,0,0,1,1
6942,92326,feFmEKXFbNOyVfG6zt996K6iCOib8Z3O,3VkHkmOtom3jM2wCu94xgzzu1d6Dn7or,2,0,0,0,0,2,1,0,3,0.42857142857142855,1,0.0,0,0,0,0,0,2,0,1,0,0,3,1
6943,92329,J5hhd28AnEjvxP8BdwPWr3oDmUVPlSav,3VkHkmOtom3jM2wCu94xgzzu1d6Dn7or,6,8,5,0,0,0,2,0,15,2.142857142857143,1,0.0,0,5,0,0,8,0,0,2,0,5,10,1
6944,92423,rRrJj9JVQXtSLrAD2dEx3ajCynQpJX6X,3VkHkmOtom3jM2wCu94xgzzu1d6Dn7or,2,0,0,0,0,0,2,0,2,0.2857142857142857,1,0.0,0,0,0,0,0,0,0,2,0,0,2,1
6945,92504,pVihbVWlZf7SUBA6zEJSZ77SByxCCfVO,3VkHkmOtom3jM2wCu94xgzzu1d6Dn7or,4,2,1,0,1,0,1,0,5,0.7142857142857143,1,0.0,0,1,0,1,2,0,0,1,0,2,3,0
6946,92521,TlD076gGGGyiK5wb6YLxBzvK2DMAYIeX,3VkHkmOtom3jM2wCu94xgzzu1d6Dn7or,14,24,11,0,6,0,8,0,49,7.0,5,0.0,0,11,0,6,24,0,0,8,0,17,32,1
6947,92529,kvTwPCctpVXcm8cUo5wo3JOt6rO0CW0u,3VkHkmOtom3jM2wCu94xgzzu1d6Dn7or,46,121,20,34,35,57,25,2,294,42.0,6,0.0,30,20,27,35,91,57,7,25,2,112,182,1
6948,92535,012CixIdJBhXRc28Z2dnvOp7AzVdh4jR,3VkHkmOtom3jM2wCu94xgzzu1d6Dn7or,10,7,3,0,3,0,7,1,21,3.0,2,0.0,2,3,0,3,5,0,0,7,1,8,13,1
6949,92655,d0yHDlJTRwNIUBveZBHoUOAhhLLmBYWM,3VkHkmOtom3jM2wCu94xgzzu1d6Dn7or,1,0,0,0,0,0,1,0,1,0.14285714285714285,1,0.0,0,0,0,0,0,0,0,1,0,0,1,1
6950,92657,lPH6xIq6FfRsodLF4Ki11A2wICp83caG,3VkHkmOtom3jM2wCu94xgzzu1d6Dn7or,24,108,13,0,2,0,8,0,131,18.714285714285715,6,0.0,10,13,0,2,98,0,0,8,0,25,106,1
6951,92689,4Odot1ifQmo934dHmroVBJ0rHAodK4A5,3VkHkmOtom3jM2wCu94xgzzu1d6Dn7or,12,19,8,4,6,5,18,2,62,8.857142857142858,4,0.0,6,8,4,6,13,5,0,18,2,24,38,1
6952,92743,fBOKrkySPMr7N6TO5KbfFY7Qb8CUYtAU,3VkHkmOtom3jM2wCu94xgzzu1d6Dn7or,1,0,0,0,0,0,1,0,1,0.14285714285714285,1,0.0,0,0,0,0,0,0,0,1,0,0,1,1
6953,92831,B2UTUKN3bAFFBRPjVt44lFW6bWnjSKKh,G8EPVSXsOYB5YQWZGiz1aVq5Pgr2GrQu,10,10,1,0,1,0,3,0,15,2.142857142857143,1,0.0,0,1,0,1,10,0,0,3,0,2,13,1
6954,92837,bUI06hErQBLCI8IpvZBPVsO5ApTPyNZ8,A3fsA9Zfv1X2fVEQhTw51lKENdNrEqT3,7,0,0,0,0,10,7,1,18,2.5714285714285716,1,0.0,0,0,0,0,0,10,0,7,1,0,18,1
6955,92842,5fh1jlCU7jXB4QIW6qiZqp3idmC7zGIG,SpATywNh6bZuzm8s1ceuBUnMUAeoAHHw,9,5,3,0,2,1,7,1,19,2.7142857142857144,2,0.0,0,3,0,2,5,1,0,7,1,5,14,1
6956,92850,Q2m4p3E1xU5tjACIAMpsbnVuTeuD9Zj8,bWdj2GDclj5ofokWjzoa5jAwMkxCykd6,17,32,2,78,4,11,14,1,142,20.285714285714285,2,0.0,3,2,75,4,29,11,3,14,1,84,58,1
6957,92858,PO9UqxqUlWjKdLcKUuvXjpBUsCJBV13h,SpATywNh6bZuzm8s1ceuBUnMUAeoAHHw,23,45,6,8,3,6,9,1,78,11.142857142857142,6,0.0,18,6,8,3,27,6,0,9,1,35,43,0
6958,92869,1WP7C2GzJDZRslYYccdoHTPh8lrMzeDB,G8EPVSXsOYB5YQWZGiz1aVq5Pgr2GrQu,22,25,14,26,10,4,15,3,97,13.857142857142858,3,0.0,7,14,25,10,18,4,1,15,3,56,41,1
6959,92883,TY1XSpzUxZYHUqU0tQYtstvuwKCsGYpR,G8EPVSXsOYB5YQWZGiz1aVq5Pgr2GrQu,77,70,50,6,39,24,23,3,215,30.714285714285715,5,0.0,10,50,3,39,60,24,3,23,3,102,113,1
6960,92918,k8Gwazobmq79kvZvGEmSVe54OgHin1Sn,bWdj2GDclj5ofokWjzoa5jAwMkxCykd6,1,0,0,0,0,0,1,0,1,0.14285714285714285,1,0.0,0,0,0,0,0,0,0,1,0,0,1,1
6961,92920,k8Gwazobmq79kvZvGEmSVe54OgHin1Sn,RXDvfPUBYFlVdlueBFbLW0mhhAyGEqpt,1,0,0,0,0,0,1,0,1,0.14285714285714285,1,0.0,0,0,0,0,0,0,0,1,0,0,1,1
6962,92927,xKVU4KxHH7yw4gLTDP7X9Lm3WXZQ3SDL,SpATywNh6bZuzm8s1ceuBUnMUAeoAHHw,7,6,1,0,1,0,1,0,9,1.2857142857142858,1,0.0,0,1,0,1,6,0,0,1,0,2,7,1
6963,92929,0Rhh8KlMvGRxFbePsrW63o0GE8JJ4ZBr,bWdj2GDclj5ofokWjzoa5jAwMkxCykd6,3,0,0,0,0,0,4,0,4,0.5714285714285714,2,0.0,0,0,0,0,0,0,0,4,0,0,4,1
6964,92942,erkNYBqLpKRElyeL8GeAgO43CMazg6Rt,SpATywNh6bZuzm8s1ceuBUnMUAeoAHHw,8,15,10,0,1,0,13,0,39,5.571428571428571,3,0.0,1,10,0,1,14,0,0,13,0,12,27,1
6965,92943,9HqwJ8d4m6K7QOSGhF3dVzXYAYpOl0vj,RXDvfPUBYFlVdlueBFbLW0mhhAyGEqpt,20,27,11,0,8,0,4,0,50,7.142857142857143,2,0.0,0,11,0,8,27,0,0,4,0,19,31,1
6966,92946,bab14MPTgN4CshxZkY1kRnkvwuN9o8mj,SpATywNh6bZuzm8s1ceuBUnMUAeoAHHw,7,6,3,0,0,0,4,0,13,1.8571428571428572,1,0.0,0,3,0,0,6,0,0,4,0,3,10,1
6967,92994,NOoY36GVhU97rerOUVOIRgnbHjJMMwCG,G8EPVSXsOYB5YQWZGiz1aVq5Pgr2GrQu,4,3,0,0,0,0,2,0,5,0.7142857142857143,1,0.0,0,0,0,0,3,0,0,2,0,0,5,1
6968,93001,0lnyhqsWvNqdzPtTAPrrtxMTUBGxwge7,bWdj2GDclj5ofokWjzoa5jAwMkxCykd6,19,26,16,60,4,21,13,1,141,20.142857142857142,2,0.0,3,16,54,4,23,21,6,13,1,77,64,1
6969,93003,jX688Ad4bKlzkVM1SgNhwbdpN9xeTtmq,SpATywNh6bZuzm8s1ceuBUnMUAeoAHHw,7,3,2,0,2,0,2,0,9,1.2857142857142858,1,0.0,0,2,0,2,3,0,0,2,0,4,5,1
6970,93008,OdMr7dE5UlAme9Tp979vREBvY5CV50po,SpATywNh6bZuzm8s1ceuBUnMUAeoAHHw,53,66,42,28,25,0,16,0,177,25.285714285714285,10,0.0,7,42,26,25,59,0,2,16,0,100,77,0
6971,93018,bvvXbZgPtHbMGEZyEKJpOMNTPWYUJwvY,SpATywNh6bZuzm8s1ceuBUnMUAeoAHHw,1,0,0,0,0,0,1,0,1,0.14285714285714285,1,0.0,0,0,0,0,0,0,0,1,0,0,1,1
6972,93021,O2zNu3OLMNHq2ZjC3tlYs2TX12EEuIAG,bWdj2GDclj5ofokWjzoa5jAwMkxCykd6,13,39,21,60,15,18,14,1,168,24.0,4,0.0,8,21,58,15,31,18,2,14,1,102,66,0
6973,93031,4ihKyViABUcTrutAyMvzpqSavA9xsDnC,SpATywNh6bZuzm8s1ceuBUnMUAeoAHHw,14,13,10,0,7,0,2,0,32,4.571428571428571,2,0.0,1,10,0,7,12,0,0,2,0,18,14,1
6974,93036,m9qgZNgP3Zn0sGVjbTdK1WyVxg0SzTDj,SpATywNh6bZuzm8s1ceuBUnMUAeoAHHw,2,0,0,0,0,0,2,0,2,0.2857142857142857,1,0.0,0,0,0,0,0,0,0,2,0,0,2,1
6975,93045,WDD9a1qNUJX21r5OnYzYbe9snqA1PiYA,SpATywNh6bZuzm8s1ceuBUnMUAeoAHHw,10,11,9,0,5,0,5,0,30,4.285714285714286,2,0.0,0,9,0,5,11,0,0,5,0,14,16,1
6976,93046,0hRwE5vbowYRJTF6rcWCTgSh4yHA34bg,A3fsA9Zfv1X2fVEQhTw51lKENdNrEqT3,36,31,2,70,0,8,20,1,132,18.857142857142858,3,0.0,1,2,57,0,30,8,13,20,1,60,72,1
6977,93051,35QP8hkG1fMgJT5B2mWO7L1K5UDzKccP,RXDvfPUBYFlVdlueBFbLW0mhhAyGEqpt,1,0,0,0,0,0,1,0,1,0.14285714285714285,1,0.0,0,0,0,0,0,0,0,1,0,0,1,1
6978,93079,nVktdU2hPjrulp1NoJo2DLy3TGZQ0Uld,A3fsA9Zfv1X2fVEQhTw51lKENdNrEqT3,7,6,0,0,0,0,2,0,8,1.1428571428571428,1,0.0,0,0,0,0,6,0,0,2,0,0,8,0
6979,93100,FOMKrwD1FP5IWZmKryOBAWZkzJtszFo9,SpATywNh6bZuzm8s1ceuBUnMUAeoAHHw,6,3,2,0,1,0,4,0,10,1.4285714285714286,1,0.0,0,2,0,1,3,0,0,4,0,3,7,1
6980,93122,YYCI1ivPCDRa3x25VBUTnS1EqXk51k7P,SpATywNh6bZuzm8s1ceuBUnMUAeoAHHw,8,15,6,4,2,0,3,0,30,4.285714285714286,2,0.0,6,6,3,2,9,0,1,3,0,17,13,0
6981,93134,dtoXBrWvzofUQqyHToiF0PcYE9x06cjk,SpATywNh6bZuzm8s1ceuBUnMUAeoAHHw,13,16,7,0,3,1,9,1,37,5.285714285714286,2,0.0,2,7,0,3,14,1,0,9,1,12,25,1
6982,93138,qS74cvHEfXf7yNOdjRQHxs4K6Mb0fkmB,SpATywNh6bZuzm8s1ceuBUnMUAeoAHHw,5,5,3,0,0,0,7,0,15,2.142857142857143,1,0.0,0,3,0,0,5,0,0,7,0,3,12,1
6983,93146,ZBPGXZQPhYZwTG0U8gbjH8byD6eXCds5,SpATywNh6bZuzm8s1ceuBUnMUAeoAHHw,6,5,2,0,1,0,2,0,10,1.4285714285714286,1,0.0,0,2,0,1,5,0,0,2,0,3,7,1
6984,93155,nSGQJTGjP40uh7YNQd2M7oeyj4wFgY5k,SpATywNh6bZuzm8s1ceuBUnMUAeoAHHw,2,0,0,0,0,0,2,0,2,0.2857142857142857,1,0.0,0,0,0,0,0,0,0,2,0,0,2,1
6985,93172,9IDnKSSeA9OzPUrVvzlwiLBkpPo3uKJE,SpATywNh6bZuzm8s1ceuBUnMUAeoAHHw,11,14,9,0,6,0,12,2,43,6.142857142857143,1,0.0,0,9,0,6,14,0,0,12,2,15,28,1
6986,93195,ky5OAnymGB6zQeiaZNCLcaybyAjfTGVL,SpATywNh6bZuzm8s1ceuBUnMUAeoAHHw,15,22,8,11,2,12,9,0,64,9.142857142857142,1,0.0,11,8,10,2,11,12,1,9,0,31,33,1
6987,93201,tT3q39TssUZPXoxVdRzgRUu1SUheNubE,RXDvfPUBYFlVdlueBFbLW0mhhAyGEqpt,45,36,16,55,11,6,7,4,135,19.285714285714285,1,0.0,13,16,54,11,23,6,1,7,4,94,41,1
6988,93211,CANUVyVkYrlpItUerZN2eMCH6gNsEzSe,SpATywNh6bZuzm8s1ceuBUnMUAeoAHHw,12,16,2,0,1,0,10,3,32,4.571428571428571,3,0.0,0,2,0,1,16,0,0,10,3,3,29,1
6989,93219,fFsk9opmVFrs9gVmzPsOgmxgpsHLQliL,RXDvfPUBYFlVdlueBFbLW0mhhAyGEqpt,5,2,1,0,1,0,2,0,6,0.8571428571428571,1,0.0,0,1,0,1,2,0,0,2,0,2,4,1
6990,93227,ZBHFsE2c9ve1GkdeoBpHdlFbQkWYYfYc,A3fsA9Zfv1X2fVEQhTw51lKENdNrEqT3,4,5,1,0,0,0,2,0,8,1.1428571428571428,1,0.0,0,1,0,0,5,0,0,2,0,1,7,1
6991,93232,PoEjlZTjKWZ6BdoswaJwpEc5iphj2X1w,SpATywNh6bZuzm8s1ceuBUnMUAeoAHHw,1,0,0,0,0,0,1,0,1,0.14285714285714285,1,0.0,0,0,0,0,0,0,0,1,0,0,1,1
6992,93243,IsU1RKSKxT8SmvRzyXcC6emxRwMddmTJ,G8EPVSXsOYB5YQWZGiz1aVq5Pgr2GrQu,58,58,31,0,26,11,16,3,145,20.714285714285715,5,0.0,0,31,0,26,58,11,0,16,3,57,88,0
6993,93246,IAOTVxG7e06ArppQIZcVBCeppiZS52Zi,SpATywNh6bZuzm8s1ceuBUnMUAeoAHHw,10,7,2,0,2,1,7,1,20,2.857142857142857,2,0.0,0,2,0,2,7,1,0,7,1,4,16,1
6994,93271,RU7DM4q1MiWySLBD1tZoVnYmW4ZnJ0DL,RXDvfPUBYFlVdlueBFbLW0mhhAyGEqpt,1,0,0,0,0,0,1,0,1,0.14285714285714285,1,0.0,0,0,0,0,0,0,0,1,0,0,1,1
6995,93276,0e7xKBaDw3RmIMJpdHntjD8WC2jIp95k,SpATywNh6bZuzm8s1ceuBUnMUAeoAHHw,8,21,0,0,0,0,1,0,22,3.142857142857143,1,0.0,6,0,0,0,15,0,0,1,0,6,16,1
6996,93303,bHLTcAQFvIQJ6YaYh6r99cb370HZ5sPT,SpATywNh6bZuzm8s1ceuBUnMUAeoAHHw,1,0,0,0,0,0,1,0,1,0.14285714285714285,1,0.0,0,0,0,0,0,0,0,1,0,0,1,1
6997,93323,tyChfLhRWgtuzBYIo0LShbD6knUykDjv,G8EPVSXsOYB5YQWZGiz1aVq5Pgr2GrQu,23,14,10,66,6,11,8,1,116,16.571428571428573,1,0.0,4,10,56,6,10,11,10,8,1,76,40,1
6998,93330,HkYdxX3voGkfjdg703KviJnQhukKhxOh,G8EPVSXsOYB5YQWZGiz1aVq5Pgr2GrQu,1,0,0,0,0,0,2,0,2,0.2857142857142857,1,0.0,0,0,0,0,0,0,0,2,0,0,2,1
6999,93334,KFG6G55toGAeaWBt5UmyioW5n1NVxSjT,bWdj2GDclj5ofokWjzoa5jAwMkxCykd6,29,95,55,109,25,2,43,1,330,47.142857142857146,9,0.0,13,55,103,25,82,2,6,43,1,196,134,0
7000,93344,05Pe1SQ9Q2cBjcEFXjoLImyNIG21bK6A,RXDvfPUBYFlVdlueBFbLW0mhhAyGEqpt,2,0,0,0,0,0,2,0,2,0.2857142857142857,1,0.0,0,0,0,0,0,0,0,2,0,0,2,1
7001,93352,PR6nGGqGE6eMvOu04QC9agInMN1u3Vt7,A3fsA9Zfv1X2fVEQhTw51lKENdNrEqT3,23,16,14,0,13,0,3,0,46,6.571428571428571,1,0.0,0,14,0,13,16,0,0,3,0,27,19,1
7002,93367,hQNy1TJdPWXJGnnjdyetV1l4iHaSeol4,A3fsA9Zfv1X2fVEQhTw51lKENdNrEqT3,35,33,10,34,7,2,12,1,99,14.142857142857142,3,0.0,2,10,32,7,31,2,2,12,1,51,48,1
7003,93371,2XEzBTMWqAbDwimqhpYNFpmeQsMJgIYu,G8EPVSXsOYB5YQWZGiz1aVq5Pgr2GrQu,10,25,13,0,2,0,10,0,50,7.142857142857143,2,0.0,0,13,0,2,25,0,0,10,0,15,35,1
7004,93372,rdlkz4QUHd85FYWQkxx9tuSVm08spAcj,bWdj2GDclj5ofokWjzoa5jAwMkxCykd6,1,0,0,0,0,0,1,0,1,0.14285714285714285,1,0.0,0,0,0,0,0,0,0,1,0,0,1,1
7005,93389,CgiSBY8umD4OFxzPTCRENtvLfSjhJE4Q,A3fsA9Zfv1X2fVEQhTw51lKENdNrEqT3,1,0,0,0,0,0,1,0,1,0.14285714285714285,1,0.0,0,0,0,0,0,0,0,1,0,0,1,1
7006,93391,zFhrdwHMxq2geDsJ6rOF9PjKHNvVI11p,A3fsA9Zfv1X2fVEQhTw51lKENdNrEqT3,12,6,5,0,5,0,1,0,17,2.4285714285714284,1,0.0,0,5,0,5,6,0,0,1,0,10,7,1
7007,93394,grc1pAXqdUQaBlZrZyROqjuEtg08nen2,A3fsA9Zfv1X2fVEQhTw51lKENdNrEqT3,8,7,2,0,1,0,4,0,14,2.0,2,0.0,0,2,0,1,7,0,0,4,0,3,11,0
7008,93398,EjONyt33Kb19bd7xhGUM8lVieVH4ABMt,SpATywNh6bZuzm8s1ceuBUnMUAeoAHHw,5,2,1,0,1,0,2,0,6,0.8571428571428571,1,0.0,0,1,0,1,2,0,0,2,0,2,4,1
7009,93406,wCSstPXY2jshjpNaBAQvMm9l3Kvl06VT,bWdj2GDclj5ofokWjzoa5jAwMkxCykd6,12,89,25,0,15,0,24,0,153,21.857142857142858,11,0.0,2,25,0,15,87,0,0,24,0,42,111,1
7010,93430,ThGblU6q4nWmu3ORXgM7eQc8q9vcBP4r,bWdj2GDclj5ofokWjzoa5jAwMkxCykd6,11,48,13,20,9,24,31,0,145,20.714285714285715,7,0.0,6,13,19,9,42,24,1,31,0,47,98,1
7011,93443,urLIpfHBZDaCypO84XCYKp0hFEe7SU3u,SpATywNh6bZuzm8s1ceuBUnMUAeoAHHw,1,0,0,0,0,0,1,0,1,0.14285714285714285,1,0.0,0,0,0,0,0,0,0,1,0,0,1,1
7012,93469,rBjcfaRB4ipdhdlaYne0HS9fWNfJaL2z,A3fsA9Zfv1X2fVEQhTw51lKENdNrEqT3,2,0,0,0,0,1,4,0,5,0.7142857142857143,1,0.0,0,0,0,0,0,1,0,4,0,0,5,1
7013,93474,lsFZ5c3HC6SK6E53cEs8WDQLHZpNYjV8,A3fsA9Zfv1X2fVEQhTw51lKENdNrEqT3,1,0,0,0,0,0,1,0,1,0.14285714285714285,1,0.0,0,0,0,0,0,0,0,1,0,0,1,1
7014,93502,rukBWzj11e0XTZm12B6q1NVFBvhUpKcw,A3fsA9Zfv1X2fVEQhTw51lKENdNrEqT3,34,22,0,44,0,1,5,0,72,10.285714285714286,1,0.0,2,0,41,0,20,1,3,5,0,43,29,1
7015,93508,ESEu5Ebb0Dwu6eqKhLWhzsorI0PztGwh,bWdj2GDclj5ofokWjzoa5jAwMkxCykd6,7,10,0,0,0,0,7,0,17,2.4285714285714284,1,0.0,0,0,0,0,10,0,0,7,0,0,17,1
7016,93516,dkuQt2AJ3psLoe6oAyOQ02agP8eEbROK,A3fsA9Zfv1X2fVEQhTw51lKENdNrEqT3,1,0,0,0,0,0,1,0,1,0.14285714285714285,1,0.0,0,0,0,0,0,0,0,1,0,0,1,1
7017,93532,d78tyy5GbLAmAIYTt0zQeNafrfAUEUnp,SpATywNh6bZuzm8s1ceuBUnMUAeoAHHw,1,0,0,0,0,0,1,0,1,0.14285714285714285,1,0.0,0,0,0,0,0,0,0,1,0,0,1,1
7018,93539,hZR4MwcYec4g0GoOyJFngJGEyWOySpv2,SpATywNh6bZuzm8s1ceuBUnMUAeoAHHw,28,70,46,10,24,60,41,0,251,35.857142857142854,11,0.0,7,46,8,24,63,60,2,41,0,85,166,0
7019,93540,uSL2RaFO9pFGmE8bYQrfyJmRnbBOdoyU,SpATywNh6bZuzm8s1ceuBUnMUAeoAHHw,15,19,0,17,0,31,6,1,74,10.571428571428571,1,0.0,2,0,15,0,17,31,2,6,1,17,57,1
7020,93541,ThGblU6q4nWmu3ORXgM7eQc8q9vcBP4r,SpATywNh6bZuzm8s1ceuBUnMUAeoAHHw,29,79,25,22,8,77,37,1,249,35.57142857142857,7,0.0,13,25,20,8,66,77,2,37,1,66,183,1
7021,93555,mG2KwufBG46hwF0tMEUG2jvsfUa3PSHf,SpATywNh6bZuzm8s1ceuBUnMUAeoAHHw,15,17,7,0,4,0,3,0,31,4.428571428571429,2,0.0,1,7,0,4,16,0,0,3,0,12,19,0
7022,93571,XqasR5GIfOx9ytwr0b8Q6Z12NNCt5pqh,bWdj2GDclj5ofokWjzoa5jAwMkxCykd6,6,4,2,0,2,0,3,0,11,1.5714285714285714,2,0.0,0,2,0,2,4,0,0,3,0,4,7,0
7023,93574,we9tWnySpl1G7k7FqyXPj8wmC2gUYK0W,bWdj2GDclj5ofokWjzoa5jAwMkxCykd6,1,0,0,0,0,0,1,0,1,0.14285714285714285,1,0.0,0,0,0,0,0,0,0,1,0,0,1,1
7024,93575,kRwbDFbRADlNU7lsdYCaasRGNiEpQeeP,SpATywNh6bZuzm8s1ceuBUnMUAeoAHHw,8,7,3,0,3,0,1,0,14,2.0,1,0.0,0,3,0,3,7,0,0,1,0,6,8,1
7025,93597,i0nkxYulaHR9i5zqaHNFQeOz0iG2pS8U,A3fsA9Zfv1X2fVEQhTw51lKENdNrEqT3,9,13,6,0,2,0,4,0,25,3.5714285714285716,2,0.0,0,6,0,2,13,0,0,4,0,8,17,0
7026,93611,mG2KwufBG46hwF0tMEUG2jvsfUa3PSHf,RXDvfPUBYFlVdlueBFbLW0mhhAyGEqpt,29,26,14,0,9,0,2,0,51,7.285714285714286,2,0.0,1,14,0,9,25,0,0,2,0,24,27,0
7027,93620,HJ2Te0AnFOdWtPQ1mbU0gvcfD3BsPlu2,SpATywNh6bZuzm8s1ceuBUnMUAeoAHHw,36,79,48,20,11,15,24,1,198,28.285714285714285,7,0.0,14,48,18,11,65,15,2,24,1,91,107,0
7028,93625,MrZt24U8nbuIX2mCMw4lqKt5FUFOZURE,SpATywNh6bZuzm8s1ceuBUnMUAeoAHHw,1,0,0,0,0,0,1,0,1,0.14285714285714285,1,0.0,0,0,0,0,0,0,0,1,0,0,1,1
7029,93626,ae9lMjY6PaxC3JKoLUmKZvfdwEZiOBPx,G8EPVSXsOYB5YQWZGiz1aVq5Pgr2GrQu,5,2,1,0,1,0,2,0,6,0.8571428571428571,1,0.0,0,1,0,1,2,0,0,2,0,2,4,1
7030,93639,Pd0CZHVPAay5ceQzChjGxlgmgiQ8cqjG,G8EPVSXsOYB5YQWZGiz1aVq5Pgr2GrQu,5,2,1,0,1,0,4,0,8,1.1428571428571428,1,0.0,0,1,0,1,2,0,0,4,0,2,6,1
7031,93645,Qbhh4psghTMTs2MbZkpJwwkpxbM26vfP,SpATywNh6bZuzm8s1ceuBUnMUAeoAHHw,4,0,0,0,0,0,3,2,5,0.7142857142857143,1,0.0,0,0,0,0,0,0,0,3,2,0,5,1
7032,93657,QO30UexmdD88uyPYe6YK3wSk3JLKQBe3,A3fsA9Zfv1X2fVEQhTw51lKENdNrEqT3,8,2,1,0,1,1,10,1,16,2.2857142857142856,2,0.0,0,1,0,1,2,1,0,10,1,2,14,1
7033,93659,F731sqjciH519ML4GCaVvNQuuR5Oaq9t,A3fsA9Zfv1X2fVEQhTw51lKENdNrEqT3,4,2,1,0,1,0,2,0,6,0.8571428571428571,1,0.0,0,1,0,1,2,0,0,2,0,2,4,1
7034,93679,ju4nY4FL2KNi1hifJCQn8sVUqJICxh4O,SpATywNh6bZuzm8s1ceuBUnMUAeoAHHw,23,24,11,34,5,0,8,0,82,11.714285714285714,3,0.0,4,11,29,5,20,0,5,8,0,49,33,1
7035,93686,pXBkDxIpO7cvN4HkForKspl0UN1aLwbn,A3fsA9Zfv1X2fVEQhTw51lKENdNrEqT3,1,0,0,0,0,0,1,0,1,0.14285714285714285,1,0.0,0,0,0,0,0,0,0,1,0,0,1,1
7036,93689,KXi2lu4GlKmrO1lJTLg3t4l701rvNXNZ,A3fsA9Zfv1X2fVEQhTw51lKENdNrEqT3,76,53,34,102,20,9,27,3,248,35.42857142857143,11,0.0,7,34,93,20,46,9,9,27,3,154,94,0
7037,93702,5JlWaFjebQSvyUeyQLJ4C0BlriWkf8Hy,SpATywNh6bZuzm8s1ceuBUnMUAeoAHHw,17,27,2,17,3,0,5,0,54,7.714285714285714,3,0.0,15,2,15,3,12,0,2,5,0,35,19,1
7038,93706,OCOZunZP01no4Zh4NYF1FDXoOWZrc1Yv,G8EPVSXsOYB5YQWZGiz1aVq5Pgr2GrQu,16,14,4,0,5,1,8,1,33,4.714285714285714,1,0.0,6,4,0,5,8,1,0,8,1,15,18,1
7039,93724,VvbZjK8y9aernnsSHvAW377h2uAEkOuF,SpATywNh6bZuzm8s1ceuBUnMUAeoAHHw,6,0,0,0,0,1,5,1,7,1.0,1,0.0,0,0,0,0,0,1,0,5,1,0,7,1
7040,93748,qYBrztNE2m7Kv5jO5Me3GoAEoNnGgBEu,G8EPVSXsOYB5YQWZGiz1aVq5Pgr2GrQu,10,13,3,0,2,5,13,2,38,5.428571428571429,1,0.0,3,3,0,2,10,5,0,13,2,8,30,1
7041,93749,jqfntS6RKR0gZFQrp9eaCMToaEgoc2Xi,SpATywNh6bZuzm8s1ceuBUnMUAeoAHHw,1,0,0,0,0,0,1,0,1,0.14285714285714285,1,0.0,0,0,0,0,0,0,0,1,0,0,1,1
7042,93753,fCj90D5XHmebJ0IrbbuHaVfcb7tqMxkl,bWdj2GDclj5ofokWjzoa5jAwMkxCykd6,28,153,48,46,28,2,27,1,305,43.57142857142857,6,0.0,36,48,38,28,117,2,8,27,1,150,155,1
7043,93815,F7cOObRHTu5td8ezD8oRze1BhvyOKDSk,SpATywNh6bZuzm8s1ceuBUnMUAeoAHHw,8,6,3,0,1,0,2,0,12,1.7142857142857142,1,0.0,2,3,0,1,4,0,0,2,0,6,6,1
7044,93825,mEXFRacWKZUZ0ZrkucFcb0mHAIpc1jKZ,G8EPVSXsOYB5YQWZGiz1aVq5Pgr2GrQu,6,3,0,0,1,1,2,0,7,1.0,1,0.0,0,0,0,1,3,1,0,2,0,1,6,1
7045,93827,qKm0x9dl3CcMx4vyQxKmKiMsD63vzUte,bWdj2GDclj5ofokWjzoa5jAwMkxCykd6,1,0,0,0,0,0,1,0,1,0.14285714285714285,1,0.0,0,0,0,0,0,0,0,1,0,0,1,1
7046,93829,O9HNCpYyjeUf5Yv9cKak2CowRvtq7CSH,SpATywNh6bZuzm8s1ceuBUnMUAeoAHHw,12,16,9,0,4,0,12,1,42,6.0,3,0.0,1,9,0,4,15,0,0,12,1,14,28,1
7047,93832,60ov46MOFnBiXMZrd5NKEQiqC0SiurVf,A3fsA9Zfv1X2fVEQhTw51lKENdNrEqT3,9,9,1,0,1,0,7,0,18,2.5714285714285716,2,0.0,0,1,0,1,9,0,0,7,0,2,16,1
7048,93836,b3eTIICIpBOeQwbL52WcSz5BKSnmXD5x,SpATywNh6bZuzm8s1ceuBUnMUAeoAHHw,10,6,4,0,2,0,6,1,19,2.7142857142857144,1,0.0,0,4,0,2,6,0,0,6,1,6,13,1
7049,93838,fkbxkXpN20umRnEu1JAMVCW41OYjb7dl,A3fsA9Zfv1X2fVEQhTw51lKENdNrEqT3,6,3,1,0,0,1,5,0,10,1.4285714285714286,1,0.0,0,1,0,0,3,1,0,5,0,1,9,1
7050,93874,mSs5bB1Rxg3xYWjWjJY9pVTt7WAiMgyu,SpATywNh6bZuzm8s1ceuBUnMUAeoAHHw,9,23,12,0,3,36,34,0,108,15.428571428571429,6,0.0,0,12,0,3,23,36,0,34,0,15,93,0
7051,93877,SjBgrEi81Cf6wmEgkI03BQFCuncsAECU,SpATywNh6bZuzm8s1ceuBUnMUAeoAHHw,4,0,0,0,0,0,4,0,4,0.5714285714285714,1,0.0,0,0,0,0,0,0,0,4,0,0,4,0
7052,93909,5Ikem26Scse18GVLkwyf1cheWsOPE25C,SpATywNh6bZuzm8s1ceuBUnMUAeoAHHw,8,5,3,0,2,0,3,0,13,1.8571428571428572,2,0.0,0,3,0,2,5,0,0,3,0,5,8,1
7053,93912,EicwSyKru5cUE8FbnBvU3nlCh4zs6SDU,SpATywNh6bZuzm8s1ceuBUnMUAeoAHHw,1,0,0,0,0,0,1,0,1,0.14285714285714285,1,0.0,0,0,0,0,0,0,0,1,0,0,1,1
7054,93943,oNQaCuO2rlrLriXUbP7yibkLZ8kZEP0A,SpATywNh6bZuzm8s1ceuBUnMUAeoAHHw,13,11,5,12,3,0,2,0,33,4.714285714285714,2,0.0,2,5,12,3,9,0,0,2,0,22,11,1
7055,93964,0bPKxjIIw0GaiIYeAS2yIr8ZqMELBNL4,RXDvfPUBYFlVdlueBFbLW0mhhAyGEqpt,5,6,4,0,0,0,2,0,12,1.7142857142857142,2,0.0,0,4,0,0,6,0,0,2,0,4,8,0
7056,93996,xV4buLLcPPEcE2C8BKOwlQiGdSlriMdM,RXDvfPUBYFlVdlueBFbLW0mhhAyGEqpt,1,0,0,0,0,0,3,0,3,0.42857142857142855,2,0.0,0,0,0,0,0,0,0,3,0,0,3,1
7057,94003,aj6uF4XWV3XUUfOpWCk3NuntI2wXym6n,A3fsA9Zfv1X2fVEQhTw51lKENdNrEqT3,9,10,0,0,0,0,18,1,29,4.142857142857143,2,0.0,1,0,0,0,9,0,0,18,1,1,28,1
7058,94042,75ii7mb7d3VTc7Qrw6mG6DwTa15X98oH,SpATywNh6bZuzm8s1ceuBUnMUAeoAHHw,4,5,2,0,0,0,2,0,9,1.2857142857142858,1,0.0,0,2,0,0,5,0,0,2,0,2,7,0
7059,94044,t88wfrSqhn6m3ghlAqrTBAHAFrsZ2sxt,bWdj2GDclj5ofokWjzoa5jAwMkxCykd6,10,8,4,0,2,15,12,0,41,5.857142857142857,2,0.0,0,4,0,2,8,15,0,12,0,6,35,1
7060,94053,x5ZyS8ChPKTwgxrKWhGeApVsRxKYNf86,bWdj2GDclj5ofokWjzoa5jAwMkxCykd6,1,0,0,0,0,0,1,0,1,0.14285714285714285,1,0.0,0,0,0,0,0,0,0,1,0,0,1,1
7061,94054,nNPe0gYBpuLKMy034NoRKs4SMhD1YQxV,G8EPVSXsOYB5YQWZGiz1aVq5Pgr2GrQu,12,7,6,0,5,0,2,0,20,2.857142857142857,1,0.0,0,6,0,5,7,0,0,2,0,11,9,1
7062,94055,OK36i7c8u9GmSfG9DXL0YN94pRFkcmzE,SpATywNh6bZuzm8s1ceuBUnMUAeoAHHw,16,19,10,12,3,1,6,0,51,7.285714285714286,2,0.0,4,10,11,3,15,1,1,6,0,28,23,1
7063,94073,60AYcG1Aqq07FBEqNwevaiEWsxsSm68V,SpATywNh6bZuzm8s1ceuBUnMUAeoAHHw,46,58,27,29,12,46,21,2,195,27.857142857142858,4,0.0,15,27,26,12,43,46,3,21,2,80,115,1
7064,94075,8msGv7I17o9HQpLUg1Ukk6N7MNl4HPMn,A3fsA9Zfv1X2fVEQhTw51lKENdNrEqT3,5,3,0,0,0,0,5,0,8,1.1428571428571428,1,0.0,1,0,0,0,2,0,0,5,0,1,7,1
7065,94105,Crjc5H6MpWbzy0UxdiisUjbxslQAKkU9,SpATywNh6bZuzm8s1ceuBUnMUAeoAHHw,16,24,9,10,4,2,8,1,58,8.285714285714286,2,0.0,9,9,9,4,15,2,1,8,1,31,27,0
7066,94112,DHDCrD1ELgYhngP3vqwv1nXGZcmsEo8S,G8EPVSXsOYB5YQWZGiz1aVq5Pgr2GrQu,1,0,0,0,0,0,1,0,1,0.14285714285714285,1,0.0,0,0,0,0,0,0,0,1,0,0,1,1
7067,94115,uCjPUqEQP5ztmFjHYApjKLEWGDYVXats,bWdj2GDclj5ofokWjzoa5jAwMkxCykd6,4,2,1,0,0,0,3,0,6,0.8571428571428571,1,0.0,0,1,0,0,2,0,0,3,0,1,5,1
7068,94117,dW2So4dhz8sFwZQzndBoTpsFa69MFo0q,SpATywNh6bZuzm8s1ceuBUnMUAeoAHHw,15,16,9,12,2,1,5,1,46,6.571428571428571,1,0.0,5,9,11,2,11,1,1,5,1,27,19,1
7069,94123,u3SPm1HFwlhJpJKaAvQIjwvJr5QcuOph,SpATywNh6bZuzm8s1ceuBUnMUAeoAHHw,5,2,1,0,1,0,2,0,6,0.8571428571428571,1,0.0,0,1,0,1,2,0,0,2,0,2,4,1
7070,94137,DHDCrD1ELgYhngP3vqwv1nXGZcmsEo8S,SpATywNh6bZuzm8s1ceuBUnMUAeoAHHw,1,0,0,0,0,0,2,0,2,0.2857142857142857,1,0.0,0,0,0,0,0,0,0,2,0,0,2,1
7071,94144,uJQbjSAUKl9mATLkoLUgrR5h8oVXq5wA,bWdj2GDclj5ofokWjzoa5jAwMkxCykd6,7,2,1,0,1,0,5,2,11,1.5714285714285714,1,0.0,0,1,0,1,2,0,0,5,2,2,9,1
7072,94146,kvf1WFygeLGKOFkoertca6J9TDxV9fcY,bWdj2GDclj5ofokWjzoa5jAwMkxCykd6,8,9,6,10,6,0,1,0,32,4.571428571428571,2,0.0,1,6,8,6,8,0,2,1,0,21,11,1
7073,94147,kvf1WFygeLGKOFkoertca6J9TDxV9fcY,A3fsA9Zfv1X2fVEQhTw51lKENdNrEqT3,10,7,6,0,6,0,1,0,20,2.857142857142857,2,0.0,0,6,0,6,7,0,0,1,0,12,8,1
7074,94165,SoWAM0SsQFATkJWX6mveBwbG0XzudUfF,RXDvfPUBYFlVdlueBFbLW0mhhAyGEqpt,6,3,2,0,1,0,3,0,9,1.2857142857142858,1,0.0,0,2,0,1,3,0,0,3,0,3,6,1
7075,94182,iFoaVRNiF8fcNT1I1ii4FKoAviHvnVwj,SpATywNh6bZuzm8s1ceuBUnMUAeoAHHw,1,0,0,0,0,0,1,0,1,0.14285714285714285,1,0.0,0,0,0,0,0,0,0,1,0,0,1,1
7076,94188,OFXXpJjmXQdJCa3neipnRUGCkhEYKOcL,SpATywNh6bZuzm8s1ceuBUnMUAeoAHHw,7,6,1,0,0,0,3,0,10,1.4285714285714286,1,0.0,0,1,0,0,6,0,0,3,0,1,9,0
7077,94196,BZpQDGkWvmHTN4poCEi9fdZmAWn1G3Rj,RXDvfPUBYFlVdlueBFbLW0mhhAyGEqpt,11,8,7,0,7,0,5,0,27,3.857142857142857,1,0.0,0,7,0,7,8,0,0,5,0,14,13,1
7078,94201,68BjCXfBFqeZ01fFx1csrFmvef5xs0w2,A3fsA9Zfv1X2fVEQhTw51lKENdNrEqT3,5,2,1,0,1,0,3,0,7,1.0,1,0.0,0,1,0,1,2,0,0,3,0,2,5,1
7079,94216,4cB4y17zVi4jfdrlreMIHGN1aQJHMMST,A3fsA9Zfv1X2fVEQhTw51lKENdNrEqT3,4,2,0,0,0,0,2,0,4,0.5714285714285714,1,0.0,0,0,0,0,2,0,0,2,0,0,4,1
7080,94230,dW2So4dhz8sFwZQzndBoTpsFa69MFo0q,A3fsA9Zfv1X2fVEQhTw51lKENdNrEqT3,1,0,0,0,0,0,1,0,1,0.14285714285714285,1,0.0,0,0,0,0,0,0,0,1,0,0,1,1
7081,94238,Zy1VvDhL0b8E5oL4KNZb2wbF72hVCk4q,bWdj2GDclj5ofokWjzoa5jAwMkxCykd6,1,0,0,0,0,0,1,0,1,0.14285714285714285,1,0.0,0,0,0,0,0,0,0,1,0,0,1,1
7082,94250,hhHp518gAY3TOdaw37KX2gsPHN1LkpFC,G8EPVSXsOYB5YQWZGiz1aVq5Pgr2GrQu,7,6,1,0,2,0,2,0,11,1.5714285714285714,1,0.0,2,1,0,2,4,0,0,2,0,5,6,1
7083,94252,jKLLTSaN1oSiVcsyuWIwr9NVnuZSs3oX,A3fsA9Zfv1X2fVEQhTw51lKENdNrEqT3,5,4,2,0,1,0,3,0,10,1.4285714285714286,1,0.0,0,2,0,1,4,0,0,3,0,3,7,1
7084,94254,r9IhUgJi3OB3rtBncFGHCU1M0fOjKF1s,SpATywNh6bZuzm8s1ceuBUnMUAeoAHHw,14,20,8,17,4,0,2,0,51,7.285714285714286,2,0.0,10,8,15,4,10,0,2,2,0,37,14,1
7085,94263,9BiLYY350hgtHO5tL7nbMfcZU0JcfZbs,A3fsA9Zfv1X2fVEQhTw51lKENdNrEqT3,7,7,2,0,1,0,6,0,16,2.2857142857142856,2,0.0,2,2,0,1,5,0,0,6,0,5,11,1
7086,94275,gxKNGjI9pNbjjsMSjrRysbX0ykCNYwqn,bWdj2GDclj5ofokWjzoa5jAwMkxCykd6,4,3,1,0,1,0,1,0,6,0.8571428571428571,1,0.0,0,1,0,1,3,0,0,1,0,2,4,1
7087,94283,PSQvTxj1y3we6BHzfg47qDUvmFQLocrD,A3fsA9Zfv1X2fVEQhTw51lKENdNrEqT3,1,0,0,0,0,0,1,0,1,0.14285714285714285,1,0.0,0,0,0,0,0,0,0,1,0,0,1,1
7088,94300,5Lcwdb3Myw57AK6P9mHbDDRptSFCTb8f,A3fsA9Zfv1X2fVEQhTw51lKENdNrEqT3,11,5,4,0,4,0,5,0,18,2.5714285714285716,1,0.0,0,4,0,4,5,0,0,5,0,8,10,1
7089,94311,Gl03eSeNtb7juYcfyy4T6xQkEEhQalIx,SpATywNh6bZuzm8s1ceuBUnMUAeoAHHw,12,12,4,14,3,0,1,0,34,4.857142857142857,4,0.0,2,4,10,3,10,0,4,1,0,19,15,1
7090,94322,7CHeHg2oDOu9Zq2LKINtBF6E413tCv88,SpATywNh6bZuzm8s1ceuBUnMUAeoAHHw,9,8,3,0,3,0,6,0,20,2.857142857142857,2,0.0,0,3,0,3,8,0,0,6,0,6,14,1
7091,94328,plAreEiDkQpc8zc9xmMhqujDBy2S6jmC,SpATywNh6bZuzm8s1ceuBUnMUAeoAHHw,13,59,12,9,2,0,20,0,102,14.571428571428571,3,0.0,0,12,7,2,59,0,2,20,0,21,81,1
7092,94331,MreMBBpkQsLa4FQRsMj3EyXahyuFtEaB,SpATywNh6bZuzm8s1ceuBUnMUAeoAHHw,1,0,0,0,0,0,1,0,1,0.14285714285714285,1,0.0,0,0,0,0,0,0,0,1,0,0,1,1
7093,94358,9aS1NSJb2Hj0xHbbuoyhLmktYrjypxsy,G8EPVSXsOYB5YQWZGiz1aVq5Pgr2GrQu,38,31,12,96,7,0,8,1,155,22.142857142857142,2,0.0,18,12,70,7,13,0,26,8,1,107,48,1
7094,94376,uJRuDDw60tHrnuGJQZHSpoPAWASu6Wpf,SpATywNh6bZuzm8s1ceuBUnMUAeoAHHw,1,0,0,0,0,0,1,0,1,0.14285714285714285,1,0.0,0,0,0,0,0,0,0,1,0,0,1,0
7095,94382,au8A4X0QHQjQtIJwXFEgDKJdutxB5gYJ,SpATywNh6bZuzm8s1ceuBUnMUAeoAHHw,1,0,0,0,0,0,1,0,1,0.14285714285714285,1,0.0,0,0,0,0,0,0,0,1,0,0,1,1
7096,94383,OEUelCFKE8Wek74t5oKIe6H8MCi9M5Fi,RXDvfPUBYFlVdlueBFbLW0mhhAyGEqpt,1,0,0,0,0,0,1,0,1,0.14285714285714285,1,0.0,0,0,0,0,0,0,0,1,0,0,1,1
7097,94407,vCP75aDcEh5tNmLpxZodjHI02YfPV1g7,SpATywNh6bZuzm8s1ceuBUnMUAeoAHHw,2,0,0,0,0,0,8,0,8,1.1428571428571428,3,0.0,0,0,0,0,0,0,0,8,0,0,8,1
7098,94408,kdTkyJM1xm4AQ2tXVSlZpNtOhQ8qhZ4V,SpATywNh6bZuzm8s1ceuBUnMUAeoAHHw,39,55,30,30,17,0,9,0,141,20.142857142857142,6,0.0,12,30,25,17,43,0,5,9,0,84,57,0
7099,94410,nTOZ6H8wygvPupRg4OwxXR9Zcu1XdDxE,RXDvfPUBYFlVdlueBFbLW0mhhAyGEqpt,1,0,0,0,0,0,1,0,1,0.14285714285714285,1,0.0,0,0,0,0,0,0,0,1,0,0,1,1
7100,94435,ZYJOgN8hxER8FBZMxsFqu3ZMgr4hrlRX,A3fsA9Zfv1X2fVEQhTw51lKENdNrEqT3,8,8,1,0,1,0,6,0,16,2.2857142857142856,1,0.0,0,1,0,1,8,0,0,6,0,2,14,1
7101,94443,FZWt1vapJFvo3kXFvlr3Pcq5dqSsXIdl,SpATywNh6bZuzm8s1ceuBUnMUAeoAHHw,29,41,24,31,11,8,11,5,131,18.714285714285715,4,0.0,9,24,28,11,32,8,3,11,5,72,59,1
7102,94449,YxWG3o8ByCvMoGHw8Fk45RhqzVf3tFyr,A3fsA9Zfv1X2fVEQhTw51lKENdNrEqT3,6,1,1,0,1,0,3,0,6,0.8571428571428571,1,0.0,0,1,0,1,1,0,0,3,0,2,4,1
7103,94454,HH9Roah3kzSupaHq1oHsqsjNMJy1K6WP,SpATywNh6bZuzm8s1ceuBUnMUAeoAHHw,6,8,1,0,1,0,2,0,12,1.7142857142857142,1,0.0,0,1,0,1,8,0,0,2,0,2,10,1
7104,94456,Yanv54bl6PB6cYN02rxbrTLlDFz7wAgw,A3fsA9Zfv1X2fVEQhTw51lKENdNrEqT3,2,0,0,0,0,0,2,0,2,0.2857142857142857,1,0.0,0,0,0,0,0,0,0,2,0,0,2,1
7105,94463,1dYxxqjVQ41eWA49zU6M54bp0RizbhKR,SpATywNh6bZuzm8s1ceuBUnMUAeoAHHw,6,5,3,0,1,0,3,0,12,1.7142857142857142,1,0.0,0,3,0,1,5,0,0,3,0,4,8,1
7106,94464,VvCLt24WQ5JOcwPfT9E7uWcGIgf1BHix,SpATywNh6bZuzm8s1ceuBUnMUAeoAHHw,14,15,10,14,5,2,3,0,49,7.0,1,0.0,3,10,11,5,12,2,3,3,0,29,20,1
7107,94486,gl2YVlebVAvCcxsYaIoTwLj5l1IGqntH,SpATywNh6bZuzm8s1ceuBUnMUAeoAHHw,24,46,24,27,0,0,7,0,104,14.857142857142858,5,0.0,14,24,26,0,32,0,1,7,0,64,40,0
7108,94496,We4HBkPE9Li2HHwmAADy328h9IORRs2l,G8EPVSXsOYB5YQWZGiz1aVq5Pgr2GrQu,1,0,0,0,0,0,1,0,1,0.14285714285714285,1,0.0,0,0,0,0,0,0,0,1,0,0,1,1
7109,94551,G424CP05HwI8jLfxKeXUJBAhe03V6D2B,3VkHkmOtom3jM2wCu94xgzzu1d6Dn7or,24,47,14,10,17,43,15,1,147,21.0,4,0.0,25,14,9,17,22,43,1,15,1,65,82,1
7110,94574,A41hdT15T7mumzDW53QCDXRUsOilvTI0,3VkHkmOtom3jM2wCu94xgzzu1d6Dn7or,8,9,6,0,3,2,7,0,27,3.857142857142857,2,0.0,0,6,0,3,9,2,0,7,0,9,18,1
7111,94626,BTv7PWmhDfp3JmOONhTjhUiL7MjjMTTR,3VkHkmOtom3jM2wCu94xgzzu1d6Dn7or,1,0,0,0,0,0,1,0,1,0.14285714285714285,1,0.0,0,0,0,0,0,0,0,1,0,0,1,1
7112,94627,7fFZLbLMI7Ucj1mdrBxpY9hCEcczhOLF,3VkHkmOtom3jM2wCu94xgzzu1d6Dn7or,9,14,5,0,5,0,3,0,27,3.857142857142857,1,0.0,4,5,0,5,10,0,0,3,0,14,13,0
7113,94640,umB57zvkjlup9uMOCbyoPHxCz5TDBKHU,3VkHkmOtom3jM2wCu94xgzzu1d6Dn7or,6,4,2,0,1,0,4,0,11,1.5714285714285714,1,0.0,0,2,0,1,4,0,0,4,0,3,8,1
7114,94651,sv2NeuLE6EuaEeLqlDnQ62bMEYW4pvkK,3VkHkmOtom3jM2wCu94xgzzu1d6Dn7or,1,0,0,0,0,0,1,0,1,0.14285714285714285,1,0.0,0,0,0,0,0,0,0,1,0,0,1,1
7115,94688,ahmR8OdgsTm8Ih7Td8OamAHkU2FrzbwI,3VkHkmOtom3jM2wCu94xgzzu1d6Dn7or,7,5,1,1,2,0,3,0,12,1.7142857142857142,1,0.0,3,1,1,2,2,0,0,3,0,7,5,1
7116,94701,Mj5FdiZEH35rYomX6fNs6Oa9daue9DlK,3VkHkmOtom3jM2wCu94xgzzu1d6Dn7or,2,0,0,0,0,0,2,0,2,0.2857142857142857,1,0.0,0,0,0,0,0,0,0,2,0,0,2,1
7117,94707,Xy5IHkH9GSUKsyMgAP7rZCdXgMgkb9b0,3VkHkmOtom3jM2wCu94xgzzu1d6Dn7or,1,0,0,0,0,0,1,0,1,0.14285714285714285,1,0.0,0,0,0,0,0,0,0,1,0,0,1,1
7118,94749,XZEP2kTALjdUPEf4KYPbZV36rJ4HppdG,3VkHkmOtom3jM2wCu94xgzzu1d6Dn7or,8,5,2,0,2,2,7,1,19,2.7142857142857144,1,0.0,0,2,0,2,5,2,0,7,1,4,15,1
7119,94750,NK5owDN3QRUt6YxvDCACv2xFFTAKIpGm,3VkHkmOtom3jM2wCu94xgzzu1d6Dn7or,1,0,0,0,0,0,1,0,1,0.14285714285714285,1,0.0,0,0,0,0,0,0,0,1,0,0,1,1
7120,94751,AiDVWQDPcNj5mF9HYJkbcDakLs2tu9iF,3VkHkmOtom3jM2wCu94xgzzu1d6Dn7or,1,0,0,0,0,0,2,0,2,0.2857142857142857,1,0.0,0,0,0,0,0,0,0,2,0,0,2,1
7121,94783,6a6P2Rm5bfBMnFhUjMkzJ4XXR5CJYmx6,3VkHkmOtom3jM2wCu94xgzzu1d6Dn7or,2,0,0,0,0,0,2,0,2,0.2857142857142857,1,0.0,0,0,0,0,0,0,0,2,0,0,2,1
7122,94789,ByGtgrhwjqag1hRRpomltO3m2pMuKwns,3VkHkmOtom3jM2wCu94xgzzu1d6Dn7or,1,0,0,0,0,0,2,0,2,0.2857142857142857,1,0.0,0,0,0,0,0,0,0,2,0,0,2,1
7123,94814,ynUoPu6CisCKYPNn8uCqIJp2I8pANQG7,3VkHkmOtom3jM2wCu94xgzzu1d6Dn7or,1,0,0,0,0,0,1,0,1,0.14285714285714285,1,0.0,0,0,0,0,0,0,0,1,0,0,1,1
7124,94821,yKJzKtteWnpiFP2nGuf1wimq3ANhZIS3,3VkHkmOtom3jM2wCu94xgzzu1d6Dn7or,1,0,0,0,0,0,1,0,1,0.14285714285714285,1,0.0,0,0,0,0,0,0,0,1,0,0,1,1
7125,94832,oNQaCuO2rlrLriXUbP7yibkLZ8kZEP0A,3VkHkmOtom3jM2wCu94xgzzu1d6Dn7or,15,31,12,5,10,5,5,0,68,9.714285714285714,3,0.0,9,12,5,10,22,5,0,5,0,36,32,1
7126,94855,JiNN6rHoPfwH1fuAk6q9tmTGqAFVjob4,3VkHkmOtom3jM2wCu94xgzzu1d6Dn7or,9,16,6,6,0,4,4,0,36,5.142857142857143,3,0.0,2,6,5,0,14,4,1,4,0,13,23,1
7127,94871,e1rHEAAgGrGghOyUOhnEIg0DWKbNO0d0,3VkHkmOtom3jM2wCu94xgzzu1d6Dn7or,12,29,4,6,3,8,6,1,57,8.142857142857142,1,0.0,8,4,5,3,21,8,1,6,1,20,37,1
7128,94883,G14xjTwMWbfsqTNiU3Ie1utHyPegqSvR,fbPkOYLVPtPgIt0MxizjfFJov3JbHyAi,1,0,0,0,0,0,1,0,1,0.14285714285714285,1,0.0,0,0,0,0,0,0,0,1,0,0,1,1
7129,94884,4dQbvsCaWQeeEpeCSiFVC9vhr2vn0RzD,fbPkOYLVPtPgIt0MxizjfFJov3JbHyAi,1,0,0,0,0,0,1,0,1,0.14285714285714285,1,0.0,0,0,0,0,0,0,0,1,0,0,1,1
7130,94885,1YxknoiTrSwQgclDlSAh4oMYHRyARhLv,fbPkOYLVPtPgIt0MxizjfFJov3JbHyAi,1,0,0,0,0,0,1,0,1,0.14285714285714285,1,0.0,0,0,0,0,0,0,0,1,0,0,1,1
7131,94887,NR0o4tRLL7So8UOrYr7iGrs6QElxoJxc,fbPkOYLVPtPgIt0MxizjfFJov3JbHyAi,5,2,1,0,1,0,3,0,7,1.0,1,0.0,0,1,0,1,2,0,0,3,0,2,5,1
7132,94888,bKxdZbIkgORsJN5JxYEpk6KGebUY8txM,fbPkOYLVPtPgIt0MxizjfFJov3JbHyAi,1,0,0,0,0,0,2,0,2,0.2857142857142857,1,0.0,0,0,0,0,0,0,0,2,0,0,2,1
7133,94891,9o9UHix1oGrunPK94561fjm7xlCyDzFC,fbPkOYLVPtPgIt0MxizjfFJov3JbHyAi,5,2,1,0,1,0,3,0,7,1.0,1,0.0,0,1,0,1,2,0,0,3,0,2,5,1
7134,94894,4n8D50YV3iUiSO6m3uW0Qx1bYmY1TKAP,fbPkOYLVPtPgIt0MxizjfFJov3JbHyAi,2,0,0,0,0,0,2,0,2,0.2857142857142857,1,0.0,0,0,0,0,0,0,0,2,0,0,2,1
7135,94895,8bCYaG7AP6aJY8s59sJr7EKW3GfZIzLQ,fbPkOYLVPtPgIt0MxizjfFJov3JbHyAi,1,0,0,0,0,0,1,0,1,0.14285714285714285,1,0.0,0,0,0,0,0,0,0,1,0,0,1,1
7136,94896,ykaUPJW4Nc9r2mv4b25QxgdHgIcQ63RQ,fbPkOYLVPtPgIt0MxizjfFJov3JbHyAi,5,4,0,0,0,0,2,0,6,0.8571428571428571,2,0.0,0,0,0,0,4,0,0,2,0,0,6,1
7137,94898,BxwiRwBCEgoMKzWOQQLk1jKrscukKpaC,fbPkOYLVPtPgIt0MxizjfFJov3JbHyAi,1,0,0,0,0,0,1,0,1,0.14285714285714285,1,0.0,0,0,0,0,0,0,0,1,0,0,1,1
7138,94905,HZUsNd9h6RIz72e7pYwO9LrQc6XgUw0C,fbPkOYLVPtPgIt0MxizjfFJov3JbHyAi,3,2,0,0,0,0,1,0,3,0.42857142857142855,1,0.0,0,0,0,0,2,0,0,1,0,0,3,1
7139,94911,B2XgVkwdGRNNRFw8S2rr86bubvgqLhLz,fbPkOYLVPtPgIt0MxizjfFJov3JbHyAi,2,0,0,0,0,0,5,0,5,0.7142857142857143,1,0.0,0,0,0,0,0,0,0,5,0,0,5,1
7140,94914,JdoyFe3ty0dkGc2UNdH7TaneDWe8Wbb5,fbPkOYLVPtPgIt0MxizjfFJov3JbHyAi,4,2,1,0,1,0,2,0,6,0.8571428571428571,2,0.0,0,1,0,1,2,0,0,2,0,2,4,1
7141,94917,GGhAGkRWD8jJVxrhUk5siJ00MzWLACx9,fbPkOYLVPtPgIt0MxizjfFJov3JbHyAi,2,0,0,0,0,0,3,0,3,0.42857142857142855,1,0.0,0,0,0,0,0,0,0,3,0,0,3,1
7142,94918,kWBY2KD53mjK2UMWhmo4HB3TIG4iJtfA,fbPkOYLVPtPgIt0MxizjfFJov3JbHyAi,11,7,4,6,4,0,3,0,24,3.4285714285714284,1,0.0,2,4,5,4,5,0,1,3,0,15,9,1
7143,94919,nLVkMUicIATb5XjlrKkVLbPcf3PrrUv6,fbPkOYLVPtPgIt0MxizjfFJov3JbHyAi,6,3,2,0,1,0,2,0,8,1.1428571428571428,1,0.0,0,2,0,1,3,0,0,2,0,3,5,1
7144,94920,AP8Ylu2Hp0YwQapv0VHVFwlhcyAdQlKm,fbPkOYLVPtPgIt0MxizjfFJov3JbHyAi,5,2,1,0,1,2,2,0,8,1.1428571428571428,1,0.0,0,1,0,1,2,2,0,2,0,2,6,1
7145,94921,1befQ3fLzEOh8IrvCOjGmYb6nrbCw6Ba,fbPkOYLVPtPgIt0MxizjfFJov3JbHyAi,3,0,0,0,0,0,5,0,5,0.7142857142857143,1,0.0,0,0,0,0,0,0,0,5,0,0,5,1
7146,94922,21C2qWSN1ubnQXVLo4VQ89cKYqN6OnV0,fbPkOYLVPtPgIt0MxizjfFJov3JbHyAi,5,2,1,0,1,0,3,0,7,1.0,1,0.0,0,1,0,1,2,0,0,3,0,2,5,1
7147,94923,ZSOqN2ncEDCf8kkfE2fTiwunpGip3a3v,fbPkOYLVPtPgIt0MxizjfFJov3JbHyAi,6,3,2,0,2,0,2,0,9,1.2857142857142858,1,0.0,0,2,0,2,3,0,0,2,0,4,5,1
7148,94924,iPQOLnMFMpAtiKO2f4vUT5fNNyluHmyN,fbPkOYLVPtPgIt0MxizjfFJov3JbHyAi,1,0,0,0,0,0,1,0,1,0.14285714285714285,1,0.0,0,0,0,0,0,0,0,1,0,0,1,1
7149,94928,rrKLV6p6Omqho3GHHSoh0noB8Eyb4dBf,fbPkOYLVPtPgIt0MxizjfFJov3JbHyAi,8,3,2,0,2,3,6,1,17,2.4285714285714284,1,0.0,0,2,0,2,3,3,0,6,1,4,13,1
7150,94929,rrZSZFoEgH3bOKdkZ0UyNzOq7Pdyx5G0,fbPkOYLVPtPgIt0MxizjfFJov3JbHyAi,2,0,0,0,0,0,2,0,2,0.2857142857142857,1,0.0,0,0,0,0,0,0,0,2,0,0,2,1
7151,94930,m81QFtDkjk8PmvblUhrkX50T3OfNUlpC,fbPkOYLVPtPgIt0MxizjfFJov3JbHyAi,1,0,0,0,0,0,1,0,1,0.14285714285714285,1,0.0,0,0,0,0,0,0,0,1,0,0,1,1
7152,94931,YLWMEkP67YDwtagmvU5WKcZzKqdf99Vy,fbPkOYLVPtPgIt0MxizjfFJov3JbHyAi,7,5,2,0,1,0,4,0,12,1.7142857142857142,1,0.0,0,2,0,1,5,0,0,4,0,3,9,1
7153,94934,53AX9rmI3k6LH6bFgA3smsUSiak9PiH8,fbPkOYLVPtPgIt0MxizjfFJov3JbHyAi,9,15,5,5,2,1,3,0,31,4.428571428571429,1,0.0,3,5,5,2,12,1,0,3,0,15,16,1
7154,94938,ATZ830ERUxX8pXsrEHiyTC9qIj0J3xKL,fbPkOYLVPtPgIt0MxizjfFJov3JbHyAi,1,0,0,0,0,0,1,0,1,0.14285714285714285,1,0.0,0,0,0,0,0,0,0,1,0,0,1,1
7155,94941,PksTe80EnSZRP5IgVxGPpb2S7NuUyS61,fbPkOYLVPtPgIt0MxizjfFJov3JbHyAi,8,8,6,0,5,0,5,0,24,3.4285714285714284,1,0.0,0,6,0,5,8,0,0,5,0,11,13,1
7156,94943,2slXWNniikORlDrKt6rdY1XwdvOyFwgH,fbPkOYLVPtPgIt0MxizjfFJov3JbHyAi,6,3,2,0,2,0,1,0,8,1.1428571428571428,1,0.0,0,2,0,2,3,0,0,1,0,4,4,1
7157,94946,7uAP6PCGaUrEF1zOYcYy8DKDCb9pFsmY,fbPkOYLVPtPgIt0MxizjfFJov3JbHyAi,26,82,17,36,23,31,17,3,209,29.857142857142858,3,0.0,34,17,30,23,48,31,6,17,3,104,105,1
7158,94950,uf9uxJ0q9fqnk8v2mIZk18f6DfpdKvW8,fbPkOYLVPtPgIt0MxizjfFJov3JbHyAi,8,5,3,0,2,0,3,0,13,1.8571428571428572,1,0.0,0,3,0,2,5,0,0,3,0,5,8,1
7159,95235,NDVe8xbt1XP1cAtDQ6t1Ohv3MmGzysIT,5Gyp41oLVo7Gg7vF4vpmggWP5MU70QO6,6,4,2,0,1,0,2,0,9,1.2857142857142858,1,0.0,1,2,0,1,3,0,0,2,0,4,5,1
7160,95237,SSpeewBDHUNKkvUJM5ASinNHvMXIOEwr,5Gyp41oLVo7Gg7vF4vpmggWP5MU70QO6,2,0,0,0,0,1,1,0,2,0.2857142857142857,1,0.0,0,0,0,0,0,1,0,1,0,0,2,1
7161,95254,YIoKCUIP4Rx4Vrk0MaySMDs3xqxsTZ0O,5Gyp41oLVo7Gg7vF4vpmggWP5MU70QO6,9,14,6,0,3,1,8,2,34,4.857142857142857,5,0.0,4,6,0,3,10,1,0,8,2,13,21,1
7162,95256,N9CQxvUgrnP9XQfIy0jBWdzeDSO6XRnQ,5Gyp41oLVo7Gg7vF4vpmggWP5MU70QO6,1,0,0,0,0,0,1,0,1,0.14285714285714285,1,0.0,0,0,0,0,0,0,0,1,0,0,1,1
7163,95278,gNPcbdnUndGrtQG9Vob7XSu4f95PgGqS,5Gyp41oLVo7Gg7vF4vpmggWP5MU70QO6,1,0,0,0,0,0,1,0,1,0.14285714285714285,1,0.0,0,0,0,0,0,0,0,1,0,0,1,1
7164,95294,eLddk0FueVUEJUwpfOsyoO4vLUtPFHIZ,5Gyp41oLVo7Gg7vF4vpmggWP5MU70QO6,1,0,0,0,0,0,1,0,1,0.14285714285714285,1,0.0,0,0,0,0,0,0,0,1,0,0,1,1
7165,95305,NzceHZYafdRYNlSM9Nht2IC1aPdIvfsS,G8EPVSXsOYB5YQWZGiz1aVq5Pgr2GrQu,7,6,4,2,0,0,1,0,13,1.8571428571428572,1,0.0,1,4,1,0,5,0,1,1,0,6,7,1
7166,95313,qosnWICleDjB0mAqFG1weKjFjwPkMIbX,SpATywNh6bZuzm8s1ceuBUnMUAeoAHHw,12,9,7,0,4,0,4,0,24,3.4285714285714284,1,0.0,0,7,0,4,9,0,0,4,0,11,13,1
7167,95361,Djs1zlGGz9CjaytXVMiGNIbCd4ODEdqG,A3fsA9Zfv1X2fVEQhTw51lKENdNrEqT3,3,0,0,0,0,0,3,0,3,0.42857142857142855,1,0.0,0,0,0,0,0,0,0,3,0,0,3,1
7168,95383,ZHBg1MltX3XrB2nTtco0amjezusVv1FZ,bWdj2GDclj5ofokWjzoa5jAwMkxCykd6,4,3,1,0,1,0,1,0,6,0.8571428571428571,1,0.0,0,1,0,1,3,0,0,1,0,2,4,1
7169,95384,9vMfKHFzhvmzdCBc05dqw5icnEdTUd5x,bWdj2GDclj5ofokWjzoa5jAwMkxCykd6,38,95,43,89,13,4,27,0,271,38.714285714285715,5,0.0,16,43,80,13,79,4,9,27,0,152,119,1
7170,95386,lVwgv61cg8fkhW9rg5b1PIPnuUWxb0Vk,A3fsA9Zfv1X2fVEQhTw51lKENdNrEqT3,93,91,69,108,38,310,70,11,697,99.57142857142857,19,0.0,4,69,90,38,87,310,18,70,11,201,496,0
7171,95388,WVU6lNV4yCEYBx8BfYMKeJgO2PfYQmk7,bWdj2GDclj5ofokWjzoa5jAwMkxCykd6,25,13,0,40,0,0,6,1,60,8.571428571428571,1,0.0,7,0,37,0,6,0,3,6,1,44,16,1
7172,95397,aFMNRUeRxFSXjv2yTdRuJu4lTCyXCFDD,bWdj2GDclj5ofokWjzoa5jAwMkxCykd6,4,2,1,0,1,1,3,0,8,1.1428571428571428,1,0.0,0,1,0,1,2,1,0,3,0,2,6,1
7173,95398,SM6SmE3aMr36NQr3MbQQW1aFlehpkSNf,bWdj2GDclj5ofokWjzoa5jAwMkxCykd6,2,0,0,0,0,0,4,0,4,0.5714285714285714,2,0.0,0,0,0,0,0,0,0,4,0,0,4,1
7174,95399,Id4UmIRRQiLXHoJYSjh5OCO1CRaFgQ2K,A3fsA9Zfv1X2fVEQhTw51lKENdNrEqT3,41,43,20,76,17,2,4,0,162,23.142857142857142,1,0.0,1,20,59,17,42,2,17,4,0,97,65,1
7175,95408,OdsEBh425XZxll0hTUv04OAotDf6aGtE,RXDvfPUBYFlVdlueBFbLW0mhhAyGEqpt,7,13,7,0,3,0,1,0,24,3.4285714285714284,1,0.0,0,7,0,3,13,0,0,1,0,10,14,1
7176,95425,79rw5BhFSnhvdIaVsXl3jeEXJRviIjGz,A3fsA9Zfv1X2fVEQhTw51lKENdNrEqT3,101,51,34,232,17,4,20,1,359,51.285714285714285,4,0.0,10,34,202,17,41,4,30,20,1,263,96,0
7177,95427,GdhgDlZa5ZJ9AzwBGC942HC991fsxvHr,G8EPVSXsOYB5YQWZGiz1aVq5Pgr2GrQu,18,19,2,16,2,0,9,6,54,7.714285714285714,1,0.0,0,2,13,2,19,0,3,9,6,17,37,1
7178,95440,NT7bBO2hHEg05ci9UTFOwIHaUZMIdh9x,SpATywNh6bZuzm8s1ceuBUnMUAeoAHHw,21,26,10,32,3,2,6,2,81,11.571428571428571,3,0.0,10,10,27,3,16,2,5,6,2,50,31,1
7179,95461,M507IlBQp64NkSWnSkchjsahApLaE1kJ,A3fsA9Zfv1X2fVEQhTw51lKENdNrEqT3,50,48,35,80,21,7,19,1,211,30.142857142857142,3,0.0,3,35,61,21,45,7,19,19,1,120,91,1
7180,95472,Dsiw0jpMBHHLbjdF7l3UeGKLOlfgXUpd,SpATywNh6bZuzm8s1ceuBUnMUAeoAHHw,29,25,15,31,7,1,5,0,84,12.0,1,0.0,5,15,28,7,20,1,3,5,0,55,29,1
7181,95490,pJLSeQHIu4aZZbYoyPq22AsdfE0vwv53,bWdj2GDclj5ofokWjzoa5jAwMkxCykd6,2,0,0,0,0,0,2,0,2,0.2857142857142857,1,0.0,0,0,0,0,0,0,0,2,0,0,2,0
7182,95493,N0D8gfv74t8uM2LFiOg2xy8nVL0vO7Kx,SpATywNh6bZuzm8s1ceuBUnMUAeoAHHw,7,3,2,0,2,0,2,0,9,1.2857142857142858,1,0.0,0,2,0,2,3,0,0,2,0,4,5,1
7183,95507,YLfjSoU2JNGG7f9SEbr83b8mp8z1n7i3,A3fsA9Zfv1X2fVEQhTw51lKENdNrEqT3,1,0,0,0,0,0,1,0,1,0.14285714285714285,1,0.0,0,0,0,0,0,0,0,1,0,0,1,1
7184,95517,WzkRGtR4EenxksGL0ftvaO4vHssxZDFt,A3fsA9Zfv1X2fVEQhTw51lKENdNrEqT3,3,0,0,0,0,0,3,0,3,0.42857142857142855,1,0.0,0,0,0,0,0,0,0,3,0,0,3,1
7185,95521,OF90Hu2g8vPUjKHCP4ULPYNMvRFKxBj6,SpATywNh6bZuzm8s1ceuBUnMUAeoAHHw,32,51,26,36,10,11,18,2,154,22.0,5,0.0,15,26,28,10,36,11,8,18,2,79,75,0
7186,95561,BILNjgDM4z6ewRYZ6qt3YLHpB6O5FFua,SpATywNh6bZuzm8s1ceuBUnMUAeoAHHw,7,4,3,0,3,0,2,0,12,1.7142857142857142,1,0.0,0,3,0,3,4,0,0,2,0,6,6,1
7187,95583,YaP2AuckukEZITP3IVvIt6Z8ci6RHew7,bWdj2GDclj5ofokWjzoa5jAwMkxCykd6,12,8,5,0,3,0,4,0,20,2.857142857142857,2,0.0,0,5,0,3,8,0,0,4,0,8,12,1
7188,95588,DxGyu8XXv7e8wbVx0mvEABKcoqoolLlv,bWdj2GDclj5ofokWjzoa5jAwMkxCykd6,4,0,0,0,0,0,11,0,11,1.5714285714285714,1,0.0,0,0,0,0,0,0,0,11,0,0,11,1
7189,95590,XfiCSk5eLAbq9rzQtnLkX2OQTd6M8xFG,A3fsA9Zfv1X2fVEQhTw51lKENdNrEqT3,1,0,0,0,0,0,1,0,1,0.14285714285714285,1,0.0,0,0,0,0,0,0,0,1,0,0,1,1
7190,95593,DHUv7XpIZcPp2QYGNmTXjhgg7Zq4BpJ7,A3fsA9Zfv1X2fVEQhTw51lKENdNrEqT3,18,10,8,12,6,0,2,0,38,5.428571428571429,2,0.0,0,8,10,6,10,0,2,2,0,24,14,1
7191,95595,ZBEHpTfGoLiomhe8zt7rkm2uZVd9b9kk,SpATywNh6bZuzm8s1ceuBUnMUAeoAHHw,5,7,0,0,1,0,1,0,9,1.2857142857142858,1,0.0,0,0,0,1,7,0,0,1,0,1,8,1
7192,95605,UaSh8dwx8gnofYbXlmpqj9uYDbpJ89pX,A3fsA9Zfv1X2fVEQhTw51lKENdNrEqT3,15,38,1,0,1,30,22,3,95,13.571428571428571,8,0.0,1,1,0,1,37,30,0,22,3,3,92,1
7193,95617,Daw06K1PSOXldo19kBgHP5sewulb7Vu5,A3fsA9Zfv1X2fVEQhTw51lKENdNrEqT3,4,2,1,0,1,0,3,0,7,1.0,2,0.0,0,1,0,1,2,0,0,3,0,2,5,0
7194,95620,Daw06K1PSOXldo19kBgHP5sewulb7Vu5,G8EPVSXsOYB5YQWZGiz1aVq5Pgr2GrQu,1,0,0,0,0,0,1,0,1,0.14285714285714285,1,0.0,0,0,0,0,0,0,0,1,0,0,1,1
7195,95622,DGrwRqi3z3Y9GhMsPFPJjWU0FULJtTwp,A3fsA9Zfv1X2fVEQhTw51lKENdNrEqT3,5,0,0,0,0,0,5,1,6,0.8571428571428571,2,0.0,0,0,0,0,0,0,0,5,1,0,6,1
7196,95624,YLJN09Je7GNR4wBomW2iH8q4HAK5TPdc,RXDvfPUBYFlVdlueBFbLW0mhhAyGEqpt,29,29,8,20,6,23,5,0,91,13.0,1,0.0,3,8,20,6,26,23,0,5,0,37,54,1
7197,95627,fxfoo3EegutxQePINTymJFzExTdNcKVI,SpATywNh6bZuzm8s1ceuBUnMUAeoAHHw,28,20,9,32,7,1,12,1,82,11.714285714285714,3,0.0,6,9,29,7,14,1,3,12,1,51,31,1
7198,95631,cW2QGOVqGX1ONxdDTXMiDqmocWqOnU5N,A3fsA9Zfv1X2fVEQhTw51lKENdNrEqT3,4,3,1,0,0,0,2,0,6,0.8571428571428571,1,0.0,0,1,0,0,3,0,0,2,0,1,5,1
7199,95633,ZtofBugo33Zo9FroLN9tXtgl9O0zgDWY,SpATywNh6bZuzm8s1ceuBUnMUAeoAHHw,20,18,6,27,2,0,3,0,56,8.0,3,0.0,4,6,24,2,14,0,3,3,0,36,20,0
7200,95646,kHWuc10C4T4imgPGXw1iL9DdxxMDyloj,RXDvfPUBYFlVdlueBFbLW0mhhAyGEqpt,1,0,0,0,0,0,1,0,1,0.14285714285714285,1,0.0,0,0,0,0,0,0,0,1,0,0,1,1
7201,95653,fn3RgMp4JCABnOK3IDXz6cUAXpmeuiYQ,G8EPVSXsOYB5YQWZGiz1aVq5Pgr2GrQu,9,6,3,0,4,0,2,0,15,2.142857142857143,1,0.0,2,3,0,4,4,0,0,2,0,9,6,1
7202,95659,y8wihgxEdHfGcxMV16au6pgiPnSQwx23,RXDvfPUBYFlVdlueBFbLW0mhhAyGEqpt,7,1,1,0,1,0,6,0,9,1.2857142857142858,1,0.0,0,1,0,1,1,0,0,6,0,2,7,1
7203,95662,4NPDuZC5Eo397A2ZzeMAm6BBPfedAt7V,SpATywNh6bZuzm8s1ceuBUnMUAeoAHHw,9,3,2,0,2,0,9,2,18,2.5714285714285716,1,0.0,0,2,0,2,3,0,0,9,2,4,14,1
7204,95669,k24Ps3wdaeoSwT1eSTFmxgPUJ0moWYPO,SpATywNh6bZuzm8s1ceuBUnMUAeoAHHw,6,4,1,0,1,0,3,0,9,1.2857142857142858,1,0.0,0,1,0,1,4,0,0,3,0,2,7,1
7205,95684,Nsz2zYB7CSRbOtMFEx5HNBJ0rxH2o1F7,A3fsA9Zfv1X2fVEQhTw51lKENdNrEqT3,4,0,0,0,0,0,8,0,8,1.1428571428571428,1,0.0,0,0,0,0,0,0,0,8,0,0,8,1
7206,95690,4NPDuZC5Eo397A2ZzeMAm6BBPfedAt7V,G8EPVSXsOYB5YQWZGiz1aVq5Pgr2GrQu,1,0,0,0,0,0,1,0,1,0.14285714285714285,1,0.0,0,0,0,0,0,0,0,1,0,0,1,1
7207,95694,m1Erwr4qiZRddhtJBwtwyQxEqeaRgIgi,SpATywNh6bZuzm8s1ceuBUnMUAeoAHHw,7,3,1,0,1,0,3,1,9,1.2857142857142858,1,0.0,0,1,0,1,3,0,0,3,1,2,7,1
7208,95699,zPbUIdTRPjnN9GVjy7Vs8SVwjdhRAaUM,SpATywNh6bZuzm8s1ceuBUnMUAeoAHHw,4,3,1,0,1,0,2,0,7,1.0,1,0.0,0,1,0,1,3,0,0,2,0,2,5,1
7209,95726,9yvWwncWvyjvEU2gkB98t6ra5ZlqpOOe,SpATywNh6bZuzm8s1ceuBUnMUAeoAHHw,31,31,15,16,8,0,10,1,81,11.571428571428571,2,0.0,6,15,15,8,25,0,1,10,1,44,37,1
7210,95737,CLsYy7g1hYWHJyj1aROfKK9oTeo5yxJx,bWdj2GDclj5ofokWjzoa5jAwMkxCykd6,1,0,0,0,0,0,1,0,1,0.14285714285714285,1,0.0,0,0,0,0,0,0,0,1,0,0,1,1
7211,95744,FXy6zIwT4trAO2Fwnqm3Ehrt0HqoYcIs,SpATywNh6bZuzm8s1ceuBUnMUAeoAHHw,6,5,1,0,1,0,2,0,9,1.2857142857142858,1,0.0,0,1,0,1,5,0,0,2,0,2,7,1
7212,95751,nMyFoPqXKsdnuE6mgxy1XpE5LPKy9GOa,G8EPVSXsOYB5YQWZGiz1aVq5Pgr2GrQu,1,0,0,0,0,0,1,0,1,0.14285714285714285,1,0.0,0,0,0,0,0,0,0,1,0,0,1,1
7213,95768,tKaMjS6KWA4OmqzSfTJZDMyzIRtISbIo,SpATywNh6bZuzm8s1ceuBUnMUAeoAHHw,1,0,0,0,0,0,1,0,1,0.14285714285714285,1,0.0,0,0,0,0,0,0,0,1,0,0,1,0
7214,95785,1SCPwRp6zs8beWzgpgsNRS1NXyUeSOy8,bWdj2GDclj5ofokWjzoa5jAwMkxCykd6,8,13,5,58,2,9,3,0,90,12.857142857142858,1,0.0,5,5,56,2,8,9,2,3,0,68,22,1
7215,95809,gMeKwVdV7xHR9zrsQTTuP5xOz4aKMsCh,RXDvfPUBYFlVdlueBFbLW0mhhAyGEqpt,10,4,4,0,2,0,4,0,14,2.0,1,0.0,0,4,0,2,4,0,0,4,0,6,8,1
7216,95814,pK3w2ljSu5UCiWTsVPCK8fUfSVn5X9S6,SpATywNh6bZuzm8s1ceuBUnMUAeoAHHw,43,56,30,27,18,0,6,0,137,19.571428571428573,2,0.0,15,30,27,18,41,0,0,6,0,90,47,1
7217,95815,forPgRyluFqH5fyMZfnKJctNYjPII95b,A3fsA9Zfv1X2fVEQhTw51lKENdNrEqT3,15,5,1,30,0,0,3,0,39,5.571428571428571,1,0.0,0,1,27,0,5,0,3,3,0,28,11,1
7218,95850,NvdQzMD14NnCAS0YAW6YP4m31ATjV5UA,SpATywNh6bZuzm8s1ceuBUnMUAeoAHHw,12,12,6,0,8,1,2,0,29,4.142857142857143,1,0.0,0,6,0,8,12,1,0,2,0,14,15,1
7219,95852,nB9RnfPmq1WfPeBn5EUZt5ffKcXJEdE4,A3fsA9Zfv1X2fVEQhTw51lKENdNrEqT3,2,0,0,0,0,0,4,0,4,0.5714285714285714,3,0.0,0,0,0,0,0,0,0,4,0,0,4,1
7220,95860,JcocKAtlN5pNw3B6wmg6BZFKdvxcJRHw,bWdj2GDclj5ofokWjzoa5jAwMkxCykd6,14,16,8,36,7,0,2,0,69,9.857142857142858,1,0.0,5,8,29,7,11,0,7,2,0,49,20,1
7221,95880,XNJvqr2ia2XRTEmLeguLZckH2aLyvBMM,SpATywNh6bZuzm8s1ceuBUnMUAeoAHHw,6,6,3,0,0,0,3,0,12,1.7142857142857142,2,0.0,0,3,0,0,6,0,0,3,0,3,9,1
7222,95899,qwWysWdLmrwh0JmjPYNGVFqdat8Jy8Lb,bWdj2GDclj5ofokWjzoa5jAwMkxCykd6,8,12,2,0,3,0,8,0,25,3.5714285714285716,3,0.0,2,2,0,3,10,0,0,8,0,7,18,0
7223,95901,jzWvwaTexkgbyBrPkQbXDb98Viqx6cSS,A3fsA9Zfv1X2fVEQhTw51lKENdNrEqT3,42,7,3,114,0,0,5,0,129,18.428571428571427,2,0.0,3,3,100,0,4,0,14,5,0,106,23,1
7224,95908,b80Lkn7xNHauWWmN3QIwsLauRSXsSHrY,SpATywNh6bZuzm8s1ceuBUnMUAeoAHHw,6,6,0,0,1,0,2,0,9,1.2857142857142858,1,0.0,2,0,0,1,4,0,0,2,0,3,6,1
7225,95913,m7hBmfvQj5nDU6vEGQuVMa4fkSxlliz4,G8EPVSXsOYB5YQWZGiz1aVq5Pgr2GrQu,4,2,0,0,0,0,2,0,4,0.5714285714285714,1,0.0,0,0,0,0,2,0,0,2,0,0,4,1
7226,95933,pwoJhGEuCXUAzWggYD0Vpr6rlqs95MdC,SpATywNh6bZuzm8s1ceuBUnMUAeoAHHw,6,3,2,0,2,0,1,0,8,1.1428571428571428,1,0.0,0,2,0,2,3,0,0,1,0,4,4,1
7227,95939,q7ixHJ98uI7DV9nBYxjXxbopCkuH6DX6,SpATywNh6bZuzm8s1ceuBUnMUAeoAHHw,3,0,0,0,0,0,3,0,3,0.42857142857142855,1,0.0,0,0,0,0,0,0,0,3,0,0,3,1
7228,95941,5FCCqL18D5yTiqyAg5N299Ugwsv8CI3G,SpATywNh6bZuzm8s1ceuBUnMUAeoAHHw,6,3,1,0,1,0,2,0,7,1.0,1,0.0,0,1,0,1,3,0,0,2,0,2,5,0
7229,95951,Uvg7ZsdO3eZ12twQcai6zLQJvqq6H5qj,G8EPVSXsOYB5YQWZGiz1aVq5Pgr2GrQu,9,5,1,0,1,0,5,0,12,1.7142857142857142,2,0.0,0,1,0,1,5,0,0,5,0,2,10,0
7230,95958,Ar7wri6od2sIMOfx95hPmMwDttR4wtOC,A3fsA9Zfv1X2fVEQhTw51lKENdNrEqT3,70,30,18,146,7,0,10,1,212,30.285714285714285,4,0.0,2,18,129,7,28,0,17,10,1,156,56,0
7231,95978,wfyGhtXQXfiz6Xnx0YIucq6EMEmHdLu2,SpATywNh6bZuzm8s1ceuBUnMUAeoAHHw,1,0,0,0,0,0,1,0,1,0.14285714285714285,1,0.0,0,0,0,0,0,0,0,1,0,0,1,1
7232,95993,pcy81jlx7huLaDPvWWRXTEiJTAUolrbh,A3fsA9Zfv1X2fVEQhTw51lKENdNrEqT3,8,4,3,0,3,0,1,0,11,1.5714285714285714,1,0.0,0,3,0,3,4,0,0,1,0,6,5,1
7233,96003,Hxd16O3nQG6ddXQCBbAu8BGBmmZmiixl,G8EPVSXsOYB5YQWZGiz1aVq5Pgr2GrQu,1,0,0,0,0,0,1,0,1,0.14285714285714285,1,0.0,0,0,0,0,0,0,0,1,0,0,1,1
7234,96011,XtXVGX6xZjaXboxbRFBRNJiE8mlrJ6RY,SpATywNh6bZuzm8s1ceuBUnMUAeoAHHw,1,0,0,0,0,0,2,0,2,0.2857142857142857,1,0.0,0,0,0,0,0,0,0,2,0,0,2,1
7235,96035,NGxVJQppNBMfgJiFwD3Ox6xl5bHm79ig,SpATywNh6bZuzm8s1ceuBUnMUAeoAHHw,7,3,2,0,2,0,2,0,9,1.2857142857142858,1,0.0,0,2,0,2,3,0,0,2,0,4,5,1
7236,96036,zwqhxdboQszkcKvPN5pyN1nGDFR4ub3y,A3fsA9Zfv1X2fVEQhTw51lKENdNrEqT3,6,2,1,0,1,0,4,0,8,1.1428571428571428,1,0.0,0,1,0,1,2,0,0,4,0,2,6,1
7237,96054,G9ja1Sell6i4GCvRpZMszshIwT0u0uoK,SpATywNh6bZuzm8s1ceuBUnMUAeoAHHw,4,3,1,0,1,0,1,0,6,0.8571428571428571,1,0.0,0,1,0,1,3,0,0,1,0,2,4,0
7238,96073,FZWt1vapJFvo3kXFvlr3Pcq5dqSsXIdl,G8EPVSXsOYB5YQWZGiz1aVq5Pgr2GrQu,4,2,0,0,0,0,4,0,6,0.8571428571428571,2,0.0,0,0,0,0,2,0,0,4,0,0,6,1
7239,96099,ps5VcFUapZM31sy4VNJWOTFBzN98932v,RXDvfPUBYFlVdlueBFbLW0mhhAyGEqpt,1,0,0,0,0,0,1,0,1,0.14285714285714285,1,0.0,0,0,0,0,0,0,0,1,0,0,1,0
7240,96116,liXvDig5u9dxIPwxTVIf3BkkLMQ16JFo,SpATywNh6bZuzm8s1ceuBUnMUAeoAHHw,5,2,1,0,1,0,3,0,7,1.0,2,0.0,0,1,0,1,2,0,0,3,0,2,5,1
7241,96129,8n73BBd3mvRJq2a0KZ4WJWTYj65s8f61,A3fsA9Zfv1X2fVEQhTw51lKENdNrEqT3,1,0,0,0,0,0,1,0,1,0.14285714285714285,1,0.0,0,0,0,0,0,0,0,1,0,0,1,1
7242,96134,VeFENcSXAiXgJQaSjlXiodtIBxgSrzaH,bWdj2GDclj5ofokWjzoa5jAwMkxCykd6,6,5,0,0,0,0,3,0,8,1.1428571428571428,1,0.0,1,0,0,0,4,0,0,3,0,1,7,0
7243,96142,caI3PSZVJV9vybgXT1YDETSgX6OiKqyu,3VkHkmOtom3jM2wCu94xgzzu1d6Dn7or,6,5,0,0,0,0,8,1,14,2.0,2,0.0,0,0,0,0,5,0,0,8,1,0,14,1
7244,96144,YpILOnilrSXnYyzJyzvQfqbAFoUoBYq3,3VkHkmOtom3jM2wCu94xgzzu1d6Dn7or,7,19,7,5,3,0,4,0,38,5.428571428571429,1,0.0,7,7,4,3,12,0,1,4,0,21,17,1
7245,96149,WmkLZEHqvZSSHNuXpTIzYz9aXCoaAXEu,3VkHkmOtom3jM2wCu94xgzzu1d6Dn7or,4,2,0,0,0,0,2,0,4,0.5714285714285714,1,0.0,0,0,0,0,2,0,0,2,0,0,4,1
7246,96150,JPJEHkb7ceKbmMXu7q2vUQVG2Q0sFzMb,3VkHkmOtom3jM2wCu94xgzzu1d6Dn7or,1,0,0,0,0,0,1,0,1,0.14285714285714285,1,0.0,0,0,0,0,0,0,0,1,0,0,1,1
7247,96155,QbAmjeEWtsgDhz2dPpwm3A1TlqFNj1sk,3VkHkmOtom3jM2wCu94xgzzu1d6Dn7or,8,22,8,0,4,0,8,1,43,6.142857142857143,1,0.0,4,8,0,4,18,0,0,8,1,16,27,1
7248,96159,jdxhRXQlunGkgGozr0CmSVt4az5rQW1H,3VkHkmOtom3jM2wCu94xgzzu1d6Dn7or,3,2,0,0,0,2,1,0,5,0.7142857142857143,1,0.0,0,0,0,0,2,2,0,1,0,0,5,1
7249,96160,UEaboZzcqfS9Ix6BTl77zBz0w31ARcd9,3VkHkmOtom3jM2wCu94xgzzu1d6Dn7or,6,2,1,0,1,0,3,1,8,1.1428571428571428,1,0.0,0,1,0,1,2,0,0,3,1,2,6,1
7250,96168,GaHk8zyhEc7E6fQfTPctcyBcPQTBz1Ic,3VkHkmOtom3jM2wCu94xgzzu1d6Dn7or,1,0,0,0,0,0,2,0,2,0.2857142857142857,1,0.0,0,0,0,0,0,0,0,2,0,0,2,1
7251,96170,dtRLDQ2C6USVHbasT68RGoAenkwQj9YN,3VkHkmOtom3jM2wCu94xgzzu1d6Dn7or,7,2,1,0,1,1,12,0,17,2.4285714285714284,1,0.0,0,1,0,1,2,1,0,12,0,2,15,1
7252,96178,4dGHYVA6cJ7in6fqz7m3ZCazfFSrt5aw,3VkHkmOtom3jM2wCu94xgzzu1d6Dn7or,1,0,0,0,0,0,1,0,1,0.14285714285714285,1,0.0,0,0,0,0,0,0,0,1,0,0,1,1
7253,96179,f8NPAWkxxIvVYrmhTynJqnvnh4B34pcB,3VkHkmOtom3jM2wCu94xgzzu1d6Dn7or,3,2,1,0,0,0,1,0,4,0.5714285714285714,1,0.0,0,1,0,0,2,0,0,1,0,1,3,1
7254,96184,15MhnITb8yOg5Tgp8NKzSsWNl4TmQTrz,3VkHkmOtom3jM2wCu94xgzzu1d6Dn7or,1,0,0,0,0,0,1,0,1,0.14285714285714285,1,0.0,0,0,0,0,0,0,0,1,0,0,1,1
7255,96189,Z8FM9znorSGd2gIh0wpgciHb3gMeceeW,3VkHkmOtom3jM2wCu94xgzzu1d6Dn7or,1,0,0,0,0,0,2,0,2,0.2857142857142857,1,0.0,0,0,0,0,0,0,0,2,0,0,2,1
7256,96196,PPCyXqVBaGhYGnTiTJ4simhaairGHZIQ,3VkHkmOtom3jM2wCu94xgzzu1d6Dn7or,10,4,3,0,3,0,3,0,13,1.8571428571428572,1,0.0,0,3,0,3,4,0,0,3,0,6,7,1
7257,96200,bUJoVvQlhtk0G1tPgtXus9a6SddEpZ7c,3VkHkmOtom3jM2wCu94xgzzu1d6Dn7or,4,2,1,0,0,0,3,0,6,0.8571428571428571,2,0.0,0,1,0,0,2,0,0,3,0,1,5,1
7258,96203,8VMZMnJmdorfW3qbwQWE21Qr8kT0OjAq,3VkHkmOtom3jM2wCu94xgzzu1d6Dn7or,5,3,1,0,1,0,2,0,7,1.0,1,0.0,1,1,0,1,2,0,0,2,0,3,4,1
7259,96205,yOuSbLU4N1OMhsuKJoYnGYyoodl7Ts9u,3VkHkmOtom3jM2wCu94xgzzu1d6Dn7or,6,6,4,0,1,0,5,0,16,2.2857142857142856,1,0.0,0,4,0,1,6,0,0,5,0,5,11,1
7260,96227,VN7mIYOy9t6d92ozIKhBx0dLnBa4IRt3,3VkHkmOtom3jM2wCu94xgzzu1d6Dn7or,1,0,0,0,0,0,1,0,1,0.14285714285714285,1,0.0,0,0,0,0,0,0,0,1,0,0,1,1
7261,96232,kxygIhpaaZ3PJ4cUkB7uXqGox4OFtNxP,3VkHkmOtom3jM2wCu94xgzzu1d6Dn7or,61,169,54,64,32,18,25,1,363,51.857142857142854,6,0.0,44,54,60,32,125,18,4,25,1,190,173,0
7262,96233,itYp3FmXXqMtnnygyLsLYbk4Lj2Ne9y3,3VkHkmOtom3jM2wCu94xgzzu1d6Dn7or,1,0,0,0,0,0,1,0,1,0.14285714285714285,1,0.0,0,0,0,0,0,0,0,1,0,0,1,1
7263,96235,AvWqyaIKZiUzZlauikMvpqeQuQERwQok,3VkHkmOtom3jM2wCu94xgzzu1d6Dn7or,1,0,0,0,0,0,1,0,1,0.14285714285714285,1,0.0,0,0,0,0,0,0,0,1,0,0,1,1
7264,96238,wER6uLDxr0UZEAgeUPfX1ygued6Mtiwe,3VkHkmOtom3jM2wCu94xgzzu1d6Dn7or,6,3,1,0,1,0,6,0,11,1.5714285714285714,1,0.0,0,1,0,1,3,0,0,6,0,2,9,1
7265,96239,I3y8UhgjOmrKX2NiYCp9q6amv1bHjqBJ,3VkHkmOtom3jM2wCu94xgzzu1d6Dn7or,8,9,6,4,3,0,4,0,26,3.7142857142857144,2,0.0,1,6,3,3,8,0,1,4,0,13,13,1
7266,96249,qCCudDhDBVL7mBCyOnFJL2iRzzfhvt3U,3VkHkmOtom3jM2wCu94xgzzu1d6Dn7or,6,5,3,0,2,0,3,0,13,1.8571428571428572,1,0.0,0,3,0,2,5,0,0,3,0,5,8,1
7267,96252,vEtredLP6JeGTP1tI36oIC1lr6fbi8FG,3VkHkmOtom3jM2wCu94xgzzu1d6Dn7or,2,0,0,0,0,0,4,0,4,0.5714285714285714,1,0.0,0,0,0,0,0,0,0,4,0,0,4,1
7268,96262,Js2oj014Od6Evf51SQQ2ab956nBOgw7H,3VkHkmOtom3jM2wCu94xgzzu1d6Dn7or,1,0,0,0,0,0,1,0,1,0.14285714285714285,1,0.0,0,0,0,0,0,0,0,1,0,0,1,1
7269,96263,514TWhkGGUhLu2MdvTnb8eiBH3DCFHzg,3VkHkmOtom3jM2wCu94xgzzu1d6Dn7or,1,0,0,0,0,0,1,0,1,0.14285714285714285,1,0.0,0,0,0,0,0,0,0,1,0,0,1,1
7270,96266,oZELzmce26r0RkjZ0m6xDljWh8jSqTN4,3VkHkmOtom3jM2wCu94xgzzu1d6Dn7or,35,44,32,0,0,0,10,0,86,12.285714285714286,4,0.0,0,32,0,0,44,0,0,10,0,32,54,1
7271,96267,qkelwAXFbtM6rFKwOjkD6SqPuqMw9quR,3VkHkmOtom3jM2wCu94xgzzu1d6Dn7or,6,4,1,0,2,0,4,0,11,1.5714285714285714,1,0.0,2,1,0,2,2,0,0,4,0,5,6,1
7272,96275,PKmEAIBeprGq9oDbNdLfSyZfGsm9X211,3VkHkmOtom3jM2wCu94xgzzu1d6Dn7or,7,7,2,0,3,0,3,0,15,2.142857142857143,1,0.0,4,2,0,3,3,0,0,3,0,9,6,1
7273,96281,dJNMH0TAT59fJcke62Qm11VvwJlqoLnV,3VkHkmOtom3jM2wCu94xgzzu1d6Dn7or,5,2,1,0,1,3,3,0,10,1.4285714285714286,1,0.0,0,1,0,1,2,3,0,3,0,2,8,1
7274,96284,65SOEzC3tEVRfnwr4FWDkxslKFgyYKS5,3VkHkmOtom3jM2wCu94xgzzu1d6Dn7or,4,2,1,0,1,0,1,0,5,0.7142857142857143,1,0.0,0,1,0,1,2,0,0,1,0,2,3,1
7275,96285,CXUNKyJ74zshCjh6SwH6czHjX2gsHXo9,3VkHkmOtom3jM2wCu94xgzzu1d6Dn7or,8,4,1,0,1,0,7,0,13,1.8571428571428572,1,0.0,0,1,0,1,4,0,0,7,0,2,11,1
7276,96287,7mGdRiMzSbTybRB8CqLZKk01SINUa2wl,3VkHkmOtom3jM2wCu94xgzzu1d6Dn7or,6,17,6,0,5,0,4,0,32,4.571428571428571,1,0.0,5,6,0,5,12,0,0,4,0,16,16,1
7277,96291,OXYbE9lnceDjkHqL3j7DavnHu44aYICK,3VkHkmOtom3jM2wCu94xgzzu1d6Dn7or,9,5,2,0,1,8,20,4,40,5.714285714285714,1,0.0,0,2,0,1,5,8,0,20,4,3,37,1
7278,96293,5HOuH8aTViql1ay76pIsM5aWtb8sbk3t,3VkHkmOtom3jM2wCu94xgzzu1d6Dn7or,16,22,5,9,11,8,3,0,58,8.285714285714286,1,0.0,16,5,8,11,6,8,1,3,0,40,18,1
7279,96304,7VIT9JPp8XCGpLntesoOkNBJZdDnphRq,3VkHkmOtom3jM2wCu94xgzzu1d6Dn7or,1,0,0,0,0,0,1,0,1,0.14285714285714285,1,0.0,0,0,0,0,0,0,0,1,0,0,1,1
7280,96313,PVd30adlkZ856ALhBHv5eYeSe8xUebRv,3VkHkmOtom3jM2wCu94xgzzu1d6Dn7or,20,23,0,0,8,0,10,0,41,5.857142857142857,3,0.0,3,0,0,8,20,0,0,10,0,11,30,0
7281,96327,BWz3V22DqG4m59HybtARfMozxr4oxBiZ,3VkHkmOtom3jM2wCu94xgzzu1d6Dn7or,4,7,0,0,0,0,3,0,10,1.4285714285714286,1,0.0,0,0,0,0,7,0,0,3,0,0,10,1
7282,96328,yOIhIWmER9QfxNzVZ9qWzk3TtbueQdVp,3VkHkmOtom3jM2wCu94xgzzu1d6Dn7or,5,7,1,0,2,2,3,0,15,2.142857142857143,1,0.0,3,1,0,2,4,2,0,3,0,6,9,1
7283,96329,gg6GnzSIxzlLDmks8csmFGSQRPWeznPP,3VkHkmOtom3jM2wCu94xgzzu1d6Dn7or,4,3,0,0,0,0,5,0,8,1.1428571428571428,1,0.0,0,0,0,0,3,0,0,5,0,0,8,1
7284,96331,FdG2SbK8srygyvvvCNd0FilB9Es4Aw9q,3VkHkmOtom3jM2wCu94xgzzu1d6Dn7or,69,134,40,84,47,0,19,0,324,46.285714285714285,5,0.0,92,40,80,47,42,0,4,19,0,259,65,1
7285,96343,p9ADfMtOwrR3Jjw60Ob5CTQ2SVZ8InwM,3VkHkmOtom3jM2wCu94xgzzu1d6Dn7or,4,2,1,0,1,0,1,0,5,0.7142857142857143,1,0.0,0,1,0,1,2,0,0,1,0,2,3,1
7286,96345,kGiwkpye34paJt0E8ZP4DxvIGSOY6Bp8,3VkHkmOtom3jM2wCu94xgzzu1d6Dn7or,2,0,0,0,0,0,2,0,2,0.2857142857142857,1,0.0,0,0,0,0,0,0,0,2,0,0,2,0
7287,96346,SUyWlx9XAmZ1ZEMTEpbOhdH9FV7d7AwX,3VkHkmOtom3jM2wCu94xgzzu1d6Dn7or,17,26,5,17,9,6,9,0,72,10.285714285714286,2,0.0,15,5,15,9,11,6,2,9,0,44,28,1
7288,96353,lVKECvqxjl8Mk7xzhLwSaYRUApxIVVNf,3VkHkmOtom3jM2wCu94xgzzu1d6Dn7or,1,0,0,0,0,0,1,0,1,0.14285714285714285,1,0.0,0,0,0,0,0,0,0,1,0,0,1,1
7289,96354,HqOw6yjK73pA4yJXwGiuK5xAqvDl7hv2,3VkHkmOtom3jM2wCu94xgzzu1d6Dn7or,7,5,1,0,1,1,13,4,25,3.5714285714285716,3,0.0,2,1,0,1,3,1,0,13,4,4,21,0
7290,96365,t6vD6AYAFEhQMgu5MLEovLAyepLBZv30,3VkHkmOtom3jM2wCu94xgzzu1d6Dn7or,1,0,0,0,0,0,1,0,1,0.14285714285714285,1,0.0,0,0,0,0,0,0,0,1,0,0,1,1
7291,96373,fYctGxkVAPh34WQ0NVTZHAd2a6Iryb4D,3VkHkmOtom3jM2wCu94xgzzu1d6Dn7or,1,0,0,0,0,0,1,0,1,0.14285714285714285,1,0.0,0,0,0,0,0,0,0,1,0,0,1,1
7292,96382,hluzPB1y7zkKLSSzVkJvXfWNLyDAuRho,3VkHkmOtom3jM2wCu94xgzzu1d6Dn7or,6,4,3,0,3,0,1,0,11,1.5714285714285714,1,0.0,0,3,0,3,4,0,0,1,0,6,5,1
7293,96401,Un3EzEE4Sz8i5Z84q9e50URbIAEkkVSB,5Gyp41oLVo7Gg7vF4vpmggWP5MU70QO6,13,16,8,17,5,0,2,0,48,6.857142857142857,2,0.0,5,8,12,5,11,0,5,2,0,30,18,1
7294,96405,KUYY5Rqotmoetp2jjazu6cGkVx3pqz6d,5Gyp41oLVo7Gg7vF4vpmggWP5MU70QO6,27,63,14,21,14,0,19,1,132,18.857142857142858,7,0.0,12,14,15,14,51,0,6,19,1,55,77,1
7295,96444,lDlatmKJdo0qBYapZcbWQLsUydBhY3xU,5Gyp41oLVo7Gg7vF4vpmggWP5MU70QO6,3,0,0,0,0,0,3,0,3,0.42857142857142855,1,0.0,0,0,0,0,0,0,0,3,0,0,3,1
7296,96446,gscO81uyFXakN6G7EORyf3gCaOhqQGKx,5Gyp41oLVo7Gg7vF4vpmggWP5MU70QO6,6,4,3,0,1,0,1,0,9,1.2857142857142858,1,0.0,0,3,0,1,4,0,0,1,0,4,5,1
7297,96458,LV1nIAvjptPun2V4leWKwnP3KZdMJc2a,5Gyp41oLVo7Gg7vF4vpmggWP5MU70QO6,5,7,2,0,0,0,5,0,14,2.0,1,0.0,1,2,0,0,6,0,0,5,0,3,11,1
7298,96520,VG5bA35PGkMDO1KNnYhrFcOHkVOY1NtY,3VkHkmOtom3jM2wCu94xgzzu1d6Dn7or,9,19,1,10,0,7,11,1,49,7.0,2,0.0,2,1,8,0,17,7,2,11,1,11,38,1
7299,96522,kKj1FlDO03hIJs4qO2fYyQxEzv7HbwXh,3VkHkmOtom3jM2wCu94xgzzu1d6Dn7or,9,6,2,0,1,0,4,1,14,2.0,1,0.0,0,2,0,1,6,0,0,4,1,3,11,1
7300,96524,W8okOCr8x8pY5E81B83539j1pFhitUMq,3VkHkmOtom3jM2wCu94xgzzu1d6Dn7or,3,1,0,0,0,0,3,0,4,0.5714285714285714,1,0.0,0,0,0,0,1,0,0,3,0,0,4,1
7301,96525,dwtg9A6LugmDZ5duYp9HulbrLf0NjOJH,3VkHkmOtom3jM2wCu94xgzzu1d6Dn7or,16,17,5,19,4,2,3,1,51,7.285714285714286,1,0.0,4,5,16,4,13,2,3,3,1,29,22,1
7302,96527,BIuaj0JMJBIdhO8MEgNTHmWapQlWsal0,3VkHkmOtom3jM2wCu94xgzzu1d6Dn7or,1,0,0,0,0,0,1,0,1,0.14285714285714285,1,0.0,0,0,0,0,0,0,0,1,0,0,1,1
7303,96532,v9O5halsKUv53gKg9koQBCw6L2IPGs2n,3VkHkmOtom3jM2wCu94xgzzu1d6Dn7or,2,0,0,0,0,0,2,0,2,0.2857142857142857,1,0.0,0,0,0,0,0,0,0,2,0,0,2,1
7304,96537,GdWpPGRpew3mdaEJ8CztRU45JrR7axlv,3VkHkmOtom3jM2wCu94xgzzu1d6Dn7or,1,0,0,0,0,0,1,0,1,0.14285714285714285,1,0.0,0,0,0,0,0,0,0,1,0,0,1,1
7305,96539,ms6xfKdleOkvOvwF7IgWafwJkOK422hV,3VkHkmOtom3jM2wCu94xgzzu1d6Dn7or,4,2,1,0,0,0,2,0,5,0.7142857142857143,1,0.0,0,1,0,0,2,0,0,2,0,1,4,1
7306,96551,1Su0fVG6Gi9jw62IGpYtFJkh1mWH5fcC,3VkHkmOtom3jM2wCu94xgzzu1d6Dn7or,8,6,0,0,0,2,18,5,31,4.428571428571429,1,0.0,0,0,0,0,6,2,0,18,5,0,31,1
7307,96553,PLC3pMF29QbxxtVOXplTvspzXElysW1A,3VkHkmOtom3jM2wCu94xgzzu1d6Dn7or,5,5,3,0,2,0,2,0,12,1.7142857142857142,2,0.0,0,3,0,2,5,0,0,2,0,5,7,1
7308,96554,ym7kGg5ui15HWNyuMI6m7sQaMRNp6TJn,3VkHkmOtom3jM2wCu94xgzzu1d6Dn7or,5,3,1,0,1,0,2,0,7,1.0,1,0.0,1,1,0,1,2,0,0,2,0,3,4,1
7309,96557,mAtPYhgVQEdXuexaQz1O6am3axcwvcQv,3VkHkmOtom3jM2wCu94xgzzu1d6Dn7or,6,16,6,0,2,0,3,0,27,3.857142857142857,3,0.0,0,6,0,2,16,0,0,3,0,8,19,1
7310,96572,5kMWoPZVnOlCdDv2aBIV7LFqiD7AOPMi,3VkHkmOtom3jM2wCu94xgzzu1d6Dn7or,5,6,1,0,2,0,3,0,12,1.7142857142857142,1,0.0,2,1,0,2,4,0,0,3,0,5,7,1
7311,96573,egpXv13dykaiU64GCgTaQGg1ErRD7Rsb,3VkHkmOtom3jM2wCu94xgzzu1d6Dn7or,1,0,0,0,0,0,1,0,1,0.14285714285714285,1,0.0,0,0,0,0,0,0,0,1,0,0,1,1
7312,96574,PXxCtbmVtxEeyK5pz3blfoRYSpiEgn9z,3VkHkmOtom3jM2wCu94xgzzu1d6Dn7or,5,2,1,0,1,0,2,0,6,0.8571428571428571,1,0.0,0,1,0,1,2,0,0,2,0,2,4,1
7313,96590,nVR6dwapzxrYZVkIMGiVw3CgFu50vE99,3VkHkmOtom3jM2wCu94xgzzu1d6Dn7or,8,2,1,0,1,0,8,1,13,1.8571428571428572,1,0.0,0,1,0,1,2,0,0,8,1,2,11,1
7314,96591,pkXHoiBE5KVw2DqtLUl3ylE2T0vC8QHo,3VkHkmOtom3jM2wCu94xgzzu1d6Dn7or,1,0,0,0,0,0,2,0,2,0.2857142857142857,1,0.0,0,0,0,0,0,0,0,2,0,0,2,0
7315,96596,z0RvqjPPDctlehk93QbsTkC9mdJE5bcB,3VkHkmOtom3jM2wCu94xgzzu1d6Dn7or,6,6,1,0,2,0,4,0,13,1.8571428571428572,1,0.0,3,1,0,2,3,0,0,4,0,6,7,1
7316,96597,qoxPKfkHxJeAIo04LboW9EiXaMAiwKC4,3VkHkmOtom3jM2wCu94xgzzu1d6Dn7or,1,0,0,0,0,0,1,0,1,0.14285714285714285,1,0.0,0,0,0,0,0,0,0,1,0,0,1,1
7317,96606,Nx1xmPxU2RlIvjZppz8vBPHelTvW59ca,3VkHkmOtom3jM2wCu94xgzzu1d6Dn7or,5,2,1,0,0,0,5,0,8,1.1428571428571428,1,0.0,0,1,0,0,2,0,0,5,0,1,7,1
7318,96613,SmwM4tXKNze1zNIsPMRc2eNlAs4eoeOB,3VkHkmOtom3jM2wCu94xgzzu1d6Dn7or,57,126,49,27,41,0,12,3,258,36.857142857142854,5,0.0,39,49,25,41,87,0,2,12,3,154,104,1
7319,96618,ABbPtVE9vR3q9TnGdVr0jhQS05eL9aJw,3VkHkmOtom3jM2wCu94xgzzu1d6Dn7or,4,10,0,0,0,0,2,0,12,1.7142857142857142,1,0.0,4,0,0,0,6,0,0,2,0,4,8,1
7320,96640,DPsmKaIBv5J6hnXaTvzHdr4bLJTjOCyc,3VkHkmOtom3jM2wCu94xgzzu1d6Dn7or,6,5,2,0,2,0,5,2,16,2.2857142857142856,1,0.0,0,2,0,2,5,0,0,5,2,4,12,1
7321,96641,sORoVXXDgl7FhK0kOm8ff9nMx0CSL3ax,3VkHkmOtom3jM2wCu94xgzzu1d6Dn7or,2,0,0,0,0,0,6,0,6,0.8571428571428571,1,0.0,0,0,0,0,0,0,0,6,0,0,6,1
7322,96642,UMj7qRVoOO3EkcdC2vK59zqDHYCN3YZ7,3VkHkmOtom3jM2wCu94xgzzu1d6Dn7or,6,2,1,0,1,0,14,0,18,2.5714285714285716,2,0.0,0,1,0,1,2,0,0,14,0,2,16,1
7323,96658,LK8u1EXzDY1NrnXiE5JB2LK2Ot6N6D1F,3VkHkmOtom3jM2wCu94xgzzu1d6Dn7or,2,0,0,0,0,0,2,0,2,0.2857142857142857,1,0.0,0,0,0,0,0,0,0,2,0,0,2,1
7324,96669,ox9NKatEBLgYaNb1N5o0nmPeS8YpJB89,SpATywNh6bZuzm8s1ceuBUnMUAeoAHHw,3,2,0,0,0,0,1,0,3,0.42857142857142855,1,0.0,0,0,0,0,2,0,0,1,0,0,3,1
7325,96677,xOjhmcafCtLT2q16oVNZpjeZh4FUCy6U,A3fsA9Zfv1X2fVEQhTw51lKENdNrEqT3,13,11,9,0,7,0,4,0,31,4.428571428571429,2,0.0,0,9,0,7,11,0,0,4,0,16,15,1
7326,96686,qpd1RINX0ghAugS9ZiQmRvWMQe2xJWfG,RXDvfPUBYFlVdlueBFbLW0mhhAyGEqpt,1,0,0,0,0,0,2,0,2,0.2857142857142857,1,0.0,0,0,0,0,0,0,0,2,0,0,2,1
7327,96695,plWW2jbmbdQAaG18LPwZIwpV7ZE0ypXp,SpATywNh6bZuzm8s1ceuBUnMUAeoAHHw,34,57,35,39,18,19,13,4,185,26.428571428571427,3,0.0,9,35,33,18,48,19,6,13,4,95,90,0
7328,96701,D6fP4TUPeMrRaZv1s9hIwWRvTnUOqwXl,SpATywNh6bZuzm8s1ceuBUnMUAeoAHHw,4,2,1,0,0,0,2,0,5,0.7142857142857143,1,0.0,0,1,0,0,2,0,0,2,0,1,4,1
7329,96719,l7f4vHvlZkxCYoU9qM63V45bmndBSeZQ,G8EPVSXsOYB5YQWZGiz1aVq5Pgr2GrQu,67,13,7,257,1,0,2,0,280,40.0,1,0.0,0,7,199,1,13,0,58,2,0,207,73,1
7330,96724,Vqh7IxciNu3w4ryq9DwYRMQWb1h8f16V,SpATywNh6bZuzm8s1ceuBUnMUAeoAHHw,41,51,21,46,14,23,12,3,170,24.285714285714285,2,0.0,13,21,40,14,38,23,6,12,3,88,82,1
7331,96728,BOb6BiUk5x51duyreHhUz5u1LJUpA9P4,bWdj2GDclj5ofokWjzoa5jAwMkxCykd6,14,11,5,18,7,8,12,1,62,8.857142857142858,1,0.0,4,5,17,7,7,8,1,12,1,33,29,1
7332,96732,RHsk3gHUm8VEfb9FwEFf8vBDNKZZ0LWe,A3fsA9Zfv1X2fVEQhTw51lKENdNrEqT3,70,30,23,142,16,5,14,2,232,33.142857142857146,3,0.0,2,23,108,16,28,5,34,14,2,149,83,1
7333,96767,HVjDCDKIJj1upsVXxBXkt7RhefGcCnlo,5X6FeZozNMgE2VRi3MJYjkkFK8SETtu2,6,0,0,0,0,0,7,1,8,1.1428571428571428,1,0.0,0,0,0,0,0,0,0,7,1,0,8,1
7334,96790,2qs5o4ShoJi8U8TmD1cNHDzshN8FK6oF,RXDvfPUBYFlVdlueBFbLW0mhhAyGEqpt,1,0,0,0,0,0,1,0,1,0.14285714285714285,1,0.0,0,0,0,0,0,0,0,1,0,0,1,1
7335,96797,ruXsBlJCykTUOLzthXWdDIn2j4fWrsqb,SpATywNh6bZuzm8s1ceuBUnMUAeoAHHw,26,18,13,1,10,0,4,0,46,6.571428571428571,2,0.0,2,13,1,10,16,0,0,4,0,26,20,1
7336,96868,em6ahWcMRmenNOPIHJ0IxuoaSlBI3zdC,SpATywNh6bZuzm8s1ceuBUnMUAeoAHHw,8,9,6,0,4,0,7,0,26,3.7142857142857144,2,0.0,0,6,0,4,9,0,0,7,0,10,16,1
7337,96893,UAyWvSjTLiO8ve7HkUm43OX3XFSgIZD0,7GRhBDsirIGkRZBtSMEzNTyDr2JQm4xx,1,0,0,0,0,0,1,0,1,0.14285714285714285,1,0.0,0,0,0,0,0,0,0,1,0,0,1,1
7338,96895,Ip3irZsxFvOeGg8WSppVhJArbPhoH3qm,A3fsA9Zfv1X2fVEQhTw51lKENdNrEqT3,11,11,8,0,7,0,2,0,28,4.0,2,0.0,0,8,0,7,11,0,0,2,0,15,13,1
7339,96900,U74IyVXcSeKcVNZXE9AVeORjHrqTX1QT,A3fsA9Zfv1X2fVEQhTw51lKENdNrEqT3,11,10,1,0,1,2,12,1,27,3.857142857142857,1,0.0,0,1,0,1,10,2,0,12,1,2,25,1
7340,96905,loMeJnte2hFeHZBJ0Bg6siKOtraEIBl0,SpATywNh6bZuzm8s1ceuBUnMUAeoAHHw,7,8,5,0,2,0,3,0,18,2.5714285714285716,1,0.0,0,5,0,2,8,0,0,3,0,7,11,1
7341,96908,OF2M41yRlwCyz2O0q40BYZxOHi0g0vah,SpATywNh6bZuzm8s1ceuBUnMUAeoAHHw,2,0,0,0,0,0,2,0,2,0.2857142857142857,1,0.0,0,0,0,0,0,0,0,2,0,0,2,1
7342,96916,zvew9uiEAc86Yp9YluqFrNFVBMozMu7i,bWdj2GDclj5ofokWjzoa5jAwMkxCykd6,1,0,0,0,0,0,1,0,1,0.14285714285714285,1,0.0,0,0,0,0,0,0,0,1,0,0,1,1
7343,96926,f65jLVnOZmyS7NngLSsomvGh5edmSblj,SpATywNh6bZuzm8s1ceuBUnMUAeoAHHw,1,0,0,0,0,0,1,0,1,0.14285714285714285,1,0.0,0,0,0,0,0,0,0,1,0,0,1,1
7344,96929,uaGHWOyiH6GRJNYQ5wYQgdGgJiyGijb7,SpATywNh6bZuzm8s1ceuBUnMUAeoAHHw,27,40,16,10,8,0,16,0,90,12.857142857142858,6,0.0,2,16,8,8,38,0,2,16,0,34,56,0
7345,96933,mgC2SKl3BkBHgSzUjS94KW5V0rxosMWt,SpATywNh6bZuzm8s1ceuBUnMUAeoAHHw,15,19,10,15,5,5,4,0,58,8.285714285714286,2,0.0,6,10,12,5,13,5,3,4,0,33,25,0
7346,96957,YPgg2F1CAgvl8C6YTtaiELfvzhMGfPjI,A3fsA9Zfv1X2fVEQhTw51lKENdNrEqT3,1,0,0,0,0,0,1,0,1,0.14285714285714285,1,0.0,0,0,0,0,0,0,0,1,0,0,1,1
7347,96976,7pD3XwJqYTfsh0zZ4M07qj3DJAHtjtGm,7GRhBDsirIGkRZBtSMEzNTyDr2JQm4xx,1,0,0,0,0,0,1,0,1,0.14285714285714285,1,0.0,0,0,0,0,0,0,0,1,0,0,1,1
7348,96978,XoAmaAEiCQyqxGtldGa1yHbrXfsnSjbj,7GRhBDsirIGkRZBtSMEzNTyDr2JQm4xx,1,0,0,0,0,0,1,0,1,0.14285714285714285,1,0.0,0,0,0,0,0,0,0,1,0,0,1,1
7349,96982,1BEo7fZ8J0CF8e5039UrK6WkzsnT15rN,A3fsA9Zfv1X2fVEQhTw51lKENdNrEqT3,1,0,0,0,0,0,1,0,1,0.14285714285714285,1,0.0,0,0,0,0,0,0,0,1,0,0,1,1
7350,97010,zFfZShI4wofndTbpmWxWI7MWPBQc6ezg,A3fsA9Zfv1X2fVEQhTw51lKENdNrEqT3,2,0,0,0,0,0,2,0,2,0.2857142857142857,1,0.0,0,0,0,0,0,0,0,2,0,0,2,0
7351,97014,MSXFOc30HZVbYZtATkSJwT5euFO05BA1,7GRhBDsirIGkRZBtSMEzNTyDr2JQm4xx,6,5,1,0,2,0,3,0,11,1.5714285714285714,1,0.0,3,1,0,2,2,0,0,3,0,6,5,1
7352,97017,MSXFOc30HZVbYZtATkSJwT5euFO05BA1,5X6FeZozNMgE2VRi3MJYjkkFK8SETtu2,1,0,0,0,0,0,1,0,1,0.14285714285714285,1,0.0,0,0,0,0,0,0,0,1,0,0,1,1
7353,97064,cpRbfaNv5usLp7El18VnnTqxc7iB3VdC,A3fsA9Zfv1X2fVEQhTw51lKENdNrEqT3,2,0,0,0,0,0,2,0,2,0.2857142857142857,1,0.0,0,0,0,0,0,0,0,2,0,0,2,0
7354,97068,XlT7X7Rn0fLTh36Iz42hC1Epd5u3ukUS,7GRhBDsirIGkRZBtSMEzNTyDr2JQm4xx,2,0,0,0,0,0,4,0,4,0.5714285714285714,1,0.0,0,0,0,0,0,0,0,4,0,0,4,1
7355,97102,RJ2AN96oZxuBCR52LgUmQpj4g9Y4mcD4,A3fsA9Zfv1X2fVEQhTw51lKENdNrEqT3,2,0,0,0,0,0,2,0,2,0.2857142857142857,2,0.0,0,0,0,0,0,0,0,2,0,0,2,1
7356,97104,pSX00XUyCx7VlmgWGN0d39OwC9BZ8bRV,7GRhBDsirIGkRZBtSMEzNTyDr2JQm4xx,1,0,0,0,0,0,1,0,1,0.14285714285714285,1,0.0,0,0,0,0,0,0,0,1,0,0,1,0
7357,97143,vcLosQzAVwhadotVELXCMAgXnlN9Qppp,7GRhBDsirIGkRZBtSMEzNTyDr2JQm4xx,12,4,3,0,1,8,7,1,24,3.4285714285714284,1,0.0,0,3,0,1,4,8,0,7,1,4,20,1
7358,97152,JGnVyZ53gH9wjqC3YYjpGEbabkw7ZVhR,A3fsA9Zfv1X2fVEQhTw51lKENdNrEqT3,6,4,3,0,1,0,5,0,13,1.8571428571428572,2,0.0,0,3,0,1,4,0,0,5,0,4,9,1
7359,97159,5DIcniD9kRbDupVPBNugV5by0SZHtD2e,A3fsA9Zfv1X2fVEQhTw51lKENdNrEqT3,1,0,0,0,0,0,3,0,3,0.42857142857142855,1,0.0,0,0,0,0,0,0,0,3,0,0,3,1
7360,97165,YE22fRNdaFtk3nhWfjSOMHWERX5O7Ymi,7GRhBDsirIGkRZBtSMEzNTyDr2JQm4xx,36,91,7,42,9,0,15,0,164,23.428571428571427,5,0.0,20,7,38,9,71,0,4,15,0,74,90,1
7361,97172,9ZsKIy2cZdyg37tMFhcfbfMbCgb1Euwl,A3fsA9Zfv1X2fVEQhTw51lKENdNrEqT3,5,2,1,0,1,0,2,0,6,0.8571428571428571,1,0.0,0,1,0,1,2,0,0,2,0,2,4,1
7362,97184,5DIcniD9kRbDupVPBNugV5by0SZHtD2e,7GRhBDsirIGkRZBtSMEzNTyDr2JQm4xx,1,0,0,0,0,0,1,0,1,0.14285714285714285,1,0.0,0,0,0,0,0,0,0,1,0,0,1,1
7363,97198,NCbFqYNTEfc5vPQvAyBwDtnbS3ENYJY7,A3fsA9Zfv1X2fVEQhTw51lKENdNrEqT3,1,0,0,0,0,0,1,0,1,0.14285714285714285,1,0.0,0,0,0,0,0,0,0,1,0,0,1,1
7364,97224,PKH12j56WyhhHbwNNO7EjzMEo1oeOneA,A3fsA9Zfv1X2fVEQhTw51lKENdNrEqT3,5,11,1,0,0,0,2,0,14,2.0,2,0.0,0,1,0,0,11,0,0,2,0,1,13,1
7365,97233,Jpxsd7AQ90urdftfAf3y5kTy6w3x8OIk,A3fsA9Zfv1X2fVEQhTw51lKENdNrEqT3,2,0,0,0,0,0,2,0,2,0.2857142857142857,2,0.0,0,0,0,0,0,0,0,2,0,0,2,1
7366,97255,Ds7Ql2Fzh0y89y9XQaeLbThJFJ8LYIlx,7GRhBDsirIGkRZBtSMEzNTyDr2JQm4xx,1,0,0,0,0,0,1,0,1,0.14285714285714285,1,0.0,0,0,0,0,0,0,0,1,0,0,1,1
7367,97295,yrlVnbrSR0LAW13A08wi2wUW5yoGSw1G,7GRhBDsirIGkRZBtSMEzNTyDr2JQm4xx,5,6,3,0,0,0,1,0,10,1.4285714285714286,1,0.0,2,3,0,0,4,0,0,1,0,5,5,1
7368,97332,5MXvp0QvzlvNUKeivxKIinvGCr9tUfSF,5X6FeZozNMgE2VRi3MJYjkkFK8SETtu2,4,2,1,0,1,0,1,0,5,0.7142857142857143,1,0.0,0,1,0,1,2,0,0,1,0,2,3,1
7369,97350,s7ckXc9uqf8Feg3vkW3n7xahOUlBlKla,A3fsA9Zfv1X2fVEQhTw51lKENdNrEqT3,18,41,1,0,1,0,4,0,47,6.714285714285714,1,0.0,0,1,0,1,41,0,0,4,0,2,45,1
7370,97355,TLSHokviSrCaXoZpssG6riwyfhdocRcz,A3fsA9Zfv1X2fVEQhTw51lKENdNrEqT3,3,0,0,0,0,0,3,0,3,0.42857142857142855,1,0.0,0,0,0,0,0,0,0,3,0,0,3,0
7371,97390,wHh7IyZg69gls07QnvzBvWbwxDpKJO6L,7GRhBDsirIGkRZBtSMEzNTyDr2JQm4xx,4,2,1,0,1,0,1,0,5,0.7142857142857143,1,0.0,0,1,0,1,2,0,0,1,0,2,3,1
7372,97410,TzuMwfaAW66vzYCJbLJUrM2CQWUNVBwC,A3fsA9Zfv1X2fVEQhTw51lKENdNrEqT3,5,2,1,0,1,0,5,0,9,1.2857142857142858,2,0.0,0,1,0,1,2,0,0,5,0,2,7,1
7373,97437,YcAjMEQHzjEkIappgCA5LKxL8wrCHqZx,7GRhBDsirIGkRZBtSMEzNTyDr2JQm4xx,6,3,2,0,2,0,1,0,8,1.1428571428571428,1,0.0,0,2,0,2,3,0,0,1,0,4,4,1
7374,97447,DK4tMY4hv5jCEWYRZnAyqsGRGzDp2xfD,7GRhBDsirIGkRZBtSMEzNTyDr2JQm4xx,7,3,2,0,1,0,4,1,11,1.5714285714285714,1,0.0,0,2,0,1,3,0,0,4,1,3,8,1
7375,97459,gtKTzkXHwS41ljYVmjlLLf4WyQSkK02q,A3fsA9Zfv1X2fVEQhTw51lKENdNrEqT3,3,3,2,0,0,0,2,0,7,1.0,3,0.0,0,2,0,0,3,0,0,2,0,2,5,0
7376,97468,LhMGo1H458StfoGsiIJMkiDJEIOqqbKe,7GRhBDsirIGkRZBtSMEzNTyDr2JQm4xx,1,0,0,0,0,0,1,0,1,0.14285714285714285,1,0.0,0,0,0,0,0,0,0,1,0,0,1,1
7377,97476,LDoKVa67JbCj3bIYTGTgWGEVPIBUkRDs,7GRhBDsirIGkRZBtSMEzNTyDr2JQm4xx,1,0,0,0,0,0,1,0,1,0.14285714285714285,1,0.0,0,0,0,0,0,0,0,1,0,0,1,1
7378,97478,9yD6wRS2N3SNxMC2ibpNMzfizxpTbLsY,7GRhBDsirIGkRZBtSMEzNTyDr2JQm4xx,4,2,1,0,1,0,1,0,5,0.7142857142857143,1,0.0,0,1,0,1,2,0,0,1,0,2,3,1
7379,97502,BVpzzXeXh42vyU3wE9rUQpEUs8P1ZpSo,7GRhBDsirIGkRZBtSMEzNTyDr2JQm4xx,33,43,15,96,8,2,12,0,176,25.142857142857142,4,0.0,23,15,88,8,20,2,8,12,0,134,42,1
7380,97533,LzIeScVJDrRe6pKpJZPOE5digO2qGiFj,A3fsA9Zfv1X2fVEQhTw51lKENdNrEqT3,140,99,80,334,54,0,8,0,575,82.14285714285714,5,0.0,6,80,297,54,93,0,37,8,0,437,138,0
7381,97546,ecpi7DZ71ZRx6H6XAh885uO1l0O5kvOG,5X6FeZozNMgE2VRi3MJYjkkFK8SETtu2,3,4,1,0,0,0,1,0,6,0.8571428571428571,1,0.0,2,1,0,0,2,0,0,1,0,3,3,1
7382,97578,tJSuuWZXDdoXjZXIctAWwDLD7oHTWJ9T,7GRhBDsirIGkRZBtSMEzNTyDr2JQm4xx,1,0,0,0,0,0,3,0,3,0.42857142857142855,3,0.0,0,0,0,0,0,0,0,3,0,0,3,1
7383,97634,hGCwfWh9ySQVbALdmRR0HUMpPic5OOrw,A3fsA9Zfv1X2fVEQhTw51lKENdNrEqT3,4,2,0,0,0,0,2,0,4,0.5714285714285714,1,0.0,0,0,0,0,2,0,0,2,0,0,4,0
7384,97690,EmgNBDQJ8EX1zHweYbszHLZL5Ix1zd1R,5X6FeZozNMgE2VRi3MJYjkkFK8SETtu2,2,0,0,0,0,0,2,0,2,0.2857142857142857,1,0.0,0,0,0,0,0,0,0,2,0,0,2,1
7385,97701,PlRR5bewxY5s5UPrV9qsB2qkDqRzxPQw,7GRhBDsirIGkRZBtSMEzNTyDr2JQm4xx,20,14,7,19,5,0,3,0,48,6.857142857142857,2,0.0,5,7,16,5,9,0,3,3,0,33,15,1
7386,97719,0OpVcmwG6bVPxKzOCpgJ9F6MfBtuGolr,A3fsA9Zfv1X2fVEQhTw51lKENdNrEqT3,1,0,0,0,0,0,2,0,2,0.2857142857142857,1,0.0,0,0,0,0,0,0,0,2,0,0,2,1
7387,97789,rUoEyfIkacNKFckMvyv3DLlxAp35p4TH,A3fsA9Zfv1X2fVEQhTw51lKENdNrEqT3,1,0,0,0,0,0,1,0,1,0.14285714285714285,1,0.0,0,0,0,0,0,0,0,1,0,0,1,1
7388,97802,UE0j9MGy4QtlCAV0dPJenzIfee02vh9K,5X6FeZozNMgE2VRi3MJYjkkFK8SETtu2,2,0,0,0,0,0,2,0,2,0.2857142857142857,1,0.0,0,0,0,0,0,0,0,2,0,0,2,1
7389,97805,tPYh43YRHAzuf09xESxSKtWvST0aCsjn,7GRhBDsirIGkRZBtSMEzNTyDr2JQm4xx,30,31,10,40,7,0,3,0,91,13.0,2,0.0,19,10,39,7,12,0,1,3,0,75,16,1
7390,97810,hRSdlrMEn8a0TvCiHu323STjlE2OMxnW,A3fsA9Zfv1X2fVEQhTw51lKENdNrEqT3,2,0,0,0,0,0,2,0,2,0.2857142857142857,1,0.0,0,0,0,0,0,0,0,2,0,0,2,1
7391,97840,Ffohn9JNnGJQD2IavzMTS00ubnVtcb2T,A3fsA9Zfv1X2fVEQhTw51lKENdNrEqT3,150,94,66,290,37,0,26,0,513,73.28571428571429,14,0.0,7,66,247,37,87,0,43,26,0,357,156,0
7392,97846,DwUuHlykLcu2QOJPkMlSk4MpGYyYCYXn,7GRhBDsirIGkRZBtSMEzNTyDr2JQm4xx,4,0,0,0,0,0,4,1,5,0.7142857142857143,1,0.0,0,0,0,0,0,0,0,4,1,0,5,1
7393,97893,txRaMeFRdTsCsziGBMMxzL5gSPIB7mbk,A3fsA9Zfv1X2fVEQhTw51lKENdNrEqT3,1,0,0,0,0,0,1,0,1,0.14285714285714285,1,0.0,0,0,0,0,0,0,0,1,0,0,1,1
7394,97926,ljhf5g1EQ7jx5ix8jB5hWiDB2kvoIcKv,3VkHkmOtom3jM2wCu94xgzzu1d6Dn7or,1,0,0,0,0,0,1,0,1,0.14285714285714285,1,0.0,0,0,0,0,0,0,0,1,0,0,1,1
7395,97935,HOh9uzKRHmixUSVl017qRO1fRhTakF2v,3VkHkmOtom3jM2wCu94xgzzu1d6Dn7or,1,0,0,0,0,0,1,0,1,0.14285714285714285,1,0.0,0,0,0,0,0,0,0,1,0,0,1,1
7396,97975,koG1j5O2D3Y4q0uVrIDera1nTAOOAZou,3VkHkmOtom3jM2wCu94xgzzu1d6Dn7or,1,0,0,0,0,0,1,0,1,0.14285714285714285,1,0.0,0,0,0,0,0,0,0,1,0,0,1,1
7397,98070,21S9MbpvSLw6ivno28dfYq6qQvy9jenJ,3VkHkmOtom3jM2wCu94xgzzu1d6Dn7or,1,0,0,0,0,0,1,0,1,0.14285714285714285,1,0.0,0,0,0,0,0,0,0,1,0,0,1,1
7398,98113,RoxLW3Wy1f0epWfgJFiZuhsVWdjFJxPT,3VkHkmOtom3jM2wCu94xgzzu1d6Dn7or,1,0,0,0,0,0,1,0,1,0.14285714285714285,1,0.0,0,0,0,0,0,0,0,1,0,0,1,1
7399,98116,ZUXSgoWa1Zgiwa3VeN9bfT2KJSPhTmyf,3VkHkmOtom3jM2wCu94xgzzu1d6Dn7or,1,0,0,0,0,0,1,0,1,0.14285714285714285,1,0.0,0,0,0,0,0,0,0,1,0,0,1,1
7400,98158,xv47Ihv1zjQOXkOaD45qDKOAj5WMwi8W,3VkHkmOtom3jM2wCu94xgzzu1d6Dn7or,9,17,5,9,5,7,7,0,50,7.142857142857143,2,0.0,10,5,6,5,7,7,3,7,0,26,24,1
7401,98166,fowR3ytWz16XiEoFapC5W8FuRvJmFQ5B,3VkHkmOtom3jM2wCu94xgzzu1d6Dn7or,2,1,0,0,0,2,1,0,4,0.5714285714285714,1,0.0,0,0,0,0,1,2,0,1,0,0,4,1
7402,98206,7n74l0OP83bbF4PlH4IxmN5kXcszgFDZ,3VkHkmOtom3jM2wCu94xgzzu1d6Dn7or,11,6,5,0,5,0,5,0,21,3.0,1,0.0,0,5,0,5,6,0,0,5,0,10,11,0
7403,98225,YUXH2bCoGQTPdapQbBa2WhLdBiH2D8Uj,3VkHkmOtom3jM2wCu94xgzzu1d6Dn7or,1,0,0,0,0,0,1,0,1,0.14285714285714285,1,0.0,0,0,0,0,0,0,0,1,0,0,1,1
7404,98231,S0tBPyosNVcd5iV87PahIGIe14TwUuJG,3VkHkmOtom3jM2wCu94xgzzu1d6Dn7or,4,3,1,0,2,0,1,0,7,1.0,1,0.0,0,1,0,2,3,0,0,1,0,3,4,1
7405,98250,Yhzt57ERvxf6GSoktyXqqveoccrAAX58,3VkHkmOtom3jM2wCu94xgzzu1d6Dn7or,1,0,0,0,0,0,1,0,1,0.14285714285714285,1,0.0,0,0,0,0,0,0,0,1,0,0,1,0
7406,98283,Rpqg9P88bPENhqF4ssy9Vus2UdJpa2gS,3VkHkmOtom3jM2wCu94xgzzu1d6Dn7or,39,141,45,52,29,26,19,3,315,45.0,7,0.0,41,45,50,29,100,26,2,19,3,165,150,1
7407,98330,eHgUt0UwvV0VhzTIYRH6GzapRWyNHi93,3VkHkmOtom3jM2wCu94xgzzu1d6Dn7or,3,2,0,0,0,0,1,0,3,0.42857142857142855,1,0.0,0,0,0,0,2,0,0,1,0,0,3,0
7408,98354,zjfRXzwfNIBGbyKSYoRe2YGJ584ezl3u,3VkHkmOtom3jM2wCu94xgzzu1d6Dn7or,4,0,0,0,0,2,4,0,6,0.8571428571428571,1,0.0,0,0,0,0,0,2,0,4,0,0,6,1
7409,98414,cePZXTMU8bX7HNyM6y6bVRMghrWRlwbt,3VkHkmOtom3jM2wCu94xgzzu1d6Dn7or,8,7,4,0,1,0,8,0,20,2.857142857142857,4,0.0,0,4,0,1,7,0,0,8,0,5,15,0
7410,98453,ZSzUjI43nc7UP7nA90at0ILPF5htFxqb,3VkHkmOtom3jM2wCu94xgzzu1d6Dn7or,9,4,3,0,3,0,7,0,17,2.4285714285714284,2,0.0,0,3,0,3,4,0,0,7,0,6,11,1
7411,98497,sYzJwN5kchvV5MDWtabtkHuh04wAlcRP,3VkHkmOtom3jM2wCu94xgzzu1d6Dn7or,6,5,3,0,2,0,6,0,16,2.2857142857142856,1,0.0,0,3,0,2,5,0,0,6,0,5,11,1
7412,98537,JdnAKegVyobYzWIb05yj4GZ7Vu8KLm6L,3VkHkmOtom3jM2wCu94xgzzu1d6Dn7or,18,33,9,8,12,19,24,0,105,15.0,1,0.0,19,9,7,12,14,19,1,24,0,47,58,1
7413,98625,XPiygQf4f2L0UgTrmMFFqxeKe6BZR3ej,3VkHkmOtom3jM2wCu94xgzzu1d6Dn7or,1,0,0,0,0,0,1,0,1,0.14285714285714285,1,0.0,0,0,0,0,0,0,0,1,0,0,1,1
7414,98758,iNmVC3DKFHfjgZSKABDd7IUAUNxDakXU,3VkHkmOtom3jM2wCu94xgzzu1d6Dn7or,7,9,4,2,4,0,1,0,20,2.857142857142857,1,0.0,4,4,2,4,5,0,0,1,0,14,6,1
7415,98760,rWol7hEiEuUpnZ0ibUv4aNnaeGzwARsw,3VkHkmOtom3jM2wCu94xgzzu1d6Dn7or,2,0,0,0,0,0,3,0,3,0.42857142857142855,1,0.0,0,0,0,0,0,0,0,3,0,0,3,1
7416,98778,Fb4URbfUO5USbMNTAtAoU1u178CKFwVo,3VkHkmOtom3jM2wCu94xgzzu1d6Dn7or,8,7,3,0,2,1,9,1,23,3.2857142857142856,2,0.0,0,3,0,2,7,1,0,9,1,5,18,1
7417,98794,oJ0e8Gg5W4q19gCqNR0VDu9RrnQl36js,3VkHkmOtom3jM2wCu94xgzzu1d6Dn7or,1,0,0,0,0,0,1,0,1,0.14285714285714285,1,0.0,0,0,0,0,0,0,0,1,0,0,1,1
7418,98810,bmM3jdkdNUNaPSRsgAKKNTDhfyA7XqWJ,3VkHkmOtom3jM2wCu94xgzzu1d6Dn7or,1,0,0,0,0,0,1,0,1,0.14285714285714285,1,0.0,0,0,0,0,0,0,0,1,0,0,1,1
7419,98816,6cHPiLDy925kya7u5yKBPmN9vGck1Edm,3VkHkmOtom3jM2wCu94xgzzu1d6Dn7or,7,7,2,0,4,0,2,0,15,2.142857142857143,1,0.0,2,2,0,4,5,0,0,2,0,8,7,1
7420,98836,i90DEJVTzM2ogFaLIi9atsn1Hoj1WpWL,3VkHkmOtom3jM2wCu94xgzzu1d6Dn7or,4,2,1,0,1,0,1,0,5,0.7142857142857143,1,0.0,0,1,0,1,2,0,0,1,0,2,3,0
7421,98837,srCmPgynCXjAmKOXXpaqGyGvobGqB8iu,3VkHkmOtom3jM2wCu94xgzzu1d6Dn7or,46,146,1,77,4,0,15,1,244,34.857142857142854,3,0.0,70,1,77,4,76,0,0,15,1,152,92,0
7422,98868,OvtFK9fZDazZHSZfHJFNzZShaT3svtVk,3VkHkmOtom3jM2wCu94xgzzu1d6Dn7or,4,2,0,0,1,0,1,0,4,0.5714285714285714,1,0.0,0,0,0,1,2,0,0,1,0,1,3,1
7423,98918,DUI5Pj6CvQUDnDmnbtTuT3AqIQLmCvbp,3VkHkmOtom3jM2wCu94xgzzu1d6Dn7or,1,0,0,0,0,0,2,0,2,0.2857142857142857,2,0.0,0,0,0,0,0,0,0,2,0,0,2,1
7424,98943,3GTJVwpejfuxIInftaaUc0uuiqyYtFQY,3VkHkmOtom3jM2wCu94xgzzu1d6Dn7or,1,0,0,0,0,0,1,0,1,0.14285714285714285,1,0.0,0,0,0,0,0,0,0,1,0,0,1,1
7425,98953,lcykm3uj0WkC2rJwnpw8jWVXHYstRrPs,bWdj2GDclj5ofokWjzoa5jAwMkxCykd6,2,0,0,0,0,0,2,0,2,0.2857142857142857,1,0.0,0,0,0,0,0,0,0,2,0,0,2,1
7426,98956,O2hEYcKpW3bz7TyhhkMeHOTvhvdMjulM,bWdj2GDclj5ofokWjzoa5jAwMkxCykd6,5,6,1,0,1,0,1,0,9,1.2857142857142858,1,0.0,0,1,0,1,6,0,0,1,0,2,7,1
7427,98966,oy7Pg8T5wy30VY5zamAkBAwv1iuWjap6,RXDvfPUBYFlVdlueBFbLW0mhhAyGEqpt,11,9,5,0,3,0,3,0,20,2.857142857142857,1,0.0,0,5,0,3,9,0,0,3,0,8,12,1
7428,98978,RbFI9SCNoIyFjKexw9cTU5NZ0thYBnL5,bWdj2GDclj5ofokWjzoa5jAwMkxCykd6,6,2,1,0,1,0,3,0,7,1.0,1,0.0,0,1,0,1,2,0,0,3,0,2,5,1
7429,98994,m30r8XAusN1tKwuw4RNeOZUufFJ19O18,RXDvfPUBYFlVdlueBFbLW0mhhAyGEqpt,1,0,0,0,0,0,1,0,1,0.14285714285714285,1,0.0,0,0,0,0,0,0,0,1,0,0,1,1
7430,98997,514TWhkGGUhLu2MdvTnb8eiBH3DCFHzg,A3fsA9Zfv1X2fVEQhTw51lKENdNrEqT3,10,11,6,0,3,1,3,0,24,3.4285714285714284,3,0.0,0,6,0,3,11,1,0,3,0,9,15,1
7431,99000,JqdbZyx8jQDjvl0RCDBDldcliaXwceyv,bWdj2GDclj5ofokWjzoa5jAwMkxCykd6,8,8,2,0,2,0,2,0,14,2.0,1,0.0,0,2,0,2,8,0,0,2,0,4,10,1
7432,99004,nqSx2YqVg8XBgQNFVkp5HECPuoyoztFf,SpATywNh6bZuzm8s1ceuBUnMUAeoAHHw,1,0,0,0,0,0,1,0,1,0.14285714285714285,1,0.0,0,0,0,0,0,0,0,1,0,0,1,1
7433,99008,udqxlb4h6NzlXvNGaijkJTXRrNX6DSPh,SpATywNh6bZuzm8s1ceuBUnMUAeoAHHw,1,0,0,0,0,0,1,0,1,0.14285714285714285,1,0.0,0,0,0,0,0,0,0,1,0,0,1,1
7434,99015,fe6JA2o6NTgNBdf1OgbAshmKUEnJCT1r,bWdj2GDclj5ofokWjzoa5jAwMkxCykd6,8,20,3,0,2,6,5,1,37,5.285714285714286,3,0.0,8,3,0,2,12,6,0,5,1,13,24,1
7435,99032,Ya8dmcUSDz09ym2vaNemTt41Djt01YaN,SpATywNh6bZuzm8s1ceuBUnMUAeoAHHw,5,5,1,0,1,0,2,0,9,1.2857142857142858,1,0.0,0,1,0,1,5,0,0,2,0,2,7,1
7436,99052,XzLXD7FWHRTDP7XVgC5p2Do9UmUukeQz,SpATywNh6bZuzm8s1ceuBUnMUAeoAHHw,3,3,0,0,0,0,1,0,4,0.5714285714285714,1,0.0,0,0,0,0,3,0,0,1,0,0,4,1
7437,99055,cR6ka5k7tAsfYo9cLOUPkpzWO6OItcGJ,SpATywNh6bZuzm8s1ceuBUnMUAeoAHHw,32,45,28,36,10,23,27,1,170,24.285714285714285,6,0.0,5,28,33,10,40,23,3,27,1,76,94,1
7438,99062,jP3AB3LItmtaoVvn4CaCoqw1w2QWhLKQ,G8EPVSXsOYB5YQWZGiz1aVq5Pgr2GrQu,27,41,0,106,2,1,14,1,165,23.571428571428573,1,0.0,20,0,84,2,21,1,22,14,1,106,59,1
7439,99068,T3sGbyIt0UjiteEMsVXGzcCDHseJZwlW,A3fsA9Zfv1X2fVEQhTw51lKENdNrEqT3,1,0,0,0,0,0,1,0,1,0.14285714285714285,1,0.0,0,0,0,0,0,0,0,1,0,0,1,1
7440,99071,Ein91FWFv0A9qDhWUbZlH2368EmphQmt,SpATywNh6bZuzm8s1ceuBUnMUAeoAHHw,11,10,1,15,0,0,3,0,29,4.142857142857143,1,0.0,5,1,12,0,5,0,3,3,0,18,11,1
7441,99093,XZ82RV9AD9npmDtj5hyoVvxIFU4kzejE,SpATywNh6bZuzm8s1ceuBUnMUAeoAHHw,5,3,1,0,1,0,1,0,6,0.8571428571428571,1,0.0,0,1,0,1,3,0,0,1,0,2,4,1
7442,99105,hCxVGafW6uZuzswuD2GRzZf6ODUAaVFJ,bWdj2GDclj5ofokWjzoa5jAwMkxCykd6,2,0,0,0,0,0,4,0,4,0.5714285714285714,1,0.0,0,0,0,0,0,0,0,4,0,0,4,0
7443,99124,DVOHqEW2vUL1QpZynG6huVjAWwl1vI6M,G8EPVSXsOYB5YQWZGiz1aVq5Pgr2GrQu,27,26,21,56,9,0,6,0,118,16.857142857142858,3,0.0,0,21,42,9,26,0,14,6,0,72,46,1
7444,99128,vGk4gKtQutULkRGPcSts7AdXqOR6DK2Z,RXDvfPUBYFlVdlueBFbLW0mhhAyGEqpt,10,9,7,0,4,0,3,0,23,3.2857142857142856,1,0.0,0,7,0,4,9,0,0,3,0,11,12,1
7445,99131,jVKznnDuZGyXtBgvnWMRtPXsgImk4qlt,SpATywNh6bZuzm8s1ceuBUnMUAeoAHHw,7,4,1,0,1,0,4,0,10,1.4285714285714286,1,0.0,0,1,0,1,4,0,0,4,0,2,8,1
7446,99138,eww5R49fPAYUK2L57nGKDp5FexxMvqZv,bWdj2GDclj5ofokWjzoa5jAwMkxCykd6,7,6,3,0,3,1,10,1,24,3.4285714285714284,1,0.0,2,3,0,3,4,1,0,10,1,8,16,1
7447,99147,1j3W4Jw1KafoLSgTmOItRSa20eh1CtOK,SpATywNh6bZuzm8s1ceuBUnMUAeoAHHw,1,0,0,0,0,0,1,0,1,0.14285714285714285,1,0.0,0,0,0,0,0,0,0,1,0,0,1,1
7448,99165,NojuWwUw3FQaTJhIEuVtN6uUtxeXYBaz,A3fsA9Zfv1X2fVEQhTw51lKENdNrEqT3,1,0,0,0,0,0,1,0,1,0.14285714285714285,1,0.0,0,0,0,0,0,0,0,1,0,0,1,1
7449,99182,N0P6Yrg1zRuUPyVufFpM0ZExnJnGTKKG,bWdj2GDclj5ofokWjzoa5jAwMkxCykd6,16,18,1,52,3,0,5,0,79,11.285714285714286,1,0.0,7,1,45,3,11,0,7,5,0,56,23,1
7450,99193,mS4KVP7r7MB15ORyOGtOcG2IZUAuYo4F,SpATywNh6bZuzm8s1ceuBUnMUAeoAHHw,4,3,1,0,0,0,2,0,6,0.8571428571428571,1,0.0,0,1,0,0,3,0,0,2,0,1,5,1
7451,99198,KUppVPuFnFs0vLCUrPJOIfquMy1mUooq,bWdj2GDclj5ofokWjzoa5jAwMkxCykd6,12,7,4,26,0,0,3,0,40,5.714285714285714,1,0.0,3,4,25,0,4,0,1,3,0,32,8,1
7452,99204,cKCzrCCCXe9nkBgWepq9AEXje7SITRTz,bWdj2GDclj5ofokWjzoa5jAwMkxCykd6,1,0,0,0,0,0,2,0,2,0.2857142857142857,2,0.0,0,0,0,0,0,0,0,2,0,0,2,1
7453,99206,cKCzrCCCXe9nkBgWepq9AEXje7SITRTz,G8EPVSXsOYB5YQWZGiz1aVq5Pgr2GrQu,1,0,0,0,0,0,2,0,2,0.2857142857142857,2,0.0,0,0,0,0,0,0,0,2,0,0,2,1
7454,99214,cKCzrCCCXe9nkBgWepq9AEXje7SITRTz,A3fsA9Zfv1X2fVEQhTw51lKENdNrEqT3,1,0,0,0,0,0,2,0,2,0.2857142857142857,2,0.0,0,0,0,0,0,0,0,2,0,0,2,1
7455,99221,wMqCiRTcG9DrOFV3mIQWVG2TWCqZLDsf,G8EPVSXsOYB5YQWZGiz1aVq5Pgr2GrQu,10,8,5,0,2,44,9,1,69,9.857142857142858,3,0.0,0,5,0,2,8,44,0,9,1,7,62,1
7456,99223,TBKTMcAi6pddCN8hy5SiGUXjC5YxeY5H,SpATywNh6bZuzm8s1ceuBUnMUAeoAHHw,8,2,1,0,1,0,6,0,10,1.4285714285714286,1,0.0,0,1,0,1,2,0,0,6,0,2,8,1
7457,99232,cdtMETRRUGW6e2sQh5Xd2C69HmYkARZ5,SpATywNh6bZuzm8s1ceuBUnMUAeoAHHw,7,6,0,0,0,1,3,0,10,1.4285714285714286,1,0.0,0,0,0,0,6,1,0,3,0,0,10,1
7458,99237,LHfLvP0G4hEksRdVPdjxg85LuBgQzx3S,bWdj2GDclj5ofokWjzoa5jAwMkxCykd6,13,13,1,38,1,52,14,1,120,17.142857142857142,3,0.0,7,1,36,1,6,52,2,14,1,45,75,0
7459,99243,T0WYTVwYJgFl0x8drZ3acqWyc5rt9vgS,A3fsA9Zfv1X2fVEQhTw51lKENdNrEqT3,1,0,0,0,0,0,1,0,1,0.14285714285714285,1,0.0,0,0,0,0,0,0,0,1,0,0,1,1
7460,99269,Ft3L9H2tidLSHsWi4FR179aCWB2oFssD,SpATywNh6bZuzm8s1ceuBUnMUAeoAHHw,9,3,2,0,2,0,6,0,13,1.8571428571428572,2,0.0,0,2,0,2,3,0,0,6,0,4,9,1
7461,99280,Zm35PP1kxKgQnBdrsL9FDU6gwqPBncBy,A3fsA9Zfv1X2fVEQhTw51lKENdNrEqT3,1,0,0,0,0,0,2,0,2,0.2857142857142857,1,0.0,0,0,0,0,0,0,0,2,0,0,2,1
7462,99292,KQNAn65G00s1hNhpNIZbIlQjdMIvn0te,G8EPVSXsOYB5YQWZGiz1aVq5Pgr2GrQu,2,0,0,0,0,2,1,0,3,0.42857142857142855,1,0.0,0,0,0,0,0,2,0,1,0,0,3,1
7463,99336,3gXjYz3VFr0TvsDYUgKtksPt5WrPBmEo,SpATywNh6bZuzm8s1ceuBUnMUAeoAHHw,34,65,34,22,13,0,18,0,152,21.714285714285715,10,0.0,12,34,21,13,53,0,1,18,0,80,72,0
7464,99371,7M1gTpajHgYWFRBJBTE3YPlAjNYb9gfx,G8EPVSXsOYB5YQWZGiz1aVq5Pgr2GrQu,1,0,0,0,0,0,1,0,1,0.14285714285714285,1,0.0,0,0,0,0,0,0,0,1,0,0,1,1
7465,99373,hJa6EP3vokxemW59iPrCWIQh0FEzTU7g,SpATywNh6bZuzm8s1ceuBUnMUAeoAHHw,10,11,1,17,1,0,2,0,32,4.571428571428571,1,0.0,6,1,15,1,5,0,2,2,0,23,9,1
7466,99376,aj90O66SXOM5h12FqdZrbSHiEhNvI2bA,SpATywNh6bZuzm8s1ceuBUnMUAeoAHHw,7,3,1,0,1,0,4,0,9,1.2857142857142858,1,0.0,1,1,0,1,2,0,0,4,0,3,6,1
7467,99400,q7MIcgFTiHmr8BKHm7XlaHNh6w8Fx7eG,A3fsA9Zfv1X2fVEQhTw51lKENdNrEqT3,1,0,0,0,0,0,1,0,1,0.14285714285714285,1,0.0,0,0,0,0,0,0,0,1,0,0,1,1
7468,99403,BSIRDTutz8KkNQ3VOx9kKk09R8urb0Ri,A3fsA9Zfv1X2fVEQhTw51lKENdNrEqT3,16,23,10,0,9,2,4,0,48,6.857142857142857,2,0.0,1,10,0,9,22,2,0,4,0,20,28,1
7469,99407,pC4iK2nDWej1Ecj7cZAC5BA8XCgOmZJi,bWdj2GDclj5ofokWjzoa5jAwMkxCykd6,3,0,0,0,0,1,2,0,3,0.42857142857142855,1,0.0,0,0,0,0,0,1,0,2,0,0,3,1
7470,99414,FbLnPRUJ3cO7BepRzJ4PsDHt79T7vpl0,SpATywNh6bZuzm8s1ceuBUnMUAeoAHHw,13,31,10,16,4,10,4,0,75,10.714285714285714,3,0.0,12,10,14,4,19,10,2,4,0,40,35,1
7471,99417,rAtBVPfi6wGHmo9go039lvWtKolaTQH4,SpATywNh6bZuzm8s1ceuBUnMUAeoAHHw,9,15,2,6,0,1,3,0,27,3.857142857142857,2,0.0,2,2,5,0,13,1,1,3,0,9,18,1
7472,99426,Uij5k6d5krJ4mWqsJUOAHKJ3rKlnctQu,A3fsA9Zfv1X2fVEQhTw51lKENdNrEqT3,1,0,0,0,0,0,1,0,1,0.14285714285714285,1,0.0,0,0,0,0,0,0,0,1,0,0,1,1
7473,99448,OLHje3sy9oD0UuSdVmOH9aE7DHL6V9Rf,G8EPVSXsOYB5YQWZGiz1aVq5Pgr2GrQu,2,0,0,0,0,0,3,0,3,0.42857142857142855,1,0.0,0,0,0,0,0,0,0,3,0,0,3,1
7474,99455,FBwWi8qV5T9PVUUQgTFb6EjAi12CMavu,SpATywNh6bZuzm8s1ceuBUnMUAeoAHHw,1,0,0,0,0,0,1,0,1,0.14285714285714285,1,0.0,0,0,0,0,0,0,0,1,0,0,1,1
7475,99464,VFYk1GyeJyGqK1t09cLe0E5m7KsULmvc,SpATywNh6bZuzm8s1ceuBUnMUAeoAHHw,25,52,28,4,14,6,13,1,118,16.857142857142858,9,0.0,0,28,3,14,52,6,1,13,1,45,73,1
7476,99470,H1SXscwZbeBIGdJtjznbLlFWKEefKgS4,A3fsA9Zfv1X2fVEQhTw51lKENdNrEqT3,9,7,3,0,3,0,4,0,17,2.4285714285714284,2,0.0,0,3,0,3,7,0,0,4,0,6,11,1
7477,99505,dDLv4oouOmVB45Y4hnRyV7IUqT7tMKiq,bWdj2GDclj5ofokWjzoa5jAwMkxCykd6,5,2,1,0,1,1,3,0,8,1.1428571428571428,1,0.0,0,1,0,1,2,1,0,3,0,2,6,1
7478,99527,4wk7mOQJdY2Tc4re4huOqsVY4BWqzpwG,SpATywNh6bZuzm8s1ceuBUnMUAeoAHHw,6,4,1,0,1,0,2,0,8,1.1428571428571428,1,0.0,0,1,0,1,4,0,0,2,0,2,6,1
7479,99558,qxVdjGWmrHaAXtxLFdUqWOB5LTvLLOy9,SpATywNh6bZuzm8s1ceuBUnMUAeoAHHw,13,15,1,3,0,8,7,0,34,4.857142857142857,1,0.0,6,1,3,0,9,8,0,7,0,10,24,1
7480,99566,WpcBrbawQCY5l6KXuhzbDIXB3ksftawE,SpATywNh6bZuzm8s1ceuBUnMUAeoAHHw,9,15,0,8,0,0,1,0,24,3.4285714285714284,1,0.0,10,0,8,0,5,0,0,1,0,18,6,1
7481,99568,oRL4hbvIrWhhsMx6uS8zWxFrJBWT9qS8,SpATywNh6bZuzm8s1ceuBUnMUAeoAHHw,8,2,1,0,1,1,6,1,12,1.7142857142857142,1,0.0,0,1,0,1,2,1,0,6,1,2,10,1
7482,99583,qe1lbudcDc26TUDIjWwsWCMadyJdvBEX,G8EPVSXsOYB5YQWZGiz1aVq5Pgr2GrQu,4,2,1,0,1,0,1,0,5,0.7142857142857143,1,0.0,0,1,0,1,2,0,0,1,0,2,3,1
7483,99663,9jzVaD1WPdcDwGhb2eIEjRQirdvM6f1C,bWdj2GDclj5ofokWjzoa5jAwMkxCykd6,1,0,0,0,0,0,1,0,1,0.14285714285714285,1,0.0,0,0,0,0,0,0,0,1,0,0,1,1
7484,99677,IL1F6pxCqZ5QZxZqthAXWrxFzw6RlKfD,SpATywNh6bZuzm8s1ceuBUnMUAeoAHHw,4,2,1,0,1,0,1,0,5,0.7142857142857143,1,0.0,0,1,0,1,2,0,0,1,0,2,3,1
7485,99682,MKYE6pEwq1YWgBTN9g77yl7jNJ14fFVC,SpATywNh6bZuzm8s1ceuBUnMUAeoAHHw,13,9,0,15,0,4,7,1,36,5.142857142857143,2,0.0,2,0,13,0,7,4,2,7,1,15,21,1
7486,99697,nGESIoGySD5XO5mI6jFhqZA6YIAniYb4,SpATywNh6bZuzm8s1ceuBUnMUAeoAHHw,5,2,0,0,0,0,3,1,6,0.8571428571428571,1,0.0,0,0,0,0,2,0,0,3,1,0,6,1
7487,99707,xg8dkQPzve0MzcpgxvEsbKyY4VwKrxAC,bWdj2GDclj5ofokWjzoa5jAwMkxCykd6,2,0,0,0,0,0,2,0,2,0.2857142857142857,1,0.0,0,0,0,0,0,0,0,2,0,0,2,1
7488,99721,i4u0VWs6ASAfOx6UbgpWUmxBkJHoZ0lf,SpATywNh6bZuzm8s1ceuBUnMUAeoAHHw,11,29,1,8,0,6,7,0,51,7.285714285714286,2,0.0,2,1,7,0,27,6,1,7,0,10,41,1
7489,99722,F5WXvUA8z1Vfdvlva1pujweut7tGE04r,A3fsA9Zfv1X2fVEQhTw51lKENdNrEqT3,6,3,1,0,0,2,5,1,12,1.7142857142857142,3,0.0,0,1,0,0,3,2,0,5,1,1,11,1
7490,99746,wfbRnjTCW6bqPFwlexPPeehj3HWJM2LV,SpATywNh6bZuzm8s1ceuBUnMUAeoAHHw,6,5,1,0,0,2,3,1,12,1.7142857142857142,1,0.0,0,1,0,0,5,2,0,3,1,1,11,1
7491,99776,s1C9M00kZ3td5Y1QHJpo6evzlHG7Bu17,A3fsA9Zfv1X2fVEQhTw51lKENdNrEqT3,1,0,0,0,0,0,1,0,1,0.14285714285714285,1,0.0,0,0,0,0,0,0,0,1,0,0,1,1
7492,99777,1umo7etGwkx7NcpFxVialzDD37NdyqRT,SpATywNh6bZuzm8s1ceuBUnMUAeoAHHw,14,23,9,12,4,1,4,0,53,7.571428571428571,3,0.0,11,9,12,4,12,1,0,4,0,36,17,0
7493,99801,Z4v9dtdXvLGvBdUbEHKilzESZFJ5MomJ,A3fsA9Zfv1X2fVEQhTw51lKENdNrEqT3,1,0,0,0,0,0,1,0,1,0.14285714285714285,1,0.0,0,0,0,0,0,0,0,1,0,0,1,1
7494,99803,wRn9VzYdznEJJbl33573ksufDlNbloBs,SpATywNh6bZuzm8s1ceuBUnMUAeoAHHw,1,0,0,0,0,0,1,0,1,0.14285714285714285,1,0.0,0,0,0,0,0,0,0,1,0,0,1,1
7495,99820,FW9yCFN4uGknAcdu3E5QkbxhIgnspzES,bWdj2GDclj5ofokWjzoa5jAwMkxCykd6,1,0,0,0,0,0,1,0,1,0.14285714285714285,1,0.0,0,0,0,0,0,0,0,1,0,0,1,1
7496,99830,l0hVKXTPSdIHJhYbRQF17YM8eZTkWoXS,SpATywNh6bZuzm8s1ceuBUnMUAeoAHHw,3,2,0,0,0,0,2,0,4,0.5714285714285714,1,0.0,0,0,0,0,2,0,0,2,0,0,4,1
7497,99841,l0hVKXTPSdIHJhYbRQF17YM8eZTkWoXS,bWdj2GDclj5ofokWjzoa5jAwMkxCykd6,1,0,0,0,0,0,1,0,1,0.14285714285714285,1,0.0,0,0,0,0,0,0,0,1,0,0,1,1
7498,99845,neKK2ykNimyF7kqeZQOYIIEzgIv0MPcH,RXDvfPUBYFlVdlueBFbLW0mhhAyGEqpt,5,2,1,0,1,0,2,0,6,0.8571428571428571,1,0.0,0,1,0,1,2,0,0,2,0,2,4,1
7499,99854,FQLZyFqiWjNudHf8Xwrwvb0mFmqAZa3g,SpATywNh6bZuzm8s1ceuBUnMUAeoAHHw,1,0,0,0,0,0,1,0,1,0.14285714285714285,1,0.0,0,0,0,0,0,0,0,1,0,0,1,1
7500,99860,Q8SrRVeWzJizOf34g4fWFcHi3GfFJHUN,SpATywNh6bZuzm8s1ceuBUnMUAeoAHHw,23,37,19,20,8,2,10,1,97,13.857142857142858,3,0.0,8,19,17,8,29,2,3,10,1,52,45,1
7501,99868,Qu1AvUJr7Rf2PLTyoAjhLhIJ5dIRQjGn,SpATywNh6bZuzm8s1ceuBUnMUAeoAHHw,8,7,6,0,2,0,2,0,17,2.4285714285714284,1,0.0,0,6,0,2,7,0,0,2,0,8,9,1
7502,99897,Qd7FMxYi2RP0CzetZmwspMbrYY8Z7160,G8EPVSXsOYB5YQWZGiz1aVq5Pgr2GrQu,2,0,0,0,0,0,2,0,2,0.2857142857142857,1,0.0,0,0,0,0,0,0,0,2,0,0,2,1
7503,99912,MW4oBOQoe8OTcAvm3yfi1VDCozBvyTdm,G8EPVSXsOYB5YQWZGiz1aVq5Pgr2GrQu,1,0,0,0,0,0,1,0,1,0.14285714285714285,1,0.0,0,0,0,0,0,0,0,1,0,0,1,1
7504,99931,T0V1MC6bsX3mZxJfTJfqpva6BwB6iZOI,RXDvfPUBYFlVdlueBFbLW0mhhAyGEqpt,4,0,0,0,0,0,3,1,4,0.5714285714285714,1,0.0,0,0,0,0,0,0,0,3,1,0,4,1
7505,99966,cUJIvx4QB7gYkEkbk184VKn3Y3N8dBd7,RXDvfPUBYFlVdlueBFbLW0mhhAyGEqpt,1,0,0,0,0,0,1,0,1,0.14285714285714285,1,0.0,0,0,0,0,0,0,0,1,0,0,1,1
7506,99979,oUNptzxKR6Tg3LMdUCW3RAFgD2fbf3ju,G8EPVSXsOYB5YQWZGiz1aVq5Pgr2GrQu,1,0,0,0,0,0,1,0,1,0.14285714285714285,1,0.0,0,0,0,0,0,0,0,1,0,0,1,1
7507,99981,irIVLRvkXyea4TMdg5wZQ17APoQLOStn,bWdj2GDclj5ofokWjzoa5jAwMkxCykd6,3,2,0,0,0,0,1,0,3,0.42857142857142855,1,0.0,0,0,0,0,2,0,0,1,0,0,3,1
7508,100046,uqIn0vdfJ1SDJCOeCVEAQPRFBBKQA2eB,RXDvfPUBYFlVdlueBFbLW0mhhAyGEqpt,1,0,0,0,0,0,1,0,1,0.14285714285714285,1,0.0,0,0,0,0,0,0,0,1,0,0,1,1
7509,100048,ZmILkESSKwaUf7dlv2MYezsPM9kEgn0g,SpATywNh6bZuzm8s1ceuBUnMUAeoAHHw,1,0,0,0,0,0,1,0,1,0.14285714285714285,1,0.0,0,0,0,0,0,0,0,1,0,0,1,1
7510,100065,C79HFTpOf1aC6aMRuXhus1qHumhqEAFk,SpATywNh6bZuzm8s1ceuBUnMUAeoAHHw,18,24,2,20,2,5,14,1,68,9.714285714285714,3,0.0,6,2,16,2,18,5,4,14,1,26,42,0
7511,100089,9MPGQ80LKMiZcqzI4e7ZT4LxgluBoFal,SpATywNh6bZuzm8s1ceuBUnMUAeoAHHw,12,14,2,0,1,0,6,2,25,3.5714285714285716,1,0.0,4,2,0,1,10,0,0,6,2,7,18,1
7512,100105,MKNBl3hhuuRZuBxyPOWBVV1OHzyXBuxg,SpATywNh6bZuzm8s1ceuBUnMUAeoAHHw,29,64,34,24,11,2,10,0,145,20.714285714285715,6,0.0,10,34,22,11,54,2,2,10,0,77,68,0
7513,100136,zhtf7EZUjW6s3Guz5lXD8KDXJ4lw9cuB,RXDvfPUBYFlVdlueBFbLW0mhhAyGEqpt,18,11,6,31,6,0,4,0,58,8.285714285714286,2,0.0,4,6,29,6,7,0,2,4,0,45,13,1
7514,100176,pfwNUWwL0srYZTJGvtMmP5xqlr01qeDv,bWdj2GDclj5ofokWjzoa5jAwMkxCykd6,4,2,0,0,0,0,9,0,11,1.5714285714285714,2,0.0,0,0,0,0,2,0,0,9,0,0,11,1
7515,100177,CD5yEeFA8Zn4o0HC0sLfKl1HGxKwer5w,A3fsA9Zfv1X2fVEQhTw51lKENdNrEqT3,1,0,0,0,0,0,2,0,2,0.2857142857142857,1,0.0,0,0,0,0,0,0,0,2,0,0,2,1
7516,100200,walE7JsvJqHl8yLz0PR8Oim32Lz4OIQ0,SpATywNh6bZuzm8s1ceuBUnMUAeoAHHw,18,36,6,14,1,20,23,1,101,14.428571428571429,3,0.0,19,6,13,1,17,20,1,23,1,39,62,1
7517,100208,oakvvUa4BMx0VOuNxMNhZr6bo8hbB626,SpATywNh6bZuzm8s1ceuBUnMUAeoAHHw,4,0,0,0,0,0,4,0,4,0.5714285714285714,1,0.0,0,0,0,0,0,0,0,4,0,0,4,1
7518,100216,iukICc3JPXkGjh0WhluWsphhopQF3KWw,SpATywNh6bZuzm8s1ceuBUnMUAeoAHHw,8,8,4,0,0,0,6,0,18,2.5714285714285716,2,0.0,0,4,0,0,8,0,0,6,0,4,14,1
7519,100243,CyLrnwOuvkEKQhwjogaYhZvzxTeqKBge,A3fsA9Zfv1X2fVEQhTw51lKENdNrEqT3,1,0,0,0,0,0,1,0,1,0.14285714285714285,1,0.0,0,0,0,0,0,0,0,1,0,0,1,1
7520,100244,3jzy20tHqZfBlzIZRWQh7hEsGbNNyC02,SpATywNh6bZuzm8s1ceuBUnMUAeoAHHw,5,2,1,0,1,0,2,0,6,0.8571428571428571,1,0.0,0,1,0,1,2,0,0,2,0,2,4,1
7521,100249,XyoP35cBUiKk44G72mbtEXCBjk8FmHfo,SpATywNh6bZuzm8s1ceuBUnMUAeoAHHw,15,12,6,18,3,3,5,0,47,6.714285714285714,2,0.0,2,6,14,3,10,3,4,5,0,25,22,1
7522,100257,8IdCnPo0KQab6PkHRu5Y6zvRlgGVQPUd,RXDvfPUBYFlVdlueBFbLW0mhhAyGEqpt,21,100,22,0,17,0,8,0,147,21.0,3,0.0,7,22,0,17,93,0,0,8,0,46,101,1
7523,100265,McYATdhZDDMDpni6a4GbjI06ustMpvdV,SpATywNh6bZuzm8s1ceuBUnMUAeoAHHw,3,0,0,0,0,1,2,0,3,0.42857142857142855,2,0.0,0,0,0,0,0,1,0,2,0,0,3,1
7524,100266,n2r6kyDnsWpbtliBFHcr0YWSTfVt0HhQ,G8EPVSXsOYB5YQWZGiz1aVq5Pgr2GrQu,17,18,1,12,1,1,5,1,39,5.571428571428571,2,0.0,8,1,6,1,10,1,6,5,1,16,23,1
7525,100294,G7KJV0aUuu9N2GhQ0BQmtfVIkYBSsISM,SpATywNh6bZuzm8s1ceuBUnMUAeoAHHw,32,92,46,22,23,2,11,0,196,28.0,4,0.0,13,46,21,23,79,2,1,11,0,103,93,1
7526,100360,09033btLbIofAoxmgr9GoACTYHCpwfe7,SpATywNh6bZuzm8s1ceuBUnMUAeoAHHw,5,3,1,0,1,0,1,0,6,0.8571428571428571,1,0.0,0,1,0,1,3,0,0,1,0,2,4,1
7527,100375,FMxvsapRPXXXNxGG3GDsHR7zl4E2ofKu,A3fsA9Zfv1X2fVEQhTw51lKENdNrEqT3,1,0,0,0,0,0,2,0,2,0.2857142857142857,1,0.0,0,0,0,0,0,0,0,2,0,0,2,1
7528,100382,dDpqWlhYBkdNBy4JfnDE71OkEoQKGKDx,bWdj2GDclj5ofokWjzoa5jAwMkxCykd6,10,6,3,4,3,0,4,0,20,2.857142857142857,1,0.0,2,3,4,3,4,0,0,4,0,12,8,0
7529,100389,Q9YOU7BuWjkOYwh9pr1oIgYKYXPPRz5K,RXDvfPUBYFlVdlueBFbLW0mhhAyGEqpt,49,47,26,109,16,2,7,0,207,29.571428571428573,7,0.0,13,26,101,16,34,2,8,7,0,156,51,0
7530,100462,MRV5bQ8CaXcdaRHJL4krm33UMDJEAYUq,SpATywNh6bZuzm8s1ceuBUnMUAeoAHHw,1,0,0,0,0,0,1,0,1,0.14285714285714285,1,0.0,0,0,0,0,0,0,0,1,0,0,1,1
7531,100518,6DFg8IrvITdyV3FmRQrzgnl2oAgir5Pb,SpATywNh6bZuzm8s1ceuBUnMUAeoAHHw,28,43,12,24,6,13,21,1,120,17.142857142857142,5,0.0,8,12,21,6,35,13,3,21,1,47,73,0
7532,100563,IVE4TocWI6FDY4RoOKamDYCfOcH2PbRL,SpATywNh6bZuzm8s1ceuBUnMUAeoAHHw,12,26,0,15,0,25,5,0,71,10.142857142857142,1,0.0,18,0,15,0,8,25,0,5,0,33,38,1
7533,100566,O9Ff0eipZjXCZhuBVdpYtN4eMe1OZ5wo,SpATywNh6bZuzm8s1ceuBUnMUAeoAHHw,5,3,1,0,1,0,2,0,7,1.0,1,0.0,0,1,0,1,3,0,0,2,0,2,5,1
7534,100567,Is7lqncTs1EDN9QmzrTbcU6KnB0BCGNX,SpATywNh6bZuzm8s1ceuBUnMUAeoAHHw,11,11,5,0,3,1,9,1,30,4.285714285714286,2,0.0,3,5,0,3,8,1,0,9,1,11,19,1
7535,100592,1W42KMSdpCt6ldPd7y6qVJ23jr8xz7L8,SpATywNh6bZuzm8s1ceuBUnMUAeoAHHw,5,3,1,0,1,0,2,0,7,1.0,1,0.0,1,1,0,1,2,0,0,2,0,3,4,1
7536,100595,MdGTO2svRwIj7bz3FYKLlYB5eW0NcpSb,SpATywNh6bZuzm8s1ceuBUnMUAeoAHHw,16,17,7,20,4,0,5,1,54,7.714285714285714,1,0.0,5,7,16,4,12,0,4,5,1,32,22,0
7537,100611,qrBxOx4xvfJbTRNtYXFo4mMHRch3LE9R,A3fsA9Zfv1X2fVEQhTw51lKENdNrEqT3,1,0,0,0,0,0,1,0,1,0.14285714285714285,1,0.0,0,0,0,0,0,0,0,1,0,0,1,1
7538,100640,NfAbLg5OeUTUtF15GhHCETvzoFPtTDPd,SpATywNh6bZuzm8s1ceuBUnMUAeoAHHw,36,52,3,44,0,25,31,0,155,22.142857142857142,8,0.0,11,3,40,0,41,25,4,31,0,54,101,1
7539,100662,DfabbQQ3v42eWYnRYIQLMUYykm14gtcZ,A3fsA9Zfv1X2fVEQhTw51lKENdNrEqT3,1,0,0,0,0,0,1,0,1,0.14285714285714285,1,0.0,0,0,0,0,0,0,0,1,0,0,1,1
7540,100670,RApdsmrncG4ay8F6bpKxBswTJBXZ7CEo,SpATywNh6bZuzm8s1ceuBUnMUAeoAHHw,11,7,6,0,9,0,27,0,49,7.0,3,0.0,0,6,0,9,7,0,0,27,0,15,34,1
7541,100686,sFr2RCMewYMYiXOoTtSwzbAYMNnrzmY5,SpATywNh6bZuzm8s1ceuBUnMUAeoAHHw,9,3,3,0,2,0,3,0,11,1.5714285714285714,1,0.0,0,3,0,2,3,0,0,3,0,5,6,1
7542,100711,dGI6yveNenjFfT8c0PjNzk1ugu0VsvkU,SpATywNh6bZuzm8s1ceuBUnMUAeoAHHw,10,6,3,0,3,0,4,1,17,2.4285714285714284,1,0.0,1,3,0,3,5,0,0,4,1,7,10,1
7543,100731,vt827MYpYgT0JKXBC62SZ24Gxa8OJ87k,SpATywNh6bZuzm8s1ceuBUnMUAeoAHHw,4,3,0,0,0,0,2,0,5,0.7142857142857143,1,0.0,0,0,0,0,3,0,0,2,0,0,5,1
7544,100736,uJVJyY1XUciqhggpcXtgNPSVAHeYLBGB,G8EPVSXsOYB5YQWZGiz1aVq5Pgr2GrQu,9,14,4,0,0,0,4,0,22,3.142857142857143,2,0.0,0,4,0,0,14,0,0,4,0,4,18,1
7545,100740,MFMS4D6VcY65iaLs08cZFKnb6UYd2dkX,SpATywNh6bZuzm8s1ceuBUnMUAeoAHHw,1,0,0,0,0,0,1,0,1,0.14285714285714285,1,0.0,0,0,0,0,0,0,0,1,0,0,1,1
7546,100744,tMihxLso3qJJt2vQUNT2SznMjAGohiuT,SpATywNh6bZuzm8s1ceuBUnMUAeoAHHw,7,3,1,0,1,1,5,1,12,1.7142857142857142,1,0.0,0,1,0,1,3,1,0,5,1,2,10,1
7547,100749,1AsQo0zAkltKFUhbJK8sQo8EMtQlw4Zw,A3fsA9Zfv1X2fVEQhTw51lKENdNrEqT3,10,10,6,0,2,2,8,0,28,4.0,5,0.0,0,6,0,2,10,2,0,8,0,8,20,1
7548,100754,UOjfyFlJmFc3i5kjWKRuDpWzrJIEqMHc,SpATywNh6bZuzm8s1ceuBUnMUAeoAHHw,2,0,0,0,0,0,2,0,2,0.2857142857142857,1,0.0,0,0,0,0,0,0,0,2,0,0,2,1
7549,100769,pjSCT01VrN3yLmICdcrZWQnnyzvIOi9x,SpATywNh6bZuzm8s1ceuBUnMUAeoAHHw,1,0,0,0,0,0,1,0,1,0.14285714285714285,1,0.0,0,0,0,0,0,0,0,1,0,0,1,1
7550,100794,Qj3zkBoKOajqBdArgJNrQ3sw89X3j0VX,SpATywNh6bZuzm8s1ceuBUnMUAeoAHHw,6,2,1,0,1,0,4,0,8,1.1428571428571428,1,0.0,0,1,0,1,2,0,0,4,0,2,6,1
7551,100859,xRb4cp7PVGLqlqc7BJgnld2XsE0F6wB3,SpATywNh6bZuzm8s1ceuBUnMUAeoAHHw,20,36,12,13,1,0,7,1,70,10.0,4,0.0,9,12,12,1,27,0,1,7,1,34,36,0
7552,100860,KFG6G55toGAeaWBt5UmyioW5n1NVxSjT,A3fsA9Zfv1X2fVEQhTw51lKENdNrEqT3,1,0,0,0,0,0,1,0,1,0.14285714285714285,1,0.0,0,0,0,0,0,0,0,1,0,0,1,1
7553,100863,VOKNou0BOm9l4CocxGjdRfkeAbtz86uT,SpATywNh6bZuzm8s1ceuBUnMUAeoAHHw,7,7,2,0,0,10,12,3,34,4.857142857142857,2,0.0,1,2,0,0,6,10,0,12,3,3,31,1
7554,100872,ES4n41HdZ3mzmajBMbCDY4C23oBD6LSY,RXDvfPUBYFlVdlueBFbLW0mhhAyGEqpt,19,24,12,0,6,0,4,0,46,6.571428571428571,3,0.0,0,12,0,6,24,0,0,4,0,18,28,1
7555,100885,GpdW10m4i4o8zebocaIwKcYTi9ALrnVK,SpATywNh6bZuzm8s1ceuBUnMUAeoAHHw,1,0,0,0,0,0,2,0,2,0.2857142857142857,1,0.0,0,0,0,0,0,0,0,2,0,0,2,1
7556,100901,3ZkHeNhSscgbNC1k9L8lbe6SROwSZPLx,SpATywNh6bZuzm8s1ceuBUnMUAeoAHHw,4,0,0,0,0,1,8,0,9,1.2857142857142858,1,0.0,0,0,0,0,0,1,0,8,0,0,9,1
7557,100936,QAQOQC9orxaSCK47wTUjk6OT4uXNA4IV,RXDvfPUBYFlVdlueBFbLW0mhhAyGEqpt,1,0,0,0,0,0,1,0,1,0.14285714285714285,1,0.0,0,0,0,0,0,0,0,1,0,0,1,1
7558,100939,QJcScxtP8sOhNP5cvZ8cp3A76mQqjuPz,SpATywNh6bZuzm8s1ceuBUnMUAeoAHHw,5,2,1,0,1,0,2,0,6,0.8571428571428571,1,0.0,0,1,0,1,2,0,0,2,0,2,4,1
7559,100951,dpzYaESA6MCFHXGYe2bLHvSr1kNOP50p,SpATywNh6bZuzm8s1ceuBUnMUAeoAHHw,1,0,0,0,0,0,1,0,1,0.14285714285714285,1,0.0,0,0,0,0,0,0,0,1,0,0,1,1
7560,100967,pdDWSL0qqW5lqoVLDvyIeqmUWuTqLvQ6,bWdj2GDclj5ofokWjzoa5jAwMkxCykd6,2,0,0,0,0,0,2,0,2,0.2857142857142857,1,0.0,0,0,0,0,0,0,0,2,0,0,2,1
7561,100982,1QJEJ5a9sT1rwzf5IhaKshE565OOWiB4,G8EPVSXsOYB5YQWZGiz1aVq5Pgr2GrQu,6,5,2,0,2,0,1,0,10,1.4285714285714286,1,0.0,0,2,0,2,5,0,0,1,0,4,6,1
7562,100989,MaNbEqxyOcaRJ63ZfC9DudJtV0A5y3yK,SpATywNh6bZuzm8s1ceuBUnMUAeoAHHw,26,33,14,46,3,13,11,2,122,17.428571428571427,2,0.0,12,14,38,3,21,13,8,11,2,67,55,0
7563,100992,pdDWSL0qqW5lqoVLDvyIeqmUWuTqLvQ6,A3fsA9Zfv1X2fVEQhTw51lKENdNrEqT3,1,0,0,0,0,0,1,0,1,0.14285714285714285,1,0.0,0,0,0,0,0,0,0,1,0,0,1,1
7564,101003,XPA1Jv5NXHfUcU7CMUA4EKvCqSxl1bO3,RXDvfPUBYFlVdlueBFbLW0mhhAyGEqpt,1,0,0,0,0,0,1,0,1,0.14285714285714285,1,0.0,0,0,0,0,0,0,0,1,0,0,1,1
7565,101033,eWW5LWmp2L4jfpnZTKTrpHZw2NPytGoT,G8EPVSXsOYB5YQWZGiz1aVq5Pgr2GrQu,2,0,0,0,0,0,2,0,2,0.2857142857142857,1,0.0,0,0,0,0,0,0,0,2,0,0,2,1
7566,101041,R5b8KqsMsDfKAxdLfUK6LRx0WUFDD5Xb,bWdj2GDclj5ofokWjzoa5jAwMkxCykd6,10,19,0,10,0,3,4,1,37,5.285714285714286,2,0.0,5,0,9,0,14,3,1,4,1,14,23,1
7567,101044,0MInlyhRLhTct7ctvAmGIMuZ2WCCEQOJ,bWdj2GDclj5ofokWjzoa5jAwMkxCykd6,1,0,0,0,0,0,1,0,1,0.14285714285714285,1,0.0,0,0,0,0,0,0,0,1,0,0,1,1
7568,101045,PCtqctDcjJHl3GW7yk0aug87eqbAmlqT,SpATywNh6bZuzm8s1ceuBUnMUAeoAHHw,24,35,3,32,1,0,10,0,81,11.571428571428571,4,0.0,6,3,28,1,29,0,4,10,0,38,43,1
7569,101047,MhrFHIexWYn2dilUXh03cpnfpoe9tMBe,bWdj2GDclj5ofokWjzoa5jAwMkxCykd6,1,0,0,0,0,0,1,0,1,0.14285714285714285,1,0.0,0,0,0,0,0,0,0,1,0,0,1,1
7570,101059,H4F1BzGEbgWgPoxlFORCSmUf8fAP6V7l,RXDvfPUBYFlVdlueBFbLW0mhhAyGEqpt,13,12,4,6,1,0,7,0,30,4.285714285714286,2,0.0,2,4,6,1,10,0,0,7,0,13,17,1
7571,101074,D9nQsPz9172rPurdQOY1oS88oPJMaAUd,bWdj2GDclj5ofokWjzoa5jAwMkxCykd6,13,40,1,26,2,19,14,0,102,14.571428571428571,3,0.0,7,1,21,2,33,19,5,14,0,31,71,1
7572,101091,NbOkuaMYNn1DiAgigOMCG3fDUQt3bFUa,SpATywNh6bZuzm8s1ceuBUnMUAeoAHHw,13,42,14,13,0,33,13,1,116,16.571428571428573,3,0.0,21,14,13,0,21,33,0,13,1,48,68,1
7573,101098,Jxd0Gyi2eFjuuzujg1eSA5QBX1QonMfb,bWdj2GDclj5ofokWjzoa5jAwMkxCykd6,11,12,10,0,7,0,8,3,40,5.714285714285714,2,0.0,0,10,0,7,12,0,0,8,3,17,23,1
7574,101103,KxUegLpOtUB19LVwgBAOjYKSbicZaJLZ,SpATywNh6bZuzm8s1ceuBUnMUAeoAHHw,5,15,1,0,0,0,4,0,20,2.857142857142857,4,0.0,0,1,0,0,15,0,0,4,0,1,19,0
7575,101112,wnkgyfR4roxhmJZsqCCxH9EfyI2qd5YM,SpATywNh6bZuzm8s1ceuBUnMUAeoAHHw,5,3,2,0,2,0,3,0,10,1.4285714285714286,2,0.0,0,2,0,2,3,0,0,3,0,4,6,1
7576,101122,B0jVKFlvXfKwVR9pXnhJZcf2VbxqeEJP,RXDvfPUBYFlVdlueBFbLW0mhhAyGEqpt,7,3,2,0,2,0,2,0,9,1.2857142857142858,2,0.0,0,2,0,2,3,0,0,2,0,4,5,1
7577,101125,B0jVKFlvXfKwVR9pXnhJZcf2VbxqeEJP,A3fsA9Zfv1X2fVEQhTw51lKENdNrEqT3,1,0,0,0,0,0,1,0,1,0.14285714285714285,1,0.0,0,0,0,0,0,0,0,1,0,0,1,1
7578,101130,4TBbHxtdM6KlXwrDZvHlXfXL45mqy6bL,SpATywNh6bZuzm8s1ceuBUnMUAeoAHHw,13,38,10,0,2,0,12,0,62,8.857142857142858,5,0.0,1,10,0,2,37,0,0,12,0,13,49,1
7579,101137,nnpMilWm5u9YfSzlEw0i8QiLM3F4GePR,G8EPVSXsOYB5YQWZGiz1aVq5Pgr2GrQu,7,1,1,0,1,2,5,1,11,1.5714285714285714,1,0.0,0,1,0,1,1,2,0,5,1,2,9,1
7580,101141,2qEZpMTxWlr35xXuNBb8vvZZiY1soKKq,SpATywNh6bZuzm8s1ceuBUnMUAeoAHHw,5,5,0,0,0,0,4,0,9,1.2857142857142858,1,0.0,0,0,0,0,5,0,0,4,0,0,9,1
7581,101154,fnJf5uFFfrA3RuutRVGe8qQuGwat3ZCQ,SpATywNh6bZuzm8s1ceuBUnMUAeoAHHw,1,0,0,0,0,0,1,0,1,0.14285714285714285,1,0.0,0,0,0,0,0,0,0,1,0,0,1,1
7582,101186,gtKTzkXHwS41ljYVmjlLLf4WyQSkK02q,bWdj2GDclj5ofokWjzoa5jAwMkxCykd6,4,2,1,0,0,0,3,0,6,0.8571428571428571,2,0.0,0,1,0,0,2,0,0,3,0,1,5,1
7583,101189,yrhXE3OyNatOr3jElQ1DJhAKv2cy7Hqx,SpATywNh6bZuzm8s1ceuBUnMUAeoAHHw,1,0,0,0,0,0,1,0,1,0.14285714285714285,1,0.0,0,0,0,0,0,0,0,1,0,0,1,1
7584,101191,yrlVnbrSR0LAW13A08wi2wUW5yoGSw1G,bWdj2GDclj5ofokWjzoa5jAwMkxCykd6,1,0,0,0,0,0,1,0,1,0.14285714285714285,1,0.0,0,0,0,0,0,0,0,1,0,0,1,1
7585,101198,OCAzb1VfLGBRFoguhxZLxVaO4EgntnGi,A3fsA9Zfv1X2fVEQhTw51lKENdNrEqT3,17,14,10,0,7,4,15,1,51,7.285714285714286,3,0.0,0,10,0,7,14,4,0,15,1,17,34,1
7586,101201,YewrI0crAA2lhm09K28QZKb66KLxgFIr,SpATywNh6bZuzm8s1ceuBUnMUAeoAHHw,5,2,1,0,1,0,2,0,6,0.8571428571428571,1,0.0,0,1,0,1,2,0,0,2,0,2,4,1
7587,101219,NIlxh2g7VTAquieuVc9RGErPkOzbSh2Z,A3fsA9Zfv1X2fVEQhTw51lKENdNrEqT3,1,0,0,0,0,0,1,0,1,0.14285714285714285,1,0.0,0,0,0,0,0,0,0,1,0,0,1,1
7588,101223,MwRVXLIjs7ObnboXYRMgXHQa3UWpN5i5,SpATywNh6bZuzm8s1ceuBUnMUAeoAHHw,19,21,15,0,6,0,5,0,47,6.714285714285714,4,0.0,0,15,0,6,21,0,0,5,0,21,26,1
7589,101248,9FCTgAxdOH7TtkaWvHpzLeDt6G1gJ5Bo,bWdj2GDclj5ofokWjzoa5jAwMkxCykd6,14,8,4,20,4,0,8,0,44,6.285714285714286,1,0.0,3,4,19,4,5,0,1,8,0,30,14,1
7590,101259,lgjOCnqMh3jm1TNv306EqOQLtLVGnS97,SpATywNh6bZuzm8s1ceuBUnMUAeoAHHw,4,2,0,0,0,2,2,0,6,0.8571428571428571,1,0.0,0,0,0,0,2,2,0,2,0,0,6,1
7591,101482,nronI72HtraF0IcAJUYxB4sbj9I4wtB0,5Gyp41oLVo7Gg7vF4vpmggWP5MU70QO6,1,0,0,0,0,0,2,0,2,0.2857142857142857,2,0.0,0,0,0,0,0,0,0,2,0,0,2,1
7592,101499,BlsuyeKFU2VPMMTGFaCoOuSyV94B6SeF,5Gyp41oLVo7Gg7vF4vpmggWP5MU70QO6,53,86,47,59,35,32,8,0,267,38.142857142857146,6,0.0,32,47,51,35,54,32,8,8,0,165,102,1
7593,101550,2QctE6rdo1LaDqkwQYQqmOphoXEtx5W7,5Gyp41oLVo7Gg7vF4vpmggWP5MU70QO6,9,3,2,0,2,0,4,0,11,1.5714285714285714,1,0.0,0,2,0,2,3,0,0,4,0,4,7,1
7594,101568,enqsupbW6wxalV5Pbbu4T32tHcMW8xiC,5Gyp41oLVo7Gg7vF4vpmggWP5MU70QO6,25,75,39,13,11,48,19,1,206,29.428571428571427,7,0.0,12,39,9,11,63,48,4,19,1,71,135,1
7595,101573,FPBRzkUZqIAMp3UsJRTJkXS9jn8UZe1l,5Gyp41oLVo7Gg7vF4vpmggWP5MU70QO6,9,4,3,0,3,0,2,0,12,1.7142857142857142,1,0.0,0,3,0,3,4,0,0,2,0,6,6,0
7596,101583,ydIfB5lDuQMdwnqw1Trec6MMfLMb9KME,5Gyp41oLVo7Gg7vF4vpmggWP5MU70QO6,12,10,6,8,4,0,2,0,30,4.285714285714286,1,0.0,3,6,4,4,7,0,4,2,0,17,13,1
7597,101616,bEuPOC49XiMJoVnxjmWOZSVu0LizKFOH,5Gyp41oLVo7Gg7vF4vpmggWP5MU70QO6,5,2,1,0,0,0,8,0,11,1.5714285714285714,2,0.0,0,1,0,0,2,0,0,8,0,1,10,1
7598,101635,BCypREe4Ez2M1svs4InXmDIOnQLgYrig,5Gyp41oLVo7Gg7vF4vpmggWP5MU70QO6,8,6,4,0,2,0,5,0,17,2.4285714285714284,2,0.0,0,4,0,2,6,0,0,5,0,6,11,1
7599,101639,NQ6Ix2SwcCnLtpnFtqWhpEREZe69Ceqp,5Gyp41oLVo7Gg7vF4vpmggWP5MU70QO6,1,0,0,0,0,0,2,0,2,0.2857142857142857,1,0.0,0,0,0,0,0,0,0,2,0,0,2,1
7600,101661,gqWGF9rxxCriQOVTyLfwVi3tPoi4EhzT,5Gyp41oLVo7Gg7vF4vpmggWP5MU70QO6,9,8,5,0,3,0,4,1,21,3.0,3,0.0,0,5,0,3,8,0,0,4,1,8,13,1
7601,101663,W6X8KDI3G9j93D0rZr6DFtxw1WAxSuwU,5Gyp41oLVo7Gg7vF4vpmggWP5MU70QO6,16,26,10,6,6,0,6,0,54,7.714285714285714,4,0.0,7,10,3,6,19,0,3,6,0,26,28,1
7602,101671,Y898vhbvBH5PVqBuh6kbj4egN3sSjMe8,5Gyp41oLVo7Gg7vF4vpmggWP5MU70QO6,6,8,0,0,0,0,2,0,10,1.4285714285714286,1,0.0,0,0,0,0,8,0,0,2,0,0,10,1
7603,101674,pmP1vo676Ls6u06kxeOxjGCjZN5T0bfn,5Gyp41oLVo7Gg7vF4vpmggWP5MU70QO6,1,0,0,0,0,0,1,0,1,0.14285714285714285,1,0.0,0,0,0,0,0,0,0,1,0,0,1,1
7604,101728,mrfbSPt6TRewduryCGdIQWJOC0FeSD76,5Gyp41oLVo7Gg7vF4vpmggWP5MU70QO6,12,20,9,8,3,4,6,1,51,7.285714285714286,2,0.0,8,9,4,3,12,4,4,6,1,24,27,1
7605,101756,MRApUnubAkEydoHvwvXziKhUNAJ5kOVI,5Gyp41oLVo7Gg7vF4vpmggWP5MU70QO6,7,3,2,0,2,0,3,0,10,1.4285714285714286,2,0.0,0,2,0,2,3,0,0,3,0,4,6,1
7606,101779,i3olLzTCOSy296QHUWxv6nRzfUo2ruGH,5Gyp41oLVo7Gg7vF4vpmggWP5MU70QO6,1,0,0,0,0,0,1,0,1,0.14285714285714285,1,0.0,0,0,0,0,0,0,0,1,0,0,1,1
7607,101783,HkE1O3IHrApBWxDCZuUezytwH5GZVstp,5Gyp41oLVo7Gg7vF4vpmggWP5MU70QO6,13,13,5,4,3,0,5,0,30,4.285714285714286,1,0.0,6,5,2,3,7,0,2,5,0,16,14,1
7608,101793,rH7q7jS4VvGmPHmUzUNov2L5WHt7pNcn,5Gyp41oLVo7Gg7vF4vpmggWP5MU70QO6,5,2,1,0,1,0,3,0,7,1.0,1,0.0,0,1,0,1,2,0,0,3,0,2,5,1
7609,101819,FJyrOX14z7chWU6pIsUghN5yUhlIZ5Lj,5Gyp41oLVo7Gg7vF4vpmggWP5MU70QO6,1,0,0,0,0,0,1,0,1,0.14285714285714285,1,0.0,0,0,0,0,0,0,0,1,0,0,1,1
7610,101824,UKG5GO5JWRjFVRMggOgvDIxPiEZzBxAO,5Gyp41oLVo7Gg7vF4vpmggWP5MU70QO6,1,0,0,0,0,0,1,0,1,0.14285714285714285,1,0.0,0,0,0,0,0,0,0,1,0,0,1,1
7611,101846,KKVIEI2lseDGpdoOhUIkkmAMhzuJw0y5,5Gyp41oLVo7Gg7vF4vpmggWP5MU70QO6,7,3,1,0,1,0,4,1,10,1.4285714285714286,1,0.0,0,1,0,1,3,0,0,4,1,2,8,1
7612,101852,JntXNtR3vyFADq0v1flreEKkRmGG9OQK,5Gyp41oLVo7Gg7vF4vpmggWP5MU70QO6,22,16,9,10,5,0,7,0,47,6.714285714285714,1,0.0,6,9,5,5,10,0,5,7,0,25,22,1
7613,101853,7v9i9hr7bP6Iw58vTdCD27LyevNIEkA0,5Gyp41oLVo7Gg7vF4vpmggWP5MU70QO6,51,108,54,42,22,88,32,2,348,49.714285714285715,12,0.0,31,54,32,22,77,88,10,32,2,139,209,0
7614,101945,Lzsz8G97Oqbb3ZBCI5dR9gHrqQ1EH7Ym,5Gyp41oLVo7Gg7vF4vpmggWP5MU70QO6,6,2,1,0,1,0,3,0,7,1.0,1,0.0,0,1,0,1,2,0,0,3,0,2,5,0
7615,101957,FH9y1iT4NiENr1hZ0odOLcMokM3ip1r3,5Gyp41oLVo7Gg7vF4vpmggWP5MU70QO6,8,6,4,0,3,0,2,0,15,2.142857142857143,1,0.0,0,4,0,3,6,0,0,2,0,7,8,1
7616,101959,nLVkMUicIATb5XjlrKkVLbPcf3PrrUv6,5Gyp41oLVo7Gg7vF4vpmggWP5MU70QO6,6,3,2,0,1,0,2,0,8,1.1428571428571428,1,0.0,0,2,0,1,3,0,0,2,0,3,5,1
7617,101984,N7MQqLeQQF4zDfQyfO9HoW1eUpwnTNGv,5Gyp41oLVo7Gg7vF4vpmggWP5MU70QO6,14,20,8,6,4,1,9,1,49,7.0,2,0.0,7,8,3,4,13,1,3,9,1,22,27,1
7618,102021,w35jVHOcytQq9jyvpFqBkMTF83ecmDQt,5Gyp41oLVo7Gg7vF4vpmggWP5MU70QO6,6,5,2,0,2,0,1,0,10,1.4285714285714286,1,0.0,0,2,0,2,5,0,0,1,0,4,6,1
7619,102033,9zKrezPpbRQghh43axqe2AhYxsX9HaSm,5Gyp41oLVo7Gg7vF4vpmggWP5MU70QO6,6,1,1,0,1,0,4,0,7,1.0,1,0.0,0,1,0,1,1,0,0,4,0,2,5,1
7620,102039,wkfBzItw0JCH6ZUz2WUZn7ngJ5M4Oksy,5Gyp41oLVo7Gg7vF4vpmggWP5MU70QO6,1,0,0,0,0,0,1,0,1,0.14285714285714285,1,0.0,0,0,0,0,0,0,0,1,0,0,1,0
7621,102073,hQ3wXP6mBT1mdkbdxuqfF7CldpTNzHCb,5Gyp41oLVo7Gg7vF4vpmggWP5MU70QO6,8,9,6,0,4,0,5,0,24,3.4285714285714284,1,0.0,0,6,0,4,9,0,0,5,0,10,14,1
7622,102075,5Rbvag4nzKt7RfTqiThTliUWaR0ZVWak,5Gyp41oLVo7Gg7vF4vpmggWP5MU70QO6,8,4,3,0,2,2,4,0,15,2.142857142857143,1,0.0,0,3,0,2,4,2,0,4,0,5,10,0
7623,102095,NTXOThvxlWD2gbdn8wqKgJboye8yTWns,5Gyp41oLVo7Gg7vF4vpmggWP5MU70QO6,35,64,36,26,15,64,31,3,239,34.142857142857146,7,0.0,11,36,20,15,53,64,6,31,3,82,157,1
7624,102103,E3buKjLKPbTtMoTsNy649dTZInvDO3Br,5Gyp41oLVo7Gg7vF4vpmggWP5MU70QO6,6,4,1,0,1,1,3,0,10,1.4285714285714286,1,0.0,0,1,0,1,4,1,0,3,0,2,8,1
7625,102125,VrTC4DzeZDftHgYWy5VUiE9qe8zwjPC5,5Gyp41oLVo7Gg7vF4vpmggWP5MU70QO6,4,0,0,0,0,0,4,0,4,0.5714285714285714,1,0.0,0,0,0,0,0,0,0,4,0,0,4,1
7626,102173,spcUWaGtojfez6ZdF6aqlTnU3zU2dqpy,5Gyp41oLVo7Gg7vF4vpmggWP5MU70QO6,7,2,0,0,1,0,6,1,10,1.4285714285714286,1,0.0,1,0,0,1,1,0,0,6,1,2,8,0
7627,102205,1rAHmNrxrqnzHEQFMlydmQ968LsZW0oG,5Gyp41oLVo7Gg7vF4vpmggWP5MU70QO6,23,27,12,7,6,16,6,1,75,10.714285714285714,1,0.0,11,12,5,6,16,16,2,6,1,34,41,1
7628,102233,Ji3E9fwS2PKUvbBJBVDClDaYO8g6Sw4n,5Gyp41oLVo7Gg7vF4vpmggWP5MU70QO6,5,1,0,0,0,1,5,0,7,1.0,1,0.0,0,0,0,0,1,1,0,5,0,0,7,1
7629,102236,1cbn6mbdbvkgaRHmtNkyztYkaJcKUMeq,5Gyp41oLVo7Gg7vF4vpmggWP5MU70QO6,23,46,14,22,6,19,20,1,128,18.285714285714285,5,0.0,17,14,14,6,29,19,8,20,1,51,77,0
7630,102241,0XiyXLikhDT45itTHi1q8aFcQzTuNpcn,5Gyp41oLVo7Gg7vF4vpmggWP5MU70QO6,1,0,0,0,0,0,1,0,1,0.14285714285714285,1,0.0,0,0,0,0,0,0,0,1,0,0,1,1
7631,102255,2gGDk563x9KJO0S3Jx29RAwBwaKlH8vL,5Gyp41oLVo7Gg7vF4vpmggWP5MU70QO6,7,2,0,0,0,1,14,2,19,2.7142857142857144,4,0.0,0,0,0,0,2,1,0,14,2,0,19,0
7632,102278,9by6FuLW9p6hAe2x8b5HjrOAjJeqk2av,5Gyp41oLVo7Gg7vF4vpmggWP5MU70QO6,25,33,14,10,11,2,8,2,80,11.428571428571429,2,0.0,13,14,8,11,20,2,2,8,2,46,34,0
7633,102286,lT1QwzmucjSEwJOaziaqa5blNPSytnWj,5Gyp41oLVo7Gg7vF4vpmggWP5MU70QO6,5,2,1,0,1,0,2,0,6,0.8571428571428571,1,0.0,0,1,0,1,2,0,0,2,0,2,4,1
7634,102788,1Ld3jQU8M0eiaLBshs8gjcgQEfdlgHyZ,7GRhBDsirIGkRZBtSMEzNTyDr2JQm4xx,1,0,0,0,0,0,1,0,1,0.14285714285714285,1,0.0,0,0,0,0,0,0,0,1,0,0,1,1
7635,102793,vkfHpP1V5bzhsiIUQc7ID6uM0xIbyM6G,7GRhBDsirIGkRZBtSMEzNTyDr2JQm4xx,100,117,41,68,43,27,5,3,304,43.42857142857143,2,0.0,66,41,42,43,51,27,26,5,3,192,112,0
7636,102811,RB20dIuqLJFw6YFQJDaxn0RCCLFzH3SF,7GRhBDsirIGkRZBtSMEzNTyDr2JQm4xx,1,0,0,0,0,0,2,0,2,0.2857142857142857,1,0.0,0,0,0,0,0,0,0,2,0,0,2,1
7637,102820,BIDc5dTJG5lHpfFnujtGp6gtwz3CxgK6,7GRhBDsirIGkRZBtSMEzNTyDr2JQm4xx,24,33,18,0,13,1,7,1,73,10.428571428571429,1,0.0,7,18,0,13,26,1,0,7,1,38,35,0
7638,102821,AFkbXbLmebwTS1tBVemZz9PyT76Wxqt3,7GRhBDsirIGkRZBtSMEzNTyDr2JQm4xx,51,35,15,30,19,0,3,0,102,14.571428571428571,2,0.0,18,15,19,19,17,0,11,3,0,71,31,0
7639,102824,WmG8kTcU8MK2hNkFFl9oxdCyXNm8K8Ej,7GRhBDsirIGkRZBtSMEzNTyDr2JQm4xx,1,0,0,0,0,0,2,0,2,0.2857142857142857,2,0.0,0,0,0,0,0,0,0,2,0,0,2,1
7640,102828,UudVkHSQDj0JlXrwnDsZ4pzCiaI82KlC,7GRhBDsirIGkRZBtSMEzNTyDr2JQm4xx,1,0,0,0,0,0,2,0,2,0.2857142857142857,2,0.0,0,0,0,0,0,0,0,2,0,0,2,1
7641,102829,FznSklAKG5wChcaIMKrWsEd2Qt5oet2J,7GRhBDsirIGkRZBtSMEzNTyDr2JQm4xx,11,5,2,0,2,8,12,0,29,4.142857142857143,1,0.0,0,2,0,2,5,8,0,12,0,4,25,1
7642,102846,bdMrZhKfGRsdtUANxFUkk3RURjlPnIxr,7GRhBDsirIGkRZBtSMEzNTyDr2JQm4xx,2,0,0,0,0,0,3,0,3,0.42857142857142855,1,0.0,0,0,0,0,0,0,0,3,0,0,3,1
7643,102852,4vfYv7K7jyRMAXbqr9d4SobwqmYMG1ZR,7GRhBDsirIGkRZBtSMEzNTyDr2JQm4xx,1,0,0,0,0,0,1,0,1,0.14285714285714285,1,0.0,0,0,0,0,0,0,0,1,0,0,1,1
7644,102855,pYasYOOyUapjKdoqnDhFpArs52eNDPLb,7GRhBDsirIGkRZBtSMEzNTyDr2JQm4xx,3,2,1,0,0,0,1,0,4,0.5714285714285714,1,0.0,0,1,0,0,2,0,0,1,0,1,3,1
7645,102867,jSPgiXDCISXGmLFuOlDszBfMRRboKynI,A3fsA9Zfv1X2fVEQhTw51lKENdNrEqT3,9,4,3,0,3,0,2,0,12,1.7142857142857142,2,0.0,0,3,0,3,4,0,0,2,0,6,6,1
7646,102875,ovOrxCTVGxQyC9labPGJ3gKHEzv9s9aZ,bWdj2GDclj5ofokWjzoa5jAwMkxCykd6,1,0,0,0,0,0,1,0,1,0.14285714285714285,1,0.0,0,0,0,0,0,0,0,1,0,0,1,1
7647,102900,xwcqyIIcIUCDL9lZCj9OZxM9SjcoYp0H,SpATywNh6bZuzm8s1ceuBUnMUAeoAHHw,1,0,0,0,0,0,1,0,1,0.14285714285714285,1,0.0,0,0,0,0,0,0,0,1,0,0,1,1
7648,102920,e4IPxveF8RO3es6V6Od4YTjwU9tdhLXH,SpATywNh6bZuzm8s1ceuBUnMUAeoAHHw,1,0,0,0,0,0,1,0,1,0.14285714285714285,1,0.0,0,0,0,0,0,0,0,1,0,0,1,1
7649,102926,qoU1vhHFDDec5VkeyGO4XQ5CxMj2dkga,SpATywNh6bZuzm8s1ceuBUnMUAeoAHHw,1,0,0,0,0,0,2,0,2,0.2857142857142857,2,0.0,0,0,0,0,0,0,0,2,0,0,2,1
7650,102932,0zaZMwzUlPvudODMBJsoUQT9Stnqz6b0,SpATywNh6bZuzm8s1ceuBUnMUAeoAHHw,5,4,2,0,1,2,5,0,14,2.0,2,0.0,0,2,0,1,4,2,0,5,0,3,11,1
7651,102935,44A0UDfpSdZoyeaVNyFZyzOHFRBDzohf,A3fsA9Zfv1X2fVEQhTw51lKENdNrEqT3,2,0,0,0,0,0,3,0,3,0.42857142857142855,1,0.0,0,0,0,0,0,0,0,3,0,0,3,1
7652,102962,hQlXSGkScEDJBAZj2lP5Zs9i72B5KYMn,bWdj2GDclj5ofokWjzoa5jAwMkxCykd6,15,9,5,8,6,78,7,1,114,16.285714285714285,2,0.0,3,5,7,6,6,78,1,7,1,21,93,1
7653,102986,mLfiafLgtlHk6mFhbivnwgftpNV0VfBx,A3fsA9Zfv1X2fVEQhTw51lKENdNrEqT3,5,5,1,0,0,0,1,0,7,1.0,1,0.0,0,1,0,0,5,0,0,1,0,1,6,1
7654,103003,vkX2gJv5gCZeM2YeKQWeGJdzNJhrpKeU,SpATywNh6bZuzm8s1ceuBUnMUAeoAHHw,3,0,0,0,0,1,2,0,3,0.42857142857142855,1,0.0,0,0,0,0,0,1,0,2,0,0,3,0
7655,103004,9tN6QbOi425qNnZ8oxcgeFVfUtI2koh7,RXDvfPUBYFlVdlueBFbLW0mhhAyGEqpt,7,10,5,0,1,0,3,0,19,2.7142857142857144,2,0.0,0,5,0,1,10,0,0,3,0,6,13,0
7656,103011,A3hbg0sRzJCuZelHR2utUpF4kEQMHGoX,A3fsA9Zfv1X2fVEQhTw51lKENdNrEqT3,8,9,6,0,3,0,11,0,29,4.142857142857143,4,0.0,0,6,0,3,9,0,0,11,0,9,20,1
7657,103046,4dcb5500hUVpclJ4asFWqYt7G3CBRrnY,SpATywNh6bZuzm8s1ceuBUnMUAeoAHHw,1,0,0,0,0,0,2,0,2,0.2857142857142857,2,0.0,0,0,0,0,0,0,0,2,0,0,2,1
7658,103066,gLAW4GOuyz8JKg5RO5Sf2rzir65isCiq,SpATywNh6bZuzm8s1ceuBUnMUAeoAHHw,1,0,0,0,0,0,1,0,1,0.14285714285714285,1,0.0,0,0,0,0,0,0,0,1,0,0,1,1
7659,103131,KKoJVU8RPVKYX0YtUEw7IyEbFA7WdrnE,SpATywNh6bZuzm8s1ceuBUnMUAeoAHHw,48,64,27,54,14,0,11,0,170,24.285714285714285,7,0.0,14,27,46,14,50,0,8,11,0,101,69,0
7660,103133,pmbdGuMJDBIMvlssCxECy27GzvD3oiIB,SpATywNh6bZuzm8s1ceuBUnMUAeoAHHw,7,9,7,0,6,0,2,0,24,3.4285714285714284,2,0.0,0,7,0,6,9,0,0,2,0,13,11,1
7661,103138,EFMEoi5W4mceo8rjft5LKrYvvT3E2eat,RXDvfPUBYFlVdlueBFbLW0mhhAyGEqpt,2,0,0,0,0,0,2,0,2,0.2857142857142857,1,0.0,0,0,0,0,0,0,0,2,0,0,2,1
7662,103212,3GMOahsvICu1XQltlxIUR4GKvebsHIVx,SpATywNh6bZuzm8s1ceuBUnMUAeoAHHw,7,5,2,0,2,0,2,0,11,1.5714285714285714,1,0.0,0,2,0,2,5,0,0,2,0,4,7,1
7663,103220,8c2gk77rfHeG4kEZpifVHT547X2ayTNE,A3fsA9Zfv1X2fVEQhTw51lKENdNrEqT3,90,56,40,180,22,25,25,2,350,50.0,9,0.0,2,40,157,22,54,25,23,25,2,221,129,1
7664,103228,1xVduM1Mt4TlM51sUaZjO9TKdOfcUOIw,RXDvfPUBYFlVdlueBFbLW0mhhAyGEqpt,1,0,0,0,0,0,1,0,1,0.14285714285714285,1,0.0,0,0,0,0,0,0,0,1,0,0,1,1
7665,103230,W6MGFBQ1Tov9lOeRQ8QlzHUMCDNEGRDq,5X6FeZozNMgE2VRi3MJYjkkFK8SETtu2,4,5,1,0,0,0,3,0,9,1.2857142857142858,1,0.0,0,1,0,0,5,0,0,3,0,1,8,1
7666,103272,tm8lPw8iVlVgbaJMBVyV1VDYMbk4uQOB,bWdj2GDclj5ofokWjzoa5jAwMkxCykd6,7,7,2,0,2,0,4,0,15,2.142857142857143,1,0.0,0,2,0,2,7,0,0,4,0,4,11,1
7667,103284,KmIlNo2pbRKBzhZUiCgI2YhiW6w8iosj,SpATywNh6bZuzm8s1ceuBUnMUAeoAHHw,1,0,0,0,0,0,1,0,1,0.14285714285714285,1,0.0,0,0,0,0,0,0,0,1,0,0,1,1
7668,103290,HFGNcmUXULevazeUTNEcAY9fpoL4pzVP,SpATywNh6bZuzm8s1ceuBUnMUAeoAHHw,4,2,1,0,1,0,1,0,5,0.7142857142857143,1,0.0,0,1,0,1,2,0,0,1,0,2,3,1
7669,103291,3xICsH6EXuYyV8kexin75XnVadi3rENN,SpATywNh6bZuzm8s1ceuBUnMUAeoAHHw,20,24,12,37,3,1,8,0,85,12.142857142857142,4,0.0,6,12,32,3,18,1,5,8,0,53,32,1
7670,103310,9LpHZ4FqcvjHyiN7Brp9qNNIFri6dqhc,SpATywNh6bZuzm8s1ceuBUnMUAeoAHHw,1,0,0,0,0,0,1,0,1,0.14285714285714285,1,0.0,0,0,0,0,0,0,0,1,0,0,1,1
7671,103321,nWOH01aZ04H6r4egoMRiiMsuUse9lbQb,SpATywNh6bZuzm8s1ceuBUnMUAeoAHHw,4,3,0,0,0,0,1,0,4,0.5714285714285714,1,0.0,0,0,0,0,3,0,0,1,0,0,4,1
7672,103349,hNJz0qbOhrUgajUkzqSdDbybHkuRglfs,bWdj2GDclj5ofokWjzoa5jAwMkxCykd6,28,31,18,108,6,1,10,1,175,25.0,4,0.0,7,18,99,6,24,1,9,10,1,130,45,1
7673,103368,RqBHYGZ0TJ0og1l3UKsrEDKJTiEi7UGH,bWdj2GDclj5ofokWjzoa5jAwMkxCykd6,1,0,0,0,0,0,1,0,1,0.14285714285714285,1,0.0,0,0,0,0,0,0,0,1,0,0,1,1
7674,103401,BfcoBJeBA5nEQ2BMwBPOzhifSeHVOPF7,A3fsA9Zfv1X2fVEQhTw51lKENdNrEqT3,15,17,2,0,1,4,11,4,39,5.571428571428571,3,0.0,0,2,0,1,17,4,0,11,4,3,36,1
7675,103403,kSmNmb8pAXQzQwcesy0KCmn8So8gUF15,RXDvfPUBYFlVdlueBFbLW0mhhAyGEqpt,11,7,1,18,1,0,2,0,29,4.142857142857143,1,0.0,1,1,17,1,6,0,1,2,0,20,9,1
7676,103416,VQlGEIRUzXNT6foVsTH49rZlcPgJT0yF,RXDvfPUBYFlVdlueBFbLW0mhhAyGEqpt,5,2,1,0,1,0,2,0,6,0.8571428571428571,1,0.0,0,1,0,1,2,0,0,2,0,2,4,1
7677,103432,i874kieazKCC94ZTypW847QbJAZunYk3,5X6FeZozNMgE2VRi3MJYjkkFK8SETtu2,5,1,1,0,0,0,3,0,5,0.7142857142857143,1,0.0,0,1,0,0,1,0,0,3,0,1,4,1
7678,103540,gEnHreVcQ3mWSHejulW9Wh8JYbtvdJff,G8EPVSXsOYB5YQWZGiz1aVq5Pgr2GrQu,6,3,1,0,1,0,2,0,7,1.0,1,0.0,0,1,0,1,3,0,0,2,0,2,5,1
7679,103542,3kqAYaZkgzFfJM9JvWI5IyiYihK9SbF2,SpATywNh6bZuzm8s1ceuBUnMUAeoAHHw,1,0,0,0,0,0,1,0,1,0.14285714285714285,1,0.0,0,0,0,0,0,0,0,1,0,0,1,1
7680,103556,uckssqvWyUYWLFOLUxtXhLnqEepVbBJ2,A3fsA9Zfv1X2fVEQhTw51lKENdNrEqT3,6,4,0,0,0,3,5,0,12,1.7142857142857142,1,0.0,0,0,0,0,4,3,0,5,0,0,12,1
7681,103579,DYy3OcZHNqaAwRPZTK5mmyz2pajxcVFG,SpATywNh6bZuzm8s1ceuBUnMUAeoAHHw,18,14,9,0,7,0,2,0,32,4.571428571428571,1,0.0,4,9,0,7,10,0,0,2,0,20,12,1
7682,103582,dQsgkNAYSmg3HfiJLo9hIHon4zbbBGlt,SpATywNh6bZuzm8s1ceuBUnMUAeoAHHw,1,0,0,0,0,0,1,0,1,0.14285714285714285,1,0.0,0,0,0,0,0,0,0,1,0,0,1,1
7683,103598,5ZyvCd3AP7a8azCiLN5JfLAP53iZpAyD,bWdj2GDclj5ofokWjzoa5jAwMkxCykd6,1,0,0,0,0,0,1,0,1,0.14285714285714285,1,0.0,0,0,0,0,0,0,0,1,0,0,1,1
7684,103599,5ZyvCd3AP7a8azCiLN5JfLAP53iZpAyD,G8EPVSXsOYB5YQWZGiz1aVq5Pgr2GrQu,1,0,0,0,0,0,1,0,1,0.14285714285714285,1,0.0,0,0,0,0,0,0,0,1,0,0,1,1
7685,103615,MoPVKWdkHBgBJN1rFoQXD7HKqTLuGX5j,SpATywNh6bZuzm8s1ceuBUnMUAeoAHHw,1,0,0,0,0,0,1,0,1,0.14285714285714285,1,0.0,0,0,0,0,0,0,0,1,0,0,1,1
7686,103621,rVswAzjMLz5uIPbCwAU1SliCQFpiAqey,G8EPVSXsOYB5YQWZGiz1aVq5Pgr2GrQu,20,27,15,12,14,0,1,0,69,9.857142857142858,1,0.0,11,15,9,14,16,0,3,1,0,49,20,1
7687,103631,KYNdfogmKCD7SA1muZkW9WEyjcJ7qGwm,A3fsA9Zfv1X2fVEQhTw51lKENdNrEqT3,1,0,0,0,0,0,2,0,2,0.2857142857142857,1,0.0,0,0,0,0,0,0,0,2,0,0,2,1
7688,103688,C14ut6PDfZPN3lsINMru6CQXJOaUeNzg,SpATywNh6bZuzm8s1ceuBUnMUAeoAHHw,2,0,0,0,0,0,3,0,3,0.42857142857142855,1,0.0,0,0,0,0,0,0,0,3,0,0,3,1
7689,103695,gMeZHtHbmrRB8drlaFHRYNGQ6Z4lgho8,5X6FeZozNMgE2VRi3MJYjkkFK8SETtu2,1,0,0,0,0,0,1,0,1,0.14285714285714285,1,0.0,0,0,0,0,0,0,0,1,0,0,1,1
7690,103708,rpRCEhtlHGcZRNaEFyNtzZ3h0JQuYrgr,A3fsA9Zfv1X2fVEQhTw51lKENdNrEqT3,1,0,0,0,0,0,1,0,1,0.14285714285714285,1,0.0,0,0,0,0,0,0,0,1,0,0,1,1
7691,103717,DKs1wVuJxi1MManiJftFpHeYNStTfS5A,G8EPVSXsOYB5YQWZGiz1aVq5Pgr2GrQu,2,0,0,0,0,0,4,0,4,0.5714285714285714,1,0.0,0,0,0,0,0,0,0,4,0,0,4,1
7692,103736,SAZRKAldhv9NmeRo6l8G7XnPsnj9TVyU,SpATywNh6bZuzm8s1ceuBUnMUAeoAHHw,1,0,0,0,0,0,1,0,1,0.14285714285714285,1,0.0,0,0,0,0,0,0,0,1,0,0,1,1
7693,103751,C8XrXSQZNN8RR6xEeSRWbKA5jTxVTtPT,RXDvfPUBYFlVdlueBFbLW0mhhAyGEqpt,1,0,0,0,0,0,1,0,1,0.14285714285714285,1,0.0,0,0,0,0,0,0,0,1,0,0,1,1
7694,103769,KyO1xM8jR0HMi7DDZ6rJYV6HufMfhFF3,SpATywNh6bZuzm8s1ceuBUnMUAeoAHHw,5,4,0,0,0,0,4,0,8,1.1428571428571428,1,0.0,0,0,0,0,4,0,0,4,0,0,8,1
7695,103770,EReWp6ilgaQY61GGX2jAkIc5IQisheJq,A3fsA9Zfv1X2fVEQhTw51lKENdNrEqT3,9,4,3,0,2,3,6,0,18,2.5714285714285716,2,0.0,0,3,0,2,4,3,0,6,0,5,13,1
7696,103771,SozLQk8695JG7fvj1Enp26s5ACJQjjq5,A3fsA9Zfv1X2fVEQhTw51lKENdNrEqT3,1,0,0,0,0,0,1,0,1,0.14285714285714285,1,0.0,0,0,0,0,0,0,0,1,0,0,1,1
7697,103772,ZeGQYJuhuvawQN9a4lM0EAzsC8fPW88J,SpATywNh6bZuzm8s1ceuBUnMUAeoAHHw,5,2,1,0,1,0,2,0,6,0.8571428571428571,1,0.0,0,1,0,1,2,0,0,2,0,2,4,1
7698,103780,8E8MlkBOuzGaVSvo1UqdWtwoQrTmYFYq,A3fsA9Zfv1X2fVEQhTw51lKENdNrEqT3,4,2,0,0,0,0,3,0,5,0.7142857142857143,1,0.0,0,0,0,0,2,0,0,3,0,0,5,1
7699,103781,DT8AqUhZw7EK0K7nTcFJ3ScDyeNUfkdW,SpATywNh6bZuzm8s1ceuBUnMUAeoAHHw,1,0,0,0,0,0,1,0,1,0.14285714285714285,1,0.0,0,0,0,0,0,0,0,1,0,0,1,1
7700,103787,g5LcibasYPSrvvKLR0Yho0cbKscCPTQe,A3fsA9Zfv1X2fVEQhTw51lKENdNrEqT3,2,0,0,0,0,0,4,0,4,0.5714285714285714,1,0.0,0,0,0,0,0,0,0,4,0,0,4,1
7701,103793,FllaTGiiKjVXL8ZyJAcKfQZYECjbYHzz,SpATywNh6bZuzm8s1ceuBUnMUAeoAHHw,1,0,0,0,0,0,1,0,1,0.14285714285714285,1,0.0,0,0,0,0,0,0,0,1,0,0,1,1
7702,103795,2ONNcB0Lk7y2f17JTT6X0dSaCbLlHzeP,A3fsA9Zfv1X2fVEQhTw51lKENdNrEqT3,24,13,11,0,10,4,4,0,42,6.0,1,0.0,0,11,0,10,13,4,0,4,0,21,21,1
7703,103796,sRe9Dv91RM9tcMLN8FfoFlx7APGbmbBC,SpATywNh6bZuzm8s1ceuBUnMUAeoAHHw,1,0,0,0,0,0,1,0,1,0.14285714285714285,1,0.0,0,0,0,0,0,0,0,1,0,0,1,1
7704,103813,CbIcKD0jazBhPd3ibnu0zTtemqpWb0KP,A3fsA9Zfv1X2fVEQhTw51lKENdNrEqT3,44,27,18,78,10,6,7,0,146,20.857142857142858,2,0.0,3,18,67,10,24,6,11,7,0,98,48,1
7705,103823,yc5B41HNSQqUbPLwIoeXaaIoBMGyXjZi,A3fsA9Zfv1X2fVEQhTw51lKENdNrEqT3,6,6,3,0,2,0,2,0,13,1.8571428571428572,1,0.0,0,3,0,2,6,0,0,2,0,5,8,1
7706,103828,z9EFyZFox24cBI6falpy1wiVcAxDOJLn,A3fsA9Zfv1X2fVEQhTw51lKENdNrEqT3,2,0,0,0,0,0,2,0,2,0.2857142857142857,1,0.0,0,0,0,0,0,0,0,2,0,0,2,1
7707,103842,At5CmMT40Lj8XDlMUQSu8tvnJD3w6cR2,SpATywNh6bZuzm8s1ceuBUnMUAeoAHHw,31,53,11,16,9,3,15,3,110,15.714285714285714,6,0.0,3,11,15,9,50,3,1,15,3,38,72,0
7708,103846,QvVe60KGKvAk40HokMNHSxHXG9LVzuVG,SpATywNh6bZuzm8s1ceuBUnMUAeoAHHw,1,0,0,0,0,0,1,0,1,0.14285714285714285,1,0.0,0,0,0,0,0,0,0,1,0,0,1,1
7709,103852,VJiHrUKuVkG2Wd7Jui04ER4qa9ZGvV1t,SpATywNh6bZuzm8s1ceuBUnMUAeoAHHw,42,59,28,27,10,5,11,2,142,20.285714285714285,5,0.0,10,28,24,10,49,5,3,11,2,72,70,1
7710,103859,ksRqzHMX68VFuQOjp1W3rk6L1KS1Cbms,5X6FeZozNMgE2VRi3MJYjkkFK8SETtu2,4,2,0,0,1,0,1,0,4,0.5714285714285714,1,0.0,0,0,0,1,2,0,0,1,0,1,3,1
7711,103870,EvnHBVsAsAQbfQWtAPpt54pufnNRU5R4,bWdj2GDclj5ofokWjzoa5jAwMkxCykd6,7,12,0,0,0,0,4,0,16,2.2857142857142856,1,0.0,0,0,0,0,12,0,0,4,0,0,16,1
7712,103886,wNLjey13wdSjq72WLYu2h7JxRXlqFXV6,SpATywNh6bZuzm8s1ceuBUnMUAeoAHHw,21,19,8,15,5,2,10,1,60,8.571428571428571,1,0.0,9,8,13,5,10,2,2,10,1,35,25,0
7713,103890,AwuND473CGsGJtyEL3enVuAsVwEKK9kF,G8EPVSXsOYB5YQWZGiz1aVq5Pgr2GrQu,5,2,1,0,1,0,2,0,6,0.8571428571428571,1,0.0,0,1,0,1,2,0,0,2,0,2,4,1
7714,103903,0w9tP8TINgzfbBeYFJprB82ry0PjYiWn,SpATywNh6bZuzm8s1ceuBUnMUAeoAHHw,11,28,4,2,1,0,5,0,40,5.714285714285714,2,0.0,2,4,2,1,26,0,0,5,0,9,31,0
7715,103908,KKVIEI2lseDGpdoOhUIkkmAMhzuJw0y5,SpATywNh6bZuzm8s1ceuBUnMUAeoAHHw,1,0,0,0,0,0,1,0,1,0.14285714285714285,1,0.0,0,0,0,0,0,0,0,1,0,0,1,1
7716,103915,Bt9uonGNpSTNQAZJ5XpbRJvBeauLMg6y,SpATywNh6bZuzm8s1ceuBUnMUAeoAHHw,5,2,1,0,1,0,2,0,6,0.8571428571428571,1,0.0,0,1,0,1,2,0,0,2,0,2,4,1
7717,103920,ixGKuRwAIkkpbDBbmpHTQFbowyxzIwFP,A3fsA9Zfv1X2fVEQhTw51lKENdNrEqT3,2,0,0,0,0,0,2,0,2,0.2857142857142857,1,0.0,0,0,0,0,0,0,0,2,0,0,2,1
7718,103921,illxSnHmbH86MI7oeDlx7PoAaCvI0459,SpATywNh6bZuzm8s1ceuBUnMUAeoAHHw,4,2,0,0,0,0,4,0,6,0.8571428571428571,1,0.0,0,0,0,0,2,0,0,4,0,0,6,1
7719,103923,ixGKuRwAIkkpbDBbmpHTQFbowyxzIwFP,bWdj2GDclj5ofokWjzoa5jAwMkxCykd6,2,0,0,0,0,0,2,0,2,0.2857142857142857,1,0.0,0,0,0,0,0,0,0,2,0,0,2,1
7720,103932,nMJrb50Z6QbaFrpJMS3h5YwSiL2VcT7z,bWdj2GDclj5ofokWjzoa5jAwMkxCykd6,2,0,0,0,0,0,3,0,3,0.42857142857142855,2,0.0,0,0,0,0,0,0,0,3,0,0,3,1
7721,103950,JNia6gKvSZOSZQHrR3Kro8PKF3m40Fop,RXDvfPUBYFlVdlueBFbLW0mhhAyGEqpt,34,23,9,59,9,0,1,0,101,14.428571428571429,1,0.0,13,9,55,9,10,0,4,1,0,86,15,1
7722,103967,kjoYyxOsZaiCA9S8PMK5B69QLaH15SYn,SpATywNh6bZuzm8s1ceuBUnMUAeoAHHw,15,23,7,18,3,17,6,1,75,10.714285714285714,2,0.0,14,7,15,3,9,17,3,6,1,39,36,0
7723,103983,c7BA0CHOGHUb6Zvl8EDChyZRMoY8mJ72,bWdj2GDclj5ofokWjzoa5jAwMkxCykd6,6,7,1,0,1,0,3,0,12,1.7142857142857142,1,0.0,1,1,0,1,6,0,0,3,0,3,9,1
7724,103989,ApFdQQBcLqTLoA4wIvtlnnwFs4FrlVS1,5X6FeZozNMgE2VRi3MJYjkkFK8SETtu2,3,0,0,0,0,0,4,0,4,0.5714285714285714,2,0.0,0,0,0,0,0,0,0,4,0,0,4,1
7725,104024,fCVSDkZ4pJqiysBxp6DwZw9KkCTFdKeE,SpATywNh6bZuzm8s1ceuBUnMUAeoAHHw,1,0,0,0,0,0,1,0,1,0.14285714285714285,1,0.0,0,0,0,0,0,0,0,1,0,0,1,1
7726,104032,s6g3JP590BuuXwlDJeFKSGLH2Uubd3rm,SpATywNh6bZuzm8s1ceuBUnMUAeoAHHw,2,0,0,0,0,0,3,0,3,0.42857142857142855,1,0.0,0,0,0,0,0,0,0,3,0,0,3,1
7727,104047,2po0f8XMp90hBVf5i62LOZgd10Lmz8YN,5X6FeZozNMgE2VRi3MJYjkkFK8SETtu2,1,0,0,0,0,0,1,0,1,0.14285714285714285,1,0.0,0,0,0,0,0,0,0,1,0,0,1,1
7728,104052,xdSWJOkklt1feMPe59TTfCkpvZpm9Xg2,A3fsA9Zfv1X2fVEQhTw51lKENdNrEqT3,1,0,0,0,0,0,1,0,1,0.14285714285714285,1,0.0,0,0,0,0,0,0,0,1,0,0,1,1
7729,104081,eGnXUl0T4jiT9b8r6xuMUjzOt9Gv7xEL,A3fsA9Zfv1X2fVEQhTw51lKENdNrEqT3,49,45,31,92,18,1,15,2,204,29.142857142857142,5,0.0,1,31,74,18,44,1,18,15,2,124,80,1
7730,104084,axVh7TT3ftc0JLvNMlUvTGTAABKlThNj,SpATywNh6bZuzm8s1ceuBUnMUAeoAHHw,2,0,0,0,0,0,3,0,3,0.42857142857142855,1,0.0,0,0,0,0,0,0,0,3,0,0,3,1
7731,104090,fGDhAQY2WhkQYcL5XaYeDMBiOUQEoTnX,A3fsA9Zfv1X2fVEQhTw51lKENdNrEqT3,46,19,14,110,12,0,3,0,158,22.571428571428573,2,0.0,2,14,92,12,17,0,18,3,0,120,38,1
7732,104102,Lf0mThPYOrtlCzgRGBCVTPy1hiGUII8h,5X6FeZozNMgE2VRi3MJYjkkFK8SETtu2,14,31,18,0,8,1,13,1,72,10.285714285714286,2,0.0,6,18,0,8,25,1,0,13,1,32,40,1
7733,104110,qwWysWdLmrwh0JmjPYNGVFqdat8Jy8Lb,A3fsA9Zfv1X2fVEQhTw51lKENdNrEqT3,3,2,0,0,0,0,2,0,4,0.5714285714285714,1,0.0,0,0,0,0,2,0,0,2,0,0,4,1
7734,104112,1nvi4T1tSgoWvIN9EbUwnTy7YI8AhzKg,SpATywNh6bZuzm8s1ceuBUnMUAeoAHHw,6,2,1,0,1,0,3,1,8,1.1428571428571428,1,0.0,0,1,0,1,2,0,0,3,1,2,6,1
7735,104113,7EU7vMf2b4Xv6MdI3zbAqQNQTiRVSvYt,5X6FeZozNMgE2VRi3MJYjkkFK8SETtu2,1,0,0,0,0,0,1,0,1,0.14285714285714285,1,0.0,0,0,0,0,0,0,0,1,0,0,1,1
7736,104128,Whrc7O8OYrwQtVL43oMCOWkRLnJ5RAnq,bWdj2GDclj5ofokWjzoa5jAwMkxCykd6,6,2,1,0,1,0,3,0,7,1.0,1,0.0,0,1,0,1,2,0,0,3,0,2,5,1
7737,104155,eHoa4dnAqoZqw72CCle00GlHxpp5Lihg,bWdj2GDclj5ofokWjzoa5jAwMkxCykd6,3,2,0,0,0,0,1,0,3,0.42857142857142855,1,0.0,0,0,0,0,2,0,0,1,0,0,3,1
7738,104174,fq6GCepmmh2YUfaUpWUiL4vGs9AXZLYY,SpATywNh6bZuzm8s1ceuBUnMUAeoAHHw,1,0,0,0,0,0,1,0,1,0.14285714285714285,1,0.0,0,0,0,0,0,0,0,1,0,0,1,1
7739,104176,sOwWyC9rA1InGJbwGE813L3Z5VYELzm2,5X6FeZozNMgE2VRi3MJYjkkFK8SETtu2,1,0,0,0,0,0,1,0,1,0.14285714285714285,1,0.0,0,0,0,0,0,0,0,1,0,0,1,1
7740,104212,Ds7wEX5jkiySqTwaoWI1jYLPSf2vDAGt,5X6FeZozNMgE2VRi3MJYjkkFK8SETtu2,1,0,0,0,0,0,1,0,1,0.14285714285714285,1,0.0,0,0,0,0,0,0,0,1,0,0,1,1
7741,104214,j3WvRsPrA16gNidaQCOf3oXIUr2Xe5Lw,bWdj2GDclj5ofokWjzoa5jAwMkxCykd6,6,6,2,0,1,0,2,0,11,1.5714285714285714,1,0.0,2,2,0,1,4,0,0,2,0,5,6,1
7742,104237,JUwnpYDokyUXTC7SfWpuPqShDK4ZEqmX,bWdj2GDclj5ofokWjzoa5jAwMkxCykd6,1,0,0,0,0,0,1,0,1,0.14285714285714285,1,0.0,0,0,0,0,0,0,0,1,0,0,1,1
7743,104248,ixafWGJcoRhCM5cJdtULfcNp2InCr2Sa,bWdj2GDclj5ofokWjzoa5jAwMkxCykd6,1,0,0,0,0,0,1,0,1,0.14285714285714285,1,0.0,0,0,0,0,0,0,0,1,0,0,1,1
7744,104257,JnJdiqdl8G12l0bbDCbx68wMLkGjKDPl,bWdj2GDclj5ofokWjzoa5jAwMkxCykd6,5,4,2,0,0,0,5,0,11,1.5714285714285714,2,0.0,0,2,0,0,4,0,0,5,0,2,9,1
7745,104281,nQnbQ4USuQPKS5dsskLpLD6Vp5PD3y57,SpATywNh6bZuzm8s1ceuBUnMUAeoAHHw,5,2,1,0,1,1,3,0,8,1.1428571428571428,1,0.0,0,1,0,1,2,1,0,3,0,2,6,0
7746,104285,eYFN65l456TZjqLokXcupn8BpQg7vecw,G8EPVSXsOYB5YQWZGiz1aVq5Pgr2GrQu,9,7,0,0,1,0,11,0,19,2.7142857142857144,1,0.0,0,0,0,1,7,0,0,11,0,1,18,1
7747,104287,E4KzNEU3ybRlAOiHqHHsGQEXiaxyHgoT,SpATywNh6bZuzm8s1ceuBUnMUAeoAHHw,32,38,21,24,10,14,15,1,123,17.571428571428573,4,0.0,10,21,24,10,28,14,0,15,1,65,58,0
7748,104293,mKHQM9iW9olu6z2WamdxK7ySH3UwX3JX,RXDvfPUBYFlVdlueBFbLW0mhhAyGEqpt,18,24,12,21,7,3,10,1,78,11.142857142857142,4,0.0,8,12,18,7,16,3,3,10,1,45,33,1
7749,104312,Q5TmTVdy8nnH2vTL73s67ZseaCMO3k91,bWdj2GDclj5ofokWjzoa5jAwMkxCykd6,1,0,0,0,0,0,1,0,1,0.14285714285714285,1,0.0,0,0,0,0,0,0,0,1,0,0,1,1
7750,104316,FdqXptfn5rlMpIwU40MbDz6o7uZKXv6A,SpATywNh6bZuzm8s1ceuBUnMUAeoAHHw,2,0,0,0,0,0,2,0,2,0.2857142857142857,1,0.0,0,0,0,0,0,0,0,2,0,0,2,1
7751,104331,sC7fymsB6mbxhnSeg6NeWpGdnl2lVglT,SpATywNh6bZuzm8s1ceuBUnMUAeoAHHw,17,27,11,19,5,0,8,3,73,10.428571428571429,1,0.0,12,11,17,5,15,0,2,8,3,45,28,0
7752,104338,rB9PPwxIRyt27C89H153o2lH09tVr1nK,G8EPVSXsOYB5YQWZGiz1aVq5Pgr2GrQu,6,11,3,0,4,0,2,0,20,2.857142857142857,1,0.0,7,3,0,4,4,0,0,2,0,14,6,1
7753,104345,2XkaIutgoPZ3laInMFqUtqSwL8hEETLH,SpATywNh6bZuzm8s1ceuBUnMUAeoAHHw,4,3,1,0,1,0,1,0,6,0.8571428571428571,1,0.0,0,1,0,1,3,0,0,1,0,2,4,1
7754,104346,wGfXRYqHkdAo1fVEEY9NvW8qy6M9m0mI,SpATywNh6bZuzm8s1ceuBUnMUAeoAHHw,7,5,2,0,2,0,2,0,11,1.5714285714285714,1,0.0,0,2,0,2,5,0,0,2,0,4,7,1
7755,104353,Nvx1FqKYM0wMKIIRgD0fWbHs2ulluJLe,SpATywNh6bZuzm8s1ceuBUnMUAeoAHHw,1,0,0,0,0,0,1,0,1,0.14285714285714285,1,0.0,0,0,0,0,0,0,0,1,0,0,1,0
7756,104362,QVxxpDseuNfbakex6vp7iIpmgTn9LMT8,G8EPVSXsOYB5YQWZGiz1aVq5Pgr2GrQu,7,4,0,0,0,0,3,1,8,1.1428571428571428,1,0.0,0,0,0,0,4,0,0,3,1,0,8,1
7757,104388,hGNdlaqDmXk6lg7T5WbaNaGNDHY5myAS,SpATywNh6bZuzm8s1ceuBUnMUAeoAHHw,7,7,3,0,2,0,3,0,15,2.142857142857143,1,0.0,3,3,0,2,4,0,0,3,0,8,7,1
7758,104394,dlHDytKql5TohtYHxgnGbeQGgJYZWDGJ,A3fsA9Zfv1X2fVEQhTw51lKENdNrEqT3,1,0,0,0,0,0,1,0,1,0.14285714285714285,1,0.0,0,0,0,0,0,0,0,1,0,0,1,1
7759,104407,8XstJLDa8agdHppUFVVZbvtgkIjc1hSo,SpATywNh6bZuzm8s1ceuBUnMUAeoAHHw,6,4,2,0,1,1,3,0,11,1.5714285714285714,2,0.0,0,2,0,1,4,1,0,3,0,3,8,1
7760,104418,pcsiSS3QOPo0n8yKp6skJyBWeonG4c8P,bWdj2GDclj5ofokWjzoa5jAwMkxCykd6,4,5,3,0,2,6,1,0,17,2.4285714285714284,1,0.0,0,3,0,2,5,6,0,1,0,5,12,1
7761,104435,GEHMGUKZ7lJGT0NAhukMXCgY3uHGI1vW,SpATywNh6bZuzm8s1ceuBUnMUAeoAHHw,7,3,2,0,2,0,2,0,9,1.2857142857142858,1,0.0,0,2,0,2,3,0,0,2,0,4,5,1
7762,104438,KJtTFVCUZxFPCdrcl94b8VUY3eA2PtX6,SpATywNh6bZuzm8s1ceuBUnMUAeoAHHw,42,54,19,31,9,25,16,5,159,22.714285714285715,5,0.0,21,19,27,9,33,25,4,16,5,76,83,0
7763,104450,fa5L7BR4QPdW8LaRhyZa9SLAtcvpLQse,SpATywNh6bZuzm8s1ceuBUnMUAeoAHHw,9,3,2,0,2,0,5,1,13,1.8571428571428572,1,0.0,0,2,0,2,3,0,0,5,1,4,9,1
7764,104454,S6zuEdHkGvIDnx9FvNNHc7xwyevTBNEw,G8EPVSXsOYB5YQWZGiz1aVq5Pgr2GrQu,81,66,27,225,22,0,8,0,348,49.714285714285715,6,0.0,23,27,190,22,43,0,35,8,0,262,86,0
7765,104471,1MR6SIEh8IgMKrYcKoTYc2JC43hmTJbZ,A3fsA9Zfv1X2fVEQhTw51lKENdNrEqT3,6,3,0,0,0,2,5,0,10,1.4285714285714286,1,0.0,0,0,0,0,3,2,0,5,0,0,10,1
7766,104488,IYFrqEdSROOp3Z1UK2YOma0RYGRatAQT,A3fsA9Zfv1X2fVEQhTw51lKENdNrEqT3,4,2,1,0,1,0,1,0,5,0.7142857142857143,1,0.0,0,1,0,1,2,0,0,1,0,2,3,1
7767,104491,yEc0qGRUsnGavj0JPbk8pVtWktClrURk,A3fsA9Zfv1X2fVEQhTw51lKENdNrEqT3,1,0,0,0,0,0,1,0,1,0.14285714285714285,1,0.0,0,0,0,0,0,0,0,1,0,0,1,1
7768,104497,jKfEyfk0HFbzE5vAszOX5qLRWBhzLYt2,SpATywNh6bZuzm8s1ceuBUnMUAeoAHHw,1,0,0,0,0,0,1,0,1,0.14285714285714285,1,0.0,0,0,0,0,0,0,0,1,0,0,1,1
7769,104501,vZWQs3w0XkSs89Ucm6ojt59ZxMUAhe1V,A3fsA9Zfv1X2fVEQhTw51lKENdNrEqT3,11,7,3,0,1,2,16,1,30,4.285714285714286,1,0.0,0,3,0,1,7,2,0,16,1,4,26,1
7770,104510,1fqT0899kRcDDGHbdo7SAtzTiZ0jb6Gw,SpATywNh6bZuzm8s1ceuBUnMUAeoAHHw,5,4,1,0,1,0,4,0,10,1.4285714285714286,1,0.0,0,1,0,1,4,0,0,4,0,2,8,1
7771,104519,4BEj7gptNyb11PfZw5Zij4k5rhZkomv9,SpATywNh6bZuzm8s1ceuBUnMUAeoAHHw,16,25,7,15,3,0,4,0,54,7.714285714285714,1,0.0,16,7,14,3,9,0,1,4,0,40,14,1
7772,104520,AXWWqNDiRDejTjo5V7yUaMbjtzXKhlP0,A3fsA9Zfv1X2fVEQhTw51lKENdNrEqT3,9,5,4,0,3,0,2,0,14,2.0,1,0.0,0,4,0,3,5,0,0,2,0,7,7,1
7773,104529,pRsdTtgRf3HNRCFBVE8ZUsyswXD2QiAk,SpATywNh6bZuzm8s1ceuBUnMUAeoAHHw,9,6,3,0,3,0,2,0,14,2.0,2,0.0,2,3,0,3,4,0,0,2,0,8,6,1
7774,104541,WrS9TB9uT4oSW7UbFINDhj14Cq6LHmEj,G8EPVSXsOYB5YQWZGiz1aVq5Pgr2GrQu,21,20,7,12,5,3,12,1,60,8.571428571428571,1,0.0,5,7,9,5,15,3,3,12,1,26,34,0
7775,104544,gUXmx34tXzFZkM4gYbNbIwLhuZfANkS1,A3fsA9Zfv1X2fVEQhTw51lKENdNrEqT3,5,6,3,0,0,0,2,0,11,1.5714285714285714,2,0.0,0,3,0,0,6,0,0,2,0,3,8,1
7776,104549,XVzLVlcu5Oyf6iAJpPwexFxr52kUVMk6,SpATywNh6bZuzm8s1ceuBUnMUAeoAHHw,1,0,0,0,0,0,1,0,1,0.14285714285714285,1,0.0,0,0,0,0,0,0,0,1,0,0,1,1
7777,104552,nR9dAgKzSlgvrJWELbwHBtX83ee7HVxY,SpATywNh6bZuzm8s1ceuBUnMUAeoAHHw,7,4,3,0,3,0,2,0,12,1.7142857142857142,1,0.0,0,3,0,3,4,0,0,2,0,6,6,1
7778,104559,efXmiwkTuBoeL7S5luYeU6sYtxURlop6,G8EPVSXsOYB5YQWZGiz1aVq5Pgr2GrQu,2,0,0,0,0,0,2,0,2,0.2857142857142857,1,0.0,0,0,0,0,0,0,0,2,0,0,2,1
7779,104583,hd3AGD7h3p4wKWEGL7m8RwayFKIA3oY6,SpATywNh6bZuzm8s1ceuBUnMUAeoAHHw,9,10,5,0,5,1,1,0,22,3.142857142857143,1,0.0,2,5,0,5,8,1,0,1,0,12,10,1
7780,104638,pVcyz42RqwGdgjmvwllHMEUwVR1vdXWF,SpATywNh6bZuzm8s1ceuBUnMUAeoAHHw,9,13,5,0,3,0,2,0,23,3.2857142857142856,1,0.0,4,5,0,3,9,0,0,2,0,12,11,0
7781,104643,OUOJlObKrXM0JmEUq0o8KzZHzr8jy9dn,SpATywNh6bZuzm8s1ceuBUnMUAeoAHHw,1,0,0,0,0,0,2,0,2,0.2857142857142857,2,0.0,0,0,0,0,0,0,0,2,0,0,2,1
7782,104660,T118Cf7QnojriLhCFYL99xCQBHodaMMt,A3fsA9Zfv1X2fVEQhTw51lKENdNrEqT3,12,12,8,0,5,0,3,0,28,4.0,2,0.0,0,8,0,5,12,0,0,3,0,13,15,1
7783,104679,b7OkWz3nq7Lb9oLoadHyvvkdfFcSwihz,bWdj2GDclj5ofokWjzoa5jAwMkxCykd6,1,0,0,0,0,0,1,0,1,0.14285714285714285,1,0.0,0,0,0,0,0,0,0,1,0,0,1,1
7784,104695,pFPFJKqqsl7E3HmJN66ulC7SsHL61zY0,G8EPVSXsOYB5YQWZGiz1aVq5Pgr2GrQu,7,1,1,0,1,0,4,1,8,1.1428571428571428,1,0.0,0,1,0,1,1,0,0,4,1,2,6,1
7785,104700,HTW0MXRsyGWqdNcPrMPEaXwWOjVd82Bo,SpATywNh6bZuzm8s1ceuBUnMUAeoAHHw,13,34,12,12,5,0,5,0,68,9.714285714285714,2,0.0,10,12,10,5,24,0,2,5,0,37,31,1
7786,104725,kOUbZbVS3Tp5fnMvFRgXRDdwa2qwOZPQ,SpATywNh6bZuzm8s1ceuBUnMUAeoAHHw,10,11,9,0,5,0,1,0,26,3.7142857142857144,1,0.0,1,9,0,5,10,0,0,1,0,15,11,1
7787,104729,EJ7udUHYDMabOR6DK8F5Y2Y2wljl56Yz,SpATywNh6bZuzm8s1ceuBUnMUAeoAHHw,19,31,9,17,1,5,8,1,72,10.285714285714286,2,0.0,16,9,16,1,15,5,1,8,1,42,30,1
7788,104732,Xp3hqJUxQ1JyPcuVR21XzaJTaS6J32IL,SpATywNh6bZuzm8s1ceuBUnMUAeoAHHw,5,2,1,0,1,0,2,0,6,0.8571428571428571,1,0.0,0,1,0,1,2,0,0,2,0,2,4,1
7789,104752,howLdYpe9Zal9CPA1BP3DgH0uhVpiT5i,SpATywNh6bZuzm8s1ceuBUnMUAeoAHHw,18,13,6,14,4,3,6,2,48,6.857142857142857,1,0.0,4,6,13,4,9,3,1,6,2,27,21,1
7790,104772,AaS8GsfaaiK26oA6b0QdGhs8opVCkjvV,A3fsA9Zfv1X2fVEQhTw51lKENdNrEqT3,31,17,12,54,0,7,6,0,96,13.714285714285714,1,0.0,2,12,47,0,15,7,7,6,0,61,35,1
7791,104790,EPmLjBxeWpwhjwoRgtmLV8RkhFOu2zzj,SpATywNh6bZuzm8s1ceuBUnMUAeoAHHw,2,0,0,0,0,0,2,0,2,0.2857142857142857,1,0.0,0,0,0,0,0,0,0,2,0,0,2,1
7792,104791,Xv7W8Uu75U6tMRhwrAaphCnFwKom9DXj,SpATywNh6bZuzm8s1ceuBUnMUAeoAHHw,2,0,0,0,0,0,2,0,2,0.2857142857142857,1,0.0,0,0,0,0,0,0,0,2,0,0,2,1
7793,104798,705a1tvxnZT7omctMx7Fjakho000VDxN,SpATywNh6bZuzm8s1ceuBUnMUAeoAHHw,3,2,0,0,0,0,1,0,3,0.42857142857142855,1,0.0,0,0,0,0,2,0,0,1,0,0,3,1
7794,104803,GHw9ck750jm0mkRym0HeCGrJelDoub5a,SpATywNh6bZuzm8s1ceuBUnMUAeoAHHw,26,70,40,8,20,5,17,0,160,22.857142857142858,4,0.0,19,40,7,20,51,5,1,17,0,86,74,0
7795,104805,O5Xv4tBkDAfcRTJRImpaIMgi7dTTYJal,SpATywNh6bZuzm8s1ceuBUnMUAeoAHHw,17,20,8,19,3,12,7,1,70,10.0,2,0.0,8,8,15,3,12,12,4,7,1,34,36,1
7796,104818,6i24nlUBlDMs5njijO1qqAg2zNti0ug9,SpATywNh6bZuzm8s1ceuBUnMUAeoAHHw,8,6,4,0,3,0,5,0,18,2.5714285714285716,1,0.0,0,4,0,3,6,0,0,5,0,7,11,1
7797,104826,1EoPeAPt0rQExpDMUB0Oh9LRcg1yhFWa,SpATywNh6bZuzm8s1ceuBUnMUAeoAHHw,1,0,0,0,0,0,1,0,1,0.14285714285714285,1,0.0,0,0,0,0,0,0,0,1,0,0,1,1
7798,104838,PzXoGwLC1Wc9fp2FSg9WCVxYfOKqR6tz,SpATywNh6bZuzm8s1ceuBUnMUAeoAHHw,9,14,9,0,0,0,5,0,28,4.0,2,0.0,0,9,0,0,14,0,0,5,0,9,19,1
7799,104840,wBcELLuAHs6lwDaecxC5fVgtQ5lnLu3S,RXDvfPUBYFlVdlueBFbLW0mhhAyGEqpt,5,3,0,0,0,0,2,0,5,0.7142857142857143,1,0.0,0,0,0,0,3,0,0,2,0,0,5,1
7800,104843,8NRsKZ3hMeinWXhN3qtntd7OTP25jyWY,SpATywNh6bZuzm8s1ceuBUnMUAeoAHHw,4,3,1,0,1,0,2,0,7,1.0,1,0.0,0,1,0,1,3,0,0,2,0,2,5,1
7801,104847,gPygmoGilNQtwbFXETY0FWnDTdZxsr6L,bWdj2GDclj5ofokWjzoa5jAwMkxCykd6,5,4,1,0,2,0,2,0,9,1.2857142857142858,1,0.0,2,1,0,2,2,0,0,2,0,5,4,1
7802,104870,vO07VFd2DYWPdrvNiSqsqXFTXPKE00c4,SpATywNh6bZuzm8s1ceuBUnMUAeoAHHw,1,0,0,0,0,0,1,0,1,0.14285714285714285,1,0.0,0,0,0,0,0,0,0,1,0,0,1,1
7803,104888,7UoJlZNmkXe9KUxED9211lah5PpgHmBQ,A3fsA9Zfv1X2fVEQhTw51lKENdNrEqT3,8,4,2,0,2,0,3,0,11,1.5714285714285714,2,0.0,0,2,0,2,4,0,0,3,0,4,7,1
7804,104899,fYcx29YG0OyhjbzerOxQ4rwr3ES74fln,bWdj2GDclj5ofokWjzoa5jAwMkxCykd6,7,9,6,0,0,0,6,0,21,3.0,2,0.0,0,6,0,0,9,0,0,6,0,6,15,1
7805,104911,0lHtTzCCkTGgpl3mL2eT9kPoN3ydIlHv,bWdj2GDclj5ofokWjzoa5jAwMkxCykd6,10,8,6,0,5,0,3,0,22,3.142857142857143,2,0.0,0,6,0,5,8,0,0,3,0,11,11,1
7806,104921,xBMlDE0EhLrV6UTu12C10f1Ev99CwT31,SpATywNh6bZuzm8s1ceuBUnMUAeoAHHw,27,30,19,0,11,0,5,0,65,9.285714285714286,3,0.0,0,19,0,11,30,0,0,5,0,30,35,1
7807,104937,nyhARUyj7ejuonDDMRnWtxhqKty5CGUe,A3fsA9Zfv1X2fVEQhTw51lKENdNrEqT3,1,0,0,0,0,0,1,0,1,0.14285714285714285,1,0.0,0,0,0,0,0,0,0,1,0,0,1,1
7808,104940,8yrIKDtnkYcLfERwrXrvcRGxHxbt2Jd3,A3fsA9Zfv1X2fVEQhTw51lKENdNrEqT3,2,0,0,0,0,0,2,0,2,0.2857142857142857,1,0.0,0,0,0,0,0,0,0,2,0,0,2,1
7809,104950,0NdMcTtal4BOZ1xlXUgTc3KVGUjBSUot,SpATywNh6bZuzm8s1ceuBUnMUAeoAHHw,16,15,10,21,3,13,10,6,78,11.142857142857142,1,0.0,4,10,18,3,11,13,3,10,6,35,43,1
7810,104951,0FkQyM0LbhhmKgkelCOZLJl6X4aMe6Y7,bWdj2GDclj5ofokWjzoa5jAwMkxCykd6,6,3,1,0,1,0,2,0,7,1.0,1,0.0,0,1,0,1,3,0,0,2,0,2,5,1
7811,104963,Gp514eONX8HiKW2kWtPnfdmsO2W1ys65,SpATywNh6bZuzm8s1ceuBUnMUAeoAHHw,7,8,0,0,0,1,5,0,14,2.0,1,0.0,0,0,0,0,8,1,0,5,0,0,14,1
7812,104973,r6HTx0usTVh2rZ8xnqG9NraBW5uoCbAW,G8EPVSXsOYB5YQWZGiz1aVq5Pgr2GrQu,3,2,0,0,0,0,1,0,3,0.42857142857142855,1,0.0,0,0,0,0,2,0,0,1,0,0,3,1
7813,104983,as0OGPaqUNY2AJHdTO1ghRp7pegJOTda,A3fsA9Zfv1X2fVEQhTw51lKENdNrEqT3,13,7,5,0,4,0,7,0,23,3.2857142857142856,1,0.0,0,5,0,4,7,0,0,7,0,9,14,1
7814,105000,pRiGzDKgwOgFTBnFOQaqzu3UaMPe8uNF,SpATywNh6bZuzm8s1ceuBUnMUAeoAHHw,16,15,6,10,3,2,5,0,41,5.857142857142857,1,0.0,6,6,9,3,9,2,1,5,0,24,17,0
7815,105006,0fpX00EX1TEQvQDvfUOFFIekoZBhUJ55,SpATywNh6bZuzm8s1ceuBUnMUAeoAHHw,13,22,1,20,1,3,5,0,52,7.428571428571429,2,0.0,9,1,16,1,13,3,4,5,0,27,25,1
7816,105009,MoIyInVwEhZdoyGdxNDzoAKuJ4ab4usf,G8EPVSXsOYB5YQWZGiz1aVq5Pgr2GrQu,44,19,7,140,3,0,8,1,178,25.428571428571427,2,0.0,9,7,111,3,10,0,29,8,1,130,48,1
7817,105045,AsBtR21xGFKZ6c2LKvPTdlawgiUBcaPL,A3fsA9Zfv1X2fVEQhTw51lKENdNrEqT3,7,6,3,0,2,0,1,0,12,1.7142857142857142,1,0.0,0,3,0,2,6,0,0,1,0,5,7,1
7818,105048,skA6GV4QKGFVtxye7Nlz906gXUD3qCvf,SpATywNh6bZuzm8s1ceuBUnMUAeoAHHw,22,61,6,20,0,4,9,1,101,14.428571428571429,5,0.0,22,6,18,0,39,4,2,9,1,46,55,1
7819,105077,0V54aOwQrSAMewtMntBBMI7Ks56rZdIS,SpATywNh6bZuzm8s1ceuBUnMUAeoAHHw,8,3,2,0,2,0,3,0,10,1.4285714285714286,1,0.0,0,2,0,2,3,0,0,3,0,4,6,1
7820,105087,il5WSyfV8t3AlDaoTevF0gOGZQXdoXsc,SpATywNh6bZuzm8s1ceuBUnMUAeoAHHw,10,3,3,0,3,0,5,0,14,2.0,2,0.0,0,3,0,3,3,0,0,5,0,6,8,1
7821,105102,Oh8nsiPPTE9TLZe9wGx8wAMkvZwDEBik,SpATywNh6bZuzm8s1ceuBUnMUAeoAHHw,7,6,3,0,3,0,2,0,14,2.0,2,0.0,0,3,0,3,6,0,0,2,0,6,8,1
7822,105108,HJsFc87NFCDg5yRkkakXIT7nSH8XGxhF,RXDvfPUBYFlVdlueBFbLW0mhhAyGEqpt,2,0,0,0,0,0,3,0,3,0.42857142857142855,2,0.0,0,0,0,0,0,0,0,3,0,0,3,0
7823,105118,Qs7Gy3lEvMM83esFdoZ1zZvUeRYTAxxM,bWdj2GDclj5ofokWjzoa5jAwMkxCykd6,4,2,1,0,1,0,3,0,7,1.0,2,0.0,0,1,0,1,2,0,0,3,0,2,5,1
7824,105126,5THwHjTl3CwrsU1mIg0WeedsGDfvyUMr,G8EPVSXsOYB5YQWZGiz1aVq5Pgr2GrQu,16,17,9,0,6,1,13,0,46,6.571428571428571,3,0.0,0,9,0,6,17,1,0,13,0,15,31,1
7825,105127,Vr52BPz4QZ36FT4KFVQoT6q0kUFkYRGt,A3fsA9Zfv1X2fVEQhTw51lKENdNrEqT3,2,0,0,0,0,0,4,0,4,0.5714285714285714,1,0.0,0,0,0,0,0,0,0,4,0,0,4,1
7826,105140,BAa1TxCsHWVGWhK6xiubabaADa3eqEud,A3fsA9Zfv1X2fVEQhTw51lKENdNrEqT3,2,0,0,0,0,0,2,0,2,0.2857142857142857,1,0.0,0,0,0,0,0,0,0,2,0,0,2,1
7827,105147,B5KRIhKjqiTl7SsQUviM99Uk4X6GH6qt,SpATywNh6bZuzm8s1ceuBUnMUAeoAHHw,4,2,1,0,0,0,2,0,5,0.7142857142857143,1,0.0,0,1,0,0,2,0,0,2,0,1,4,1
7828,105169,Ruj4G7IwBWWMNjdkNO62PMD51YZNkIvC,SpATywNh6bZuzm8s1ceuBUnMUAeoAHHw,6,1,1,0,1,0,3,0,6,0.8571428571428571,1,0.0,0,1,0,1,1,0,0,3,0,2,4,1
7829,105174,ek3MzKxIa2dEtIB8F3GcpuahHmTwWTB6,SpATywNh6bZuzm8s1ceuBUnMUAeoAHHw,7,14,2,0,1,0,3,0,20,2.857142857142857,2,0.0,5,2,0,1,9,0,0,3,0,8,12,1
7830,105179,3ZE4TsW4kNV4MayVbDMw5du6BBHsJQ28,bWdj2GDclj5ofokWjzoa5jAwMkxCykd6,4,2,0,0,0,1,3,0,6,0.8571428571428571,1,0.0,0,0,0,0,2,1,0,3,0,0,6,1
7831,105183,vIlcyxyCAnrnNirD1pT1JNHi1Wuqkh6N,G8EPVSXsOYB5YQWZGiz1aVq5Pgr2GrQu,1,0,0,0,0,0,1,0,1,0.14285714285714285,1,0.0,0,0,0,0,0,0,0,1,0,0,1,1
7832,105193,3KmURJPHsPOw8V9aGbkBVqZ8GfDwNzjb,SpATywNh6bZuzm8s1ceuBUnMUAeoAHHw,7,3,2,0,2,0,2,0,9,1.2857142857142858,1,0.0,0,2,0,2,3,0,0,2,0,4,5,1
7833,105213,f6fUoSUJslaShApLLQ3C3hAE39t0Ewco,A3fsA9Zfv1X2fVEQhTw51lKENdNrEqT3,2,0,0,0,0,0,2,0,2,0.2857142857142857,2,0.0,0,0,0,0,0,0,0,2,0,0,2,1
7834,105215,XqjUxB8l2EDnNsPmb4GmXeJWVp4D1ShM,SpATywNh6bZuzm8s1ceuBUnMUAeoAHHw,5,4,0,0,0,1,3,0,8,1.1428571428571428,1,0.0,0,0,0,0,4,1,0,3,0,0,8,1
7835,105238,D49L08bhYMDNZcjv8FPy2UNVru9gYK6t,bWdj2GDclj5ofokWjzoa5jAwMkxCykd6,5,1,1,0,1,0,2,0,5,0.7142857142857143,1,0.0,0,1,0,1,1,0,0,2,0,2,3,1
7836,105258,iaVYLE1BI86xpC2ERUpI1xclzmGmTOg0,SpATywNh6bZuzm8s1ceuBUnMUAeoAHHw,4,2,0,0,0,0,2,0,4,0.5714285714285714,1,0.0,0,0,0,0,2,0,0,2,0,0,4,1
7837,105265,yvMe4l8GZJNWinwQEogjzWQJd9z0H33J,SpATywNh6bZuzm8s1ceuBUnMUAeoAHHw,8,7,5,0,1,2,3,1,19,2.7142857142857144,1,0.0,0,5,0,1,7,2,0,3,1,6,13,1
7838,105277,KUZLnWk3DnESTDfMbkIGdOBiU12ntmts,A3fsA9Zfv1X2fVEQhTw51lKENdNrEqT3,7,4,2,0,1,0,8,0,15,2.142857142857143,1,0.0,1,2,0,1,3,0,0,8,0,4,11,1
7839,105309,8yGhHOYnj9M6W9ULBEe6c9dxuWlFPuyX,SpATywNh6bZuzm8s1ceuBUnMUAeoAHHw,5,3,2,0,1,0,2,0,8,1.1428571428571428,1,0.0,0,2,0,1,3,0,0,2,0,3,5,1
7840,105310,drUu3tyovHqnF7EAaPHayHDYbWMe2Od6,G8EPVSXsOYB5YQWZGiz1aVq5Pgr2GrQu,1,0,0,0,0,0,1,0,1,0.14285714285714285,1,0.0,0,0,0,0,0,0,0,1,0,0,1,1
7841,105311,drUu3tyovHqnF7EAaPHayHDYbWMe2Od6,RXDvfPUBYFlVdlueBFbLW0mhhAyGEqpt,1,0,0,0,0,0,1,0,1,0.14285714285714285,1,0.0,0,0,0,0,0,0,0,1,0,0,1,1
7842,105313,drUu3tyovHqnF7EAaPHayHDYbWMe2Od6,A3fsA9Zfv1X2fVEQhTw51lKENdNrEqT3,1,0,0,0,0,0,1,0,1,0.14285714285714285,1,0.0,0,0,0,0,0,0,0,1,0,0,1,1
7843,105323,yiX0lNiEyuJnsK7G0Hy1jjUqzZwKTcF0,SpATywNh6bZuzm8s1ceuBUnMUAeoAHHw,24,41,2,20,1,15,17,2,98,14.0,6,0.0,5,2,19,1,36,15,1,17,2,27,71,1
7844,105325,afcoJmZ0nAGqrhElRzMbfqW6LhEtEJYc,A3fsA9Zfv1X2fVEQhTw51lKENdNrEqT3,10,5,4,0,4,0,2,0,15,2.142857142857143,1,0.0,0,4,0,4,5,0,0,2,0,8,7,1
7845,105329,e7lti3fBvO8XZNtS4I7hMo5JFh6PqMCH,A3fsA9Zfv1X2fVEQhTw51lKENdNrEqT3,3,2,0,0,0,0,2,0,4,0.5714285714285714,1,0.0,0,0,0,0,2,0,0,2,0,0,4,1
7846,105330,l1I3uQILh7eNNq6Rwc2qZc5y0kyUy4xt,SpATywNh6bZuzm8s1ceuBUnMUAeoAHHw,1,0,0,0,0,0,1,0,1,0.14285714285714285,1,0.0,0,0,0,0,0,0,0,1,0,0,1,1
7847,105337,DI0mr4BQNoklidHTIy9m8FuU69db5M3W,SpATywNh6bZuzm8s1ceuBUnMUAeoAHHw,6,6,2,0,1,0,2,0,11,1.5714285714285714,2,0.0,0,2,0,1,6,0,0,2,0,3,8,1
7848,105339,fa4GjkZRgCxI5T2nX0B0SnNvYjPJTUJZ,bWdj2GDclj5ofokWjzoa5jAwMkxCykd6,2,0,0,0,0,0,3,0,3,0.42857142857142855,1,0.0,0,0,0,0,0,0,0,3,0,0,3,1
7849,105346,8cxCnT3STAEth9x4HzjOcerWufkhGlX3,SpATywNh6bZuzm8s1ceuBUnMUAeoAHHw,10,3,2,0,2,4,7,1,19,2.7142857142857144,1,0.0,0,2,0,2,3,4,0,7,1,4,15,1
7850,105348,jyuEVmbrPcyGnV7pufxSb0rPrKJZItsk,SpATywNh6bZuzm8s1ceuBUnMUAeoAHHw,30,58,32,27,15,2,12,0,146,20.857142857142858,5,0.0,18,32,23,15,40,2,4,12,0,88,58,1
7851,105354,yPqVjRtl1ZeCcEk7haS4nj4BOuHk3MT1,A3fsA9Zfv1X2fVEQhTw51lKENdNrEqT3,1,0,0,0,0,0,2,0,2,0.2857142857142857,1,0.0,0,0,0,0,0,0,0,2,0,0,2,1
7852,105357,Q9q5caNwjGe6Mi6I72wyiS18BJTL4KH1,SpATywNh6bZuzm8s1ceuBUnMUAeoAHHw,11,15,4,16,0,0,4,0,39,5.571428571428571,1,0.0,8,4,14,0,7,0,2,4,0,26,13,1
7853,105362,IqTYyD7L0euRgN3diEzqrprrc2W9uyF6,A3fsA9Zfv1X2fVEQhTw51lKENdNrEqT3,14,8,6,0,5,4,5,1,29,4.142857142857143,2,0.0,0,6,0,5,8,4,0,5,1,11,18,1
7854,105369,ATdd6t2UWonXImy5O3tzf7AEJJ0cHqzx,SpATywNh6bZuzm8s1ceuBUnMUAeoAHHw,3,0,0,0,0,0,3,0,3,0.42857142857142855,1,0.0,0,0,0,0,0,0,0,3,0,0,3,1
7855,105392,m52MhXMTVGYF4Y9Pc8zOC6jKXo973eSz,SpATywNh6bZuzm8s1ceuBUnMUAeoAHHw,1,0,0,0,0,0,1,0,1,0.14285714285714285,1,0.0,0,0,0,0,0,0,0,1,0,0,1,1
7856,105410,vqSgORDp5PsEpveQVJoPh4dnJvR6AQkK,A3fsA9Zfv1X2fVEQhTw51lKENdNrEqT3,1,0,0,0,0,0,1,0,1,0.14285714285714285,1,0.0,0,0,0,0,0,0,0,1,0,0,1,1
7857,105420,biOEnvJNbNmJmtnLohBToN5g3ppQrMj4,SpATywNh6bZuzm8s1ceuBUnMUAeoAHHw,5,8,4,0,1,0,3,0,16,2.2857142857142856,2,0.0,0,4,0,1,8,0,0,3,0,5,11,1
7858,105421,DgZ8el6keJUnUjxjYHQCrfhij2kpBixa,bWdj2GDclj5ofokWjzoa5jAwMkxCykd6,7,9,3,0,1,0,1,0,14,2.0,1,0.0,0,3,0,1,9,0,0,1,0,4,10,0
7859,105425,EBjWbzPkmDW0GuiUkHj889OvqfrdDhI2,SpATywNh6bZuzm8s1ceuBUnMUAeoAHHw,9,8,5,4,0,0,3,0,20,2.857142857142857,1,0.0,1,5,4,0,7,0,0,3,0,10,10,1
7860,105428,h3LsKXMnT4HqL0yI33YFdQ7c6aiA632R,SpATywNh6bZuzm8s1ceuBUnMUAeoAHHw,15,24,7,9,3,10,3,2,58,8.285714285714286,1,0.0,15,7,9,3,9,10,0,3,2,34,24,1
7861,105434,3n6ajKAkQu8rgtUnNpdWOfMF8VSNsMVs,A3fsA9Zfv1X2fVEQhTw51lKENdNrEqT3,4,2,1,0,0,0,3,0,6,0.8571428571428571,2,0.0,0,1,0,0,2,0,0,3,0,1,5,1
7862,105436,wbX1noywm1bmZy8t47H8TCRwxZP7RsKK,bWdj2GDclj5ofokWjzoa5jAwMkxCykd6,1,0,0,0,0,0,1,0,1,0.14285714285714285,1,0.0,0,0,0,0,0,0,0,1,0,0,1,1
7863,105438,4bmL6hoAF72J4V8IxCYpOyypEujwyDUs,A3fsA9Zfv1X2fVEQhTw51lKENdNrEqT3,6,2,0,0,0,1,5,0,8,1.1428571428571428,1,0.0,0,0,0,0,2,1,0,5,0,0,8,1
7864,105442,1YSmilr2ajm5pFk4iAawwfB3mRapy4GR,A3fsA9Zfv1X2fVEQhTw51lKENdNrEqT3,4,2,1,0,1,0,1,0,5,0.7142857142857143,1,0.0,0,1,0,1,2,0,0,1,0,2,3,1
7865,105467,dEPUxcdyZTnKUVP0o2JXv6VWX3ETnwmr,bWdj2GDclj5ofokWjzoa5jAwMkxCykd6,6,2,1,0,0,0,4,0,7,1.0,1,0.0,1,1,0,0,1,0,0,4,0,2,5,1
7866,105476,pMxyBMX7n5deuUC9YyUONEJJAyoPl0BG,SpATywNh6bZuzm8s1ceuBUnMUAeoAHHw,11,12,0,0,0,0,4,0,16,2.2857142857142856,3,0.0,0,0,0,0,12,0,0,4,0,0,16,1
7867,105477,uMcognJuP2U8fvNcuj2o9G4hdrHlzffM,SpATywNh6bZuzm8s1ceuBUnMUAeoAHHw,8,13,6,0,0,1,11,1,32,4.571428571428571,1,0.0,2,6,0,0,11,1,0,11,1,8,24,1
7868,105482,sVA3jWGeZiIVEsBLKNyDfSGu7oUE3Uyc,A3fsA9Zfv1X2fVEQhTw51lKENdNrEqT3,2,0,0,0,0,0,5,0,5,0.7142857142857143,3,0.0,0,0,0,0,0,0,0,5,0,0,5,1
7869,105494,RS3yqsxA8GMaO1hS4uSnfa6jOPVVMGWD,bWdj2GDclj5ofokWjzoa5jAwMkxCykd6,6,3,1,0,1,0,2,0,7,1.0,1,0.0,0,1,0,1,3,0,0,2,0,2,5,1
7870,105522,Sj6pTyY9d8gvsSx1FCIqF3bTiiQB5ISO,RXDvfPUBYFlVdlueBFbLW0mhhAyGEqpt,1,0,0,0,0,0,1,0,1,0.14285714285714285,1,0.0,0,0,0,0,0,0,0,1,0,0,1,1
7871,105531,E9EKlY1j2c1T8yweLd0nuHvfVuBiMa1Z,SpATywNh6bZuzm8s1ceuBUnMUAeoAHHw,1,0,0,0,0,0,1,0,1,0.14285714285714285,1,0.0,0,0,0,0,0,0,0,1,0,0,1,1
7872,105536,JiGlqAbyZaZegus8dku8k8Xk9BHhTCdV,SpATywNh6bZuzm8s1ceuBUnMUAeoAHHw,8,2,1,0,1,5,7,1,17,2.4285714285714284,1,0.0,0,1,0,1,2,5,0,7,1,2,15,1
7873,105547,x3ZcCHvytIJQEMLj5E05tgfA0i9bCC3E,SpATywNh6bZuzm8s1ceuBUnMUAeoAHHw,1,0,0,0,0,0,1,0,1,0.14285714285714285,1,0.0,0,0,0,0,0,0,0,1,0,0,1,1
7874,105556,aa0arothpvvvORCnYecBgFktA9Cuu0Tk,SpATywNh6bZuzm8s1ceuBUnMUAeoAHHw,12,10,7,4,5,0,2,0,28,4.0,1,0.0,0,7,4,5,10,0,0,2,0,16,12,1
7875,105558,GbO46rd9u4nTIYKWQ4uqsc2u6MxCvlf3,A3fsA9Zfv1X2fVEQhTw51lKENdNrEqT3,7,8,5,0,0,0,5,0,18,2.5714285714285716,3,0.0,0,5,0,0,8,0,0,5,0,5,13,1
7876,105566,QsEau4BvaT6rjAper2QSXSr2L9nKgnZa,SpATywNh6bZuzm8s1ceuBUnMUAeoAHHw,1,0,0,0,0,0,1,0,1,0.14285714285714285,1,0.0,0,0,0,0,0,0,0,1,0,0,1,0
7877,105583,Cb1oMMLwTjTacmho2xz7pvU7NsoZgScq,A3fsA9Zfv1X2fVEQhTw51lKENdNrEqT3,8,5,3,0,2,0,3,0,13,1.8571428571428572,2,0.0,0,3,0,2,5,0,0,3,0,5,8,1
7878,105593,CVNZnTiRds77aV88t7oO5JnyjLjE4gZ5,A3fsA9Zfv1X2fVEQhTw51lKENdNrEqT3,8,6,3,0,3,0,1,0,13,1.8571428571428572,1,0.0,0,3,0,3,6,0,0,1,0,6,7,1
7879,105607,Z91ylcCa0QBPuZRAZnN7Bi8KMhEMk84I,SpATywNh6bZuzm8s1ceuBUnMUAeoAHHw,1,0,0,0,0,0,1,0,1,0.14285714285714285,1,0.0,0,0,0,0,0,0,0,1,0,0,1,1
7880,105612,kTfeD1yVO5Jc7Nzx4cKtELWtok3ws4tr,bWdj2GDclj5ofokWjzoa5jAwMkxCykd6,8,10,0,0,0,36,8,1,55,7.857142857142857,2,0.0,2,0,0,0,8,36,0,8,1,2,53,1
7881,105613,Z91ylcCa0QBPuZRAZnN7Bi8KMhEMk84I,RXDvfPUBYFlVdlueBFbLW0mhhAyGEqpt,1,0,0,0,0,0,1,0,1,0.14285714285714285,1,0.0,0,0,0,0,0,0,0,1,0,0,1,1
7882,105617,6ZG1BmPHf4xACRz5Wb0XhmecfqdoDBrw,SpATywNh6bZuzm8s1ceuBUnMUAeoAHHw,9,10,2,0,0,1,7,1,21,3.0,1,0.0,0,2,0,0,10,1,0,7,1,2,19,1
7883,105619,XDUz0oVcNwke0CqAlFlmwOWSA32SgeFl,RXDvfPUBYFlVdlueBFbLW0mhhAyGEqpt,1,0,0,0,0,0,1,0,1,0.14285714285714285,1,0.0,0,0,0,0,0,0,0,1,0,0,1,1
7884,105621,Z2LpxeyN5IUym4huJGBt4liqsVm2EQ7Q,SpATywNh6bZuzm8s1ceuBUnMUAeoAHHw,33,64,14,42,3,35,33,1,192,27.428571428571427,10,0.0,13,14,35,3,51,35,7,33,1,65,127,0
7885,105630,UU4MEikmCGklRVK3djHNSk7yxxkesa3p,bWdj2GDclj5ofokWjzoa5jAwMkxCykd6,12,15,10,0,4,4,15,0,48,6.857142857142857,2,0.0,0,10,0,4,15,4,0,15,0,14,34,1
7886,105631,RWrD2aL8EikwNOiemk8w8nKZlf66LQBh,SpATywNh6bZuzm8s1ceuBUnMUAeoAHHw,4,5,3,0,3,0,2,0,13,1.8571428571428572,2,0.0,1,3,0,3,4,0,0,2,0,7,6,1
7887,105635,6UsHFnhiB8wUPOMCvGQlekDt4oV3KUX3,A3fsA9Zfv1X2fVEQhTw51lKENdNrEqT3,5,3,2,0,0,0,7,1,13,1.8571428571428572,2,0.0,0,2,0,0,3,0,0,7,1,2,11,1
7888,105657,GRVPWiEvNASyREwGmbaFNHUClZD26ajQ,A3fsA9Zfv1X2fVEQhTw51lKENdNrEqT3,9,3,3,0,3,0,3,0,12,1.7142857142857142,1,0.0,0,3,0,3,3,0,0,3,0,6,6,1
7889,105659,HDn8BqQviq3qzBRDiLH1seTa1wZLl2Fv,SpATywNh6bZuzm8s1ceuBUnMUAeoAHHw,2,0,0,0,0,0,2,0,2,0.2857142857142857,1,0.0,0,0,0,0,0,0,0,2,0,0,2,1
7890,105674,pPG4IhCdtFDb0ApVQ8Cw5mvhtg1pBVlc,A3fsA9Zfv1X2fVEQhTw51lKENdNrEqT3,1,0,0,0,0,0,1,0,1,0.14285714285714285,1,0.0,0,0,0,0,0,0,0,1,0,0,1,1
7891,105683,RyhsCovpAO4Tu33MEtD28G55TyhpodT7,bWdj2GDclj5ofokWjzoa5jAwMkxCykd6,1,0,0,0,0,0,2,0,2,0.2857142857142857,1,0.0,0,0,0,0,0,0,0,2,0,0,2,1
7892,105686,ZMYniXzfaHfNUK3JevOZjrK1dOWNKOE7,A3fsA9Zfv1X2fVEQhTw51lKENdNrEqT3,2,0,0,0,0,0,2,0,2,0.2857142857142857,1,0.0,0,0,0,0,0,0,0,2,0,0,2,1
7893,105692,vP4adNJVoKfOfC59LI5B3RjnV290gjOc,SpATywNh6bZuzm8s1ceuBUnMUAeoAHHw,4,2,0,0,0,0,2,0,4,0.5714285714285714,1,0.0,0,0,0,0,2,0,0,2,0,0,4,1
7894,105705,Higp7tL2evAdDfwxJ7Fv3MD5xI1FILhG,bWdj2GDclj5ofokWjzoa5jAwMkxCykd6,1,0,0,0,0,0,1,0,1,0.14285714285714285,1,0.0,0,0,0,0,0,0,0,1,0,0,1,1
7895,105717,YGd4irzc5KMR1PH2KdOtbCkghLMZ2dPk,SpATywNh6bZuzm8s1ceuBUnMUAeoAHHw,9,6,4,10,0,0,2,0,22,3.142857142857143,1,0.0,2,4,9,0,4,0,1,2,0,15,7,1
7896,105761,nykkKhG5AxCe9Czq7wPmsDcTY6IOvKIH,5X6FeZozNMgE2VRi3MJYjkkFK8SETtu2,7,6,1,2,2,0,2,0,13,1.8571428571428572,1,0.0,2,1,2,2,4,0,0,2,0,7,6,1
7897,105773,40Xea2YMOWW1uT2M8t7POlJQUIkhUdnJ,7GRhBDsirIGkRZBtSMEzNTyDr2JQm4xx,7,4,3,0,2,0,3,0,12,1.7142857142857142,1,0.0,0,3,0,2,4,0,0,3,0,5,7,1
7898,105801,khmHazlC1lBTqllIsTqLn3G01U4sjYKo,5X6FeZozNMgE2VRi3MJYjkkFK8SETtu2,6,3,1,0,2,0,3,0,9,1.2857142857142858,1,0.0,1,1,0,2,2,0,0,3,0,4,5,1
7899,105862,QcbB4zGNvIA8Hos1EmgULZPHy4JycNs5,7GRhBDsirIGkRZBtSMEzNTyDr2JQm4xx,1,0,0,0,0,0,2,0,2,0.2857142857142857,1,0.0,0,0,0,0,0,0,0,2,0,0,2,1
7900,105863,G86VNHc8vSSjCeTTfojU4Lj6kJiGcQPq,5X6FeZozNMgE2VRi3MJYjkkFK8SETtu2,5,3,1,0,1,0,2,0,7,1.0,1,0.0,0,1,0,1,3,0,0,2,0,2,5,1
7901,105894,Msm7VbQnHSrKXxwAtvM1UL3x4iRGks4I,5X6FeZozNMgE2VRi3MJYjkkFK8SETtu2,1,0,0,0,0,0,1,0,1,0.14285714285714285,1,0.0,0,0,0,0,0,0,0,1,0,0,1,1
7902,105928,T8ZgVxZ1KcbbwwKauSYOnW28FLVyPTlj,7GRhBDsirIGkRZBtSMEzNTyDr2JQm4xx,2,0,0,0,0,0,2,0,2,0.2857142857142857,1,0.0,0,0,0,0,0,0,0,2,0,0,2,1
7903,105954,RmlyieNXfVrGM9LWnpgNxfz0WPjjsgcE,5X6FeZozNMgE2VRi3MJYjkkFK8SETtu2,14,17,9,2,12,0,1,0,41,5.857142857142857,1,0.0,6,9,2,12,11,0,0,1,0,29,12,1
7904,105967,FxPyq8YtKk0yw3NNE8ZksN1yqg6GsuE4,7GRhBDsirIGkRZBtSMEzNTyDr2JQm4xx,2,0,0,0,0,0,6,0,6,0.8571428571428571,1,0.0,0,0,0,0,0,0,0,6,0,0,6,1
7905,105969,ikVmCxeXCKQtR8OPUUdHoGQCjATpEVdj,7GRhBDsirIGkRZBtSMEzNTyDr2JQm4xx,9,6,2,6,2,1,5,0,22,3.142857142857143,1,0.0,2,2,5,2,4,1,1,5,0,11,11,1
7906,105978,Z0RxOk6qXdCVEUwgYNFnCN7QFecq61SF,7GRhBDsirIGkRZBtSMEzNTyDr2JQm4xx,1,0,0,0,0,0,1,0,1,0.14285714285714285,1,0.0,0,0,0,0,0,0,0,1,0,0,1,1
7907,106017,UTdeWmi6AePo1O6hg6pDbCCeGok0eGfZ,7GRhBDsirIGkRZBtSMEzNTyDr2JQm4xx,1,0,0,0,0,0,1,0,1,0.14285714285714285,1,0.0,0,0,0,0,0,0,0,1,0,0,1,1
7908,106292,eaf2dBLOkAjzSJFeSL5LIO99DDxG9xBE,SpATywNh6bZuzm8s1ceuBUnMUAeoAHHw,5,18,1,0,0,0,6,0,25,3.5714285714285716,3,0.0,0,1,0,0,18,0,0,6,0,1,24,0
7909,106302,CHiI46TzJ7KTopzqYzHnHLTSqsLCQupU,SpATywNh6bZuzm8s1ceuBUnMUAeoAHHw,1,0,0,0,0,0,1,0,1,0.14285714285714285,1,0.0,0,0,0,0,0,0,0,1,0,0,1,0
7910,106312,nvXkSuJjNwPy4x4PN83PXogIa9iXtJsm,bWdj2GDclj5ofokWjzoa5jAwMkxCykd6,6,2,2,0,2,0,7,0,13,1.8571428571428572,1,0.0,0,2,0,2,2,0,0,7,0,4,9,1
7911,106355,w2dtGgNPRzxwneFGubkorQo36PxfqqeK,SpATywNh6bZuzm8s1ceuBUnMUAeoAHHw,5,0,0,0,0,0,4,1,5,0.7142857142857143,1,0.0,0,0,0,0,0,0,0,4,1,0,5,1
7912,106377,pIUA4CxUOhlZMOg4cOlVb2la0FCnmRD3,A3fsA9Zfv1X2fVEQhTw51lKENdNrEqT3,11,8,7,0,6,0,1,0,22,3.142857142857143,1,0.0,0,7,0,6,8,0,0,1,0,13,9,1
7913,106380,aiUFQFUA2cfQeIiWYfzvV70Kxs8bzZjl,A3fsA9Zfv1X2fVEQhTw51lKENdNrEqT3,4,2,1,0,1,0,2,0,6,0.8571428571428571,1,0.0,0,1,0,1,2,0,0,2,0,2,4,1
7914,106398,tJSuuWZXDdoXjZXIctAWwDLD7oHTWJ9T,bWdj2GDclj5ofokWjzoa5jAwMkxCykd6,2,0,0,0,0,0,2,0,2,0.2857142857142857,1,0.0,0,0,0,0,0,0,0,2,0,0,2,1
7915,106418,4vGASaaJ1gif3X9ohNHSGBizcSlajzrR,G8EPVSXsOYB5YQWZGiz1aVq5Pgr2GrQu,2,0,0,0,0,0,2,0,2,0.2857142857142857,1,0.0,0,0,0,0,0,0,0,2,0,0,2,0
7916,106438,NyEijNa9dfqUApw5iyHdD9FPGDdLrbLb,RXDvfPUBYFlVdlueBFbLW0mhhAyGEqpt,28,21,16,0,11,1,5,0,54,7.714285714285714,1,0.0,0,16,0,11,21,1,0,5,0,27,27,1
7917,106440,FiDLmZS7SZoCB8c2FPrLrdnRZi9p4XPX,bWdj2GDclj5ofokWjzoa5jAwMkxCykd6,8,9,4,0,4,0,3,1,21,3.0,2,0.0,3,4,0,4,6,0,0,3,1,11,10,0
7918,106451,lKD6NXfkh6Hzqg1qAGXl1PKKyBvPYL7k,SpATywNh6bZuzm8s1ceuBUnMUAeoAHHw,2,0,0,0,0,0,2,0,2,0.2857142857142857,1,0.0,0,0,0,0,0,0,0,2,0,0,2,1
7919,106457,VtALT7PCDyJDsdPo6puj2SULDyuNrsZ2,5X6FeZozNMgE2VRi3MJYjkkFK8SETtu2,2,0,0,0,0,0,2,0,2,0.2857142857142857,1,0.0,0,0,0,0,0,0,0,2,0,0,2,1
7920,106466,CNb0Sul2DOkX3VhMOeM6DWqvlrGgHagf,A3fsA9Zfv1X2fVEQhTw51lKENdNrEqT3,1,0,0,0,0,0,1,0,1,0.14285714285714285,1,0.0,0,0,0,0,0,0,0,1,0,0,1,1
7921,106496,bP02cfOIFimMsMVUcFl4uLZksud3wO6q,RXDvfPUBYFlVdlueBFbLW0mhhAyGEqpt,1,0,0,0,0,0,1,0,1,0.14285714285714285,1,0.0,0,0,0,0,0,0,0,1,0,0,1,1
7922,106505,SSjMJy46FRxCnKuhMLxzF4UfAx5Jlk65,A3fsA9Zfv1X2fVEQhTw51lKENdNrEqT3,7,11,3,0,1,0,7,0,22,3.142857142857143,1,0.0,0,3,0,1,11,0,0,7,0,4,18,1
7923,106506,wywFtc7buIqNEURngjXjEkiYAf5BIbLx,bWdj2GDclj5ofokWjzoa5jAwMkxCykd6,11,9,2,26,4,0,6,1,48,6.857142857142857,2,0.0,4,2,25,4,5,0,1,6,1,35,13,1
7924,106528,58p1CjrP7XDWRfO9BWpFsEFnKaKNXYOr,SpATywNh6bZuzm8s1ceuBUnMUAeoAHHw,5,9,0,0,0,0,2,0,11,1.5714285714285714,1,0.0,6,0,0,0,3,0,0,2,0,6,5,0
7925,106540,aRBsP3RNC28m05qU4AuLdcShaMIKbk0T,RXDvfPUBYFlVdlueBFbLW0mhhAyGEqpt,2,0,0,0,0,0,2,0,2,0.2857142857142857,1,0.0,0,0,0,0,0,0,0,2,0,0,2,1
7926,106550,dstTpT2BjfmJxSzmJpU00abOAObDPwAz,5X6FeZozNMgE2VRi3MJYjkkFK8SETtu2,1,0,0,0,0,0,1,0,1,0.14285714285714285,1,0.0,0,0,0,0,0,0,0,1,0,0,1,1
7927,106587,eJuJSF1kb4boRbrBsR9P3vZW2Mag1arE,SpATywNh6bZuzm8s1ceuBUnMUAeoAHHw,11,13,0,7,0,0,3,0,23,3.2857142857142856,2,0.0,5,0,7,0,8,0,0,3,0,12,11,1
7928,106592,QycygN4wUJdorVPgO5PJQhHEi2M0czTF,bWdj2GDclj5ofokWjzoa5jAwMkxCykd6,4,4,0,0,0,0,2,0,6,0.8571428571428571,2,0.0,0,0,0,0,4,0,0,2,0,0,6,1
7929,106599,rbxTporlOqtSqZOyiDbvbMHveyvkICoI,A3fsA9Zfv1X2fVEQhTw51lKENdNrEqT3,1,0,0,0,0,0,2,0,2,0.2857142857142857,1,0.0,0,0,0,0,0,0,0,2,0,0,2,1
7930,106627,ScIuqHs55u32PpI8ATvWh59ifl2MpG45,SpATywNh6bZuzm8s1ceuBUnMUAeoAHHw,34,27,20,9,16,0,4,0,76,10.857142857142858,1,0.0,1,20,8,16,26,0,1,4,0,45,31,1
7931,106659,RMG4hzng4Wp3OF1KXSagJtTgEvPUSiPj,A3fsA9Zfv1X2fVEQhTw51lKENdNrEqT3,2,0,0,0,0,0,5,0,5,0.7142857142857143,1,0.0,0,0,0,0,0,0,0,5,0,0,5,1
7932,106699,edEL8C4u3SeG3jN4X4AKp0GVosDARXCS,SpATywNh6bZuzm8s1ceuBUnMUAeoAHHw,1,0,0,0,0,0,1,0,1,0.14285714285714285,1,0.0,0,0,0,0,0,0,0,1,0,0,1,1
7933,106730,bUlVBXqXRojGcrtmo2UOxhIzd8vCtLry,RXDvfPUBYFlVdlueBFbLW0mhhAyGEqpt,24,33,19,0,14,2,6,0,74,10.571428571428571,3,0.0,0,19,0,14,33,2,0,6,0,33,41,1
7934,106736,VbQhjd0ThHRRAU7zAe9C6rWO0bsprcst,SpATywNh6bZuzm8s1ceuBUnMUAeoAHHw,1,0,0,0,0,0,1,0,1,0.14285714285714285,1,0.0,0,0,0,0,0,0,0,1,0,0,1,1
7935,106766,Nsm5QAhxA1QCdT1zW4z4WaVJyYPTmGcO,RXDvfPUBYFlVdlueBFbLW0mhhAyGEqpt,1,0,0,0,0,0,1,0,1,0.14285714285714285,1,0.0,0,0,0,0,0,0,0,1,0,0,1,1
7936,106769,H40umhtRkpIQB1fzDkKwom1MRBMPCSA7,RXDvfPUBYFlVdlueBFbLW0mhhAyGEqpt,6,4,1,0,1,0,2,0,8,1.1428571428571428,1,0.0,0,1,0,1,4,0,0,2,0,2,6,1
7937,106774,y6i20DJpIul6LihHwgZcWxbdAap5GcBP,5X6FeZozNMgE2VRi3MJYjkkFK8SETtu2,1,0,0,0,0,0,4,0,4,0.5714285714285714,2,0.0,0,0,0,0,0,0,0,4,0,0,4,1
7938,106801,jmBcV5GzgEvFPXiOm3lIcsMGTfagH1ak,SpATywNh6bZuzm8s1ceuBUnMUAeoAHHw,1,0,0,0,0,0,1,0,1,0.14285714285714285,1,0.0,0,0,0,0,0,0,0,1,0,0,1,1
7939,106806,vUowOWE9grUVnUy6A9M0f4pOETawtkpU,bWdj2GDclj5ofokWjzoa5jAwMkxCykd6,2,0,0,0,0,0,2,0,2,0.2857142857142857,1,0.0,0,0,0,0,0,0,0,2,0,0,2,1
7940,106808,9ReKyoH1pwgMi23AYKJMYTsoBlnJmYH9,SpATywNh6bZuzm8s1ceuBUnMUAeoAHHw,2,0,0,0,0,0,3,0,3,0.42857142857142855,1,0.0,0,0,0,0,0,0,0,3,0,0,3,1
7941,106823,goH3eL8vc5HDpMZExF8B0A1ykP7H7H0A,A3fsA9Zfv1X2fVEQhTw51lKENdNrEqT3,9,5,3,0,3,0,1,0,12,1.7142857142857142,1,0.0,0,3,0,3,5,0,0,1,0,6,6,1
7942,106860,6lERIt9LK72b4gBh1gc6JqDmon4igZIH,A3fsA9Zfv1X2fVEQhTw51lKENdNrEqT3,47,64,41,60,22,43,25,13,268,38.285714285714285,4,0.0,5,41,50,22,59,43,10,25,13,118,150,0
7943,106870,7QrJe5BY6GVg5UADev8ewJVu7PPlVQrU,SpATywNh6bZuzm8s1ceuBUnMUAeoAHHw,9,7,3,0,2,0,3,0,15,2.142857142857143,2,0.0,0,3,0,2,7,0,0,3,0,5,10,1
7944,106896,LGIto3qFAmkLm07XwtWQCNPbarZXKMyq,SpATywNh6bZuzm8s1ceuBUnMUAeoAHHw,11,16,1,0,1,0,3,0,21,3.0,1,0.0,0,1,0,1,16,0,0,3,0,2,19,1
7945,106897,yrxUCbkwiU0Qgu0wZMF5MylHBneN7zri,SpATywNh6bZuzm8s1ceuBUnMUAeoAHHw,32,61,24,16,12,1,9,0,123,17.571428571428573,6,0.0,3,24,16,12,58,1,0,9,0,55,68,0
7946,106907,Nqn3ANjR8SmFf4pF0O8Kve4CiSpmex7G,A3fsA9Zfv1X2fVEQhTw51lKENdNrEqT3,4,6,1,0,1,0,1,0,9,1.2857142857142858,1,0.0,2,1,0,1,4,0,0,1,0,4,5,0
7947,106910,QXuvnwuKGvhNAY9NohmlAFZHlIFa6rI7,RXDvfPUBYFlVdlueBFbLW0mhhAyGEqpt,1,0,0,0,0,0,2,0,2,0.2857142857142857,1,0.0,0,0,0,0,0,0,0,2,0,0,2,1
7948,106945,V8hRrBfC4m6o5SRifZvjczGfigxmUHIL,G8EPVSXsOYB5YQWZGiz1aVq5Pgr2GrQu,1,0,0,0,0,0,1,0,1,0.14285714285714285,1,0.0,0,0,0,0,0,0,0,1,0,0,1,1
7949,106958,JVX13yi9NtZIvDKYUG9hgCWS9Rbsc8S6,SpATywNh6bZuzm8s1ceuBUnMUAeoAHHw,1,0,0,0,0,0,1,0,1,0.14285714285714285,1,0.0,0,0,0,0,0,0,0,1,0,0,1,1
7950,106970,eNA8Do3VklggbxHrm6LTfg4Q8kccaQmP,bWdj2GDclj5ofokWjzoa5jAwMkxCykd6,5,2,1,0,1,0,2,0,6,0.8571428571428571,1,0.0,0,1,0,1,2,0,0,2,0,2,4,0
7951,106972,GKYpiWZuICG4mzHDIMBAcMJwYd14l50I,A3fsA9Zfv1X2fVEQhTw51lKENdNrEqT3,5,3,1,0,1,0,2,0,7,1.0,1,0.0,1,1,0,1,2,0,0,2,0,3,4,1
7952,106981,reBpiAvYdQFwXMmy7qYcpfedR98eE5B4,bWdj2GDclj5ofokWjzoa5jAwMkxCykd6,8,3,2,0,2,1,3,1,12,1.7142857142857142,1,0.0,0,2,0,2,3,1,0,3,1,4,8,1
7953,106984,9yJM3R19OwcfPlxfVtLgyGlcFgNllk8L,SpATywNh6bZuzm8s1ceuBUnMUAeoAHHw,1,0,0,0,0,0,1,0,1,0.14285714285714285,1,0.0,0,0,0,0,0,0,0,1,0,0,1,1
7954,106996,LCXXQFy8KIoQNTdeO89e9nW5ZJ3hEpFD,SpATywNh6bZuzm8s1ceuBUnMUAeoAHHw,17,30,10,16,3,2,6,1,68,9.714285714285714,2,0.0,18,10,15,3,12,2,1,6,1,46,22,1
7955,107022,1sAyB3nxbs73TCz7P8ePgbTuRyvUJi7o,bWdj2GDclj5ofokWjzoa5jAwMkxCykd6,1,0,0,0,0,0,1,0,1,0.14285714285714285,1,0.0,0,0,0,0,0,0,0,1,0,0,1,1
7956,107025,ggEr2STKTwtSSUdtGCmiPr3DBu3TJ34B,G8EPVSXsOYB5YQWZGiz1aVq5Pgr2GrQu,61,7,0,112,0,0,1,0,120,17.142857142857142,1,0.0,0,0,112,0,7,0,0,1,0,112,8,1
7957,107056,Y5AX6ZQ5Ugwn3sD9xwZmBQdLr2GbgKTx,SpATywNh6bZuzm8s1ceuBUnMUAeoAHHw,6,1,1,0,1,0,7,0,10,1.4285714285714286,1,0.0,0,1,0,1,1,0,0,7,0,2,8,1
7958,107100,Kpn2SZmmiazR6DCkcb8B8TXM52qr9chW,3VkHkmOtom3jM2wCu94xgzzu1d6Dn7or,23,53,13,14,8,1,11,0,100,14.285714285714286,3,0.0,12,13,12,8,41,1,2,11,0,45,55,0
7959,107105,3kXcB21kCQHJG7kYLFPH8fKSXD349Vv9,3VkHkmOtom3jM2wCu94xgzzu1d6Dn7or,1,0,0,0,0,0,1,0,1,0.14285714285714285,1,0.0,0,0,0,0,0,0,0,1,0,0,1,1
7960,107115,pVNffwJrTxorKOdHeVlhpeq6y9qcrAtJ,3VkHkmOtom3jM2wCu94xgzzu1d6Dn7or,1,0,0,0,0,0,1,0,1,0.14285714285714285,1,0.0,0,0,0,0,0,0,0,1,0,0,1,1
7961,107133,Ze3H0pXAe85g74vQ9AmzNNSc5F7API8z,3VkHkmOtom3jM2wCu94xgzzu1d6Dn7or,5,2,1,0,1,0,4,0,8,1.1428571428571428,1,0.0,0,1,0,1,2,0,0,4,0,2,6,1
7962,107287,6evgHaxfeHX9D3uq6P8QUq1lpm69q4m2,3VkHkmOtom3jM2wCu94xgzzu1d6Dn7or,1,0,0,0,0,0,1,0,1,0.14285714285714285,1,0.0,0,0,0,0,0,0,0,1,0,0,1,1
7963,107297,Fqm3zeQ6YZlDv445nsgyUgVTYPRvPI6D,3VkHkmOtom3jM2wCu94xgzzu1d6Dn7or,20,38,9,4,8,4,7,0,70,10.0,4,0.0,9,9,3,8,29,4,1,7,0,29,41,0
7964,107314,keO4wKyYYjh8FIG3opHOkpLp1NA3BjTu,3VkHkmOtom3jM2wCu94xgzzu1d6Dn7or,8,8,5,0,3,1,14,0,31,4.428571428571429,2,0.0,0,5,0,3,8,1,0,14,0,8,23,1
7965,107392,6mSUG9eU1fdbtH5agWJN7q80r8UxSswV,3VkHkmOtom3jM2wCu94xgzzu1d6Dn7or,53,95,38,31,29,67,32,5,297,42.42857142857143,7,0.0,39,38,28,29,56,67,3,32,5,134,163,0
7966,107419,3rBmxyGX2x2EitMnfKeDWUsWZG6ahhDU,3VkHkmOtom3jM2wCu94xgzzu1d6Dn7or,12,32,2,8,1,0,16,0,59,8.428571428571429,3,0.0,11,2,7,1,21,0,1,16,0,21,38,1
7967,107434,q97bLehCsTDUKkQQDzWfdPKlUvACWFSd,3VkHkmOtom3jM2wCu94xgzzu1d6Dn7or,5,2,0,0,1,0,2,0,5,0.7142857142857143,1,0.0,0,0,0,1,2,0,0,2,0,1,4,1
7968,107450,Dt6JY8BmXySjN4txv1zU8kuHucv28fNq,3VkHkmOtom3jM2wCu94xgzzu1d6Dn7or,5,7,1,0,1,0,2,0,11,1.5714285714285714,1,0.0,2,1,0,1,5,0,0,2,0,4,7,1
7969,107483,rLo3MEn7Uk9eN6YOnjWT2bPs8hjx3rxx,3VkHkmOtom3jM2wCu94xgzzu1d6Dn7or,6,6,0,0,0,0,3,0,9,1.2857142857142858,1,0.0,0,0,0,0,6,0,0,3,0,0,9,1
7970,107512,LN2S04kUws0xhVBF22TjcUWxHmKEc3c0,3VkHkmOtom3jM2wCu94xgzzu1d6Dn7or,9,4,3,0,3,0,2,0,12,1.7142857142857142,2,0.0,0,3,0,3,4,0,0,2,0,6,6,1
7971,107513,EgPkwyKVzxQ3pMHnSPdDYGGUpTrdw5Rz,3VkHkmOtom3jM2wCu94xgzzu1d6Dn7or,1,0,0,0,0,0,1,0,1,0.14285714285714285,1,0.0,0,0,0,0,0,0,0,1,0,0,1,1
7972,107520,7tVOKMnTpVsQTNIR9VucG6vEKmeogiVL,3VkHkmOtom3jM2wCu94xgzzu1d6Dn7or,1,0,0,0,0,0,1,0,1,0.14285714285714285,1,0.0,0,0,0,0,0,0,0,1,0,0,1,1
7973,107539,M4YIohCADYfWDtmAFcr9Yo4DF18taWXd,3VkHkmOtom3jM2wCu94xgzzu1d6Dn7or,2,0,0,0,0,0,4,0,4,0.5714285714285714,1,0.0,0,0,0,0,0,0,0,4,0,0,4,1
7974,107548,abgvpo0SPpX42r2UvEpLyr3GGXwjdhN9,3VkHkmOtom3jM2wCu94xgzzu1d6Dn7or,4,2,0,0,0,0,4,0,6,0.8571428571428571,1,0.0,0,0,0,0,2,0,0,4,0,0,6,1
7975,107574,SRZHKsTuyx5cQQZdrPPgGMMi0YaWb7iW,3VkHkmOtom3jM2wCu94xgzzu1d6Dn7or,4,2,1,0,1,0,1,0,5,0.7142857142857143,1,0.0,0,1,0,1,2,0,0,1,0,2,3,1
7976,107596,ruJd1NvBaJjebdW0awtZ6qUCgWGn6X0g,3VkHkmOtom3jM2wCu94xgzzu1d6Dn7or,4,3,2,0,0,0,1,0,6,0.8571428571428571,1,0.0,0,2,0,0,3,0,0,1,0,2,4,1
7977,107597,rgYT38Kqk0cxbhUKs5hjGenYt4lCQq7h,3VkHkmOtom3jM2wCu94xgzzu1d6Dn7or,4,4,1,0,2,0,2,0,9,1.2857142857142858,1,0.0,2,1,0,2,2,0,0,2,0,5,4,0
7978,107599,aMt9h42fT1FmAn3plylyUOkSwsvgU17x,3VkHkmOtom3jM2wCu94xgzzu1d6Dn7or,1,0,0,0,0,0,1,0,1,0.14285714285714285,1,0.0,0,0,0,0,0,0,0,1,0,0,1,1
7979,107651,HMUZFtMvMF2blrnHw0lfzyMPHvoaVYfd,3VkHkmOtom3jM2wCu94xgzzu1d6Dn7or,10,18,4,0,0,6,7,3,38,5.428571428571429,1,0.0,0,4,0,0,18,6,0,7,3,4,34,1
7980,107709,XAmpKwge1guxudWVDooHHyz3OE0r4wbg,3VkHkmOtom3jM2wCu94xgzzu1d6Dn7or,1,0,0,0,0,0,1,0,1,0.14285714285714285,1,0.0,0,0,0,0,0,0,0,1,0,0,1,1
7981,107729,ZbrAFgZBdj5Q6yNC28mh9Wq6moLpUHyJ,3VkHkmOtom3jM2wCu94xgzzu1d6Dn7or,11,3,3,0,3,2,17,0,28,4.0,1,0.0,0,3,0,3,3,2,0,17,0,6,22,1
7982,107811,amzSaAhEVYiJCoRiDu6cd5BYPiTTwZ6j,3VkHkmOtom3jM2wCu94xgzzu1d6Dn7or,5,2,0,0,1,0,3,0,6,0.8571428571428571,1,0.0,0,0,0,1,2,0,0,3,0,1,5,1
7983,107891,95fHgWNvJpmp0iW9cV37RjqKyhMGAGKz,3VkHkmOtom3jM2wCu94xgzzu1d6Dn7or,1,0,0,0,0,0,1,0,1,0.14285714285714285,1,0.0,0,0,0,0,0,0,0,1,0,0,1,1
7984,107956,ERmCWTdvUnD8SHuJiSyZie0niDeQ1UlO,3VkHkmOtom3jM2wCu94xgzzu1d6Dn7or,5,8,3,0,0,0,2,0,13,1.8571428571428572,1,0.0,0,3,0,0,8,0,0,2,0,3,10,1
7985,107957,IFxthWLazhxD7CvT8D736tU2RfMY0bzi,3VkHkmOtom3jM2wCu94xgzzu1d6Dn7or,14,19,5,14,9,7,4,0,58,8.285714285714286,1,0.0,13,5,11,9,6,7,3,4,0,38,20,1
7986,107960,6IfJ9QgODO64U1dhYUGyAtcV0JIrduov,3VkHkmOtom3jM2wCu94xgzzu1d6Dn7or,8,2,1,0,1,0,15,1,20,2.857142857142857,1,0.0,0,1,0,1,2,0,0,15,1,2,18,1
7987,107984,ZvjGFQSLt8Pf81ZTzV1faPXh7hwFiT2P,bWdj2GDclj5ofokWjzoa5jAwMkxCykd6,5,2,1,0,1,0,2,0,6,0.8571428571428571,1,0.0,0,1,0,1,2,0,0,2,0,2,4,1
7988,108010,Yw9EoSKbruOuBH6aQRkV9fYbTLRt0cv4,RXDvfPUBYFlVdlueBFbLW0mhhAyGEqpt,17,26,14,0,4,33,8,11,96,13.714285714285714,2,0.0,3,14,0,4,23,33,0,8,11,21,75,0
7989,108016,oqv7kZUhC1l3nFsgavJo476khlgSwYid,SpATywNh6bZuzm8s1ceuBUnMUAeoAHHw,1,0,0,0,0,0,1,0,1,0.14285714285714285,1,0.0,0,0,0,0,0,0,0,1,0,0,1,1
7990,108020,0vxEa23unQMrxuymP5mTGCJs9sE8CeTU,SpATywNh6bZuzm8s1ceuBUnMUAeoAHHw,1,0,0,0,0,0,2,0,2,0.2857142857142857,1,0.0,0,0,0,0,0,0,0,2,0,0,2,1
7991,108024,0twK7rhgKGqeqt1sYkdUHMDWvjIusJRc,SpATywNh6bZuzm8s1ceuBUnMUAeoAHHw,7,3,2,0,2,0,2,0,9,1.2857142857142858,1,0.0,0,2,0,2,3,0,0,2,0,4,5,1
7992,108034,2jvZGTQOv5HI5u69PvJ98o1zG3YXhtLw,G8EPVSXsOYB5YQWZGiz1aVq5Pgr2GrQu,14,12,1,38,0,0,3,0,54,7.714285714285714,1,0.0,5,1,34,0,7,0,4,3,0,40,14,1
7993,108042,aF4i8JIBNexmNiVkNsVLybq4ZcEaP7YR,SpATywNh6bZuzm8s1ceuBUnMUAeoAHHw,6,2,1,0,1,0,3,0,7,1.0,1,0.0,0,1,0,1,2,0,0,3,0,2,5,1
7994,108050,eJGGi2xDKgvawXthli4R4Tq9NtEOUzLF,SpATywNh6bZuzm8s1ceuBUnMUAeoAHHw,1,0,0,0,0,0,1,0,1,0.14285714285714285,1,0.0,0,0,0,0,0,0,0,1,0,0,1,1
7995,108052,wBGtqMIqfQE0VLJPhcCJAUkBOhFNa6qW,SpATywNh6bZuzm8s1ceuBUnMUAeoAHHw,8,3,2,0,2,1,6,1,15,2.142857142857143,1,0.0,0,2,0,2,3,1,0,6,1,4,11,1
7996,108071,EboqTOLce3Kcnbr13rePsINEM3noHrcD,G8EPVSXsOYB5YQWZGiz1aVq5Pgr2GrQu,18,13,7,16,4,2,13,6,61,8.714285714285714,3,0.0,1,7,13,4,12,2,3,13,6,25,36,0
7997,108073,RMWokNypcdQUZgRk5KLBAzdNAXoaWUZf,G8EPVSXsOYB5YQWZGiz1aVq5Pgr2GrQu,6,6,1,0,0,1,4,0,12,1.7142857142857142,2,0.0,0,1,0,0,6,1,0,4,0,1,11,1
7998,108131,IBlECzoX8mSOCzZYc1uWUiXexIzVTXM2,SpATywNh6bZuzm8s1ceuBUnMUAeoAHHw,8,5,3,0,2,1,5,0,16,2.2857142857142856,1,0.0,0,3,0,2,5,1,0,5,0,5,11,1
7999,108136,JtMmp5BCDQnYE7CMI3NvnX4aRCZsQW9K,SpATywNh6bZuzm8s1ceuBUnMUAeoAHHw,1,0,0,0,0,0,1,0,1,0.14285714285714285,1,0.0,0,0,0,0,0,0,0,1,0,0,1,1
8000,108150,JtMmp5BCDQnYE7CMI3NvnX4aRCZsQW9K,G8EPVSXsOYB5YQWZGiz1aVq5Pgr2GrQu,1,0,0,0,0,0,1,0,1,0.14285714285714285,1,0.0,0,0,0,0,0,0,0,1,0,0,1,1
8001,108157,qkSLpyUXo3wNVtHKY2foszTLsaaG0zFf,SpATywNh6bZuzm8s1ceuBUnMUAeoAHHw,7,9,5,0,1,0,6,0,21,3.0,1,0.0,0,5,0,1,9,0,0,6,0,6,15,1
8002,108159,7wwnUxCzQI2wyfpl5OyzTa3WTS3Ri45e,A3fsA9Zfv1X2fVEQhTw51lKENdNrEqT3,6,3,1,0,1,0,5,0,10,1.4285714285714286,1,0.0,0,1,0,1,3,0,0,5,0,2,8,1
8003,108176,3uS5WA36Sj3PVBnvxWDx1MwVkWDCgzsS,SpATywNh6bZuzm8s1ceuBUnMUAeoAHHw,2,0,0,0,0,0,2,0,2,0.2857142857142857,1,0.0,0,0,0,0,0,0,0,2,0,0,2,1
8004,108194,BUjI8VQSt0tGyIQBRIK2BBh4HRC6a57H,SpATywNh6bZuzm8s1ceuBUnMUAeoAHHw,7,11,5,0,2,0,4,0,22,3.142857142857143,2,0.0,0,5,0,2,11,0,0,4,0,7,15,1
8005,108212,dbPMzxs1MK4eXxSu7capyuymr7qmuT7h,SpATywNh6bZuzm8s1ceuBUnMUAeoAHHw,13,13,4,12,3,0,3,0,35,5.0,1,0.0,7,4,11,3,6,0,1,3,0,25,10,1
8006,108216,vpqIMSPa2wuLU7jLHJxpKglWXRMFM5XG,G8EPVSXsOYB5YQWZGiz1aVq5Pgr2GrQu,10,6,3,0,3,0,3,0,15,2.142857142857143,1,0.0,1,3,0,3,5,0,0,3,0,7,8,1
8007,108224,Q5TmTVdy8nnH2vTL73s67ZseaCMO3k91,A3fsA9Zfv1X2fVEQhTw51lKENdNrEqT3,22,16,14,22,3,0,15,0,70,10.0,1,0.0,0,14,17,3,16,0,5,15,0,34,36,1
8008,108232,Vuj7KEezi5cbt5TkGTsUazylLOCSeSWW,G8EPVSXsOYB5YQWZGiz1aVq5Pgr2GrQu,6,7,1,0,1,1,5,0,15,2.142857142857143,1,0.0,4,1,0,1,3,1,0,5,0,6,9,1
8009,108238,kacdt9t6znrlEBdAnqrcK2PQA5VKsmyU,bWdj2GDclj5ofokWjzoa5jAwMkxCykd6,1,0,0,0,0,0,1,0,1,0.14285714285714285,1,0.0,0,0,0,0,0,0,0,1,0,0,1,1
8010,108248,GfEp1fhW8V7ekci3T3EdNbH3NBJ6ewC2,bWdj2GDclj5ofokWjzoa5jAwMkxCykd6,10,14,9,0,4,0,6,0,33,4.714285714285714,2,0.0,0,9,0,4,14,0,0,6,0,13,20,1
8011,108249,U86H0D53uFDssNj4hNXQwNhRzNF9WB0g,SpATywNh6bZuzm8s1ceuBUnMUAeoAHHw,10,3,2,0,2,0,5,0,12,1.7142857142857142,2,0.0,0,2,0,2,3,0,0,5,0,4,8,1
8012,108253,ZBWbhIaLqDYBcX3S1kBM4TsAR4PCNgfw,SpATywNh6bZuzm8s1ceuBUnMUAeoAHHw,1,0,0,0,0,0,1,0,1,0.14285714285714285,1,0.0,0,0,0,0,0,0,0,1,0,0,1,1
8013,108260,BKTGezJoHjleu4tXARXtOL0EOZtL4wb9,A3fsA9Zfv1X2fVEQhTw51lKENdNrEqT3,5,6,3,0,0,0,2,0,11,1.5714285714285714,1,0.0,0,3,0,0,6,0,0,2,0,3,8,1
8014,108287,vD0of5WrmeM0o4WJQ1K1mROO3xI4vaqL,A3fsA9Zfv1X2fVEQhTw51lKENdNrEqT3,8,11,9,0,0,0,3,0,23,3.2857142857142856,1,0.0,0,9,0,0,11,0,0,3,0,9,14,1
8015,108322,fDs5TBVrvPHEIMLkBACIVQ2YkCdHCFLD,G8EPVSXsOYB5YQWZGiz1aVq5Pgr2GrQu,1,0,0,0,0,0,1,0,1,0.14285714285714285,1,0.0,0,0,0,0,0,0,0,1,0,0,1,1
8016,108332,t3IeBt0q2KGXGh8PROvXa3GntwInvrsf,SpATywNh6bZuzm8s1ceuBUnMUAeoAHHw,12,19,5,15,3,5,6,0,53,7.571428571428571,1,0.0,14,5,14,3,5,5,1,6,0,36,17,1
8017,108334,OTVmyM3oMOEh3RPUJ9JvZ1cqJuClk9Op,bWdj2GDclj5ofokWjzoa5jAwMkxCykd6,6,5,2,0,1,0,3,0,11,1.5714285714285714,1,0.0,1,2,0,1,4,0,0,3,0,4,7,1
8018,108352,iqv1ZLT0r4OWnPHIoXugw2YP50zRTQ28,SpATywNh6bZuzm8s1ceuBUnMUAeoAHHw,8,4,3,0,2,0,2,0,11,1.5714285714285714,1,0.0,0,3,0,2,4,0,0,2,0,5,6,1
8019,108405,uyomj5PLSD8MuBnIm3UXNOM2zJB1f3kv,A3fsA9Zfv1X2fVEQhTw51lKENdNrEqT3,13,11,1,22,0,0,4,0,38,5.428571428571429,1,0.0,0,1,18,0,11,0,4,4,0,19,19,1
8020,108406,bQyZ6DmGQSg1Dv1lCa5q9TEfeZ36WEXr,SpATywNh6bZuzm8s1ceuBUnMUAeoAHHw,5,2,1,0,1,0,2,0,6,0.8571428571428571,1,0.0,0,1,0,1,2,0,0,2,0,2,4,1
8021,108412,SEiKj37VG0PEpKDpAqYMYNdcODsfurcu,SpATywNh6bZuzm8s1ceuBUnMUAeoAHHw,1,0,0,0,0,0,1,0,1,0.14285714285714285,1,0.0,0,0,0,0,0,0,0,1,0,0,1,1
8022,108421,Z8VFKUoySr9L7FZfGeoeDWQqxwnJbTos,SpATywNh6bZuzm8s1ceuBUnMUAeoAHHw,31,66,3,37,1,8,16,0,131,18.714285714285715,8,0.0,13,3,36,1,53,8,1,16,0,53,78,0
8023,108427,xVeg2852GnVdRuLPSlBP0iZfvv9oAoyC,SpATywNh6bZuzm8s1ceuBUnMUAeoAHHw,9,3,2,0,2,1,4,1,13,1.8571428571428572,1,0.0,0,2,0,2,3,1,0,4,1,4,9,1
8024,108446,d08ApNp1WFaPBGXKvD3xbJPFNLpPIfS7,A3fsA9Zfv1X2fVEQhTw51lKENdNrEqT3,1,0,0,0,0,0,1,0,1,0.14285714285714285,1,0.0,0,0,0,0,0,0,0,1,0,0,1,1
8025,108449,dclSFP3hreeLXdhyb5AYWKpQgF9cKZB8,A3fsA9Zfv1X2fVEQhTw51lKENdNrEqT3,1,0,0,0,0,0,2,0,2,0.2857142857142857,1,0.0,0,0,0,0,0,0,0,2,0,0,2,1
8026,108452,Da1XsE2lZHBZahEFVPSmxclehQ2xZK1j,RXDvfPUBYFlVdlueBFbLW0mhhAyGEqpt,1,0,0,0,0,0,2,0,2,0.2857142857142857,2,0.0,0,0,0,0,0,0,0,2,0,0,2,1
8027,108457,AeCrxYByugIwu4XUBpI0LhoTguBozLAa,A3fsA9Zfv1X2fVEQhTw51lKENdNrEqT3,41,26,13,74,10,0,4,0,127,18.142857142857142,2,0.0,1,13,66,10,25,0,8,4,0,90,37,1
8028,108519,Wz77TRcICZ17h9qFLsblYtkOSc4ixQ6c,G8EPVSXsOYB5YQWZGiz1aVq5Pgr2GrQu,11,8,3,0,3,1,6,1,22,3.142857142857143,1,0.0,3,3,0,3,5,1,0,6,1,9,13,1
8029,108541,vZzTgGwK0cR24BSm1xzdfANP52hj4iMk,bWdj2GDclj5ofokWjzoa5jAwMkxCykd6,2,0,0,0,0,0,2,0,2,0.2857142857142857,1,0.0,0,0,0,0,0,0,0,2,0,0,2,1
8030,108543,vZzTgGwK0cR24BSm1xzdfANP52hj4iMk,A3fsA9Zfv1X2fVEQhTw51lKENdNrEqT3,6,4,1,0,0,0,7,0,12,1.7142857142857142,2,0.0,0,1,0,0,4,0,0,7,0,1,11,1
8031,108545,RzzALWvRctgoyhkcvSWQNXbBdfBwiqD5,A3fsA9Zfv1X2fVEQhTw51lKENdNrEqT3,26,11,10,24,8,0,1,0,54,7.714285714285714,1,0.0,0,10,23,8,11,0,1,1,0,41,13,1
8032,108563,cJebZdZYNfcRFrDILULKtUjsVZucvQNZ,A3fsA9Zfv1X2fVEQhTw51lKENdNrEqT3,1,0,0,0,0,0,2,0,2,0.2857142857142857,1,0.0,0,0,0,0,0,0,0,2,0,0,2,1
8033,108568,nMLZADizXQkPbs7I128RAOQN3Z54bNq5,G8EPVSXsOYB5YQWZGiz1aVq5Pgr2GrQu,1,0,0,0,0,0,1,0,1,0.14285714285714285,1,0.0,0,0,0,0,0,0,0,1,0,0,1,1
8034,108580,T96tu0kAAtO9h4UaJoJi1p0l5O91f75g,SpATywNh6bZuzm8s1ceuBUnMUAeoAHHw,1,0,0,0,0,0,1,0,1,0.14285714285714285,1,0.0,0,0,0,0,0,0,0,1,0,0,1,1
8035,108593,b5A378d0kY1phoH7ZEYLGeRu5gSN3Jom,bWdj2GDclj5ofokWjzoa5jAwMkxCykd6,3,3,0,0,0,0,1,0,4,0.5714285714285714,1,0.0,0,0,0,0,3,0,0,1,0,0,4,1
8036,108610,fwSe9M4wVBk21yhnHfi9Elq0Dtd4QFmB,A3fsA9Zfv1X2fVEQhTw51lKENdNrEqT3,1,0,0,0,0,0,1,0,1,0.14285714285714285,1,0.0,0,0,0,0,0,0,0,1,0,0,1,1
8037,108613,8QplB1koC0Z3ESwyMSDlYtTT9MlUMn1q,SpATywNh6bZuzm8s1ceuBUnMUAeoAHHw,15,23,8,17,3,4,3,1,59,8.428571428571429,1,0.0,6,8,15,3,17,4,2,3,1,32,27,1
8038,108618,6pZAnEuoA7RiYeKYKN3oDQwjOWGfm51A,A3fsA9Zfv1X2fVEQhTw51lKENdNrEqT3,6,7,3,0,1,0,3,0,14,2.0,2,0.0,0,3,0,1,7,0,0,3,0,4,10,1
8039,108642,kjQDeVPqENR6xvjjKnsVoxY8hUaoqktw,A3fsA9Zfv1X2fVEQhTw51lKENdNrEqT3,1,0,0,0,0,0,1,0,1,0.14285714285714285,1,0.0,0,0,0,0,0,0,0,1,0,0,1,1
8040,108643,hkTx4XunczsnVq4H9eVYRZURkkofvB6I,A3fsA9Zfv1X2fVEQhTw51lKENdNrEqT3,39,22,11,60,8,0,4,0,105,15.0,1,0.0,1,11,48,8,21,0,12,4,0,68,37,1
8041,108645,GC5D689aLkJhzPWQtqYm81ojaLgS2Wpz,A3fsA9Zfv1X2fVEQhTw51lKENdNrEqT3,6,1,0,0,0,0,4,1,6,0.8571428571428571,1,0.0,0,0,0,0,1,0,0,4,1,0,6,1
8042,108650,9RsO9nEnlOjxAtY8xl5lBuOHOGbVMyeg,A3fsA9Zfv1X2fVEQhTw51lKENdNrEqT3,11,9,5,0,4,0,3,0,21,3.0,1,0.0,0,5,0,4,9,0,0,3,0,9,12,1
8043,108658,FAjTaGnsfZLBQS9slQbYMPpuh5mcYxue,SpATywNh6bZuzm8s1ceuBUnMUAeoAHHw,29,33,14,44,1,16,16,1,125,17.857142857142858,6,0.0,11,14,36,1,22,16,8,16,1,62,63,0
8044,108675,EQrILQPubl10Uf5lVjVEtCpelMBJDysL,A3fsA9Zfv1X2fVEQhTw51lKENdNrEqT3,4,2,1,0,1,0,1,0,5,0.7142857142857143,1,0.0,0,1,0,1,2,0,0,1,0,2,3,1
8045,108685,vUg72yuNvNQBasGeqPwQue3GKgSAK3Os,A3fsA9Zfv1X2fVEQhTw51lKENdNrEqT3,43,13,11,70,10,6,5,1,116,16.571428571428573,1,0.0,1,11,61,10,12,6,9,5,1,83,33,1
8046,108690,Ofc6ixmmoavYN92PkloL7C1g0H36jbU2,bWdj2GDclj5ofokWjzoa5jAwMkxCykd6,5,2,1,0,1,0,2,0,6,0.8571428571428571,1,0.0,0,1,0,1,2,0,0,2,0,2,4,1
8047,108691,ETnDIYS5Ij7vrZAmbXEAqG1htLhXjsuH,SpATywNh6bZuzm8s1ceuBUnMUAeoAHHw,2,0,0,0,0,0,3,0,3,0.42857142857142855,1,0.0,0,0,0,0,0,0,0,3,0,0,3,1
8048,108692,Ofc6ixmmoavYN92PkloL7C1g0H36jbU2,RXDvfPUBYFlVdlueBFbLW0mhhAyGEqpt,5,3,1,0,1,0,2,0,7,1.0,1,0.0,0,1,0,1,3,0,0,2,0,2,5,1
8049,108709,WVlATpkkXvQVe3Tvai8IoxKvCeKjRiIw,A3fsA9Zfv1X2fVEQhTw51lKENdNrEqT3,4,2,1,0,1,0,1,0,5,0.7142857142857143,1,0.0,0,1,0,1,2,0,0,1,0,2,3,1
8050,108716,vEKYOhRdGZ59kfXY6wTO63YZY4EqPYqX,A3fsA9Zfv1X2fVEQhTw51lKENdNrEqT3,1,0,0,0,0,0,2,0,2,0.2857142857142857,1,0.0,0,0,0,0,0,0,0,2,0,0,2,1
8051,108726,SjPvBG8Fb7d7fOOQdZd3mlZyesFaFzzS,SpATywNh6bZuzm8s1ceuBUnMUAeoAHHw,12,16,4,9,3,8,1,0,41,5.857142857142857,1,0.0,11,4,9,3,5,8,0,1,0,27,14,1
8052,108730,APkKPEpve0ecRJut2qy8IYwsafYtrJRq,A3fsA9Zfv1X2fVEQhTw51lKENdNrEqT3,1,0,0,0,0,0,1,0,1,0.14285714285714285,1,0.0,0,0,0,0,0,0,0,1,0,0,1,1
8053,108759,bhb17IwRClCqRNHE7gBYbr4QuZbINJH7,SpATywNh6bZuzm8s1ceuBUnMUAeoAHHw,8,2,1,0,1,0,4,1,9,1.2857142857142858,1,0.0,0,1,0,1,2,0,0,4,1,2,7,1
8054,108770,i91HA7YyZRSQdFHabHG3p2UNPo1UnEE9,SpATywNh6bZuzm8s1ceuBUnMUAeoAHHw,6,0,0,0,0,1,5,1,7,1.0,1,0.0,0,0,0,0,0,1,0,5,1,0,7,1
8055,108777,jqvna1BzHcNX8F2L51mHo8iTsRvtrp5h,G8EPVSXsOYB5YQWZGiz1aVq5Pgr2GrQu,5,2,0,0,0,0,3,1,6,0.8571428571428571,1,0.0,0,0,0,0,2,0,0,3,1,0,6,1
8056,108783,XJEGQFjl8bj0TlozEJx10miZtxUTAzR8,G8EPVSXsOYB5YQWZGiz1aVq5Pgr2GrQu,6,5,2,0,0,0,2,0,9,1.2857142857142858,1,0.0,0,2,0,0,5,0,0,2,0,2,7,1
8057,108788,lE2eUyNgAborZHVo0d0toAQgs9JY0elm,bWdj2GDclj5ofokWjzoa5jAwMkxCykd6,1,0,0,0,0,0,1,0,1,0.14285714285714285,1,0.0,0,0,0,0,0,0,0,1,0,0,1,1
8058,108794,YpN0FUGuAT4i4OgsV1AMvBTJ03FCi4h4,SpATywNh6bZuzm8s1ceuBUnMUAeoAHHw,13,19,6,19,3,0,1,0,48,6.857142857142857,1,0.0,11,6,18,3,8,0,1,1,0,38,10,1
8059,108802,G6Ra4LKWBFlkpiQLwJKXdjsFL1NYBNU7,SpATywNh6bZuzm8s1ceuBUnMUAeoAHHw,8,10,7,0,4,0,8,1,30,4.285714285714286,1,0.0,0,7,0,4,10,0,0,8,1,11,19,1
8060,108816,7tzKJch94HYBj1yvg1gEwizifcqZuqol,SpATywNh6bZuzm8s1ceuBUnMUAeoAHHw,14,16,8,9,5,11,6,2,57,8.142857142857142,1,0.0,7,8,9,5,9,11,0,6,2,29,28,1
8061,108817,JJML5NgT9kE9CQ1mkNivVNVP1TfRNDmZ,G8EPVSXsOYB5YQWZGiz1aVq5Pgr2GrQu,10,11,3,0,3,0,3,0,20,2.857142857142857,2,0.0,5,3,0,3,6,0,0,3,0,11,9,1
8062,108819,y2DmmWW7ijkXHglZV8tDd3ydHBY1lyEP,SpATywNh6bZuzm8s1ceuBUnMUAeoAHHw,11,7,2,12,1,6,5,1,34,4.857142857142857,1,0.0,4,2,12,1,3,6,0,5,1,19,15,1
8063,108823,ToFnQfVVYpsgtNup5oaVFrzJEXqZqLe7,SpATywNh6bZuzm8s1ceuBUnMUAeoAHHw,4,3,1,0,1,0,1,0,6,0.8571428571428571,1,0.0,0,1,0,1,3,0,0,1,0,2,4,1
8064,108832,fZ0FA06F54ZxAJdajcaJsw9dO9sZFuoy,SpATywNh6bZuzm8s1ceuBUnMUAeoAHHw,8,3,2,0,2,2,4,1,14,2.0,1,0.0,0,2,0,2,3,2,0,4,1,4,10,1
8065,108836,S2vZm8iaot7LbfQexObVqVFppwpxyTJj,RXDvfPUBYFlVdlueBFbLW0mhhAyGEqpt,13,9,1,0,1,2,7,2,22,3.142857142857143,1,0.0,0,1,0,1,9,2,0,7,2,2,20,1
8066,108840,Gmz5iMjiwcyTx4KusyWM0rOecmUutZaf,bWdj2GDclj5ofokWjzoa5jAwMkxCykd6,7,4,2,0,1,0,3,0,10,1.4285714285714286,1,0.0,0,2,0,1,4,0,0,3,0,3,7,1
8067,108848,Aj8S98OGNNNrJMemSZdPdZipwwjNd5vE,A3fsA9Zfv1X2fVEQhTw51lKENdNrEqT3,8,7,3,0,3,0,1,0,14,2.0,1,0.0,0,3,0,3,7,0,0,1,0,6,8,0
8068,108863,rFLx9fxaxLoqhUJucYhN0TS80ql3o0el,G8EPVSXsOYB5YQWZGiz1aVq5Pgr2GrQu,6,3,2,0,2,4,1,0,12,1.7142857142857142,1,0.0,0,2,0,2,3,4,0,1,0,4,8,1
8069,108870,EyBRRLQ9lC714P9pZPb13KmtdxaOzX2x,A3fsA9Zfv1X2fVEQhTw51lKENdNrEqT3,5,2,1,0,1,0,2,0,6,0.8571428571428571,1,0.0,0,1,0,1,2,0,0,2,0,2,4,1
8070,108881,wKWD0CLruBoVWyxPKWZ61pmQ3HoT2Bog,SpATywNh6bZuzm8s1ceuBUnMUAeoAHHw,4,2,0,0,0,0,2,0,4,0.5714285714285714,1,0.0,0,0,0,0,2,0,0,2,0,0,4,1
8071,108896,rFLx9fxaxLoqhUJucYhN0TS80ql3o0el,SpATywNh6bZuzm8s1ceuBUnMUAeoAHHw,6,3,2,0,2,14,1,0,22,3.142857142857143,1,0.0,0,2,0,2,3,14,0,1,0,4,18,1
8072,108911,IcSi6sLfpSlHjHhdlf5rd2h3NSptZDO1,A3fsA9Zfv1X2fVEQhTw51lKENdNrEqT3,1,0,0,0,0,0,2,0,2,0.2857142857142857,1,0.0,0,0,0,0,0,0,0,2,0,0,2,1
8073,108918,vSo169SOn6AJKRTPbSllZALjmnCkOElL,G8EPVSXsOYB5YQWZGiz1aVq5Pgr2GrQu,12,28,4,0,3,1,23,1,60,8.571428571428571,3,0.0,0,4,0,3,28,1,0,23,1,7,53,1
8074,108937,GrD7pvZobVcyydLOoZLt2XOTjKEE4rVN,A3fsA9Zfv1X2fVEQhTw51lKENdNrEqT3,1,0,0,0,0,0,1,0,1,0.14285714285714285,1,0.0,0,0,0,0,0,0,0,1,0,0,1,1
8075,108940,4JgrlxTTs75mHh4mrh8qrfNDEELryL3p,A3fsA9Zfv1X2fVEQhTw51lKENdNrEqT3,22,30,13,0,10,0,5,0,58,8.285714285714286,1,0.0,0,13,0,10,30,0,0,5,0,23,35,1
8076,108943,tBILMisvPJumSCkGoqvXZmjsWBPsAhcx,RXDvfPUBYFlVdlueBFbLW0mhhAyGEqpt,1,0,0,0,0,0,1,0,1,0.14285714285714285,1,0.0,0,0,0,0,0,0,0,1,0,0,1,1
8077,108949,jcbtaVIpxYLzIPm0BM5PQEVvcUjaS5Wk,SpATywNh6bZuzm8s1ceuBUnMUAeoAHHw,5,2,1,0,1,0,4,0,8,1.1428571428571428,2,0.0,0,1,0,1,2,0,0,4,0,2,6,1
8078,108954,kLrl7hvNIzvhv6K321CFhgLYEgDfA62M,A3fsA9Zfv1X2fVEQhTw51lKENdNrEqT3,3,3,1,0,0,0,1,0,5,0.7142857142857143,1,0.0,0,1,0,0,3,0,0,1,0,1,4,1
8079,108956,cQImh85eb0T3yUp3SL5f7uBssRRbM6Re,A3fsA9Zfv1X2fVEQhTw51lKENdNrEqT3,9,9,1,0,1,0,3,0,14,2.0,1,0.0,0,1,0,1,9,0,0,3,0,2,12,1
8080,108964,a5FYs3qIaiIKIJ0gF2U8byHoJI2aZV3O,SpATywNh6bZuzm8s1ceuBUnMUAeoAHHw,2,0,0,0,0,0,2,0,2,0.2857142857142857,1,0.0,0,0,0,0,0,0,0,2,0,0,2,1
8081,108986,YCpaFH59BZea33ilZmurVIrcGKs7kkSW,A3fsA9Zfv1X2fVEQhTw51lKENdNrEqT3,8,7,5,0,0,1,4,2,19,2.7142857142857144,1,0.0,0,5,0,0,7,1,0,4,2,5,14,1
8082,109051,QzYbn86ruFNwqcTxxFURk0zGhEatBUQQ,RXDvfPUBYFlVdlueBFbLW0mhhAyGEqpt,1,0,0,0,0,0,1,0,1,0.14285714285714285,1,0.0,0,0,0,0,0,0,0,1,0,0,1,1
8083,109052,YQuE8HipF2FTxF6yilCc6Hjt2hO1hf9q,A3fsA9Zfv1X2fVEQhTw51lKENdNrEqT3,14,6,4,0,3,3,9,2,27,3.857142857142857,1,0.0,0,4,0,3,6,3,0,9,2,7,20,1
8084,109053,L7J2caDjAzkqOGAjsx5a9Dl5Aldyaum1,G8EPVSXsOYB5YQWZGiz1aVq5Pgr2GrQu,20,15,10,40,5,0,6,0,76,10.857142857142858,1,0.0,5,10,35,5,10,0,5,6,0,55,21,1
8085,109068,XkjQH424HqtaqeKw3sfi1hEAdISSsUfo,SpATywNh6bZuzm8s1ceuBUnMUAeoAHHw,5,2,1,0,1,0,2,0,6,0.8571428571428571,1,0.0,0,1,0,1,2,0,0,2,0,2,4,1
8086,109076,rqibqLTSyQMTu8RtpalbPrVfa4YBNses,A3fsA9Zfv1X2fVEQhTw51lKENdNrEqT3,1,0,0,0,0,0,1,0,1,0.14285714285714285,1,0.0,0,0,0,0,0,0,0,1,0,0,1,1
8087,109083,eRuuxh46RK1wEtA4qinnmcAexePgrgfl,A3fsA9Zfv1X2fVEQhTw51lKENdNrEqT3,2,0,0,0,0,0,4,0,4,0.5714285714285714,1,0.0,0,0,0,0,0,0,0,4,0,0,4,1
8088,109094,W72vMFAqWF3rx04XbAdkI4z1Q7B2JuRi,A3fsA9Zfv1X2fVEQhTw51lKENdNrEqT3,6,2,1,0,1,1,3,0,8,1.1428571428571428,1,0.0,0,1,0,1,2,1,0,3,0,2,6,1
8089,109103,MZomFQTbHAKaDGd0B9fv7KQ9MRsZJ7m6,A3fsA9Zfv1X2fVEQhTw51lKENdNrEqT3,7,7,2,0,1,0,4,0,14,2.0,2,0.0,0,2,0,1,7,0,0,4,0,3,11,1
8090,109113,PsjDYcq0jr7p5zzKT5Q6GyQwL0TaEGxZ,SpATywNh6bZuzm8s1ceuBUnMUAeoAHHw,1,0,0,0,0,0,1,0,1,0.14285714285714285,1,0.0,0,0,0,0,0,0,0,1,0,0,1,1
8091,109133,ktJXKKINyOPjiCF3mohYZXSugYepgG15,bWdj2GDclj5ofokWjzoa5jAwMkxCykd6,6,2,0,0,0,2,4,2,10,1.4285714285714286,1,0.0,0,0,0,0,2,2,0,4,2,0,10,1
8092,109134,V9A9B2T9pRTU3AqvpqzuKs4MfRcAEte2,A3fsA9Zfv1X2fVEQhTw51lKENdNrEqT3,10,21,13,0,10,0,10,0,54,7.714285714285714,3,0.0,0,13,0,10,21,0,0,10,0,23,31,1
8093,109141,cj6ogEjauZu0hDMlOaFW3lBaL32xGBVV,A3fsA9Zfv1X2fVEQhTw51lKENdNrEqT3,33,18,0,44,0,1,5,0,68,9.714285714285714,1,0.0,1,0,44,0,17,1,0,5,0,45,23,1
8094,109159,qflx2gEpsoPySBX8xNwFSgJhYyLnWK68,SpATywNh6bZuzm8s1ceuBUnMUAeoAHHw,5,2,1,0,1,0,2,0,6,0.8571428571428571,1,0.0,0,1,0,1,2,0,0,2,0,2,4,1
8095,109160,BjBet1XrpmufRo3nJSBrADvKxDiooNdd,SpATywNh6bZuzm8s1ceuBUnMUAeoAHHw,17,19,9,10,6,4,6,2,56,8.0,1,0.0,8,9,9,6,11,4,1,6,2,32,24,0
8096,109168,75JIeVMZStYpkimfm5Z5dMpV25aOohZB,A3fsA9Zfv1X2fVEQhTw51lKENdNrEqT3,1,0,0,0,0,0,1,0,1,0.14285714285714285,1,0.0,0,0,0,0,0,0,0,1,0,0,1,1
8097,109175,3HlwwUK8TRPXkUKapLyYM8Mklh9O7Jts,SpATywNh6bZuzm8s1ceuBUnMUAeoAHHw,1,0,0,0,0,0,1,0,1,0.14285714285714285,1,0.0,0,0,0,0,0,0,0,1,0,0,1,1
8098,109197,JWGtW72K75u0pLec4sms8rsOXm4SeKAG,SpATywNh6bZuzm8s1ceuBUnMUAeoAHHw,15,27,10,15,2,8,11,1,74,10.571428571428571,3,0.0,12,10,12,2,15,8,3,11,1,36,38,1
8099,109229,txSjWYX3TEWx5QLOiaADcbFdCZMHt7yE,A3fsA9Zfv1X2fVEQhTw51lKENdNrEqT3,12,9,1,0,1,0,5,3,19,2.7142857142857144,2,0.0,0,1,0,1,9,0,0,5,3,2,17,0
8100,109249,xHkJ6XK0y35MSFhta6m6oK3R3vwlFDsX,SpATywNh6bZuzm8s1ceuBUnMUAeoAHHw,6,3,1,0,1,0,2,0,7,1.0,1,0.0,0,1,0,1,3,0,0,2,0,2,5,1
8101,109255,N8EIkrIEEI0tSrQnptuBZRzWsVxCnAJ9,bWdj2GDclj5ofokWjzoa5jAwMkxCykd6,1,0,0,0,0,0,1,0,1,0.14285714285714285,1,0.0,0,0,0,0,0,0,0,1,0,0,1,1
8102,109285,PTDwgRsRPDT7EScAgKe30PHvW2ZEf3hf,SpATywNh6bZuzm8s1ceuBUnMUAeoAHHw,1,0,0,0,0,0,1,0,1,0.14285714285714285,1,0.0,0,0,0,0,0,0,0,1,0,0,1,1
8103,109288,J2q8zoWRny7YrAZZQIJQYIKpfAnrsg3t,SpATywNh6bZuzm8s1ceuBUnMUAeoAHHw,18,26,10,19,5,11,10,1,82,11.714285714285714,2,0.0,12,10,16,5,14,11,3,10,1,43,39,1
8104,109294,Qs7Gy3lEvMM83esFdoZ1zZvUeRYTAxxM,A3fsA9Zfv1X2fVEQhTw51lKENdNrEqT3,1,0,0,0,0,0,2,0,2,0.2857142857142857,1,0.0,0,0,0,0,0,0,0,2,0,0,2,1
8105,109308,giXuT5U1RtMqgo8IXt5j9x4mrlpr0AWq,bWdj2GDclj5ofokWjzoa5jAwMkxCykd6,10,22,2,28,3,0,17,0,72,10.285714285714286,4,0.0,6,2,26,3,16,0,2,17,0,37,35,1
8106,109309,WAUVjfvcVVKr4l1eRzgNNfyqoF4mUwKn,SpATywNh6bZuzm8s1ceuBUnMUAeoAHHw,20,27,18,17,5,0,8,0,75,10.714285714285714,2,0.0,4,18,15,5,23,0,2,8,0,42,33,1
8107,109323,h7wsu0U7FXIgaCVLolzif2WMIHfC12Bp,RXDvfPUBYFlVdlueBFbLW0mhhAyGEqpt,9,6,0,0,0,0,4,0,10,1.4285714285714286,2,0.0,0,0,0,0,6,0,0,4,0,0,10,1
8108,109342,obFxfGLSP12hWUYqYGw1SR5lINNLUPlg,SpATywNh6bZuzm8s1ceuBUnMUAeoAHHw,39,100,28,21,14,8,13,1,185,26.428571428571427,5,0.0,37,28,19,14,63,8,2,13,1,98,87,1
8109,109357,E3qy0Aw6hJTYQ75juho52GdWukHpC8PO,A3fsA9Zfv1X2fVEQhTw51lKENdNrEqT3,38,32,15,70,9,0,1,0,127,18.142857142857142,1,0.0,3,15,58,9,29,0,12,1,0,85,42,1
8110,109362,GzwlErGyP5vVrMuPju1CoSG91uAwN5Ll,A3fsA9Zfv1X2fVEQhTw51lKENdNrEqT3,1,0,0,0,0,0,1,0,1,0.14285714285714285,1,0.0,0,0,0,0,0,0,0,1,0,0,1,1
8111,109370,PgyyNRYpQtA302ymgWhOo3FWJ5ZVr14a,A3fsA9Zfv1X2fVEQhTw51lKENdNrEqT3,9,2,1,0,1,1,9,1,15,2.142857142857143,1,0.0,0,1,0,1,2,1,0,9,1,2,13,1
8112,109386,wRfMgDoh08sOJ1iN7xQ6xWeUhnvT3LS5,SpATywNh6bZuzm8s1ceuBUnMUAeoAHHw,5,2,1,0,1,0,4,0,8,1.1428571428571428,1,0.0,1,1,0,1,1,0,0,4,0,3,5,1
8113,109397,fwSe9M4wVBk21yhnHfi9Elq0Dtd4QFmB,bWdj2GDclj5ofokWjzoa5jAwMkxCykd6,5,3,1,0,1,0,2,0,7,1.0,1,0.0,0,1,0,1,3,0,0,2,0,2,5,1
8114,109399,r9Iw8qv5Gd0slmKCVr3aUz7TALROG0cf,bWdj2GDclj5ofokWjzoa5jAwMkxCykd6,1,0,0,0,0,0,1,0,1,0.14285714285714285,1,0.0,0,0,0,0,0,0,0,1,0,0,1,1
8115,109400,9uGUU0TH4lqYEkuGLK9jp9MwW0oSvGiG,A3fsA9Zfv1X2fVEQhTw51lKENdNrEqT3,9,4,1,0,1,10,11,2,29,4.142857142857143,4,0.0,0,1,0,1,4,10,0,11,2,2,27,1
8116,109426,Sq3omHTGoSF2f0DuMM8gp5rI7SBr6tWj,A3fsA9Zfv1X2fVEQhTw51lKENdNrEqT3,20,8,8,0,8,0,4,0,28,4.0,2,0.0,0,8,0,8,8,0,0,4,0,16,12,1
8117,109429,HoFYxRSokx9ZKuDwytJP5rWsXC8CIKJC,A3fsA9Zfv1X2fVEQhTw51lKENdNrEqT3,30,7,4,44,2,3,9,1,70,10.0,1,0.0,1,4,42,2,6,3,2,9,1,49,21,1
8118,109431,1UiNR1aBQTbqc6GjmZAuykRrYIV3jOJO,SpATywNh6bZuzm8s1ceuBUnMUAeoAHHw,7,3,1,0,1,2,4,1,12,1.7142857142857142,1,0.0,1,1,0,1,2,2,0,4,1,3,9,1
8119,109442,uMcGJbFLkrWwli3FYGfWHtIVPBjXGyBh,SpATywNh6bZuzm8s1ceuBUnMUAeoAHHw,1,0,0,0,0,0,1,0,1,0.14285714285714285,1,0.0,0,0,0,0,0,0,0,1,0,0,1,1
8120,109459,AFA8ekqoAZiNztO6KW91x6d2D9lFcQ7X,RXDvfPUBYFlVdlueBFbLW0mhhAyGEqpt,5,1,0,0,1,0,5,0,7,1.0,1,0.0,0,0,0,1,1,0,0,5,0,1,6,1
8121,109468,An4Cs2oUOz8lYcIplHFLdygweoh5kMIV,A3fsA9Zfv1X2fVEQhTw51lKENdNrEqT3,8,5,1,0,1,0,2,0,9,1.2857142857142858,1,0.0,0,1,0,1,5,0,0,2,0,2,7,1
8122,109494,dvvW9sSxW5mjEruYpucTZ2qRrmMv8qM8,SpATywNh6bZuzm8s1ceuBUnMUAeoAHHw,4,2,1,0,0,1,2,0,6,0.8571428571428571,1,0.0,0,1,0,0,2,1,0,2,0,1,5,1
8123,109497,CB1M4aW1J3aRGdW8HkF8tezfCYyk7Eoq,RXDvfPUBYFlVdlueBFbLW0mhhAyGEqpt,12,8,6,0,5,0,4,0,23,3.2857142857142856,3,0.0,0,6,0,5,8,0,0,4,0,11,12,1
8124,109501,eAowQ45OiNPPsLkfxUtBSZ5lhWPhAgzz,SpATywNh6bZuzm8s1ceuBUnMUAeoAHHw,5,2,0,0,0,1,5,0,8,1.1428571428571428,1,0.0,0,0,0,0,2,1,0,5,0,0,8,1
8125,109507,IgPmhYztZgoutItcrcEcsnhrRrb2KvYs,A3fsA9Zfv1X2fVEQhTw51lKENdNrEqT3,9,17,3,0,1,0,6,0,27,3.857142857142857,1,0.0,0,3,0,1,17,0,0,6,0,4,23,1
8126,109508,pKS0bXWim4kclZTTgr34KULrUojenqdP,SpATywNh6bZuzm8s1ceuBUnMUAeoAHHw,1,0,0,0,0,0,1,0,1,0.14285714285714285,1,0.0,0,0,0,0,0,0,0,1,0,0,1,1
8127,109526,wZ6yWCylvqNezqFzx20ftEJc7jYDipih,A3fsA9Zfv1X2fVEQhTw51lKENdNrEqT3,16,9,7,0,5,0,8,0,29,4.142857142857143,2,0.0,1,7,0,5,8,0,0,8,0,13,16,1
8128,109536,Cv1aavObJnuABKfipF6OGePzg0BnGPFs,SpATywNh6bZuzm8s1ceuBUnMUAeoAHHw,15,15,6,19,0,1,22,0,63,9.0,7,0.0,9,6,19,0,6,1,0,22,0,34,29,1
8129,109538,Cv1aavObJnuABKfipF6OGePzg0BnGPFs,A3fsA9Zfv1X2fVEQhTw51lKENdNrEqT3,42,9,7,156,0,0,12,0,184,26.285714285714285,5,0.0,2,7,156,0,7,0,0,12,0,165,19,1
8130,109542,UzfhQlNSIoLM6AVYNl7JKilqEEtlOXJC,bWdj2GDclj5ofokWjzoa5jAwMkxCykd6,13,17,7,26,3,0,8,0,61,8.714285714285714,4,0.0,2,7,23,3,15,0,3,8,0,35,26,1
8131,109543,Cv1aavObJnuABKfipF6OGePzg0BnGPFs,bWdj2GDclj5ofokWjzoa5jAwMkxCykd6,21,13,7,96,0,0,10,0,126,18.0,4,0.0,6,7,93,0,7,0,3,10,0,106,20,1
8132,109586,tnFgBBhxwl3ThYwRfbs1nBP0c5GsC0Nt,G8EPVSXsOYB5YQWZGiz1aVq5Pgr2GrQu,6,2,1,0,1,0,3,0,7,1.0,1,0.0,0,1,0,1,2,0,0,3,0,2,5,1
8133,109588,4QzNBqELMiYit65uUaxWvkflyE9kKEti,RXDvfPUBYFlVdlueBFbLW0mhhAyGEqpt,45,39,24,58,11,0,4,0,136,19.428571428571427,2,0.0,7,24,57,11,32,0,1,4,0,99,37,1
8134,109596,yH5UPr6OYjoduVn8gG4Lqcccv4nGJLGC,A3fsA9Zfv1X2fVEQhTw51lKENdNrEqT3,5,3,2,0,0,0,2,0,7,1.0,1,0.0,0,2,0,0,3,0,0,2,0,2,5,1
8135,109617,47U1Ft55cUwsb6d6kZ6WNRfAgXy0966b,A3fsA9Zfv1X2fVEQhTw51lKENdNrEqT3,20,12,8,18,5,0,3,0,46,6.571428571428571,1,0.0,0,8,16,5,12,0,2,3,0,29,17,1
8136,109630,OnyZH4F3oW4crdu4EYjgcCg5L4Cq5yIA,A3fsA9Zfv1X2fVEQhTw51lKENdNrEqT3,6,11,1,0,1,0,1,0,14,2.0,1,0.0,0,1,0,1,11,0,0,1,0,2,12,1
8137,109633,CxbJpiz9m1eHAB0gIyTtLs7Pvx86qvPB,A3fsA9Zfv1X2fVEQhTw51lKENdNrEqT3,15,26,15,0,7,4,9,0,61,8.714285714285714,2,0.0,0,15,0,7,26,4,0,9,0,22,39,1
8138,109635,S7YgWZv0zfBDCXesrYQobA6r2Ns5N7Tq,A3fsA9Zfv1X2fVEQhTw51lKENdNrEqT3,2,0,0,0,0,0,4,0,4,0.5714285714285714,1,0.0,0,0,0,0,0,0,0,4,0,0,4,1
8139,109645,t36cT9Msm4Hh3sPjMIr6iaOAbn6g4BQN,bWdj2GDclj5ofokWjzoa5jAwMkxCykd6,7,8,3,2,0,0,7,0,20,2.857142857142857,2,0.0,4,3,2,0,4,0,0,7,0,9,11,1
8140,109661,vlxKYuyoAuMqS1coFL9iKQUv0EZG5cjH,RXDvfPUBYFlVdlueBFbLW0mhhAyGEqpt,13,16,10,0,3,13,10,2,54,7.714285714285714,2,0.0,2,10,0,3,14,13,0,10,2,15,39,1
8141,109662,tVIaEH9O89RTqDCRllWVA85ShLX4ujE7,SpATywNh6bZuzm8s1ceuBUnMUAeoAHHw,7,12,6,0,1,0,6,0,25,3.5714285714285716,1,0.0,3,6,0,1,9,0,0,6,0,10,15,1
8142,109663,yNBmodc8EXXXXDprMuN3jSh3qPXFcpn8,SpATywNh6bZuzm8s1ceuBUnMUAeoAHHw,10,11,6,0,3,1,3,0,24,3.4285714285714284,1,0.0,0,6,0,3,11,1,0,3,0,9,15,1
8143,109677,Wq5vw9D8EzxIbQ18OklpNCvzPZVsfETA,G8EPVSXsOYB5YQWZGiz1aVq5Pgr2GrQu,6,2,1,0,1,0,2,0,6,0.8571428571428571,1,0.0,0,1,0,1,2,0,0,2,0,2,4,1
8144,109688,TQrIrIwuSwem0ov7co8TUDqNlQcIvB5k,SpATywNh6bZuzm8s1ceuBUnMUAeoAHHw,15,28,11,6,3,8,3,0,59,8.428571428571429,1,0.0,4,11,6,3,24,8,0,3,0,24,35,1
8145,109696,1IVW102tL25hf5DslCWoTGf8umKhKStK,A3fsA9Zfv1X2fVEQhTw51lKENdNrEqT3,9,4,3,0,3,0,2,0,12,1.7142857142857142,1,0.0,1,3,0,3,3,0,0,2,0,7,5,1
8146,109697,pGYP47am2d3xk9zOKdaE6fuoOc52iQiA,A3fsA9Zfv1X2fVEQhTw51lKENdNrEqT3,59,40,0,150,0,0,12,0,202,28.857142857142858,5,0.0,6,0,130,0,34,0,20,12,0,136,66,1
8147,109726,YsCj2vq22thtrABlGTiHQmd1Rq7WC2yD,G8EPVSXsOYB5YQWZGiz1aVq5Pgr2GrQu,1,0,0,0,0,0,1,0,1,0.14285714285714285,1,0.0,0,0,0,0,0,0,0,1,0,0,1,1
8148,109736,Pw5qvLGpB0h5kMFVFGpEeHaRx9RXaDPK,A3fsA9Zfv1X2fVEQhTw51lKENdNrEqT3,14,8,6,0,5,0,4,0,23,3.2857142857142856,2,0.0,0,6,0,5,8,0,0,4,0,11,12,1
8149,109762,Ag1hVTrJxORxsKul36O8LJkzu7JsNNWP,SpATywNh6bZuzm8s1ceuBUnMUAeoAHHw,14,21,9,10,7,0,6,2,55,7.857142857142857,2,0.0,7,9,9,7,14,0,1,6,2,32,23,1
8150,109765,MJcUUCn8PV6c1s6azIezqfn8QYa8QKmD,SpATywNh6bZuzm8s1ceuBUnMUAeoAHHw,1,0,0,0,0,0,1,0,1,0.14285714285714285,1,0.0,0,0,0,0,0,0,0,1,0,0,1,1
8151,109788,YK9goZgoN0rvofZU4YE46jMvnter3goc,G8EPVSXsOYB5YQWZGiz1aVq5Pgr2GrQu,8,7,3,0,2,1,3,0,16,2.2857142857142856,1,0.0,2,3,0,2,5,1,0,3,0,7,9,1
8152,109790,p7ttFbRCERCwhTg2CGSQKJTx8BwPrv0X,SpATywNh6bZuzm8s1ceuBUnMUAeoAHHw,16,15,7,12,3,0,5,0,42,6.0,1,0.0,8,7,12,3,7,0,0,5,0,30,12,1
8153,109797,BvGZp7WaxxtjkCv9TCLYGxFTwKxW9SN6,SpATywNh6bZuzm8s1ceuBUnMUAeoAHHw,1,0,0,0,0,0,1,0,1,0.14285714285714285,1,0.0,0,0,0,0,0,0,0,1,0,0,1,1
8154,109798,K1BSnyoMMyobTomJrER9oQIG5DUTaz3Q,SpATywNh6bZuzm8s1ceuBUnMUAeoAHHw,4,2,1,0,0,0,2,0,5,0.7142857142857143,1,0.0,0,1,0,0,2,0,0,2,0,1,4,1
8155,109817,S9Szq6g9ved8FvqRXhj5wFkk1JBdWVxm,SpATywNh6bZuzm8s1ceuBUnMUAeoAHHw,16,33,14,4,7,2,16,7,83,11.857142857142858,2,0.0,13,14,4,7,20,2,0,16,7,38,45,1
8156,109822,kNz6Otgr0OzNKmI1vQVj8WSVh9NxP9ty,A3fsA9Zfv1X2fVEQhTw51lKENdNrEqT3,13,5,3,0,3,7,10,3,31,4.428571428571429,2,0.0,1,3,0,3,4,7,0,10,3,7,24,1
8157,109838,5G14OqJhAMEtcEWhkGrUvPjxVR4dIAwN,SpATywNh6bZuzm8s1ceuBUnMUAeoAHHw,9,17,1,0,1,1,5,1,26,3.7142857142857144,1,0.0,12,1,0,1,5,1,0,5,1,14,12,1
8158,109844,hvsRGWJp5579jHaZrBOzJk6TUYpgGqDO,A3fsA9Zfv1X2fVEQhTw51lKENdNrEqT3,10,5,4,0,4,0,1,0,14,2.0,1,0.0,0,4,0,4,5,0,0,1,0,8,6,1
8159,109892,mbcohNJJNHml8jzBeHm74GmBbBH9udey,bWdj2GDclj5ofokWjzoa5jAwMkxCykd6,1,0,0,0,0,0,1,0,1,0.14285714285714285,1,0.0,0,0,0,0,0,0,0,1,0,0,1,1
8160,109897,YQYuuodMZUFMR21jPqGx2gjrHZSeRDRA,A3fsA9Zfv1X2fVEQhTw51lKENdNrEqT3,18,17,7,0,6,0,10,0,40,5.714285714285714,4,0.0,0,7,0,6,17,0,0,10,0,13,27,1
8161,109901,mbcohNJJNHml8jzBeHm74GmBbBH9udey,A3fsA9Zfv1X2fVEQhTw51lKENdNrEqT3,1,0,0,0,0,0,1,0,1,0.14285714285714285,1,0.0,0,0,0,0,0,0,0,1,0,0,1,1
8162,109908,HCwGALsXdQRvdnW9Y1SicRkbFYJcehRz,G8EPVSXsOYB5YQWZGiz1aVq5Pgr2GrQu,64,76,26,120,12,14,15,1,264,37.714285714285715,4,0.0,29,26,99,12,47,14,21,15,1,166,98,0
8163,109914,y8NaQIDe3D7l0VzaS1fuEDzV6bcaTY0g,bWdj2GDclj5ofokWjzoa5jAwMkxCykd6,4,2,1,0,1,0,1,0,5,0.7142857142857143,1,0.0,0,1,0,1,2,0,0,1,0,2,3,1
8164,109927,CwyOL3RMOVLomxrxyN9D4jPa9R0iWrS5,bWdj2GDclj5ofokWjzoa5jAwMkxCykd6,12,14,9,16,5,0,9,0,53,7.571428571428571,1,0.0,2,9,16,5,12,0,0,9,0,32,21,1
8165,109942,69mjZoNGtUdd47OHaI2iQubsVwSBE5CT,A3fsA9Zfv1X2fVEQhTw51lKENdNrEqT3,7,9,4,0,2,0,4,0,19,2.7142857142857144,1,0.0,0,4,0,2,9,0,0,4,0,6,13,1
8166,109946,mdF4VSOHdhU4Fo37q40c5lLreOU7ezPS,A3fsA9Zfv1X2fVEQhTw51lKENdNrEqT3,8,5,3,0,0,1,8,1,18,2.5714285714285716,1,0.0,0,3,0,0,5,1,0,8,1,3,15,1
8167,109955,c5FmvWqHimPY3en4KzYtEePuWbXPcm4V,bWdj2GDclj5ofokWjzoa5jAwMkxCykd6,4,2,1,0,0,1,4,0,8,1.1428571428571428,1,0.0,0,1,0,0,2,1,0,4,0,1,7,1
8168,109956,HNOGJwV4rdRhqUou8hYUuOI1xR3yp1lD,SpATywNh6bZuzm8s1ceuBUnMUAeoAHHw,2,0,0,0,0,0,2,0,2,0.2857142857142857,1,0.0,0,0,0,0,0,0,0,2,0,0,2,1
8169,109982,DmULS2tEq0maGheqJ8Xg7VkvUxmleIug,SpATywNh6bZuzm8s1ceuBUnMUAeoAHHw,12,40,1,0,1,0,5,0,47,6.714285714285714,4,0.0,1,1,0,1,39,0,0,5,0,3,44,0
8170,109983,5Dqq361dkHzqa5S9GQLfoF5pBVvOZxtV,SpATywNh6bZuzm8s1ceuBUnMUAeoAHHw,1,0,0,0,0,0,1,0,1,0.14285714285714285,1,0.0,0,0,0,0,0,0,0,1,0,0,1,1
8171,110026,KC30Cns1M10UV49aokZvWIXO8ZPauHoR,bWdj2GDclj5ofokWjzoa5jAwMkxCykd6,2,0,0,0,0,0,2,0,2,0.2857142857142857,1,0.0,0,0,0,0,0,0,0,2,0,0,2,1
8172,110029,KC30Cns1M10UV49aokZvWIXO8ZPauHoR,RXDvfPUBYFlVdlueBFbLW0mhhAyGEqpt,2,0,0,0,0,0,2,0,2,0.2857142857142857,1,0.0,0,0,0,0,0,0,0,2,0,0,2,1
8173,110080,hcKYo6bLhlANvHE0FxLuR4YY8jocfBwJ,3VkHkmOtom3jM2wCu94xgzzu1d6Dn7or,1,0,0,0,0,0,1,0,1,0.14285714285714285,1,0.0,0,0,0,0,0,0,0,1,0,0,1,1
8174,110160,tQTTqm9DjemtPNF3ORI2L4M8osQnAURf,3VkHkmOtom3jM2wCu94xgzzu1d6Dn7or,1,0,0,0,0,0,1,0,1,0.14285714285714285,1,0.0,0,0,0,0,0,0,0,1,0,0,1,1
8175,110172,dgw4tTSPoodEIw3NArkQfHVLNlyVpfo8,3VkHkmOtom3jM2wCu94xgzzu1d6Dn7or,6,8,3,0,1,0,6,0,18,2.5714285714285716,4,0.0,0,3,0,1,8,0,0,6,0,4,14,1
8176,110201,uuX226ZRzkH40ob6OQauhckMXaHIVvO6,3VkHkmOtom3jM2wCu94xgzzu1d6Dn7or,1,0,0,0,0,0,1,0,1,0.14285714285714285,1,0.0,0,0,0,0,0,0,0,1,0,0,1,1
8177,110273,CJsNiGCsxs0gSxnKzYmVgd6irEKAgYWb,3VkHkmOtom3jM2wCu94xgzzu1d6Dn7or,4,2,0,0,1,0,1,0,4,0.5714285714285714,1,0.0,0,0,0,1,2,0,0,1,0,1,3,1
8178,110314,Kw4j4zV2G17wNG0fvJSniJC0vpSp4WB3,3VkHkmOtom3jM2wCu94xgzzu1d6Dn7or,3,7,1,0,0,0,2,0,10,1.4285714285714286,1,0.0,2,1,0,0,5,0,0,2,0,3,7,1
8179,110315,KWgayNex9Wt525YiePdZOaMt6mX0X0eu,3VkHkmOtom3jM2wCu94xgzzu1d6Dn7or,6,5,1,0,2,1,4,1,14,2.0,1,0.0,3,1,0,2,2,1,0,4,1,6,8,1
8180,110324,ypGN2wgc9crA4zEJXwMWXNDHD4O5YyyW,3VkHkmOtom3jM2wCu94xgzzu1d6Dn7or,4,2,1,0,1,0,1,0,5,0.7142857142857143,1,0.0,0,1,0,1,2,0,0,1,0,2,3,1
8181,110335,pjAfJHyO8N5jQipO1PMinHg7bhzVpnp5,3VkHkmOtom3jM2wCu94xgzzu1d6Dn7or,2,0,0,0,0,0,2,0,2,0.2857142857142857,1,0.0,0,0,0,0,0,0,0,2,0,0,2,1
8182,110373,qiegS2hNiYigSBc2IvMkXPpA0hNqDPGC,3VkHkmOtom3jM2wCu94xgzzu1d6Dn7or,6,5,2,0,1,1,2,0,11,1.5714285714285714,1,0.0,0,2,0,1,5,1,0,2,0,3,8,1
8183,110382,DD3RB9vWEpLhfNx2699s29qSfhYix0qh,3VkHkmOtom3jM2wCu94xgzzu1d6Dn7or,1,0,0,0,0,0,1,0,1,0.14285714285714285,1,0.0,0,0,0,0,0,0,0,1,0,0,1,1
8184,110391,MQZdAEEmvpjWGuI3HotP9v7Hv3drJgho,3VkHkmOtom3jM2wCu94xgzzu1d6Dn7or,1,0,0,0,0,0,1,0,1,0.14285714285714285,1,0.0,0,0,0,0,0,0,0,1,0,0,1,1
8185,110405,dklUB6yC0xsZG5YlRHgQDJ8HWL9EGj2b,3VkHkmOtom3jM2wCu94xgzzu1d6Dn7or,1,0,0,0,0,0,2,0,2,0.2857142857142857,1,0.0,0,0,0,0,0,0,0,2,0,0,2,1
8186,110420,lk3lGbNCFxoPG1OVILbfGp3s2wN91K2M,3VkHkmOtom3jM2wCu94xgzzu1d6Dn7or,9,6,4,0,3,0,2,0,15,2.142857142857143,2,0.0,0,4,0,3,6,0,0,2,0,7,8,1
8187,110431,Eoq6GI8WvhBY8jGaKSz9pwBaAPOaKefs,3VkHkmOtom3jM2wCu94xgzzu1d6Dn7or,17,10,1,0,7,0,3,0,21,3.0,2,0.0,1,1,0,7,9,0,0,3,0,9,12,1
8188,110442,VPZdopz81m6GMrIZPFm4nryG685J1OxT,3VkHkmOtom3jM2wCu94xgzzu1d6Dn7or,1,0,0,0,0,0,1,0,1,0.14285714285714285,1,0.0,0,0,0,0,0,0,0,1,0,0,1,1
8189,110561,JRJaGujKrM28bu4l5ufPAodjLHbLI1ND,3VkHkmOtom3jM2wCu94xgzzu1d6Dn7or,5,2,1,0,1,0,2,0,6,0.8571428571428571,1,0.0,0,1,0,1,2,0,0,2,0,2,4,1
8190,110647,lYs6uTLhEyomcaec07g09oLWhf3wcIzp,3VkHkmOtom3jM2wCu94xgzzu1d6Dn7or,6,2,1,0,1,0,3,0,7,1.0,1,0.0,0,1,0,1,2,0,0,3,0,2,5,1
8191,110649,5txttxupjDZ5RVkKM8mUX5AwlfTmH5yF,3VkHkmOtom3jM2wCu94xgzzu1d6Dn7or,1,0,0,0,0,0,1,0,1,0.14285714285714285,1,0.0,0,0,0,0,0,0,0,1,0,0,1,1
8192,110690,hIVUDhb4i3nVGfAV6do3ugshBCuhX9Mx,3VkHkmOtom3jM2wCu94xgzzu1d6Dn7or,1,0,0,0,0,0,1,0,1,0.14285714285714285,1,0.0,0,0,0,0,0,0,0,1,0,0,1,1
8193,110701,MDJK2KVw2sHLHwyALdBdwbko7CJt3B5W,3VkHkmOtom3jM2wCu94xgzzu1d6Dn7or,18,33,15,7,16,5,4,0,80,11.428571428571429,2,0.0,15,15,7,16,18,5,0,4,0,53,27,0
8194,110719,91sZGqEx9uDXZlwTbnZ3tvnn10BqfT5E,3VkHkmOtom3jM2wCu94xgzzu1d6Dn7or,18,41,4,11,16,20,9,1,102,14.571428571428571,1,0.0,35,4,10,16,6,20,1,9,1,65,37,1
8195,110839,Hc0D2UkydjyUi3vnnsfmiB8lOnMbIWKo,3VkHkmOtom3jM2wCu94xgzzu1d6Dn7or,89,282,74,104,101,8,41,9,619,88.42857142857143,4,0.0,177,74,87,101,105,8,17,41,9,439,180,1
8196,110946,h7Gk9Pr4tHraGHEA4N989G6mMEttrQ7F,3VkHkmOtom3jM2wCu94xgzzu1d6Dn7or,1,0,0,0,0,0,1,0,1,0.14285714285714285,1,0.0,0,0,0,0,0,0,0,1,0,0,1,1
8197,110952,385eoDvq5L7kSzlslamm7bGDDIFQKNoc,3VkHkmOtom3jM2wCu94xgzzu1d6Dn7or,71,141,71,97,49,51,36,1,446,63.714285714285715,9,0.0,39,71,81,49,102,51,16,36,1,240,206,0
8198,111009,DiP7fLvMTHut4vp8IPCEmth5BO8Y3xyZ,3VkHkmOtom3jM2wCu94xgzzu1d6Dn7or,79,122,66,76,50,23,18,5,360,51.42857142857143,3,0.0,38,66,73,50,84,23,3,18,5,227,133,0
8199,111011,dBwvitRj8tl4oRvKTVIguzs8yzvyjBHl,3VkHkmOtom3jM2wCu94xgzzu1d6Dn7or,67,238,103,69,52,16,54,8,540,77.14285714285714,9,0.0,87,103,67,52,151,16,2,54,8,309,231,0
8200,111044,4WnXFlVVsDRP9zMYu9GhBkmRaEDuNfCw,3VkHkmOtom3jM2wCu94xgzzu1d6Dn7or,1,0,0,0,0,0,2,0,2,0.2857142857142857,1,0.0,0,0,0,0,0,0,0,2,0,0,2,1
8201,111051,FxaU1aiaJfFcWvu1nipWOIaSeSTieKCJ,3VkHkmOtom3jM2wCu94xgzzu1d6Dn7or,10,10,3,0,2,3,14,1,33,4.714285714285714,1,0.0,0,3,0,2,10,3,0,14,1,5,28,1
8202,111098,gCOl0XKZgn7U20rgDk2nqeymvoIH6h2A,3VkHkmOtom3jM2wCu94xgzzu1d6Dn7or,1,0,0,0,0,0,1,0,1,0.14285714285714285,1,0.0,0,0,0,0,0,0,0,1,0,0,1,1
8203,111134,UtAqhqB3FX1II4t3OmHm0AmqSdhnUJww,3VkHkmOtom3jM2wCu94xgzzu1d6Dn7or,74,53,24,26,23,1,13,1,141,20.142857142857142,1,0.0,22,24,25,23,31,1,1,13,1,94,47,0
8204,111202,J4alNwqJn6WPGLv0oNVXgfBnikipd1X1,3VkHkmOtom3jM2wCu94xgzzu1d6Dn7or,69,92,47,98,28,22,30,0,317,45.285714285714285,1,0.0,32,47,86,28,60,22,12,30,0,193,124,1
8205,111247,frTI0FocLiDe4yupewVASUS2u4VqwYIi,3VkHkmOtom3jM2wCu94xgzzu1d6Dn7or,1,0,0,0,0,0,1,0,1,0.14285714285714285,1,0.0,0,0,0,0,0,0,0,1,0,0,1,1
8206,111278,u4XgrwL7SekHV6NpCL6rWztzww1pNSow,3VkHkmOtom3jM2wCu94xgzzu1d6Dn7or,1,0,0,0,0,0,1,0,1,0.14285714285714285,1,0.0,0,0,0,0,0,0,0,1,0,0,1,1
8207,111281,DAhW5rh28SUHtuiMbPZb9rI9MdH1t7pB,3VkHkmOtom3jM2wCu94xgzzu1d6Dn7or,1,0,0,0,0,0,1,0,1,0.14285714285714285,1,0.0,0,0,0,0,0,0,0,1,0,0,1,1
8208,111298,Edq6Echk8wEs8ShX5RBw5c8Yx8ANHVje,3VkHkmOtom3jM2wCu94xgzzu1d6Dn7or,65,158,72,31,53,16,40,8,378,54.0,8,0.0,37,72,25,53,121,16,6,40,8,187,191,0
8209,111324,JVjtBSreKMlUtn69yisEBp2mMBmVSbkl,3VkHkmOtom3jM2wCu94xgzzu1d6Dn7or,1,0,0,0,0,0,1,0,1,0.14285714285714285,1,0.0,0,0,0,0,0,0,0,1,0,0,1,1
8210,111381,qy4bKhXqNBlINsljPVNLHwKIsvlS56JE,3VkHkmOtom3jM2wCu94xgzzu1d6Dn7or,1,0,0,0,0,0,1,0,1,0.14285714285714285,1,0.0,0,0,0,0,0,0,0,1,0,0,1,1
8211,111383,KuvsFrN97YK5My2eYxIvxOJQK3uGLMZl,3VkHkmOtom3jM2wCu94xgzzu1d6Dn7or,8,4,3,0,3,0,2,0,12,1.7142857142857142,2,0.0,0,3,0,3,4,0,0,2,0,6,6,0
8212,111410,q71qOWfICaVfg6Zw64BA0tNHU6xbZhD6,3VkHkmOtom3jM2wCu94xgzzu1d6Dn7or,2,0,0,0,0,0,5,0,5,0.7142857142857143,1,0.0,0,0,0,0,0,0,0,5,0,0,5,1
8213,111420,gYURfn1wGFkYpvwmL9xjcpaVpwUtS21C,3VkHkmOtom3jM2wCu94xgzzu1d6Dn7or,5,9,4,0,2,0,3,0,18,2.5714285714285716,1,0.0,0,4,0,2,9,0,0,3,0,6,12,1
8214,111423,n0aD0wlRo2epwn74jquTDUFpiwWF99mc,3VkHkmOtom3jM2wCu94xgzzu1d6Dn7or,28,95,35,39,18,22,31,0,240,34.285714285714285,3,0.0,37,35,32,18,58,22,7,31,0,122,118,0
8215,111486,ph5wiKq9PFfSU2tf3ynRG351nJE4IJkg,3VkHkmOtom3jM2wCu94xgzzu1d6Dn7or,6,5,0,0,1,0,5,0,11,1.5714285714285714,1,0.0,3,0,0,1,2,0,0,5,0,4,7,1
8216,111507,GYAhe7QkBFzfyQOufZzJyKbMW1Ol7QR2,3VkHkmOtom3jM2wCu94xgzzu1d6Dn7or,63,95,27,48,32,1,9,0,212,30.285714285714285,3,0.0,54,27,48,32,41,1,0,9,0,161,51,0
8217,111509,Qg58L4tshpaHzP1wdPOKDyrMxGfjR0JY,3VkHkmOtom3jM2wCu94xgzzu1d6Dn7or,1,0,0,0,0,0,1,0,1,0.14285714285714285,1,0.0,0,0,0,0,0,0,0,1,0,0,1,1
8218,111511,MiNPEyHmjvHg1wNBdSa8s4LNXdy6iLx3,3VkHkmOtom3jM2wCu94xgzzu1d6Dn7or,7,2,1,0,1,1,6,1,12,1.7142857142857142,1,0.0,0,1,0,1,2,1,0,6,1,2,10,0
8219,111556,7IxTaoybgqwYaeApepZlCbtcTpX0V2Zq,3VkHkmOtom3jM2wCu94xgzzu1d6Dn7or,17,37,20,3,17,8,7,0,92,13.142857142857142,4,0.0,9,20,2,17,28,8,1,7,0,48,44,1
8220,111564,zUobDCRhz2JvPr18gEcZcSJ3b1q6D65b,3VkHkmOtom3jM2wCu94xgzzu1d6Dn7or,9,13,8,2,4,2,7,0,36,5.142857142857143,2,0.0,2,8,2,4,11,2,0,7,0,16,20,1
8221,111582,3p1ktBOq5CZcyAsD0nHTLBZZjpK9i1Gn,3VkHkmOtom3jM2wCu94xgzzu1d6Dn7or,1,0,0,0,0,0,1,0,1,0.14285714285714285,1,0.0,0,0,0,0,0,0,0,1,0,0,1,1
8222,111583,CaPxrejcLjdFG5dqioKl8ehEL4wq8JH2,3VkHkmOtom3jM2wCu94xgzzu1d6Dn7or,9,8,5,0,3,9,19,1,45,6.428571428571429,3,0.0,1,5,0,3,7,9,0,19,1,9,36,1
8223,111600,P10HaDx6l8IuAsJbV4kOql1OHfzQ01pK,3VkHkmOtom3jM2wCu94xgzzu1d6Dn7or,6,4,2,0,1,3,3,0,13,1.8571428571428572,1,0.0,0,2,0,1,4,3,0,3,0,3,10,1
8224,111617,uudNxB4rLeWW9Hko0kaY7p0fpljb07CO,3VkHkmOtom3jM2wCu94xgzzu1d6Dn7or,1,0,0,0,0,0,1,0,1,0.14285714285714285,1,0.0,0,0,0,0,0,0,0,1,0,0,1,1
8225,111676,xLLYMOxgSGV4lCmifoUg1VooBZRaCvj1,3VkHkmOtom3jM2wCu94xgzzu1d6Dn7or,1,0,0,0,0,0,1,0,1,0.14285714285714285,1,0.0,0,0,0,0,0,0,0,1,0,0,1,1
8226,111706,X8NuLmgGRaFMI5zNKihuJdLjGBr35knv,3VkHkmOtom3jM2wCu94xgzzu1d6Dn7or,6,3,2,0,1,0,3,0,9,1.2857142857142858,1,0.0,0,2,0,1,3,0,0,3,0,3,6,1
8227,111736,dRP0ir8plXgy7LWTvwwfAqySkmmXoOPk,3VkHkmOtom3jM2wCu94xgzzu1d6Dn7or,7,3,1,0,2,0,2,0,8,1.1428571428571428,1,0.0,0,1,0,2,3,0,0,2,0,3,5,1
8228,111744,MlhSM0XKuMJ0bCO7z2w3vdKbHEE7ba20,3VkHkmOtom3jM2wCu94xgzzu1d6Dn7or,8,6,1,0,2,2,5,5,21,3.0,1,0.0,2,1,0,2,4,2,0,5,5,5,16,1
8229,111768,Ve3uoVQNDVK9QV5oetJsvI3CTxMOaW16,3VkHkmOtom3jM2wCu94xgzzu1d6Dn7or,7,7,4,0,3,0,3,0,17,2.4285714285714284,1,0.0,0,4,0,3,7,0,0,3,0,7,10,1
8230,111770,ZSlBckdwoYlTvZClIIiOXz0ZMgxNYGfM,3VkHkmOtom3jM2wCu94xgzzu1d6Dn7or,1,0,0,0,0,0,1,0,1,0.14285714285714285,1,0.0,0,0,0,0,0,0,0,1,0,0,1,1
8231,111785,GebdA7Vo87ReyKP2A7BXi3CttXQIgfXb,3VkHkmOtom3jM2wCu94xgzzu1d6Dn7or,1,0,0,0,0,0,1,0,1,0.14285714285714285,1,0.0,0,0,0,0,0,0,0,1,0,0,1,1
8232,111850,SZCjuQFEoPPVPSbhIibtzJ6PkWJhxivD,3VkHkmOtom3jM2wCu94xgzzu1d6Dn7or,4,2,1,0,1,0,1,0,5,0.7142857142857143,1,0.0,0,1,0,1,2,0,0,1,0,2,3,0
8233,111860,2ZN7cPIeVdD0KZCT2ktom7Ut5usBqNmS,3VkHkmOtom3jM2wCu94xgzzu1d6Dn7or,9,16,2,0,0,0,8,1,27,3.857142857142857,1,0.0,4,2,0,0,12,0,0,8,1,6,21,1
8234,111869,UyGxbLGpzWj9nUt4zlv3JQ4QXzLJV2bP,3VkHkmOtom3jM2wCu94xgzzu1d6Dn7or,1,0,0,0,0,0,1,0,1,0.14285714285714285,1,0.0,0,0,0,0,0,0,0,1,0,0,1,1
8235,111930,3DfsQ9gyILzjZd3Nv6DJhAXnVcPbzdjq,3VkHkmOtom3jM2wCu94xgzzu1d6Dn7or,14,12,4,0,5,4,8,3,36,5.142857142857143,1,0.0,5,4,0,5,7,4,0,8,3,14,22,1
8236,111936,pKAupmA8Zsx6hWHvCVolaq97GTNR8NMr,3VkHkmOtom3jM2wCu94xgzzu1d6Dn7or,8,2,1,0,1,1,5,1,11,1.5714285714285714,1,0.0,0,1,0,1,2,1,0,5,1,2,9,1
8237,111938,fsiWcpaBqhmZ0C1onKGiGw90SPlP8tG1,3VkHkmOtom3jM2wCu94xgzzu1d6Dn7or,5,9,2,2,2,1,1,0,17,2.4285714285714284,1,0.0,3,2,2,2,6,1,0,1,0,9,8,1
8238,111943,f2V0oICuYr1XUKhIx9tXBvYEtmo9HOKI,3VkHkmOtom3jM2wCu94xgzzu1d6Dn7or,10,30,6,6,11,3,6,0,62,8.857142857142858,1,0.0,21,6,5,11,9,3,1,6,0,43,19,1
8239,111944,Exx3Un9q1uCMXWbbyyaAPCkg6gWu2oBK,3VkHkmOtom3jM2wCu94xgzzu1d6Dn7or,1,0,0,0,0,0,1,0,1,0.14285714285714285,1,0.0,0,0,0,0,0,0,0,1,0,0,1,1
8240,111947,WvM5M1NFRJzPyKi5SvQNN6PHxvm7x8f1,3VkHkmOtom3jM2wCu94xgzzu1d6Dn7or,8,4,1,0,1,1,6,1,14,2.0,2,0.0,1,1,0,1,3,1,0,6,1,3,11,1
8241,111953,skpJtZYiMDDMx1OrlY5mDzZ4vLhPTUr0,3VkHkmOtom3jM2wCu94xgzzu1d6Dn7or,70,166,67,40,66,17,17,0,373,53.285714285714285,12,0.0,72,67,40,66,94,17,0,17,0,245,128,0
8242,111955,Estdjd6V12yYbDglfRGOJrJgPUySsORQ,3VkHkmOtom3jM2wCu94xgzzu1d6Dn7or,4,0,0,0,0,1,3,0,4,0.5714285714285714,1,0.0,0,0,0,0,0,1,0,3,0,0,4,1
8243,111958,UIl4zQsYWbldMZPjUNpW4NT1FiQSwWSq,3VkHkmOtom3jM2wCu94xgzzu1d6Dn7or,8,7,4,0,2,0,9,1,23,3.2857142857142856,1,0.0,0,4,0,2,7,0,0,9,1,6,17,1
8244,111960,8ySChdMhILkWrFidrAeAcbpscZk12bIK,3VkHkmOtom3jM2wCu94xgzzu1d6Dn7or,7,3,2,0,2,0,5,0,12,1.7142857142857142,1,0.0,0,2,0,2,3,0,0,5,0,4,8,1
8245,111961,wxlTuL6FVeoyKGq1xWxdRI4GRTsaG1Ha,3VkHkmOtom3jM2wCu94xgzzu1d6Dn7or,4,6,2,0,0,0,2,0,10,1.4285714285714286,1,0.0,3,2,0,0,3,0,0,2,0,5,5,1
8246,111971,h6o87K2TwGFARqnbFLA8ALKnrMFFMZSS,3VkHkmOtom3jM2wCu94xgzzu1d6Dn7or,7,6,0,0,1,1,4,0,12,1.7142857142857142,2,0.0,1,0,0,1,5,1,0,4,0,2,10,1
8247,111977,UT72iLyPsiKxDVBpTr4IKm3K6RJA6lY0,3VkHkmOtom3jM2wCu94xgzzu1d6Dn7or,2,0,0,0,0,0,6,0,6,0.8571428571428571,1,0.0,0,0,0,0,0,0,0,6,0,0,6,1
8248,111981,y0iWjLNC6UZ1t5vHgtgjLHxXYlZwkmmB,3VkHkmOtom3jM2wCu94xgzzu1d6Dn7or,6,2,0,0,0,0,4,0,6,0.8571428571428571,1,0.0,0,0,0,0,2,0,0,4,0,0,6,1
8249,111984,G0nwXlWZMERhq2ON5nxnxNtoRAERGxUq,3VkHkmOtom3jM2wCu94xgzzu1d6Dn7or,14,8,7,0,7,0,1,0,23,3.2857142857142856,1,0.0,0,7,0,7,8,0,0,1,0,14,9,1
8250,111985,Zc2H7AOkStouMPrWXTVWTTQu8hKuh8Ix,3VkHkmOtom3jM2wCu94xgzzu1d6Dn7or,21,30,23,0,22,0,5,0,80,11.428571428571429,1,0.0,3,23,0,22,27,0,0,5,0,48,32,1
8251,111991,LqcGRzWXAOTgfy7uWLpn5rWutSneazTK,3VkHkmOtom3jM2wCu94xgzzu1d6Dn7or,2,0,0,0,0,0,4,0,4,0.5714285714285714,1,0.0,0,0,0,0,0,0,0,4,0,0,4,1
8252,112000,7gdV7KHFxHCq7uneNPZ2mJZzAKbnphff,3VkHkmOtom3jM2wCu94xgzzu1d6Dn7or,7,7,4,0,2,0,11,0,24,3.4285714285714284,2,0.0,0,4,0,2,7,0,0,11,0,6,18,1
8253,112013,W6dP7nTf9BNP7aV0CbJYvRNsUWmdVpbc,3VkHkmOtom3jM2wCu94xgzzu1d6Dn7or,1,0,0,0,0,0,1,0,1,0.14285714285714285,1,0.0,0,0,0,0,0,0,0,1,0,0,1,1
8254,112019,76pKCefEfcfpKWQtQXjk4oYjnkzOZxgt,3VkHkmOtom3jM2wCu94xgzzu1d6Dn7or,3,8,2,0,0,0,1,0,11,1.5714285714285714,1,0.0,2,2,0,0,6,0,0,1,0,4,7,1
8255,112022,KVo59motAkvZvNOOD8FGbdMlYFkMnvCS,3VkHkmOtom3jM2wCu94xgzzu1d6Dn7or,1,0,0,0,0,0,2,0,2,0.2857142857142857,1,0.0,0,0,0,0,0,0,0,2,0,0,2,1
8256,112030,CP3nhN9EdmeKw6zajWsPWDgJI2wN23yd,3VkHkmOtom3jM2wCu94xgzzu1d6Dn7or,1,0,0,0,0,0,1,0,1,0.14285714285714285,1,0.0,0,0,0,0,0,0,0,1,0,0,1,1
8257,112031,BdfiHqmY8y0Rb9j3NkCjTbrPRsqwK9UA,3VkHkmOtom3jM2wCu94xgzzu1d6Dn7or,1,0,0,0,0,0,1,0,1,0.14285714285714285,1,0.0,0,0,0,0,0,0,0,1,0,0,1,1
8258,112037,YBkzZZhOJVCrbhYhnWEKCK1kCty9skX4,3VkHkmOtom3jM2wCu94xgzzu1d6Dn7or,4,2,1,0,1,0,1,0,5,0.7142857142857143,1,0.0,0,1,0,1,2,0,0,1,0,2,3,1
8259,112038,cPOTZdhRHkdjEi5m6KG2HFGdYqzepY5d,3VkHkmOtom3jM2wCu94xgzzu1d6Dn7or,2,0,0,0,0,0,2,0,2,0.2857142857142857,1,0.0,0,0,0,0,0,0,0,2,0,0,2,1
8260,112039,wrcYJrLAOsQKdwZZIoFJl5xvtnZ7aQv7,3VkHkmOtom3jM2wCu94xgzzu1d6Dn7or,4,0,0,0,0,0,4,0,4,0.5714285714285714,1,0.0,0,0,0,0,0,0,0,4,0,0,4,1
8261,112040,qMFAmPw34z5IViYTtA1Kkpcn2uEg1WBM,3VkHkmOtom3jM2wCu94xgzzu1d6Dn7or,1,0,0,0,0,0,1,0,1,0.14285714285714285,1,0.0,0,0,0,0,0,0,0,1,0,0,1,1
8262,112061,pXhlODqjUGiHEnVqqJV8aw6jGGC44Z9b,3VkHkmOtom3jM2wCu94xgzzu1d6Dn7or,4,2,1,0,0,0,2,0,5,0.7142857142857143,1,0.0,0,1,0,0,2,0,0,2,0,1,4,1
8263,112109,ATfemq9ZbNbnnT9IBiRcbfRhEk6fLmjZ,3VkHkmOtom3jM2wCu94xgzzu1d6Dn7or,6,2,1,0,1,0,4,1,9,1.2857142857142858,1,0.0,0,1,0,1,2,0,0,4,1,2,7,1
8264,112120,UWAUal0Hpb3RbEmfIAwz3lm4E3yvYQMV,3VkHkmOtom3jM2wCu94xgzzu1d6Dn7or,1,0,0,0,0,0,1,0,1,0.14285714285714285,1,0.0,0,0,0,0,0,0,0,1,0,0,1,1
8265,112145,c5JhVDkXO4Xl1o4x0X5wpbuFHZccHbBn,3VkHkmOtom3jM2wCu94xgzzu1d6Dn7or,8,2,1,0,1,0,6,0,10,1.4285714285714286,1,0.0,0,1,0,1,2,0,0,6,0,2,8,1
8266,112161,JcCpItFxuZKtVIsbgPaRDIeLN2ik56pZ,3VkHkmOtom3jM2wCu94xgzzu1d6Dn7or,1,0,0,0,0,0,1,0,1,0.14285714285714285,1,0.0,0,0,0,0,0,0,0,1,0,0,1,1
8267,112171,T1xwSBpIR06eshHrqOHizSKkKz8v47RI,3VkHkmOtom3jM2wCu94xgzzu1d6Dn7or,8,9,4,0,3,0,4,0,20,2.857142857142857,1,0.0,2,4,0,3,7,0,0,4,0,9,11,1
8268,112176,94L6G6uqjoIozyLQIsc4GEWmNn1tQth5,3VkHkmOtom3jM2wCu94xgzzu1d6Dn7or,1,0,0,0,0,0,1,0,1,0.14285714285714285,1,0.0,0,0,0,0,0,0,0,1,0,0,1,1
8269,112177,BNU2wGZhV5dmPLymeUzZGTZPF40H3QyF,3VkHkmOtom3jM2wCu94xgzzu1d6Dn7or,31,20,19,0,19,0,1,0,59,8.428571428571429,1,0.0,0,19,0,19,20,0,0,1,0,38,21,1
8270,112184,2f8w2JPFYWYlQ8YCbFTA0pgMRO6fzXen,3VkHkmOtom3jM2wCu94xgzzu1d6Dn7or,5,2,1,0,1,0,2,0,6,0.8571428571428571,1,0.0,0,1,0,1,2,0,0,2,0,2,4,1
8271,112205,V525N9mtqrNpraRU1F9QVCqUQEU1WfxW,3VkHkmOtom3jM2wCu94xgzzu1d6Dn7or,6,1,1,0,1,0,4,0,7,1.0,1,0.0,0,1,0,1,1,0,0,4,0,2,5,1
8272,112243,syN7254OdJ7LnC3HWyjnPHaGfR8Du2Io,3VkHkmOtom3jM2wCu94xgzzu1d6Dn7or,2,0,0,0,0,0,4,0,4,0.5714285714285714,1,0.0,0,0,0,0,0,0,0,4,0,0,4,0
8273,112289,kGF8CGQ426uE7xF8JEXhsJ2gcirqmBoI,3VkHkmOtom3jM2wCu94xgzzu1d6Dn7or,4,2,1,0,1,5,2,0,11,1.5714285714285714,1,0.0,0,1,0,1,2,5,0,2,0,2,9,1
8274,112306,RgykpghwGJQQimxBR8odeQ7kA01zSs4z,3VkHkmOtom3jM2wCu94xgzzu1d6Dn7or,24,53,17,17,15,10,14,1,127,18.142857142857142,4,0.0,26,17,15,15,27,10,2,14,1,73,54,1
8275,112308,GEP9PIxkZLOm5AbT7V1aSC88PhAcNGOk,3VkHkmOtom3jM2wCu94xgzzu1d6Dn7or,7,2,1,0,1,1,4,3,12,1.7142857142857142,1,0.0,0,1,0,1,2,1,0,4,3,2,10,1
8276,112334,FRAAuV41f0A1JwZFXkz0IPkuaO4bvD0Y,3VkHkmOtom3jM2wCu94xgzzu1d6Dn7or,1,0,0,0,0,0,1,0,1,0.14285714285714285,1,0.0,0,0,0,0,0,0,0,1,0,0,1,1
8277,112347,AOKKHTTFDt3cG76lqD8M5js5DVaXEufq,5Gyp41oLVo7Gg7vF4vpmggWP5MU70QO6,4,2,1,0,0,4,4,0,11,1.5714285714285714,1,0.0,0,1,0,0,2,4,0,4,0,1,10,1
8278,112380,MpSNV24HikKcci8LVDCzB6LlDUQPkZS7,5Gyp41oLVo7Gg7vF4vpmggWP5MU70QO6,6,5,3,0,0,0,3,0,11,1.5714285714285714,1,0.0,0,3,0,0,5,0,0,3,0,3,8,1
8279,112382,azxaSvsDmT4A6SNOsI1Fhg8dajvIGqlD,5Gyp41oLVo7Gg7vF4vpmggWP5MU70QO6,13,13,9,2,4,0,5,0,33,4.714285714285714,4,0.0,0,9,1,4,13,0,1,5,0,14,19,1
8280,112414,gvbilxxJzio6bU0Dq93ZcoCjsIZMrKzu,5Gyp41oLVo7Gg7vF4vpmggWP5MU70QO6,10,9,4,2,2,1,2,0,20,2.857142857142857,1,0.0,3,4,1,2,6,1,1,2,0,10,10,1
8281,112458,GJLKw6tfNJPMqBJIRYwRi9vEhQle2nLj,5Gyp41oLVo7Gg7vF4vpmggWP5MU70QO6,12,12,8,0,5,2,17,2,46,6.571428571428571,3,0.0,1,8,0,5,11,2,0,17,2,14,32,1
8282,112508,TUwVrd2hmfW6VyLzKbv0bNRWMKGDOGOV,5Gyp41oLVo7Gg7vF4vpmggWP5MU70QO6,14,79,30,4,2,0,34,0,149,21.285714285714285,13,0.0,5,30,2,2,74,0,2,34,0,39,110,0
8283,112536,3qTlPtBsk5txTgIAC0TiKjYYcFuLtWKe,5Gyp41oLVo7Gg7vF4vpmggWP5MU70QO6,12,18,7,2,2,0,3,0,32,4.571428571428571,2,0.0,2,7,1,2,16,0,1,3,0,12,20,1
8284,112546,UnBwSmlOPbYUmVq2fUKodPbT52jzjDn0,5Gyp41oLVo7Gg7vF4vpmggWP5MU70QO6,15,32,21,8,12,0,10,0,83,11.857142857142858,5,0.0,6,21,5,12,26,0,3,10,0,44,39,0
8285,112557,59KrgCJlOEHQHzBNjsHoSd6BkQVArDrc,5Gyp41oLVo7Gg7vF4vpmggWP5MU70QO6,6,5,1,0,1,0,2,0,9,1.2857142857142858,1,0.0,0,1,0,1,5,0,0,2,0,2,7,1
8286,112571,AbYBYWZBb1Rg8bMbPOYcN6TCnE8uQX0y,5Gyp41oLVo7Gg7vF4vpmggWP5MU70QO6,7,7,3,0,2,0,2,0,14,2.0,1,0.0,0,3,0,2,7,0,0,2,0,5,9,1
8287,112572,u3SPm1HFwlhJpJKaAvQIjwvJr5QcuOph,5Gyp41oLVo7Gg7vF4vpmggWP5MU70QO6,1,0,0,0,0,0,1,0,1,0.14285714285714285,1,0.0,0,0,0,0,0,0,0,1,0,0,1,1
8288,112577,ycgZ98qvYlJIVifUUXet21FpEE8fnXg5,5Gyp41oLVo7Gg7vF4vpmggWP5MU70QO6,9,10,4,0,2,0,16,0,32,4.571428571428571,2,0.0,0,4,0,2,10,0,0,16,0,6,26,1
8289,112606,KnZXEOdCUZ4HTOZmg6haJiVPAqpJWDbk,5Gyp41oLVo7Gg7vF4vpmggWP5MU70QO6,5,2,1,0,1,0,2,0,6,0.8571428571428571,1,0.0,0,1,0,1,2,0,0,2,0,2,4,1
8290,112613,1Y5Tu6sRC67MVvT6PQzUkrnGn5Ec34mK,5Gyp41oLVo7Gg7vF4vpmggWP5MU70QO6,17,32,15,2,8,24,12,0,93,13.285714285714286,5,0.0,7,15,1,8,25,24,1,12,0,31,62,0
8291,112620,WDppciaQaSX4rO2Po407OBe8xDSe4iCL,5Gyp41oLVo7Gg7vF4vpmggWP5MU70QO6,19,46,25,20,11,0,4,0,106,15.142857142857142,3,0.0,14,25,11,11,32,0,9,4,0,61,45,1
8292,112631,78H6quizWzTs7OxtmaQJ1vJz0xUti4uS,5Gyp41oLVo7Gg7vF4vpmggWP5MU70QO6,2,0,0,0,0,0,2,0,2,0.2857142857142857,1,0.0,0,0,0,0,0,0,0,2,0,0,2,1
8293,112634,uqXaJBjlB2fR1jGFPXdDLi7hSsdUaco6,5Gyp41oLVo7Gg7vF4vpmggWP5MU70QO6,9,5,3,0,2,4,7,1,22,3.142857142857143,1,0.0,0,3,0,2,5,4,0,7,1,5,17,0
8294,112638,oxOn4BZLLdvCRFIc1Ac5np9t8DXUQ5bE,5Gyp41oLVo7Gg7vF4vpmggWP5MU70QO6,25,38,26,13,19,23,8,2,129,18.428571428571427,7,0.0,10,26,10,19,28,23,3,8,2,65,64,1
8295,112644,RdOTPiN7khNeleO1Yo3Wax3dSMd9rcAA,5Gyp41oLVo7Gg7vF4vpmggWP5MU70QO6,5,2,1,0,1,0,2,0,6,0.8571428571428571,1,0.0,0,1,0,1,2,0,0,2,0,2,4,1
8296,112666,iyh1hSFiFvKLuqtG3iw5CBCRHjFynFH1,5Gyp41oLVo7Gg7vF4vpmggWP5MU70QO6,6,3,1,0,1,0,2,0,7,1.0,1,0.0,0,1,0,1,3,0,0,2,0,2,5,1
8297,112686,HBbfTF7IDrJPTIg3LtdtLpoFRQM4pUsW,5Gyp41oLVo7Gg7vF4vpmggWP5MU70QO6,18,22,11,4,5,0,4,0,46,6.571428571428571,1,0.0,6,11,2,5,16,0,2,4,0,24,22,1
8298,112702,5AZvkrXdjv7Dh9hOSSXBk98ktGISqlYy,5Gyp41oLVo7Gg7vF4vpmggWP5MU70QO6,28,88,52,35,15,66,10,1,267,38.142857142857146,7,0.0,21,52,24,15,67,66,11,10,1,112,155,1
8299,112740,draxLlMrAsTi83twWbn61IUhSde1kOLx,5Gyp41oLVo7Gg7vF4vpmggWP5MU70QO6,6,2,2,0,1,0,5,0,10,1.4285714285714286,1,0.0,0,2,0,1,2,0,0,5,0,3,7,1
8300,112745,Ux0tez3CsVGjSwIIoA3MCOtaqdDdHQZ5,5Gyp41oLVo7Gg7vF4vpmggWP5MU70QO6,6,3,2,0,2,0,1,0,8,1.1428571428571428,1,0.0,0,2,0,2,3,0,0,1,0,4,4,1
8301,112746,h9inoGjnAUSg7BVY5rswRJ2sMSxAeY3N,5Gyp41oLVo7Gg7vF4vpmggWP5MU70QO6,6,3,2,0,1,0,2,0,8,1.1428571428571428,1,0.0,1,2,0,1,2,0,0,2,0,4,4,1
8302,112752,DfqU2HhaUqxdDt3bmcLzGFwFca0Bl6XL,5Gyp41oLVo7Gg7vF4vpmggWP5MU70QO6,8,8,4,0,0,1,6,1,20,2.857142857142857,2,0.0,2,4,0,0,6,1,0,6,1,6,14,1
8303,112771,I6X17ieof2IwIzaSbSDCN7B2bWXgcxJJ,5Gyp41oLVo7Gg7vF4vpmggWP5MU70QO6,6,2,1,0,1,0,4,0,8,1.1428571428571428,1,0.0,0,1,0,1,2,0,0,4,0,2,6,1
8304,112772,C7lNu4ULRhNvP0ezS2pr2jPc61wQ63IS,5Gyp41oLVo7Gg7vF4vpmggWP5MU70QO6,13,33,8,22,1,4,5,0,73,10.428571428571429,4,0.0,10,8,12,1,23,4,10,5,0,31,42,1
8305,112776,O0PH77enO9wX8k8hSC8xBawp8RimvZAe,5Gyp41oLVo7Gg7vF4vpmggWP5MU70QO6,7,4,1,0,3,0,3,0,11,1.5714285714285714,1,0.0,2,1,0,3,2,0,0,3,0,6,5,1
8306,112795,xPk7hfp3dMT8dxmNb6qTwC6VC8rmmQZe,5Gyp41oLVo7Gg7vF4vpmggWP5MU70QO6,15,13,9,0,6,0,2,0,30,4.285714285714286,1,0.0,0,9,0,6,13,0,0,2,0,15,15,1
8307,112842,ud8Y2EsnBupML3rKElwJORvnGy1H8SMp,5Gyp41oLVo7Gg7vF4vpmggWP5MU70QO6,13,17,8,16,3,3,7,1,55,7.857142857142857,4,0.0,3,8,12,3,14,3,4,7,1,26,29,1
8308,112864,o9yxG8Em98EZmBRbh1vFPl35WJ9Ht8S0,5Gyp41oLVo7Gg7vF4vpmggWP5MU70QO6,11,7,3,6,2,0,3,4,25,3.5714285714285716,1,0.0,3,3,3,2,4,0,3,3,4,11,14,1
8309,112880,yBSrnVhS1DeBYwGR5nHsoDkoqPgdpPDL,5Gyp41oLVo7Gg7vF4vpmggWP5MU70QO6,1,0,0,0,0,0,1,0,1,0.14285714285714285,1,0.0,0,0,0,0,0,0,0,1,0,0,1,1
8310,112938,u82lBhpDxJIwlZISEntCxj1zgVFdW0vT,5Gyp41oLVo7Gg7vF4vpmggWP5MU70QO6,1,0,0,0,0,0,2,0,2,0.2857142857142857,2,0.0,0,0,0,0,0,0,0,2,0,0,2,1
8311,112973,z5Xd8FxyLpXnR1XrLiNvHInD8fa31hZG,5Gyp41oLVo7Gg7vF4vpmggWP5MU70QO6,5,2,1,0,1,0,3,0,7,1.0,2,0.0,0,1,0,1,2,0,0,3,0,2,5,1
8312,113000,jNRA434lMAMZjPiQhPmaP5pXlW3ni5X9,5Gyp41oLVo7Gg7vF4vpmggWP5MU70QO6,6,9,2,2,0,0,2,0,15,2.142857142857143,3,0.0,1,2,1,0,8,0,1,2,0,4,11,1
8313,113005,suOeipVROVXXPGj0VZHJUUTxQ7mEMHZk,5Gyp41oLVo7Gg7vF4vpmggWP5MU70QO6,27,77,37,28,11,30,23,1,207,29.571428571428573,7,0.0,19,37,22,11,58,30,6,23,1,89,118,1
8314,113009,ZWLFs9GKrNhPN0D68ADGyrQdN3kTRIXt,5Gyp41oLVo7Gg7vF4vpmggWP5MU70QO6,36,111,58,24,21,27,19,2,262,37.42857142857143,7,0.0,35,58,18,21,76,27,6,19,2,132,130,1
8315,113021,szmVnhPypUPoSdN8Z8D02a6M8Gjrnwmf,5Gyp41oLVo7Gg7vF4vpmggWP5MU70QO6,30,63,31,14,17,0,22,3,150,21.428571428571427,4,0.0,19,31,7,17,44,0,7,22,3,74,76,1
8316,113036,uzKo5XybDLGWG8pNxiIda7r0TfSQ9SeA,5Gyp41oLVo7Gg7vF4vpmggWP5MU70QO6,23,72,31,8,11,0,16,0,138,19.714285714285715,8,0.0,26,31,5,11,46,0,3,16,0,73,65,1
8317,113055,4INqxCEsluwmbqvTup8Ug7EagwC5F45P,5Gyp41oLVo7Gg7vF4vpmggWP5MU70QO6,1,0,0,0,0,0,1,0,1,0.14285714285714285,1,0.0,0,0,0,0,0,0,0,1,0,0,1,1
8318,113072,Bv9FSXvHlE6wLC4E4yrAKqe3BQhrrtfx,5Gyp41oLVo7Gg7vF4vpmggWP5MU70QO6,29,84,47,13,20,24,22,1,211,30.142857142857142,10,0.0,21,47,8,20,63,24,5,22,1,96,115,1
8319,113094,zWyTWw9gp1aZ16WI7RPlDJzhTqGyXOcs,5Gyp41oLVo7Gg7vF4vpmggWP5MU70QO6,1,0,0,0,0,0,1,0,1,0.14285714285714285,1,0.0,0,0,0,0,0,0,0,1,0,0,1,1
8320,113104,FoiV6QUkVyZ8Sum7ovbYTbVuBO8X2ug8,5Gyp41oLVo7Gg7vF4vpmggWP5MU70QO6,19,50,22,10,11,0,14,0,107,15.285714285714286,4,0.0,8,22,5,11,42,0,5,14,0,46,61,0
8321,113191,Yr8wrZqxEJ6OVVfg3BfRt9Ybql4kj7Nn,5Gyp41oLVo7Gg7vF4vpmggWP5MU70QO6,5,3,2,0,0,0,2,0,7,1.0,1,0.0,0,2,0,0,3,0,0,2,0,2,5,1
8322,113200,kdvuBg0k4a0KCHoHiVrFpxzbEWbfFWlX,5Gyp41oLVo7Gg7vF4vpmggWP5MU70QO6,8,9,0,0,0,1,6,1,17,2.4285714285714284,1,0.0,1,0,0,0,8,1,0,6,1,1,16,1
8323,113202,nHLKdpZRS4alloVobYuoUtG1Y3j42RbN,5Gyp41oLVo7Gg7vF4vpmggWP5MU70QO6,8,3,2,0,2,0,3,0,10,1.4285714285714286,1,0.0,0,2,0,2,3,0,0,3,0,4,6,1
8324,113224,YnryKMU5NBkS3Ubsyb9gjAcDZ6iJfgwC,7GRhBDsirIGkRZBtSMEzNTyDr2JQm4xx,6,4,1,0,1,0,3,0,9,1.2857142857142858,2,0.0,1,1,0,1,3,0,0,3,0,3,6,1
8325,113246,W1essmAPC2jEQUEeOrORPOOmMSTDsByt,7GRhBDsirIGkRZBtSMEzNTyDr2JQm4xx,1,0,0,0,0,0,1,0,1,0.14285714285714285,1,0.0,0,0,0,0,0,0,0,1,0,0,1,1
8326,113257,tYXSIW41vEc1ilow8iQ6smCJvAodHkNV,7GRhBDsirIGkRZBtSMEzNTyDr2JQm4xx,3,2,0,0,0,0,2,0,4,0.5714285714285714,1,0.0,0,0,0,0,2,0,0,2,0,0,4,1
8327,113264,LVleI3qgj2oma5ID0p9Vm9qRM8p2ETLg,7GRhBDsirIGkRZBtSMEzNTyDr2JQm4xx,4,3,0,0,0,0,9,0,12,1.7142857142857142,2,0.0,0,0,0,0,3,0,0,9,0,0,12,1
8328,113276,eswvbpHhxCUZC3kUIoEHkNpn6ukXHFpo,7GRhBDsirIGkRZBtSMEzNTyDr2JQm4xx,14,15,6,10,5,0,7,0,43,6.142857142857143,3,0.0,6,6,7,5,9,0,3,7,0,24,19,0
8329,113365,m6EzzQ2Z50XD1FEkDIvr4FKtcZ3nQg48,3VkHkmOtom3jM2wCu94xgzzu1d6Dn7or,6,6,3,0,3,0,1,0,13,1.8571428571428572,1,0.0,0,3,0,3,6,0,0,1,0,6,7,1
8330,113379,CNgm4SAYt7ZcKmIbqzOE4huFdWyuHrBB,3VkHkmOtom3jM2wCu94xgzzu1d6Dn7or,6,7,1,0,1,0,4,0,13,1.8571428571428572,1,0.0,1,1,0,1,6,0,0,4,0,3,10,1
8331,113394,zYTtXhMaGZihyCwsnkPXNLHJNoCwrxEn,3VkHkmOtom3jM2wCu94xgzzu1d6Dn7or,5,4,1,0,1,2,3,0,11,1.5714285714285714,1,0.0,0,1,0,1,4,2,0,3,0,2,9,1
8332,113423,Z8jGpFPgxfYdQ45E2JmscYA650Gt6KRw,3VkHkmOtom3jM2wCu94xgzzu1d6Dn7or,2,0,0,0,0,0,2,0,2,0.2857142857142857,1,0.0,0,0,0,0,0,0,0,2,0,0,2,1
8333,113447,LgRwWVU7f3Uyf9tKge7xmIu4EdMB1jMm,3VkHkmOtom3jM2wCu94xgzzu1d6Dn7or,1,0,0,0,0,0,1,0,1,0.14285714285714285,1,0.0,0,0,0,0,0,0,0,1,0,0,1,1
8334,113499,weW7WCl1PLzcG7QeTcF7nAYRZFxpbb6T,3VkHkmOtom3jM2wCu94xgzzu1d6Dn7or,6,7,3,0,1,0,3,0,14,2.0,1,0.0,0,3,0,1,7,0,0,3,0,4,10,1
8335,113507,xhevg6JjK2rrYOm315OyMAnP1ijNPsHG,3VkHkmOtom3jM2wCu94xgzzu1d6Dn7or,7,3,2,0,2,0,3,0,10,1.4285714285714286,1,0.0,0,2,0,2,3,0,0,3,0,4,6,1
8336,113520,Orqz1MI6CD3UYQA2x7AoJrrzdXuNjXgT,3VkHkmOtom3jM2wCu94xgzzu1d6Dn7or,1,0,0,0,0,0,1,0,1,0.14285714285714285,1,0.0,0,0,0,0,0,0,0,1,0,0,1,1
8337,113678,ZobeGMKyIBgjnUNms43CrtMrVHf6iI1r,3VkHkmOtom3jM2wCu94xgzzu1d6Dn7or,64,114,47,50,46,0,24,5,286,40.857142857142854,5,0.0,32,47,46,46,82,0,4,24,5,171,115,0
8338,113723,fbJQhb9qJhxn4GPcwi4AErVjPsHJbyL7,3VkHkmOtom3jM2wCu94xgzzu1d6Dn7or,41,151,36,17,27,32,48,2,313,44.714285714285715,7,0.0,51,36,15,27,100,32,2,48,2,129,184,0
8339,113735,mBfdJcOP5Q4qScmvhx97yK7EXBtKqSR0,3VkHkmOtom3jM2wCu94xgzzu1d6Dn7or,4,3,0,0,0,0,4,0,7,1.0,1,0.0,0,0,0,0,3,0,0,4,0,0,7,0
8340,113761,IJTTEfs2CTbrV7pMtnuHrqGN5D8K4cmY,3VkHkmOtom3jM2wCu94xgzzu1d6Dn7or,3,3,0,0,0,0,1,0,4,0.5714285714285714,1,0.0,0,0,0,0,3,0,0,1,0,0,4,1
8341,113831,UqksMVZ1lLvn2u7s6dT9SU5OFeNJnaAy,5X6FeZozNMgE2VRi3MJYjkkFK8SETtu2,5,0,0,0,0,0,4,1,5,0.7142857142857143,2,0.0,0,0,0,0,0,0,0,4,1,0,5,0
8342,113891,9d8tCYKPfh5NHPKNlwRKmrZh3Cuf1Ls2,7GRhBDsirIGkRZBtSMEzNTyDr2JQm4xx,32,101,40,4,14,0,19,0,178,25.428571428571427,8,0.0,12,40,4,14,89,0,0,19,0,70,108,0
8343,113892,YvqXtgBNC43WLi1Y1OHrc4YV5wJZj5BZ,7GRhBDsirIGkRZBtSMEzNTyDr2JQm4xx,36,105,2,59,10,0,4,0,180,25.714285714285715,1,0.0,20,2,50,10,85,0,9,4,0,82,98,1
8344,113895,YnqMJ9ZetFUbaqSHD6gLHyJT0CEwFNIZ,5X6FeZozNMgE2VRi3MJYjkkFK8SETtu2,62,135,36,61,37,3,31,0,303,43.285714285714285,8,0.0,73,36,53,37,62,3,8,31,0,199,104,1
8345,113921,cQJEH4N9NA86ElT2x4zkE6ToN6rVT4MQ,7GRhBDsirIGkRZBtSMEzNTyDr2JQm4xx,35,45,18,40,14,2,8,0,127,18.142857142857142,3,0.0,21,18,34,14,24,2,6,8,0,87,40,1
8346,113977,AnqzEiR7s4CfuKEZI3xmlDjhp0SJ9rWN,7GRhBDsirIGkRZBtSMEzNTyDr2JQm4xx,39,88,32,65,21,53,15,1,275,39.285714285714285,2,0.0,22,32,54,21,66,53,11,15,1,129,146,0
8347,113978,pi6uVUUcWdM15szjsg09SfyhPrGkMugT,7GRhBDsirIGkRZBtSMEzNTyDr2JQm4xx,7,5,1,0,0,0,5,0,11,1.5714285714285714,2,0.0,0,1,0,0,5,0,0,5,0,1,10,1
8348,113991,z7I1QeH8tOlWf6s0Xi8QGEEG8QaCPAno,7GRhBDsirIGkRZBtSMEzNTyDr2JQm4xx,66,127,44,97,24,74,29,9,404,57.714285714285715,7,0.0,73,44,88,24,54,74,9,29,9,229,175,1
8349,114015,DQbRxk8ac6yWVBibRdJM3Qxn0d1XOiuE,5X6FeZozNMgE2VRi3MJYjkkFK8SETtu2,6,3,1,0,2,0,4,0,10,1.4285714285714286,1,0.0,1,1,0,2,2,0,0,4,0,4,6,1
8350,114084,HolfiiRMNIE2y1ufEDM4W3kjJIHyUraM,7GRhBDsirIGkRZBtSMEzNTyDr2JQm4xx,1,0,0,0,0,0,1,0,1,0.14285714285714285,1,0.0,0,0,0,0,0,0,0,1,0,0,1,1
8351,114122,4Pd3e254V1ylErxapJL6FJZ2vSaLD95s,7GRhBDsirIGkRZBtSMEzNTyDr2JQm4xx,56,203,9,77,17,43,31,3,383,54.714285714285715,10,0.0,64,9,71,17,139,43,6,31,3,161,222,0
8352,114180,TQ8OFVc2xBKvPKyjEssWVNNgqzlZ0PAa,5X6FeZozNMgE2VRi3MJYjkkFK8SETtu2,26,77,26,80,37,7,12,0,239,34.142857142857146,10,0.0,36,26,67,37,41,7,13,12,0,166,73,1
8353,114193,w43NdaSTOQbbSDTdI0RJiLpdaaUTMsHa,7GRhBDsirIGkRZBtSMEzNTyDr2JQm4xx,1,0,0,0,0,0,1,0,1,0.14285714285714285,1,0.0,0,0,0,0,0,0,0,1,0,0,1,1
8354,114269,0x0DTAti5ubTkiTCaiKBYXVEL4Zs1kyR,5X6FeZozNMgE2VRi3MJYjkkFK8SETtu2,1,0,0,0,0,0,1,0,1,0.14285714285714285,1,0.0,0,0,0,0,0,0,0,1,0,0,1,1
8355,114295,54WqxClItaVjByzUIcBLUNfuvPRBRhiZ,5X6FeZozNMgE2VRi3MJYjkkFK8SETtu2,53,69,16,86,30,0,4,0,205,29.285714285714285,3,0.0,50,16,75,30,19,0,11,4,0,171,34,1
8356,114299,uuzc81RWrrz7iGcyTE1vS0JQYD0lJgbY,7GRhBDsirIGkRZBtSMEzNTyDr2JQm4xx,26,66,2,44,3,11,12,1,139,19.857142857142858,3,0.0,45,2,37,3,21,11,7,12,1,87,52,1
8357,114354,nwFT4lnmg30fCvHRB6tbALo9FpcanuLx,5X6FeZozNMgE2VRi3MJYjkkFK8SETtu2,19,74,16,20,25,2,15,0,152,21.714285714285715,6,0.0,35,16,16,25,39,2,4,15,0,92,60,1
8358,114378,kwtDMW6kCF4Dj4cVANDmT2RtqpyiMQZT,5X6FeZozNMgE2VRi3MJYjkkFK8SETtu2,22,83,8,29,21,1,17,16,175,25.0,7,0.0,41,8,26,21,42,1,3,17,16,96,79,1
8359,114393,P1HSpor3v4n3f5MCbT8ojUVfn1um6uI3,5X6FeZozNMgE2VRi3MJYjkkFK8SETtu2,9,7,1,0,1,5,8,1,23,3.2857142857142856,1,0.0,0,1,0,1,7,5,0,8,1,2,21,1
8360,114411,2jRIZMWHA5rH4ew2UCv2iZrYBWoFczyG,7GRhBDsirIGkRZBtSMEzNTyDr2JQm4xx,33,47,2,36,6,1,8,0,100,14.285714285714286,5,0.0,19,2,26,6,28,1,10,8,0,53,47,0
8361,114488,czTQ5ELSy91Dy79vk5MgxZdL9nunJtpb,5X6FeZozNMgE2VRi3MJYjkkFK8SETtu2,4,3,1,0,0,0,2,0,6,0.8571428571428571,1,0.0,0,1,0,0,3,0,0,2,0,1,5,1
8362,114496,rqwp0DRxlrzViX8K4jHTHKpfYZPPmBwb,7GRhBDsirIGkRZBtSMEzNTyDr2JQm4xx,1,0,0,0,0,0,1,0,1,0.14285714285714285,1,0.0,0,0,0,0,0,0,0,1,0,0,1,1
8363,114497,3RcsrMTbPrb8ZHYXLlgwoRK7zrqTGSuq,7GRhBDsirIGkRZBtSMEzNTyDr2JQm4xx,11,19,6,0,0,7,4,0,36,5.142857142857143,1,0.0,8,6,0,0,11,7,0,4,0,14,22,1
8364,114543,aEgt3dXm9v9Y3bAdN5dHXVwqStuJSLzy,7GRhBDsirIGkRZBtSMEzNTyDr2JQm4xx,1,0,0,0,0,0,1,0,1,0.14285714285714285,1,0.0,0,0,0,0,0,0,0,1,0,0,1,1
8365,114559,KkSinTdG2PbGrJIRATMZos8HES46UawO,7GRhBDsirIGkRZBtSMEzNTyDr2JQm4xx,34,111,32,10,21,0,15,0,189,27.0,11,0.0,36,32,10,21,75,0,0,15,0,99,90,0
8366,114568,39kDK9y6rUMxkyJQwaOrfTRJDkq1CpVh,7GRhBDsirIGkRZBtSMEzNTyDr2JQm4xx,4,2,0,0,1,0,2,0,5,0.7142857142857143,2,0.0,0,0,0,1,2,0,0,2,0,1,4,1
8367,114615,dADOrE6FAWkIPcnZuLBj5KGmzjdxSunH,fbPkOYLVPtPgIt0MxizjfFJov3JbHyAi,58,139,73,67,49,46,15,1,390,55.714285714285715,14,0.0,49,73,63,49,90,46,4,15,1,234,156,0
8368,114616,VXYzZfu6ih0keHE9HAJ1SdpDOLcLAbwC,fbPkOYLVPtPgIt0MxizjfFJov3JbHyAi,2,0,0,0,0,0,2,0,2,0.2857142857142857,1,0.0,0,0,0,0,0,0,0,2,0,0,2,1
8369,114618,WRvlgY7ph3Ny0jrRnDAZFFFRQZCnVuX6,fbPkOYLVPtPgIt0MxizjfFJov3JbHyAi,1,0,0,0,0,0,1,0,1,0.14285714285714285,1,0.0,0,0,0,0,0,0,0,1,0,0,1,1
8370,114620,6T8cBNKGNp544PxJriaeroN36khQqLPz,fbPkOYLVPtPgIt0MxizjfFJov3JbHyAi,9,11,7,0,2,15,11,0,46,6.571428571428571,4,0.0,0,7,0,2,11,15,0,11,0,9,37,1
8371,114628,O7KWuxai8l3iLaIsn7RnwycnICMA6q02,fbPkOYLVPtPgIt0MxizjfFJov3JbHyAi,10,7,5,0,4,0,4,0,20,2.857142857142857,1,0.0,0,5,0,4,7,0,0,4,0,9,11,1
8372,114630,7oMr9QCj97jPuJtMryw8HLKHPiNBVkWQ,fbPkOYLVPtPgIt0MxizjfFJov3JbHyAi,2,0,0,0,0,0,2,0,2,0.2857142857142857,1,0.0,0,0,0,0,0,0,0,2,0,0,2,1
8373,114631,317mJtMaUHETA3BjLJPMWdxWMX2D2sbB,fbPkOYLVPtPgIt0MxizjfFJov3JbHyAi,5,3,2,0,2,0,2,0,9,1.2857142857142858,1,0.0,0,2,0,2,3,0,0,2,0,4,5,1
8374,114632,feP8lvUh5Uqyd3T78g3lJHRfKMRKGTdu,fbPkOYLVPtPgIt0MxizjfFJov3JbHyAi,1,0,0,0,0,0,1,0,1,0.14285714285714285,1,0.0,0,0,0,0,0,0,0,1,0,0,1,1
8375,114636,5bxFzsGB3g2DhCNnlfoVA3bbijRi2jwN,fbPkOYLVPtPgIt0MxizjfFJov3JbHyAi,1,0,0,0,0,0,1,0,1,0.14285714285714285,1,0.0,0,0,0,0,0,0,0,1,0,0,1,1
8376,114641,dYC6Q6IXtOHRHCawBvKivQeuFVOWFZ5M,fbPkOYLVPtPgIt0MxizjfFJov3JbHyAi,1,0,0,0,0,0,1,0,1,0.14285714285714285,1,0.0,0,0,0,0,0,0,0,1,0,0,1,1
8377,114644,AtNMPzFEYACRMN0iwn9jbY3jXKyaOANn,fbPkOYLVPtPgIt0MxizjfFJov3JbHyAi,4,2,1,0,1,0,1,0,5,0.7142857142857143,1,0.0,0,1,0,1,2,0,0,1,0,2,3,1
8378,114646,80y9S8r32w7HjdSrNUEAoEBMUZWJtxmp,fbPkOYLVPtPgIt0MxizjfFJov3JbHyAi,1,0,0,0,0,0,1,0,1,0.14285714285714285,1,0.0,0,0,0,0,0,0,0,1,0,0,1,1
8379,114648,aqQTf2fLQrJTXefctm75awHMgV3chcLI,fbPkOYLVPtPgIt0MxizjfFJov3JbHyAi,6,4,2,0,1,4,3,0,14,2.0,2,0.0,0,2,0,1,4,4,0,3,0,3,11,1
8380,114650,A8VDs8qMXoWf6TAFhFdXwBPwA0se80p0,fbPkOYLVPtPgIt0MxizjfFJov3JbHyAi,1,0,0,0,0,0,1,0,1,0.14285714285714285,1,0.0,0,0,0,0,0,0,0,1,0,0,1,1
8381,114653,a1rKHMbdvsiqyl2QdJJHwGTEOUsJeY1Z,fbPkOYLVPtPgIt0MxizjfFJov3JbHyAi,2,1,0,0,0,0,1,0,2,0.2857142857142857,1,0.0,0,0,0,0,1,0,0,1,0,0,2,1
8382,115137,1G63i1rmcnlHIJV8rQ5ZsMc8KSeXw42F,3VkHkmOtom3jM2wCu94xgzzu1d6Dn7or,29,124,51,16,28,33,20,0,272,38.857142857142854,6,0.0,41,51,14,28,83,33,2,20,0,134,138,1
8383,115138,YmdgsFslyipuqAvTNMUf5cKIo7lT9UI2,3VkHkmOtom3jM2wCu94xgzzu1d6Dn7or,6,7,3,0,2,0,7,0,19,2.7142857142857144,3,0.0,0,3,0,2,7,0,0,7,0,5,14,1
8384,115179,hT4tvsNw0lrlCX10WGvFW9mAmG3Fy4KO,3VkHkmOtom3jM2wCu94xgzzu1d6Dn7or,98,423,133,93,116,68,97,4,934,133.42857142857142,4,0.0,214,133,85,116,209,68,8,97,4,548,386,0
8385,115180,9teXZYkWVKqsq9cOvq45UGbDxrVqLaJM,3VkHkmOtom3jM2wCu94xgzzu1d6Dn7or,61,62,49,0,35,0,7,0,153,21.857142857142858,9,0.0,0,49,0,35,62,0,0,7,0,84,69,0
8386,115191,EZXIuLhOmjJIkshWdkSFxHC0xu6JDJcs,3VkHkmOtom3jM2wCu94xgzzu1d6Dn7or,64,134,56,36,52,37,15,1,331,47.285714285714285,9,0.0,63,56,33,52,71,37,3,15,1,204,127,0
8387,115301,0IAqLIVHc4D35uepZBxo4kkDcvat0q2X,3VkHkmOtom3jM2wCu94xgzzu1d6Dn7or,4,2,1,0,1,0,2,0,6,0.8571428571428571,1,0.0,0,1,0,1,2,0,0,2,0,2,4,0
8388,115324,XWGGygjalWfSSQzM8onkLHgnl96JFwDh,3VkHkmOtom3jM2wCu94xgzzu1d6Dn7or,57,81,3,21,41,0,6,0,152,21.714285714285715,2,0.0,29,3,18,41,52,0,3,6,0,91,61,1
8389,115418,8xcJse8MxIDPfdJXCHPrDNIK3GBUm9K8,3VkHkmOtom3jM2wCu94xgzzu1d6Dn7or,41,166,41,80,1,23,5,0,316,45.142857142857146,3,0.0,111,41,77,1,55,23,3,5,0,230,86,0
8390,115431,1Km02lmAiH8fmuk2UTlG1rnEWgsc67HL,3VkHkmOtom3jM2wCu94xgzzu1d6Dn7or,80,266,55,80,98,24,73,5,601,85.85714285714286,8,0.0,186,55,70,98,80,24,10,73,5,409,192,0
8391,115438,sTZs64XdymONYItS9gEdLuGM3ZO9ZhgW,3VkHkmOtom3jM2wCu94xgzzu1d6Dn7or,1,0,0,0,0,0,1,0,1,0.14285714285714285,1,0.0,0,0,0,0,0,0,0,1,0,0,1,0
8392,115441,mSXZKJ9e3RCTXopgrFUphpxYgeKp7tlG,3VkHkmOtom3jM2wCu94xgzzu1d6Dn7or,80,282,100,58,102,113,26,2,683,97.57142857142857,16,0.0,169,100,55,102,113,113,3,26,2,426,257,0
8393,115483,XlsotxACWnN0EqQWLUCPLI9pWBNgMgk1,3VkHkmOtom3jM2wCu94xgzzu1d6Dn7or,5,2,1,0,1,0,2,0,6,0.8571428571428571,1,0.0,0,1,0,1,2,0,0,2,0,2,4,1
8394,115564,Qjlt412VdjQrw004zXTfHyzbH6lTyzfQ,3VkHkmOtom3jM2wCu94xgzzu1d6Dn7or,10,9,5,0,5,0,7,0,26,3.7142857142857144,2,0.0,2,5,0,5,7,0,0,7,0,12,14,1
8395,115576,VPiBb86kd8BKC2TOTvwUFu9fx4vzCW4b,3VkHkmOtom3jM2wCu94xgzzu1d6Dn7or,80,176,48,111,36,20,31,5,427,61.0,11,0.0,66,48,103,36,110,20,8,31,5,253,174,0
8396,115609,NRvPF6FnE2qOoEKQlwRiAGDiz3Y2mfqX,3VkHkmOtom3jM2wCu94xgzzu1d6Dn7or,1,0,0,0,0,0,1,0,1,0.14285714285714285,1,0.0,0,0,0,0,0,0,0,1,0,0,1,1
8397,115619,CwyOL3RMOVLomxrxyN9D4jPa9R0iWrS5,3VkHkmOtom3jM2wCu94xgzzu1d6Dn7or,27,36,14,18,13,4,4,0,89,12.714285714285714,4,0.0,12,14,18,13,24,4,0,4,0,57,32,1
8398,115640,FhJZaEAvbnhYhzwxfd8m2nbSjrU4ykT8,3VkHkmOtom3jM2wCu94xgzzu1d6Dn7or,3,3,0,0,0,0,2,0,5,0.7142857142857143,1,0.0,0,0,0,0,3,0,0,2,0,0,5,1
8399,115683,aNJE1B7Om5LHj59YkXIa7Cp0ZqypQHhy,3VkHkmOtom3jM2wCu94xgzzu1d6Dn7or,31,58,27,30,13,4,14,0,146,20.857142857142858,9,0.0,9,27,23,13,49,4,7,14,0,72,74,0
8400,115706,uiGnKayGz8iGWXIMLQgmlJFJNvbGDTb9,3VkHkmOtom3jM2wCu94xgzzu1d6Dn7or,12,29,5,0,6,3,17,6,66,9.428571428571429,2,0.0,8,5,0,6,21,3,0,17,6,19,47,1
8401,115721,YUpIUaEv1EetQGMxsyjuTsiOSj9Pere8,3VkHkmOtom3jM2wCu94xgzzu1d6Dn7or,23,33,10,35,12,3,1,0,94,13.428571428571429,2,0.0,14,10,32,12,19,3,3,1,0,68,26,0
8402,115737,O2rUq90V5lR36PY1lXYAoUFT98vBmg1w,3VkHkmOtom3jM2wCu94xgzzu1d6Dn7or,78,208,54,53,71,48,16,1,451,64.42857142857143,11,0.0,87,54,48,71,121,48,5,16,1,260,191,0
8403,115748,Paf36JLTqfFno9Z8aWVtTee4y7179HfB,3VkHkmOtom3jM2wCu94xgzzu1d6Dn7or,26,73,32,4,22,0,7,0,138,19.714285714285715,2,0.0,3,32,3,22,70,0,1,7,0,60,78,1
8404,115779,EfhdW5rf6OZIEnzvBZeQWc7g2MskX2ds,3VkHkmOtom3jM2wCu94xgzzu1d6Dn7or,66,196,53,92,54,35,59,4,493,70.42857142857143,7,0.0,81,53,81,54,115,35,11,59,4,269,224,0
8405,115823,eV3NFjg3yWzKzkccXHxTnI0xouXOD2PQ,3VkHkmOtom3jM2wCu94xgzzu1d6Dn7or,13,20,6,6,8,4,12,1,57,8.142857142857142,1,0.0,12,6,5,8,8,4,1,12,1,31,26,1
8406,115838,VXnVR97kFloTTSU2ST7pLjCQ8tjcq63x,3VkHkmOtom3jM2wCu94xgzzu1d6Dn7or,59,99,45,28,47,23,7,0,249,35.57142857142857,9,0.0,41,45,27,47,58,23,1,7,0,160,89,0
8407,115867,BYQK3CvpfMxBRtirOERpPoB3xPzRoJk5,3VkHkmOtom3jM2wCu94xgzzu1d6Dn7or,91,201,74,61,73,65,19,0,493,70.42857142857143,5,0.0,98,74,51,73,103,65,10,19,0,296,197,0
8408,115970,eOYLxzCLLArdp3PTRMGdBtm1GUxdjDCw,3VkHkmOtom3jM2wCu94xgzzu1d6Dn7or,27,53,11,34,16,11,8,2,135,19.285714285714285,4,0.0,29,11,31,16,24,11,3,8,2,87,48,1
8409,115991,HABID5qfypKIwrRHvQPznrk9KmB4tWzT,3VkHkmOtom3jM2wCu94xgzzu1d6Dn7or,1,0,0,0,0,0,1,0,1,0.14285714285714285,1,0.0,0,0,0,0,0,0,0,1,0,0,1,1
8410,116029,T2XDhi3FWMYFAUuE0zIbikEnIxiJs2MQ,3VkHkmOtom3jM2wCu94xgzzu1d6Dn7or,4,2,0,0,0,0,3,0,5,0.7142857142857143,1,0.0,0,0,0,0,2,0,0,3,0,0,5,1
8411,116068,3dbaC3sJ9OJS1pU4dFxDkqiRGQ9yQgLt,3VkHkmOtom3jM2wCu94xgzzu1d6Dn7or,3,0,0,0,0,0,4,0,4,0.5714285714285714,1,0.0,0,0,0,0,0,0,0,4,0,0,4,1
8412,116154,bDqqR2hng29QNjexgLbMGRH4AJBfyli8,3VkHkmOtom3jM2wCu94xgzzu1d6Dn7or,19,43,20,0,9,9,12,0,93,13.285714285714286,5,0.0,2,20,0,9,41,9,0,12,0,31,62,1
8413,116193,Oa3Yn1JDw25rNnHn2BNCxgiCAj54mdbE,3VkHkmOtom3jM2wCu94xgzzu1d6Dn7or,64,369,72,106,80,17,41,2,687,98.14285714285714,11,0.0,165,72,99,80,204,17,7,41,2,416,271,0
8414,116212,iFP56GVsRn7PQgdfzS2a7d6uFo1EOk1i,3VkHkmOtom3jM2wCu94xgzzu1d6Dn7or,6,9,4,0,0,0,4,0,17,2.4285714285714284,2,0.0,0,4,0,0,9,0,0,4,0,4,13,1
8415,116215,3u2Og5WE9UAxrPpxqe06PZzIgysDZEr7,3VkHkmOtom3jM2wCu94xgzzu1d6Dn7or,5,2,1,0,1,0,3,0,7,1.0,1,0.0,0,1,0,1,2,0,0,3,0,2,5,0
8416,116272,Dv4nP0an2ZA48lmeMFn0PJPZ7mStVpc5,3VkHkmOtom3jM2wCu94xgzzu1d6Dn7or,13,156,7,6,7,6,17,0,199,28.428571428571427,3,0.0,27,7,5,7,129,6,1,17,0,46,153,1
8417,116321,mLWHIw1cHfgiEyo587m6rHem7nmVE3z4,3VkHkmOtom3jM2wCu94xgzzu1d6Dn7or,1,0,0,0,0,0,1,0,1,0.14285714285714285,1,0.0,0,0,0,0,0,0,0,1,0,0,1,1
8418,116351,4SEsrW6tKoIcrFOcEbAzlYSxkxqTdzcN,3VkHkmOtom3jM2wCu94xgzzu1d6Dn7or,2,0,0,0,0,0,2,0,2,0.2857142857142857,1,0.0,0,0,0,0,0,0,0,2,0,0,2,1
8419,116383,saxxTKR6QFum7HyMG9cYa0rXhe5D7UPC,3VkHkmOtom3jM2wCu94xgzzu1d6Dn7or,90,132,63,65,54,42,27,0,383,54.714285714285715,11,0.0,50,63,55,54,82,42,10,27,0,222,161,0
8420,116400,5sovUdBY4AsVUtXY7BWDVXxvHAPsWkZb,5Gyp41oLVo7Gg7vF4vpmggWP5MU70QO6,71,373,153,15,154,80,46,26,847,121.0,24,0.0,118,153,13,154,255,80,2,46,26,438,409,0
8421,116436,meJV5qRzmJA836PpWZKeoFo4ZX1xiQOS,5Gyp41oLVo7Gg7vF4vpmggWP5MU70QO6,8,7,5,0,2,0,2,0,16,2.2857142857142856,1,0.0,0,5,0,2,7,0,0,2,0,7,9,1
8422,116439,dR89kP4g2lR7wOxYCeRjTvTMOhrAu7It,5Gyp41oLVo7Gg7vF4vpmggWP5MU70QO6,7,4,2,0,3,0,2,0,11,1.5714285714285714,1,0.0,1,2,0,3,3,0,0,2,0,6,5,1
8423,116466,483NgTD1fHdeYX0RRzoyedDRsQpewqQG,5Gyp41oLVo7Gg7vF4vpmggWP5MU70QO6,21,32,15,0,8,0,3,0,58,8.285714285714286,2,0.0,2,15,0,8,30,0,0,3,0,25,33,1
8424,116487,bA4tnPZD0UU4XAL3OkL7nUjtkAzbgj9d,5Gyp41oLVo7Gg7vF4vpmggWP5MU70QO6,30,116,54,21,14,54,25,3,287,41.0,10,0.0,16,54,16,14,100,54,5,25,3,100,187,0
8425,116502,MLRJZ97UMA5raZKCNrieCiIqteBWSZH0,5Gyp41oLVo7Gg7vF4vpmggWP5MU70QO6,43,194,117,48,2,150,63,2,576,82.28571428571429,13,0.0,43,117,33,2,151,150,15,63,2,195,381,0
8426,116546,3CARVzZPaLSVsfLijIwBvqCibG90zhz6,5Gyp41oLVo7Gg7vF4vpmggWP5MU70QO6,8,5,3,2,2,0,2,0,14,2.0,1,0.0,1,3,1,2,4,0,1,2,0,7,7,1
8427,116550,UvYdE00Z5Ts8a6wK0WxKxxpGT2cAkrRh,5Gyp41oLVo7Gg7vF4vpmggWP5MU70QO6,25,40,16,8,8,51,14,2,139,19.857142857142858,4,0.0,8,16,4,8,32,51,4,14,2,36,103,0
8428,116624,5NDfsjI0ns1nf5WPi1FEheeMhNgCZqVH,5Gyp41oLVo7Gg7vF4vpmggWP5MU70QO6,27,73,26,25,21,16,17,1,179,25.571428571428573,8,0.0,30,26,18,21,43,16,7,17,1,95,84,1
8429,116640,Oyq7ji1m15xuxwPKjm7Gg05YiNCQEcyW,5Gyp41oLVo7Gg7vF4vpmggWP5MU70QO6,4,0,0,0,0,1,5,1,7,1.0,1,0.0,0,0,0,0,0,1,0,5,1,0,7,1
8430,116650,vQKXRGJivHAUfIMdau8F2EHQ9nob0SwQ,5Gyp41oLVo7Gg7vF4vpmggWP5MU70QO6,45,99,54,34,45,12,22,3,269,38.42857142857143,9,0.0,27,54,24,45,72,12,10,22,3,150,119,0
8431,116658,AH1MK3fQ3KuM7ZbwzZD8njF9VCSnOi9t,5Gyp41oLVo7Gg7vF4vpmggWP5MU70QO6,14,31,4,10,3,0,14,0,62,8.857142857142858,7,0.0,7,4,5,3,24,0,5,14,0,19,43,1
8432,116681,vBH0dHu4NmOj62y1ASafcuCscurKeDfE,5Gyp41oLVo7Gg7vF4vpmggWP5MU70QO6,33,80,39,39,14,75,14,0,261,37.285714285714285,5,0.0,28,39,32,14,52,75,7,14,0,113,148,1
8433,116697,Xf3PIvz3E8e2IZNJkOjmWhieMgnywNfX,5Gyp41oLVo7Gg7vF4vpmggWP5MU70QO6,25,21,16,1,12,0,3,0,53,7.571428571428571,2,0.0,1,16,1,12,20,0,0,3,0,30,23,1
8434,116708,OMEL4ay2FeLAUvBpF5PNfopRFoBTNYW8,5Gyp41oLVo7Gg7vF4vpmggWP5MU70QO6,12,22,11,4,4,0,7,0,48,6.857142857142857,6,0.0,4,11,3,4,18,0,1,7,0,22,26,1
8435,116760,hHbNJAgP7w8fISF0lwfjdp2aDNUBCyTs,5Gyp41oLVo7Gg7vF4vpmggWP5MU70QO6,2,0,0,0,0,0,2,0,2,0.2857142857142857,1,0.0,0,0,0,0,0,0,0,2,0,0,2,1
8436,116761,nmayyB5ucLchK32WlUH7RISaNWZAn8KC,5Gyp41oLVo7Gg7vF4vpmggWP5MU70QO6,1,0,0,0,0,0,1,0,1,0.14285714285714285,1,0.0,0,0,0,0,0,0,0,1,0,0,1,1
8437,116784,Pd5WM2e1UwTG0cR5DN1ccdVCJHomBlo2,5Gyp41oLVo7Gg7vF4vpmggWP5MU70QO6,34,41,29,2,16,8,16,1,113,16.142857142857142,2,0.0,2,29,1,16,39,8,1,16,1,48,65,0
8438,116795,eycoCMbNIztwvmFtziuM2ej6f7vevrZP,5Gyp41oLVo7Gg7vF4vpmggWP5MU70QO6,5,2,1,0,0,1,7,0,11,1.5714285714285714,2,0.0,1,1,0,0,1,1,0,7,0,2,9,1
8439,116834,OL27ZbeV6MemgtkLCwIDxu0rN9mfmCXH,5Gyp41oLVo7Gg7vF4vpmggWP5MU70QO6,1,0,0,0,0,0,1,0,1,0.14285714285714285,1,0.0,0,0,0,0,0,0,0,1,0,0,1,1
8440,116889,ilR9m4NYW0HKmYwgUbfrj7K8hPSHt8Dc,5Gyp41oLVo7Gg7vF4vpmggWP5MU70QO6,8,2,2,0,2,0,3,0,9,1.2857142857142858,1,0.0,0,2,0,2,2,0,0,3,0,4,5,1
8441,116933,SEGJwH5xjhu0GixnmBSSBGNuHPRYimOx,5Gyp41oLVo7Gg7vF4vpmggWP5MU70QO6,8,5,3,0,2,1,4,0,15,2.142857142857143,1,0.0,0,3,0,2,5,1,0,4,0,5,10,1
8442,116941,HABID5qfypKIwrRHvQPznrk9KmB4tWzT,5Gyp41oLVo7Gg7vF4vpmggWP5MU70QO6,10,6,3,0,2,0,5,1,17,2.4285714285714284,1,0.0,0,3,0,2,6,0,0,5,1,5,12,1
8443,116975,wTIGY3h7ssyDLNCDE3vIDjb84Wc0yl9L,5Gyp41oLVo7Gg7vF4vpmggWP5MU70QO6,19,22,11,2,8,1,6,1,51,7.285714285714286,1,0.0,9,11,1,8,13,1,1,6,1,29,22,1
8444,117002,oQx9Zi5ZyJMy0WMeLPYZjVccicVMhybt,5Gyp41oLVo7Gg7vF4vpmggWP5MU70QO6,1,0,0,0,0,0,1,0,1,0.14285714285714285,1,0.0,0,0,0,0,0,0,0,1,0,0,1,1
8445,117031,VRMac2IvvU9u3ZghC4UbOnKHM3J0I59c,5Gyp41oLVo7Gg7vF4vpmggWP5MU70QO6,6,3,2,0,2,0,1,0,8,1.1428571428571428,1,0.0,0,2,0,2,3,0,0,1,0,4,4,1
8446,117048,CWyQorKTdtJysACpC8OcqJBGDDmfcHTs,5Gyp41oLVo7Gg7vF4vpmggWP5MU70QO6,5,1,1,0,1,0,4,0,7,1.0,2,0.0,0,1,0,1,1,0,0,4,0,2,5,1
8447,117058,rfMb2j9N61xL4Y9I6C9nq7Nuc9rZsyAs,5Gyp41oLVo7Gg7vF4vpmggWP5MU70QO6,1,0,0,0,0,0,1,0,1,0.14285714285714285,1,0.0,0,0,0,0,0,0,0,1,0,0,1,1
8448,117078,sZ57TkysruoepeISYxmD5U3y7MWrY3Ss,5Gyp41oLVo7Gg7vF4vpmggWP5MU70QO6,6,1,1,0,1,1,4,0,8,1.1428571428571428,1,0.0,0,1,0,1,1,1,0,4,0,2,6,1
8449,117091,mXfwwTIVjHMqoVKAh2iEQbinKUCJHwTp,5Gyp41oLVo7Gg7vF4vpmggWP5MU70QO6,1,0,0,0,0,0,1,0,1,0.14285714285714285,1,0.0,0,0,0,0,0,0,0,1,0,0,1,1
8450,117111,ZKnlTaI7EAEevi7EMFgsiNYoZ62ldh8s,5Gyp41oLVo7Gg7vF4vpmggWP5MU70QO6,1,0,0,0,0,0,1,0,1,0.14285714285714285,1,0.0,0,0,0,0,0,0,0,1,0,0,1,1
8451,117130,SqXBoMVuJsxifEXIMI5YCscwwBFsTdU6,5Gyp41oLVo7Gg7vF4vpmggWP5MU70QO6,13,18,10,0,7,18,10,1,64,9.142857142857142,2,0.0,3,10,0,7,15,18,0,10,1,20,44,0
8452,117171,OaWKTG9fuUF2LaWt7IOwHUelI2GpkfJy,5Gyp41oLVo7Gg7vF4vpmggWP5MU70QO6,8,3,2,0,2,0,3,0,10,1.4285714285714286,1,0.0,0,2,0,2,3,0,0,3,0,4,6,1
8453,117190,8ZhJb3ZljNgrst8iUlAX82OG7V6bYnBq,5Gyp41oLVo7Gg7vF4vpmggWP5MU70QO6,9,10,6,0,3,0,3,0,22,3.142857142857143,2,0.0,0,6,0,3,10,0,0,3,0,9,13,1
8454,117195,BPLTF2By1jayxHugVACT0ruRLIH96sul,5Gyp41oLVo7Gg7vF4vpmggWP5MU70QO6,8,15,8,0,2,0,7,0,32,4.571428571428571,7,0.0,0,8,0,2,15,0,0,7,0,10,22,1
8455,117223,rxiyxsAAzCJUopsa649NtjV0kC762juL,5Gyp41oLVo7Gg7vF4vpmggWP5MU70QO6,15,16,7,4,2,11,8,1,49,7.0,2,0.0,7,7,2,2,9,11,2,8,1,18,31,1
8456,117235,u8Y97sSr2xWs294k9cdsB9u79pU8RMWs,5Gyp41oLVo7Gg7vF4vpmggWP5MU70QO6,1,0,0,0,0,0,1,0,1,0.14285714285714285,1,0.0,0,0,0,0,0,0,0,1,0,0,1,1
8457,117237,bzlTCtIUcO5BfACSIQwT3PRYSdK0QGTr,5Gyp41oLVo7Gg7vF4vpmggWP5MU70QO6,44,54,21,26,19,8,22,6,156,22.285714285714285,6,0.0,20,21,18,19,34,8,8,22,6,78,78,0
8458,117251,sk2v7bNpQgoO2yTSiMdsEtRjibjjXdbF,5Gyp41oLVo7Gg7vF4vpmggWP5MU70QO6,5,2,1,0,1,0,2,0,6,0.8571428571428571,1,0.0,0,1,0,1,2,0,0,2,0,2,4,1
8459,117252,DmtYVZArE2EvS9aiKUqKSMgZGIBgO1QS,5Gyp41oLVo7Gg7vF4vpmggWP5MU70QO6,23,27,13,8,8,1,8,1,66,9.428571428571429,3,0.0,6,13,4,8,21,1,4,8,1,31,35,0
8460,117287,ubm3uzS9QRP12uex4omSne4jYySpi1vE,5Gyp41oLVo7Gg7vF4vpmggWP5MU70QO6,6,3,1,0,1,0,5,0,10,1.4285714285714286,1,0.0,0,1,0,1,3,0,0,5,0,2,8,1
8461,117323,aNJE1B7Om5LHj59YkXIa7Cp0ZqypQHhy,5Gyp41oLVo7Gg7vF4vpmggWP5MU70QO6,9,9,5,0,3,0,7,0,24,3.4285714285714284,2,0.0,1,5,0,3,8,0,0,7,0,9,15,1
8462,117327,5dwhOYeq6DRSGIBZohMlMunxrKsjka7v,5Gyp41oLVo7Gg7vF4vpmggWP5MU70QO6,2,0,0,0,0,0,2,0,2,0.2857142857142857,1,0.0,0,0,0,0,0,0,0,2,0,0,2,1
8463,117367,z9oiQyplHlMmhFVKenfY0OjMOlRO24Ty,fbPkOYLVPtPgIt0MxizjfFJov3JbHyAi,6,6,2,0,2,0,1,0,11,1.5714285714285714,1,0.0,0,2,0,2,6,0,0,1,0,4,7,1
8464,117368,6AwbnbZTB5s1lrnTdEnSshjUPytTPXpI,fbPkOYLVPtPgIt0MxizjfFJov3JbHyAi,1,0,0,0,0,0,1,0,1,0.14285714285714285,1,0.0,0,0,0,0,0,0,0,1,0,0,1,1
8465,117370,3JEt0I9b0JhZhM0RD2D5jI5S8zjjeHFo,fbPkOYLVPtPgIt0MxizjfFJov3JbHyAi,9,12,7,0,4,3,7,0,33,4.714285714285714,4,0.0,1,7,0,4,11,3,0,7,0,12,21,0
8466,117377,ED2RRaLgnPevoSmZx4Qg8rLBDplQ4qIA,fbPkOYLVPtPgIt0MxizjfFJov3JbHyAi,5,2,1,0,1,0,2,0,6,0.8571428571428571,1,0.0,0,1,0,1,2,0,0,2,0,2,4,1
8467,117379,h77jUHQjzYddHbYwLAoFxVw2uSIfwhBs,fbPkOYLVPtPgIt0MxizjfFJov3JbHyAi,4,2,0,0,0,1,6,0,9,1.2857142857142858,1,0.0,0,0,0,0,2,1,0,6,0,0,9,1
8468,117380,RArjmmV02rd6h9pGPjgt5onR6MwVvvt1,fbPkOYLVPtPgIt0MxizjfFJov3JbHyAi,8,5,3,0,2,6,5,0,21,3.0,1,0.0,0,3,0,2,5,6,0,5,0,5,16,1
8469,117382,W4YcttFAI3GezJalLYSgr5LsB9fMfJw6,fbPkOYLVPtPgIt0MxizjfFJov3JbHyAi,5,2,1,0,1,0,2,0,6,0.8571428571428571,1,0.0,0,1,0,1,2,0,0,2,0,2,4,1
8470,117385,AuMjwLeYBChETH8L0EPQQLBqdJg4wXaV,fbPkOYLVPtPgIt0MxizjfFJov3JbHyAi,14,14,7,0,8,22,6,0,57,8.142857142857142,1,0.0,5,7,0,8,9,22,0,6,0,20,37,1
8471,117386,i0ksX07HnsV5rQlWqOr1uKEuc7yNU24c,fbPkOYLVPtPgIt0MxizjfFJov3JbHyAi,7,2,1,0,1,4,8,1,17,2.4285714285714284,2,0.0,0,1,0,1,2,4,0,8,1,2,15,1
8472,117389,mXfwwTIVjHMqoVKAh2iEQbinKUCJHwTp,fbPkOYLVPtPgIt0MxizjfFJov3JbHyAi,1,0,0,0,0,0,9,0,9,1.2857142857142858,1,0.0,0,0,0,0,0,0,0,9,0,0,9,0
8473,117396,pNEyURvIjTiESJT2evjPVs5QcamqwYsg,fbPkOYLVPtPgIt0MxizjfFJov3JbHyAi,1,0,0,0,0,0,1,0,1,0.14285714285714285,1,0.0,0,0,0,0,0,0,0,1,0,0,1,1
8474,117397,2XVXsblIDsQNrX8upAtO1F8OiAwOV3sC,fbPkOYLVPtPgIt0MxizjfFJov3JbHyAi,1,0,0,0,0,0,1,0,1,0.14285714285714285,1,0.0,0,0,0,0,0,0,0,1,0,0,1,1
8475,117399,bPCJkP9ZTzzi0I9DbpQGe5iKBkWKaKhH,fbPkOYLVPtPgIt0MxizjfFJov3JbHyAi,10,8,6,0,3,2,4,1,24,3.4285714285714284,1,0.0,0,6,0,3,8,2,0,4,1,9,15,1
8476,117405,fu0f20KU28Bd4xE03nYnaxnydSL4s6JV,fbPkOYLVPtPgIt0MxizjfFJov3JbHyAi,3,3,1,0,0,0,3,0,7,1.0,1,0.0,0,1,0,0,3,0,0,3,0,1,6,1
8477,117407,u3ha5zP0wtMcDDWbo2YVGmhJ5EihdJ7B,fbPkOYLVPtPgIt0MxizjfFJov3JbHyAi,1,0,0,0,0,0,1,0,1,0.14285714285714285,1,0.0,0,0,0,0,0,0,0,1,0,0,1,1
8478,117408,T7YlTqIDVTZFYEYihxD1Zij5IkDsmVZP,fbPkOYLVPtPgIt0MxizjfFJov3JbHyAi,8,11,3,0,3,6,3,0,26,3.7142857142857144,1,0.0,3,3,0,3,8,6,0,3,0,9,17,1
8479,117409,oZFc1qOsYmuXaa2y9yuDE2JOyaJ6tpRo,fbPkOYLVPtPgIt0MxizjfFJov3JbHyAi,12,19,11,0,6,0,6,0,42,6.0,4,0.0,0,11,0,6,19,0,0,6,0,17,25,1
8480,117410,Lpjd1s2Qa852YWnveC5CAHyEzqzKjCKM,fbPkOYLVPtPgIt0MxizjfFJov3JbHyAi,8,4,1,0,1,4,6,1,17,2.4285714285714284,2,0.0,0,1,0,1,4,4,0,6,1,2,15,1
8481,117420,sATu1yjmTMxfV1UwbY34TM5sGL4dFyhU,fbPkOYLVPtPgIt0MxizjfFJov3JbHyAi,4,6,1,0,0,0,3,0,10,1.4285714285714286,2,0.0,0,1,0,0,6,0,0,3,0,1,9,1
8482,117421,6o1ZSS0MBiJ4i90ElFoAvCZGSxQxxLtD,fbPkOYLVPtPgIt0MxizjfFJov3JbHyAi,1,0,0,0,0,0,1,0,1,0.14285714285714285,1,0.0,0,0,0,0,0,0,0,1,0,0,1,1
8483,117425,YjySOKJ8Qhep1ksiy3pkGK8hyQnj63Bg,fbPkOYLVPtPgIt0MxizjfFJov3JbHyAi,2,0,0,0,0,0,4,0,4,0.5714285714285714,1,0.0,0,0,0,0,0,0,0,4,0,0,4,1
8484,117426,1I29v8UmoBuouK5thDbwjYUDiAkrMElJ,fbPkOYLVPtPgIt0MxizjfFJov3JbHyAi,2,0,0,0,0,0,6,0,6,0.8571428571428571,1,0.0,0,0,0,0,0,0,0,6,0,0,6,1
8485,117429,pbZR4GJe7P6eoTNcArXxFSrGW6cVA8YU,fbPkOYLVPtPgIt0MxizjfFJov3JbHyAi,15,15,11,0,8,0,8,0,42,6.0,3,0.0,0,11,0,8,15,0,0,8,0,19,23,1
8486,117430,MmozMzpVuu7lJ9WhybOg7LnFJamucwNf,fbPkOYLVPtPgIt0MxizjfFJov3JbHyAi,5,3,1,0,1,0,2,0,7,1.0,1,0.0,0,1,0,1,3,0,0,2,0,2,5,1
8487,117432,CN6hYLtHy52UqiF5PRGtJEkOeeMIm2un,fbPkOYLVPtPgIt0MxizjfFJov3JbHyAi,7,3,2,0,2,0,4,0,11,1.5714285714285714,1,0.0,0,2,0,2,3,0,0,4,0,4,7,1
8488,117434,T6F7StAhzA9Nt1gx3xcfSamiwd1hA4kb,fbPkOYLVPtPgIt0MxizjfFJov3JbHyAi,2,0,0,0,0,0,2,0,2,0.2857142857142857,1,0.0,0,0,0,0,0,0,0,2,0,0,2,1
8489,117437,HOh9uzKRHmixUSVl017qRO1fRhTakF2v,fbPkOYLVPtPgIt0MxizjfFJov3JbHyAi,17,39,17,6,10,5,12,1,90,12.857142857142858,7,0.0,8,17,4,10,31,5,2,12,1,39,51,1
8490,117442,kyRDtUassKyWkKwd2NxuRMWbNGMmYQuD,fbPkOYLVPtPgIt0MxizjfFJov3JbHyAi,54,115,58,41,29,26,38,2,309,44.142857142857146,13,0.0,28,58,34,29,87,26,7,38,2,149,160,1
8491,117443,V44Q36yyz0HxZhlrCwrLJjYwv8UzqoCn,fbPkOYLVPtPgIt0MxizjfFJov3JbHyAi,6,3,2,0,2,0,2,0,9,1.2857142857142858,1,0.0,0,2,0,2,3,0,0,2,0,4,5,1
8492,117444,oWOfoMSwxFJkBlwLG8XI3GNMHdlBBaGM,fbPkOYLVPtPgIt0MxizjfFJov3JbHyAi,17,39,24,4,5,4,15,1,92,13.142857142857142,10,0.0,6,24,3,5,33,4,1,15,1,38,54,1
8493,117445,gkiUIfN50TiqMc6ruS3MmgF2p099c98R,fbPkOYLVPtPgIt0MxizjfFJov3JbHyAi,7,8,5,0,3,0,3,0,19,2.7142857142857144,1,0.0,0,5,0,3,8,0,0,3,0,8,11,1
8494,117446,Q3CFFFFeztddQPg34HzeWJOUWopSHXqI,fbPkOYLVPtPgIt0MxizjfFJov3JbHyAi,5,2,1,0,1,0,3,0,7,1.0,1,0.0,0,1,0,1,2,0,0,3,0,2,5,1
8495,117447,OvHFca8fZMJjxNBJonj6ZM9Jmu5uZHn1,fbPkOYLVPtPgIt0MxizjfFJov3JbHyAi,5,3,1,0,0,0,3,0,7,1.0,1,0.0,0,1,0,0,3,0,0,3,0,1,6,1
8496,117452,XD3SfNDDSMmRivtrECVvGAm4sTgAQhtN,fbPkOYLVPtPgIt0MxizjfFJov3JbHyAi,11,6,3,6,3,0,4,0,22,3.142857142857143,1,0.0,1,3,5,3,5,0,1,4,0,12,10,1
8497,117454,m6lnook0RtQLOadkyTjepku2EsfPQUkf,fbPkOYLVPtPgIt0MxizjfFJov3JbHyAi,1,0,0,0,0,0,1,0,1,0.14285714285714285,1,0.0,0,0,0,0,0,0,0,1,0,0,1,1
8498,117460,ZCWIo0rlDJYX4bFrxwqUtfFzcyFGtbPC,fbPkOYLVPtPgIt0MxizjfFJov3JbHyAi,7,5,1,0,1,0,1,0,8,1.1428571428571428,1,0.0,0,1,0,1,5,0,0,1,0,2,6,1
8499,117467,hDNiOFPvRB9cUydss5Qxpv78aI19HlnV,fbPkOYLVPtPgIt0MxizjfFJov3JbHyAi,15,10,7,0,7,0,5,0,29,4.142857142857143,2,0.0,2,7,0,7,8,0,0,5,0,16,13,1
8500,117470,mT6waBgPTnOBUmAiQrY4keGZNquTpjJI,fbPkOYLVPtPgIt0MxizjfFJov3JbHyAi,7,5,0,0,0,1,6,1,13,1.8571428571428572,1,0.0,0,0,0,0,5,1,0,6,1,0,13,1
8501,117472,GaQzOXFZJNvUueucyW3BfG1sfbLN7TqZ,fbPkOYLVPtPgIt0MxizjfFJov3JbHyAi,6,2,1,0,1,0,3,0,7,1.0,1,0.0,0,1,0,1,2,0,0,3,0,2,5,1
8502,117476,RwvuGEh3euIR11rktJrGBhzDqcQMkhOC,fbPkOYLVPtPgIt0MxizjfFJov3JbHyAi,11,28,16,4,7,1,9,0,65,9.285714285714286,5,0.0,3,16,3,7,25,1,1,9,0,29,36,1
8503,117477,0VSuyC2fbUM3VIvEXql75XtNw7kg5Izm,fbPkOYLVPtPgIt0MxizjfFJov3JbHyAi,16,15,7,8,6,0,3,0,39,5.571428571428571,3,0.0,5,7,7,6,10,0,1,3,0,25,14,1
8504,117478,W7oz4HopNsS4RPNw2s87918URq124P2s,fbPkOYLVPtPgIt0MxizjfFJov3JbHyAi,4,2,0,0,0,1,5,0,8,1.1428571428571428,1,0.0,0,0,0,0,2,1,0,5,0,0,8,1
8505,117483,ckU7S9iTSheBHJPYCUZtMgrhgDvQPsUY,fbPkOYLVPtPgIt0MxizjfFJov3JbHyAi,6,3,2,0,2,0,1,0,8,1.1428571428571428,1,0.0,0,2,0,2,3,0,0,1,0,4,4,1
8506,117484,5bnbtuO3BHv5NYIfEbfBpvStPzGdNjte,fbPkOYLVPtPgIt0MxizjfFJov3JbHyAi,5,2,1,0,1,0,2,0,6,0.8571428571428571,1,0.0,0,1,0,1,2,0,0,2,0,2,4,1
8507,117485,V1BKbINyQwKyububdNQHUPGcGTvoZmLt,fbPkOYLVPtPgIt0MxizjfFJov3JbHyAi,7,3,2,0,2,0,5,0,12,1.7142857142857142,1,0.0,0,2,0,2,3,0,0,5,0,4,8,1
8508,117497,TZ8M7GqMqYnKB1lP0bgNhFJYSqdTmbQI,fbPkOYLVPtPgIt0MxizjfFJov3JbHyAi,7,13,6,0,3,0,3,0,25,3.5714285714285716,2,0.0,0,6,0,3,13,0,0,3,0,9,16,1
8509,117498,aRBsP3RNC28m05qU4AuLdcShaMIKbk0T,fbPkOYLVPtPgIt0MxizjfFJov3JbHyAi,5,2,1,0,1,0,2,0,6,0.8571428571428571,1,0.0,0,1,0,1,2,0,0,2,0,2,4,1
8510,117504,7nfwj1I7hYBfuxm4jUuStM2n17LzzRmj,SpATywNh6bZuzm8s1ceuBUnMUAeoAHHw,56,57,44,38,35,142,74,2,392,56.0,15,0.0,10,44,35,35,47,142,3,74,2,124,268,0
8511,117521,LU9kxt8aKnlOn8SnA2EuX2MLajf5Sg2a,5X6FeZozNMgE2VRi3MJYjkkFK8SETtu2,38,64,18,0,32,0,12,0,126,18.0,8,0.0,36,18,0,32,28,0,0,12,0,86,40,0
8512,117532,qX3w4IgztgXyu9swieirFObama3kJyza,G8EPVSXsOYB5YQWZGiz1aVq5Pgr2GrQu,66,79,4,204,2,2,23,6,320,45.714285714285715,6,0.0,6,4,164,2,73,2,40,23,6,176,144,1
8513,117567,KlEAwfTXNSli6vdNdYlm5CYknLkxK1Br,SpATywNh6bZuzm8s1ceuBUnMUAeoAHHw,38,85,50,30,23,10,12,0,210,30.0,7,0.0,19,50,27,23,66,10,3,12,0,119,91,0
8514,117568,VK6VYsFJEy8hhWdKq52KmrJkO3b6jNbn,A3fsA9Zfv1X2fVEQhTw51lKENdNrEqT3,36,29,18,36,14,1,27,2,127,18.142857142857142,6,0.0,2,18,30,14,27,1,6,27,2,64,63,0
8515,117572,xH5f8nfW6oTIgHjXoQgEUKIx6qvDN8rk,RXDvfPUBYFlVdlueBFbLW0mhhAyGEqpt,9,4,2,6,1,0,3,0,16,2.2857142857142856,1,0.0,1,2,6,1,3,0,0,3,0,10,6,1
8516,117589,GW3u4KgPsgAWkRER2WW6Fgp0OqlMuGFL,5X6FeZozNMgE2VRi3MJYjkkFK8SETtu2,11,9,1,12,3,0,2,0,27,3.857142857142857,1,0.0,7,1,11,3,2,0,1,2,0,22,5,1
8517,117609,hyhyxhn6qO7nii28PZygBx2DF5Qsnp6b,SpATywNh6bZuzm8s1ceuBUnMUAeoAHHw,20,19,13,0,10,0,3,0,45,6.428571428571429,4,0.0,0,13,0,10,19,0,0,3,0,23,22,1
8518,117610,ByImt5XiYRVr6hSHRVc9HRcRiIYkoT5Y,SpATywNh6bZuzm8s1ceuBUnMUAeoAHHw,10,13,3,0,1,0,10,3,30,4.285714285714286,4,0.0,2,3,0,1,11,0,0,10,3,6,24,0
8519,117612,Kd69M9W1nim0woqVm1QxfVaSebsYtFIh,SpATywNh6bZuzm8s1ceuBUnMUAeoAHHw,28,35,15,32,8,0,4,0,94,13.428571428571429,3,0.0,9,15,28,8,26,0,4,4,0,60,34,1
8520,117613,VEmnuZOsoHSPcS4ojGYL7wyh1ioGqsGt,SpATywNh6bZuzm8s1ceuBUnMUAeoAHHw,50,60,30,33,19,0,12,0,154,22.0,8,0.0,6,30,33,19,54,0,0,12,0,88,66,0
8521,117615,NdhfP9LezOw47EKstFkVNQYaCX8DmoQI,SpATywNh6bZuzm8s1ceuBUnMUAeoAHHw,47,107,7,70,3,0,28,0,215,30.714285714285715,15,0.0,19,7,59,3,88,0,11,28,0,88,127,0
8522,117655,MkluYfJDefHhcRPY3QsRGiWxg2BDcm18,SpATywNh6bZuzm8s1ceuBUnMUAeoAHHw,37,107,2,33,2,8,41,5,198,28.285714285714285,6,0.0,43,2,30,2,64,8,3,41,5,77,121,0
8523,117666,GGjg9S36MZkhfOc2c4FtP7oUCiriIkzW,A3fsA9Zfv1X2fVEQhTw51lKENdNrEqT3,1,0,0,0,0,0,1,0,1,0.14285714285714285,1,0.0,0,0,0,0,0,0,0,1,0,0,1,1
8524,117671,LvmRr9NACuniPuboiWpXG15NCOEyIfpb,SpATywNh6bZuzm8s1ceuBUnMUAeoAHHw,34,67,38,38,8,0,25,1,177,25.285714285714285,9,0.0,14,38,32,8,53,0,6,25,1,92,85,0
8525,117672,NdhfP9LezOw47EKstFkVNQYaCX8DmoQI,RXDvfPUBYFlVdlueBFbLW0mhhAyGEqpt,64,134,25,197,16,59,23,0,454,64.85714285714286,13,0.0,33,25,173,16,101,59,24,23,0,247,207,0
8526,117673,nC8ZC7ZEZFxQ1fyXozb96bBtFUPG3sJG,RXDvfPUBYFlVdlueBFbLW0mhhAyGEqpt,24,16,12,0,8,2,7,1,46,6.571428571428571,1,0.0,0,12,0,8,16,2,0,7,1,20,26,1
8527,117675,l64zD2DC6Q6fZRqMhhM1r4HOjVM4BOX7,SpATywNh6bZuzm8s1ceuBUnMUAeoAHHw,37,79,6,52,4,1,22,1,165,23.571428571428573,8,0.0,15,6,44,4,64,1,8,22,1,69,96,0
8528,117679,VE9HD5yzeCmqc2pNGfTQWsVbRdaqJBIV,SpATywNh6bZuzm8s1ceuBUnMUAeoAHHw,41,61,29,12,15,6,12,1,136,19.428571428571427,8,0.0,8,29,12,15,53,6,0,12,1,64,72,0
8529,117680,qnnOX2tUCPlICAK14wMKzZel5x1shlyc,SpATywNh6bZuzm8s1ceuBUnMUAeoAHHw,1,0,0,0,0,0,1,0,1,0.14285714285714285,1,0.0,0,0,0,0,0,0,0,1,0,0,1,1
8530,117682,TwVX3mHoGy0nFKENpqHSy2JVaUgsNzW0,SpATywNh6bZuzm8s1ceuBUnMUAeoAHHw,1,0,0,0,0,0,1,0,1,0.14285714285714285,1,0.0,0,0,0,0,0,0,0,1,0,0,1,1
8531,117700,hKd0tEZKHss60gUM0z43MBrDD3KnSpLX,bWdj2GDclj5ofokWjzoa5jAwMkxCykd6,12,23,4,0,3,2,10,1,43,6.142857142857143,4,0.0,0,4,0,3,23,2,0,10,1,7,36,1
8532,117701,VgmFAu9L9uoZcxRAsErY5yMnCkdw48U0,SpATywNh6bZuzm8s1ceuBUnMUAeoAHHw,26,20,14,36,10,0,24,0,104,14.857142857142858,7,0.0,4,14,33,10,16,0,3,24,0,61,43,0
8533,117704,imCqSahSQFbp2MKSKmbn03XNPhpj1Zgr,bWdj2GDclj5ofokWjzoa5jAwMkxCykd6,19,25,11,61,4,5,4,0,110,15.714285714285714,2,0.0,3,11,56,4,22,5,5,4,0,74,36,1
8534,117705,KM2jhllffvH7le7smUIPpeiXHGu50JUy,G8EPVSXsOYB5YQWZGiz1aVq5Pgr2GrQu,28,77,1,53,6,4,9,1,151,21.571428571428573,3,0.0,43,1,41,6,34,4,12,9,1,91,60,1
8535,117713,BdtTUaUgpTqIzhF2tLHXM8NXK8k0XF8q,bWdj2GDclj5ofokWjzoa5jAwMkxCykd6,45,124,62,68,19,27,24,0,324,46.285714285714285,8,0.0,20,62,62,19,104,27,6,24,0,163,161,0
8536,117723,B1Gq6e77yv7kkDqJ7SH2TygdPDzPBwQh,RXDvfPUBYFlVdlueBFbLW0mhhAyGEqpt,109,223,132,173,51,195,37,12,823,117.57142857142857,18,0.0,27,132,153,51,196,195,20,37,12,363,460,0
8537,117725,HPir8NcsI5RSXTzlx3oC2YqcMhZG1iu7,bWdj2GDclj5ofokWjzoa5jAwMkxCykd6,9,11,4,0,4,0,24,1,44,6.285714285714286,6,0.0,2,4,0,4,9,0,0,24,1,10,34,0
8538,117726,IspEVPShBbjx8d4IihOvyrT9DEmhjxUS,RXDvfPUBYFlVdlueBFbLW0mhhAyGEqpt,4,2,1,0,1,0,1,0,5,0.7142857142857143,1,0.0,0,1,0,1,2,0,0,1,0,2,3,1
8539,117734,cQJEH4N9NA86ElT2x4zkE6ToN6rVT4MQ,bWdj2GDclj5ofokWjzoa5jAwMkxCykd6,11,9,6,18,3,0,2,0,38,5.428571428571429,4,0.0,2,6,17,3,7,0,1,2,0,28,10,0
8540,117742,FhtwGNNoWtYYBXhYRu77jAPRU1UPxpBL,SpATywNh6bZuzm8s1ceuBUnMUAeoAHHw,30,33,19,12,8,5,15,0,92,13.142857142857142,8,0.0,6,19,12,8,27,5,0,15,0,45,47,0
8541,117774,jFYWygr5nLqLhHkXltZRkT0S1zQoLEVR,A3fsA9Zfv1X2fVEQhTw51lKENdNrEqT3,153,100,60,458,32,11,48,1,710,101.42857142857143,11,0.0,11,60,392,32,89,11,66,48,1,495,215,0
8542,117784,CFQksue0mvvarj6k4PvTddPXnYjnyZ25,SpATywNh6bZuzm8s1ceuBUnMUAeoAHHw,19,23,1,18,0,19,6,1,68,9.714285714285714,2,0.0,0,1,14,0,23,19,4,6,1,15,53,1
8543,117791,efPQEaUnbKTGcoOM9khi0sSrVhfE9TxE,bWdj2GDclj5ofokWjzoa5jAwMkxCykd6,11,52,23,4,2,0,12,0,93,13.285714285714286,6,0.0,2,23,3,2,50,0,1,12,0,30,63,1
8544,117800,RJv5TI20pjqK3VtKSctdVBLm65ceGNPu,SpATywNh6bZuzm8s1ceuBUnMUAeoAHHw,59,127,66,65,20,48,35,4,365,52.142857142857146,18,0.0,26,66,61,20,101,48,4,35,4,173,192,0
8545,117842,68jxA2PUjT1NQfZbUcdmPfGR0u6r2zeM,5X6FeZozNMgE2VRi3MJYjkkFK8SETtu2,36,83,32,44,14,0,29,0,202,28.857142857142858,15,0.0,26,32,41,14,57,0,3,29,0,113,89,0
8546,117893,Bos3zEEnAcYzPXQktMkJJ0ak5mhGWCAf,SpATywNh6bZuzm8s1ceuBUnMUAeoAHHw,22,34,12,26,6,0,2,0,80,11.428571428571429,2,0.0,13,12,25,6,21,0,1,2,0,56,24,0
8547,117897,uww7NsJbMYsrx0EthqYUSLQnuRAcw7nQ,A3fsA9Zfv1X2fVEQhTw51lKENdNrEqT3,5,1,1,0,1,0,5,0,8,1.1428571428571428,1,0.0,0,1,0,1,1,0,0,5,0,2,6,1
8548,117935,1R1zO9aMB7Mx1Lw84JzsChVEV5JpwmZv,SpATywNh6bZuzm8s1ceuBUnMUAeoAHHw,41,126,13,34,6,40,67,5,291,41.57142857142857,23,0.0,27,13,31,6,99,40,3,67,5,77,214,0
8549,117989,4dfnEKxHCmGabkBCiKHt5nKr3H7Bwo1x,G8EPVSXsOYB5YQWZGiz1aVq5Pgr2GrQu,4,2,1,0,1,0,1,0,5,0.7142857142857143,2,0.0,0,1,0,1,2,0,0,1,0,2,3,0
8550,118027,LKippngJk3cGSHQFQuBifcn7F1qfi1gi,SpATywNh6bZuzm8s1ceuBUnMUAeoAHHw,6,3,2,0,2,0,1,0,8,1.1428571428571428,1,0.0,0,2,0,2,3,0,0,1,0,4,4,1
8551,118040,Eemq3hk1Q3P1Pw1UumR7jNQlYsAdhi76,SpATywNh6bZuzm8s1ceuBUnMUAeoAHHw,36,46,20,47,7,12,17,4,153,21.857142857142858,6,0.0,19,20,42,7,27,12,5,17,4,88,65,1
8552,118052,lQKPFBdAwC9d5aFjgrzYc27szNyJlIOi,bWdj2GDclj5ofokWjzoa5jAwMkxCykd6,1,0,0,0,0,0,2,0,2,0.2857142857142857,1,0.0,0,0,0,0,0,0,0,2,0,0,2,1
8553,118056,skJn7dtfSekFrPHRHs9swZ9AtSUKi36u,bWdj2GDclj5ofokWjzoa5jAwMkxCykd6,4,5,3,0,0,0,2,0,10,1.4285714285714286,2,0.0,0,3,0,0,5,0,0,2,0,3,7,1
8554,118084,hJwtwnOzJaTrAeP4eXJAEwz2xbKsgc4M,A3fsA9Zfv1X2fVEQhTw51lKENdNrEqT3,9,3,2,0,1,1,30,1,38,5.428571428571429,13,0.0,0,2,0,1,3,1,0,30,1,3,35,0
8555,118085,hJwtwnOzJaTrAeP4eXJAEwz2xbKsgc4M,bWdj2GDclj5ofokWjzoa5jAwMkxCykd6,2,0,0,0,0,0,21,0,21,3.0,12,0.0,0,0,0,0,0,0,0,21,0,0,21,0
8556,118091,hJwtwnOzJaTrAeP4eXJAEwz2xbKsgc4M,RXDvfPUBYFlVdlueBFbLW0mhhAyGEqpt,7,2,1,0,1,1,22,4,31,4.428571428571429,13,0.0,0,1,0,1,2,1,0,22,4,2,29,1
8557,118100,qceTeoelxto8cUOivqTuxvNZNnsHQRN6,SpATywNh6bZuzm8s1ceuBUnMUAeoAHHw,28,31,17,19,11,1,6,0,85,12.142857142857142,4,0.0,5,17,18,11,26,1,1,6,0,51,34,0
8558,118110,n97hqxU6pa0pyrYxofJJX3kbArZF9Hya,SpATywNh6bZuzm8s1ceuBUnMUAeoAHHw,5,2,1,0,1,0,2,0,6,0.8571428571428571,1,0.0,0,1,0,1,2,0,0,2,0,2,4,1
8559,118111,vlcrE6RvFFuyjHZx9sgpQaFTegXr4wza,bWdj2GDclj5ofokWjzoa5jAwMkxCykd6,8,8,5,0,2,0,6,0,21,3.0,2,0.0,0,5,0,2,8,0,0,6,0,7,14,1
8560,118115,QXyZtQTzdxqnHSXK4hpAwUSj9MimJfEp,SpATywNh6bZuzm8s1ceuBUnMUAeoAHHw,34,36,21,49,9,13,6,1,135,19.285714285714285,2,0.0,11,21,43,9,25,13,6,6,1,84,51,0
8561,118118,l3b9HlsGDQW9AY17jLNuKVLgfuE5tsF4,SpATywNh6bZuzm8s1ceuBUnMUAeoAHHw,42,106,25,67,4,3,19,0,224,32.0,15,0.0,39,25,58,4,67,3,9,19,0,126,98,0
8562,118119,5rIDDYg0Y0BALcyb0c2BGIVHn1eXoPjW,SpATywNh6bZuzm8s1ceuBUnMUAeoAHHw,17,16,8,6,4,0,4,0,38,5.428571428571429,2,0.0,4,8,6,4,12,0,0,4,0,22,16,1
8563,118127,h4Ts0QZ9Axnf77ZfOuF03oUEp9wmSbSp,SpATywNh6bZuzm8s1ceuBUnMUAeoAHHw,22,19,11,7,6,1,10,1,55,7.857142857142857,3,0.0,3,11,7,6,16,1,0,10,1,27,28,1
8564,118130,0sa6kP9h4ahNr7Hzfeaa1Mssp5M7IVmw,SpATywNh6bZuzm8s1ceuBUnMUAeoAHHw,20,33,11,18,6,15,13,1,97,13.857142857142858,4,0.0,4,11,15,6,29,15,3,13,1,36,61,1
8565,118174,FeFq7ZGqpMZdGp1e1neypp6dkWmjw2YJ,SpATywNh6bZuzm8s1ceuBUnMUAeoAHHw,3,3,0,0,0,0,1,0,4,0.5714285714285714,1,0.0,0,0,0,0,3,0,0,1,0,0,4,1
8566,118203,HX0eOrMEwIw9JyfkWs6Tn0Lny06N2ZVO,SpATywNh6bZuzm8s1ceuBUnMUAeoAHHw,29,66,26,36,11,23,18,0,180,25.714285714285715,5,0.0,27,26,30,11,39,23,6,18,0,94,86,0
8567,118208,iPn4eHBBcGh91aOsj9d5XOb4QbfUGe6N,bWdj2GDclj5ofokWjzoa5jAwMkxCykd6,14,21,7,16,8,2,20,1,75,10.714285714285714,3,0.0,9,7,14,8,12,2,2,20,1,38,37,1
8568,118218,66rxtelZjlVaBERuinHZ5AhHu9R6Idp5,SpATywNh6bZuzm8s1ceuBUnMUAeoAHHw,7,5,1,0,1,0,4,0,11,1.5714285714285714,2,0.0,0,1,0,1,5,0,0,4,0,2,9,1
8569,118230,2HbabEHSEnqM0bBaiJs30PG9549v5yOk,A3fsA9Zfv1X2fVEQhTw51lKENdNrEqT3,2,0,0,0,0,0,2,0,2,0.2857142857142857,1,0.0,0,0,0,0,0,0,0,2,0,0,2,1
8570,118232,TANF2ueHbJbwPsuSCbh96NH4X4PT1TeC,SpATywNh6bZuzm8s1ceuBUnMUAeoAHHw,21,26,1,22,1,0,3,0,53,7.571428571428571,2,0.0,8,1,21,1,18,0,1,3,0,31,22,1
8571,118239,4uAdkCJ4XUaD1NQGV93nNifOuyurJNKS,SpATywNh6bZuzm8s1ceuBUnMUAeoAHHw,21,37,1,7,1,5,13,2,66,9.428571428571429,3,0.0,17,1,7,1,20,5,0,13,2,26,40,0
8572,118258,5rpYxIaCTDb4PhszkJWpACOx5VMpNGcQ,SpATywNh6bZuzm8s1ceuBUnMUAeoAHHw,45,54,28,31,13,15,21,0,162,23.142857142857142,8,0.0,17,28,29,13,37,15,2,21,0,87,75,0
8573,118279,JGr8n6jajfkXDK9cWT8ogx09tHg0xA1G,SpATywNh6bZuzm8s1ceuBUnMUAeoAHHw,5,2,1,0,1,0,2,0,6,0.8571428571428571,1,0.0,0,1,0,1,2,0,0,2,0,2,4,1
8574,118314,ctfOhdlbQGiOVF89Y090EmsAqQEvSWmz,5X6FeZozNMgE2VRi3MJYjkkFK8SETtu2,1,0,0,0,0,0,1,0,1,0.14285714285714285,1,0.0,0,0,0,0,0,0,0,1,0,0,1,1
8575,118318,7hhGe4WcGEHypOzIVz3DLRx9GS52ozkE,RXDvfPUBYFlVdlueBFbLW0mhhAyGEqpt,69,107,69,103,41,35,27,0,382,54.57142857142857,9,0.0,24,69,96,41,83,35,7,27,0,230,152,0
8576,118326,yKuiBw79vz6YoDe6ZvtlnOfjIuGqFl4A,A3fsA9Zfv1X2fVEQhTw51lKENdNrEqT3,7,10,2,0,0,0,2,0,14,2.0,2,0.0,0,2,0,0,10,0,0,2,0,2,12,1
8577,118329,vzFJcjAnysUIi1BVDTqBUXqQfeRMIRJD,5X6FeZozNMgE2VRi3MJYjkkFK8SETtu2,6,3,2,0,2,0,2,0,9,1.2857142857142858,1,0.0,0,2,0,2,3,0,0,2,0,4,5,0
8578,118332,5ZiEBByu9KqLLuVXJILf5031ejtxPgIX,A3fsA9Zfv1X2fVEQhTw51lKENdNrEqT3,1,0,0,0,0,0,1,0,1,0.14285714285714285,1,0.0,0,0,0,0,0,0,0,1,0,0,1,1
8579,118339,cu2czfUbk8fdWWzCcDvTVYWH50Wg3XUq,SpATywNh6bZuzm8s1ceuBUnMUAeoAHHw,34,58,4,53,0,20,21,4,160,22.857142857142858,11,0.0,14,4,46,0,44,20,7,21,4,64,96,0
8580,118354,go2ODVnHLUhmZxhceJfs22CCaN5tZ78H,SpATywNh6bZuzm8s1ceuBUnMUAeoAHHw,5,2,1,0,1,0,2,0,6,0.8571428571428571,1,0.0,0,1,0,1,2,0,0,2,0,2,4,1
8581,118356,qq2zimIe7yMW71hAccGiqBqEtNw9FUIo,5X6FeZozNMgE2VRi3MJYjkkFK8SETtu2,1,0,0,0,0,0,1,0,1,0.14285714285714285,1,0.0,0,0,0,0,0,0,0,1,0,0,1,1
8582,118368,Tsd6J3Xles5MCEcWektA7d5EB7cldkxK,bWdj2GDclj5ofokWjzoa5jAwMkxCykd6,1,0,0,0,0,0,1,0,1,0.14285714285714285,1,0.0,0,0,0,0,0,0,0,1,0,0,1,1
8583,118369,httl8KJFJiDMZk4tgEQADrIoYysynrAv,SpATywNh6bZuzm8s1ceuBUnMUAeoAHHw,16,18,2,17,1,0,4,0,42,6.0,2,0.0,7,2,16,1,11,0,1,4,0,26,16,1
8584,118371,hZtYMC0K38gXqBKrTDOxWf2kSwG06wA4,RXDvfPUBYFlVdlueBFbLW0mhhAyGEqpt,72,114,56,100,18,66,30,4,388,55.42857142857143,8,0.0,15,56,93,18,99,66,7,30,4,182,206,0
8585,118387,FlAkKX6ow9SvOzk0dTWPWgnX5766zY29,5X6FeZozNMgE2VRi3MJYjkkFK8SETtu2,14,34,5,13,9,0,3,0,64,9.142857142857142,3,0.0,12,5,13,9,22,0,0,3,0,39,25,1
8586,118393,LVTU4qA4F3wWkxH81iGfu4ZuIt77nyhh,SpATywNh6bZuzm8s1ceuBUnMUAeoAHHw,37,55,31,43,10,17,19,1,176,25.142857142857142,6,0.0,5,31,37,10,50,17,6,19,1,83,93,0
8587,118409,m0VKHGN6a79sZImpQa7H4uF4wJYbxAYi,5X6FeZozNMgE2VRi3MJYjkkFK8SETtu2,1,0,0,0,0,0,1,0,1,0.14285714285714285,1,0.0,0,0,0,0,0,0,0,1,0,0,1,1
8588,118412,wxgnNpyHS7Q1morNnvAZvs6kd9hIBHTd,5X6FeZozNMgE2VRi3MJYjkkFK8SETtu2,22,51,0,44,14,10,8,3,130,18.571428571428573,2,0.0,36,0,34,14,15,10,10,8,3,84,46,1
8589,118422,ZNBGAlJve4TYJ3FcDlTLBdyuklADldDZ,bWdj2GDclj5ofokWjzoa5jAwMkxCykd6,11,9,3,12,3,0,9,1,37,5.285714285714286,4,0.0,4,3,12,3,5,0,0,9,1,22,15,1
8590,118435,U4egSBuIz4Tp2aExbhUIhaem6H1lHi4I,bWdj2GDclj5ofokWjzoa5jAwMkxCykd6,3,3,1,0,0,0,2,0,6,0.8571428571428571,1,0.0,0,1,0,0,3,0,0,2,0,1,5,1
8591,118439,e09uq36QgLuBVK5DERoejsHeMH2uPMRM,5X6FeZozNMgE2VRi3MJYjkkFK8SETtu2,1,0,0,0,0,0,1,0,1,0.14285714285714285,1,0.0,0,0,0,0,0,0,0,1,0,0,1,1
8592,118459,ZMTgNYkbfDsBe4X8ZM8wJYJMTUYSz0bl,5X6FeZozNMgE2VRi3MJYjkkFK8SETtu2,4,3,0,0,0,0,2,0,5,0.7142857142857143,1,0.0,0,0,0,0,3,0,0,2,0,0,5,1
8593,118467,Lu93o5GXoxd6qTdHk7BshqxRhX67SrrE,SpATywNh6bZuzm8s1ceuBUnMUAeoAHHw,26,69,11,16,7,0,6,0,109,15.571428571428571,5,0.0,20,11,15,7,49,0,1,6,0,53,56,0
8594,118468,s18XVhMq5o50489RseclkjZSQF8K6sqD,G8EPVSXsOYB5YQWZGiz1aVq5Pgr2GrQu,33,68,15,38,9,9,11,0,150,21.428571428571427,5,0.0,17,15,26,9,51,9,12,11,0,67,83,1
8595,118492,zQVzVvuYje8Ojw7BZjrypxHWGjUQol9i,5X6FeZozNMgE2VRi3MJYjkkFK8SETtu2,4,5,2,0,1,0,3,0,11,1.5714285714285714,2,0.0,2,2,0,1,3,0,0,3,0,5,6,1
8596,118500,37JCabFNpj6A5aUwdVeB55bOPV42TLJp,RXDvfPUBYFlVdlueBFbLW0mhhAyGEqpt,5,2,1,0,1,0,3,0,7,1.0,2,0.0,0,1,0,1,2,0,0,3,0,2,5,1
8597,118501,dhPPBp8unV3f13L4xkPHpVmkrnYAmORu,SpATywNh6bZuzm8s1ceuBUnMUAeoAHHw,7,4,3,0,3,0,2,0,12,1.7142857142857142,1,0.0,0,3,0,3,4,0,0,2,0,6,6,1
8598,118506,GrjEbVPh1uYw8afH98AN7VXn6UMAVnC8,A3fsA9Zfv1X2fVEQhTw51lKENdNrEqT3,6,8,0,0,0,0,9,0,17,2.4285714285714284,2,0.0,0,0,0,0,8,0,0,9,0,0,17,1
8599,118508,TnL4ialg6Pf5M7cIMrmaVmE9VMhEtv14,RXDvfPUBYFlVdlueBFbLW0mhhAyGEqpt,18,22,3,16,4,2,8,1,56,8.0,3,0.0,4,3,15,4,18,2,1,8,1,26,30,1
8600,118514,W3axEfDtpWFQrOsjh1ju6UWJlt7DtE7b,SpATywNh6bZuzm8s1ceuBUnMUAeoAHHw,19,34,3,16,0,9,28,5,95,13.571428571428571,9,0.0,2,3,12,0,32,9,4,28,5,17,78,1
8601,118520,JOqHNkiAQMopMtNnxSpHdAOKSp68V43j,5X6FeZozNMgE2VRi3MJYjkkFK8SETtu2,1,0,0,0,0,0,2,0,2,0.2857142857142857,1,0.0,0,0,0,0,0,0,0,2,0,0,2,1
8602,118535,Xd9kUiTgAJSeI24Pf6yPClc38pebYRoH,SpATywNh6bZuzm8s1ceuBUnMUAeoAHHw,5,4,2,0,0,0,2,0,8,1.1428571428571428,1,0.0,0,2,0,0,4,0,0,2,0,2,6,1
8603,118548,2i4UZQIumoYMpXAy2hMZiboq0bmSvHzQ,RXDvfPUBYFlVdlueBFbLW0mhhAyGEqpt,9,26,1,0,0,0,4,0,31,4.428571428571429,2,0.0,0,1,0,0,26,0,0,4,0,1,30,1
8604,118554,YBwTM3Bv2witVJ0Ed4zAbHn1UCLHLsEN,G8EPVSXsOYB5YQWZGiz1aVq5Pgr2GrQu,42,62,31,64,16,1,10,1,185,26.428571428571427,5,0.0,23,31,42,16,39,1,22,10,1,112,73,0
8605,118577,fjx9OtTbfeYJcewn1ZUVP1qyFT70WiAr,SpATywNh6bZuzm8s1ceuBUnMUAeoAHHw,1,0,0,0,0,0,1,0,1,0.14285714285714285,1,0.0,0,0,0,0,0,0,0,1,0,0,1,1
8606,118590,7GOzqt1OWuRQhmoyI6QcRiOEY3qIt0kS,SpATywNh6bZuzm8s1ceuBUnMUAeoAHHw,4,2,0,0,0,0,2,0,4,0.5714285714285714,1,0.0,0,0,0,0,2,0,0,2,0,0,4,1
8607,118602,MtBiVqpAnkXdNADfxYcv3MUEyfj2PI07,5X6FeZozNMgE2VRi3MJYjkkFK8SETtu2,1,0,0,0,0,0,1,0,1,0.14285714285714285,1,0.0,0,0,0,0,0,0,0,1,0,0,1,1
8608,118620,tKs772tHpR5tE8Ceee9VXQcqKPNhx6zt,SpATywNh6bZuzm8s1ceuBUnMUAeoAHHw,23,25,3,12,2,3,11,2,58,8.285714285714286,5,0.0,3,3,10,2,22,3,2,11,2,18,40,1
8609,118642,PpZEAa1Mdati01h1lf363alLOjmVtvBB,A3fsA9Zfv1X2fVEQhTw51lKENdNrEqT3,7,8,4,0,2,0,2,0,16,2.2857142857142856,1,0.0,1,4,0,2,7,0,0,2,0,7,9,1
8610,118650,ANtHTaCISHkEW6ENLanE6G1HEnRFLZdw,A3fsA9Zfv1X2fVEQhTw51lKENdNrEqT3,3,2,1,0,0,0,1,0,4,0.5714285714285714,1,0.0,0,1,0,0,2,0,0,1,0,1,3,0
8611,118652,eNgDL8k9xOLyBlZ3UNlseJHly8SfPZZu,bWdj2GDclj5ofokWjzoa5jAwMkxCykd6,32,145,85,128,9,121,53,1,542,77.42857142857143,19,0.0,25,85,117,9,120,121,11,53,1,236,306,0
8612,118658,eJLeV7Xq2bhq90HDU7vo6Tpmzbd63FDZ,SpATywNh6bZuzm8s1ceuBUnMUAeoAHHw,25,33,21,0,11,0,11,0,76,10.857142857142858,10,0.0,0,21,0,11,33,0,0,11,0,32,44,0
8613,118687,c1BXmJNemroOPh6WUefTBD28s2WzSNwi,A3fsA9Zfv1X2fVEQhTw51lKENdNrEqT3,59,69,5,98,4,1,25,3,205,29.285714285714285,10,0.0,5,5,92,4,64,1,6,25,3,106,99,1
8614,118688,c1BXmJNemroOPh6WUefTBD28s2WzSNwi,SpATywNh6bZuzm8s1ceuBUnMUAeoAHHw,51,98,7,57,8,5,20,2,197,28.142857142857142,8,0.0,34,7,53,8,64,5,4,20,2,102,95,0
8615,118704,ZfIQYurnR6gJbWxLJ81cU3ZqzX4mpHm0,bWdj2GDclj5ofokWjzoa5jAwMkxCykd6,9,22,9,0,1,0,12,0,44,6.285714285714286,7,0.0,1,9,0,1,21,0,0,12,0,11,33,0
8616,118705,rPluxrp33x1irahRnKiA3x2EKOheskK1,5X6FeZozNMgE2VRi3MJYjkkFK8SETtu2,69,186,71,81,72,9,28,0,447,63.857142857142854,15,0.0,92,71,70,72,94,9,11,28,0,305,142,0
8617,118714,MdZgTLmSGHkFWwMHVbVxaIOd0RHUp1Ya,G8EPVSXsOYB5YQWZGiz1aVq5Pgr2GrQu,8,2,2,0,2,1,3,0,10,1.4285714285714286,1,0.0,0,2,0,2,2,1,0,3,0,4,6,1
8618,118716,fomJrwdlOVBB27jkNMuLttmiA1XIZPzf,SpATywNh6bZuzm8s1ceuBUnMUAeoAHHw,15,22,4,4,4,1,3,0,38,5.428571428571429,4,0.0,4,4,3,4,18,1,1,3,0,15,23,1
8619,118723,9Gk0qMwFPQMSYtSGwJwjevbzKboXiTpg,SpATywNh6bZuzm8s1ceuBUnMUAeoAHHw,27,49,3,36,2,10,11,1,112,16.0,3,0.0,13,3,30,2,36,10,6,11,1,48,64,1
8620,118727,uFAwXIcuVZUrzooQS3i05Ojiq5CkITl5,G8EPVSXsOYB5YQWZGiz1aVq5Pgr2GrQu,5,2,1,0,1,0,2,0,6,0.8571428571428571,1,0.0,0,1,0,1,2,0,0,2,0,2,4,1
8621,118735,f6FNE8vNtrL6TKWAyYNA5KZvLoAoDp49,SpATywNh6bZuzm8s1ceuBUnMUAeoAHHw,19,25,4,23,6,2,24,0,84,12.0,3,0.0,8,4,20,6,17,2,3,24,0,38,46,1
8622,118740,7pYjVdOmbPwcRdb5BQqrv1P4hFEqv8iv,A3fsA9Zfv1X2fVEQhTw51lKENdNrEqT3,7,4,1,0,1,0,2,0,8,1.1428571428571428,1,0.0,0,1,0,1,4,0,0,2,0,2,6,1
8623,118748,grNuFIQJF1sOOkw8RJjaExhlwTJt52uU,G8EPVSXsOYB5YQWZGiz1aVq5Pgr2GrQu,64,165,85,132,39,25,38,2,486,69.42857142857143,15,0.0,20,85,120,39,145,25,12,38,2,264,222,0
8624,118753,5ccVO0DXIbSzn48qO0PlyxYK6uXvmUBC,SpATywNh6bZuzm8s1ceuBUnMUAeoAHHw,12,11,9,0,6,0,3,0,29,4.142857142857143,2,0.0,0,9,0,6,11,0,0,3,0,15,14,1
8625,118757,8x72g1EnsW8bYBL6HWtA15C4pKj2sPjA,G8EPVSXsOYB5YQWZGiz1aVq5Pgr2GrQu,7,8,1,0,1,0,4,0,14,2.0,3,0.0,0,1,0,1,8,0,0,4,0,2,12,1
8626,118770,JMRIHPxvEm8exxpzKPAmRrEIUgoG5Mrh,SpATywNh6bZuzm8s1ceuBUnMUAeoAHHw,7,10,4,0,1,1,5,0,21,3.0,3,0.0,0,4,0,1,10,1,0,5,0,5,16,0
8627,118779,xH5f8nfW6oTIgHjXoQgEUKIx6qvDN8rk,bWdj2GDclj5ofokWjzoa5jAwMkxCykd6,1,0,0,0,0,0,1,0,1,0.14285714285714285,1,0.0,0,0,0,0,0,0,0,1,0,0,1,0
8628,118787,bKVslXuzEQ1pv4c6iV5mVjs6X6avUbmL,A3fsA9Zfv1X2fVEQhTw51lKENdNrEqT3,40,14,11,56,10,0,4,0,95,13.571428571428571,3,0.0,1,11,53,10,13,0,3,4,0,75,20,1
8629,118792,bKVslXuzEQ1pv4c6iV5mVjs6X6avUbmL,SpATywNh6bZuzm8s1ceuBUnMUAeoAHHw,8,3,2,0,2,2,4,0,13,1.8571428571428572,3,0.0,0,2,0,2,3,2,0,4,0,4,9,1
8630,118793,lrp5AGJUh69hKuCI5IYUEU19E2beipwd,bWdj2GDclj5ofokWjzoa5jAwMkxCykd6,19,45,4,0,5,13,17,0,84,12.0,10,0.0,0,4,0,5,45,13,0,17,0,9,75,1
8631,118797,Lk947zUxODvAz9uAzr7LhEhqya4oVnNV,SpATywNh6bZuzm8s1ceuBUnMUAeoAHHw,7,8,2,0,0,0,5,0,15,2.142857142857143,2,0.0,1,2,0,0,7,0,0,5,0,3,12,0
8632,118803,AXOBQLaknxwaGBasKpj34YfhU436HR6z,A3fsA9Zfv1X2fVEQhTw51lKENdNrEqT3,1,0,0,0,0,0,1,0,1,0.14285714285714285,1,0.0,0,0,0,0,0,0,0,1,0,0,1,1
8633,118805,c9mIdDAhRczXEb5UJiDqrnVR2zYNOBwR,A3fsA9Zfv1X2fVEQhTw51lKENdNrEqT3,1,0,0,0,0,0,3,0,3,0.42857142857142855,3,0.0,0,0,0,0,0,0,0,3,0,0,3,1
8634,118806,NbUyHCtjlZY38KWhmKKrrw2eE1rI3XlV,SpATywNh6bZuzm8s1ceuBUnMUAeoAHHw,38,24,21,0,20,0,3,0,68,9.714285714285714,3,0.0,0,21,0,20,24,0,0,3,0,41,27,0
8635,118864,uvmnuTMWO7CUJMGmbknJbfcrAcbdWpqR,A3fsA9Zfv1X2fVEQhTw51lKENdNrEqT3,1,0,0,0,0,0,1,0,1,0.14285714285714285,1,0.0,0,0,0,0,0,0,0,1,0,0,1,1
8636,118869,5J6qme6tgFximxgH6JaagcgP0HlXsQ9E,SpATywNh6bZuzm8s1ceuBUnMUAeoAHHw,1,0,0,0,0,0,1,0,1,0.14285714285714285,1,0.0,0,0,0,0,0,0,0,1,0,0,1,1
8637,118870,5J6qme6tgFximxgH6JaagcgP0HlXsQ9E,G8EPVSXsOYB5YQWZGiz1aVq5Pgr2GrQu,2,0,0,0,0,0,2,0,2,0.2857142857142857,1,0.0,0,0,0,0,0,0,0,2,0,0,2,1
8638,118873,xKEKXJFa8iwv6Ll5IrcgpUyxzmqp78kE,G8EPVSXsOYB5YQWZGiz1aVq5Pgr2GrQu,4,2,1,0,1,0,2,0,6,0.8571428571428571,1,0.0,0,1,0,1,2,0,0,2,0,2,4,1
8639,118880,bqWpav7ocOhCfb3xc4QgAvBDK5g8BmiZ,RXDvfPUBYFlVdlueBFbLW0mhhAyGEqpt,14,30,18,0,5,0,13,0,66,9.428571428571429,7,0.0,2,18,0,5,28,0,0,13,0,25,41,0
8640,118884,c8WJAdYLV71mOx4ZXSglpCNd0dBUR3Om,SpATywNh6bZuzm8s1ceuBUnMUAeoAHHw,56,63,35,44,20,0,19,0,181,25.857142857142858,13,0.0,11,35,38,20,52,0,6,19,0,104,77,0
8641,118894,5ESBYT4YXwThMhRWcyNvUGRmyEr1sxDg,bWdj2GDclj5ofokWjzoa5jAwMkxCykd6,8,12,5,58,1,0,2,0,78,11.142857142857142,2,0.0,1,5,56,1,11,0,2,2,0,63,15,0
8642,118896,Jp4TJ4yNuhjTEvrsxd0CarZSf22aa7u6,bWdj2GDclj5ofokWjzoa5jAwMkxCykd6,1,0,0,0,0,0,1,0,1,0.14285714285714285,1,0.0,0,0,0,0,0,0,0,1,0,0,1,1
8643,118899,4TYIBYUjGx5Az0xYJI94tEHK7klSyatr,SpATywNh6bZuzm8s1ceuBUnMUAeoAHHw,1,0,0,0,0,0,1,0,1,0.14285714285714285,1,0.0,0,0,0,0,0,0,0,1,0,0,1,1
8644,118902,fhqx50pW0TcVQ59FT0II7MmWoAXcWiY8,RXDvfPUBYFlVdlueBFbLW0mhhAyGEqpt,1,0,0,0,0,0,2,0,2,0.2857142857142857,1,0.0,0,0,0,0,0,0,0,2,0,0,2,1
8645,118905,bqWpav7ocOhCfb3xc4QgAvBDK5g8BmiZ,5X6FeZozNMgE2VRi3MJYjkkFK8SETtu2,26,20,7,50,4,0,5,0,86,12.285714285714286,1,0.0,11,7,39,4,9,0,11,5,0,61,25,1
8646,118934,9Nk7mnk1e8KYLiEHu7uBQQPnqWiwScVk,RXDvfPUBYFlVdlueBFbLW0mhhAyGEqpt,47,77,29,93,16,11,25,2,253,36.142857142857146,4,0.0,16,29,83,16,61,11,10,25,2,144,109,1
8647,118936,0PuPhUY9SiHUBSSrbkLAmF5o2IPgOmxV,SpATywNh6bZuzm8s1ceuBUnMUAeoAHHw,9,14,12,0,11,1,2,0,40,5.714285714285714,3,0.0,0,12,0,11,14,1,0,2,0,23,17,1
8648,118948,59I5in7ieFGusS8qxVtrv60LZ3ifOtyr,bWdj2GDclj5ofokWjzoa5jAwMkxCykd6,19,52,23,128,10,0,8,0,221,31.571428571428573,5,0.0,15,23,128,10,37,0,0,8,0,176,45,1
8649,118949,ELJa8A81VOfiqD4Bg0Px962sx2WBYvb0,SpATywNh6bZuzm8s1ceuBUnMUAeoAHHw,12,7,4,0,3,9,5,1,29,4.142857142857143,2,0.0,2,4,0,3,5,9,0,5,1,9,20,0
8650,118951,TBPsTKQ0wiJelelFqXJF9QW001tGl6zy,A3fsA9Zfv1X2fVEQhTw51lKENdNrEqT3,35,28,1,50,0,0,25,1,105,15.0,3,0.0,3,1,45,0,25,0,5,25,1,49,56,1
8651,118960,TzZdxcOoymQCIG3dwqgzf7xbUV8iLHy5,SpATywNh6bZuzm8s1ceuBUnMUAeoAHHw,5,5,0,0,0,1,6,0,12,1.7142857142857142,3,0.0,0,0,0,0,5,1,0,6,0,0,12,1
8652,118971,u2BXxIc4z9dAiJXDpFgnfPpgZoYcSTcc,bWdj2GDclj5ofokWjzoa5jAwMkxCykd6,6,19,12,0,4,0,12,0,47,6.714285714285714,6,0.0,0,12,0,4,19,0,0,12,0,16,31,1
8653,118997,mlU6Sa4kvQqDwrJTiTVy3DXIlsysw3Tt,A3fsA9Zfv1X2fVEQhTw51lKENdNrEqT3,35,22,0,92,0,12,9,1,136,19.428571428571427,2,0.0,2,0,75,0,20,12,17,9,1,77,59,1
8654,118998,Xi5jJx0Z2MOBm1fPpYwlvuzwElYhyszd,G8EPVSXsOYB5YQWZGiz1aVq5Pgr2GrQu,7,9,3,0,2,0,1,0,15,2.142857142857143,1,0.0,0,3,0,2,9,0,0,1,0,5,10,1
8655,119004,3eP3vquJMvO37pCrMFuVqCWmbxwqBlGj,A3fsA9Zfv1X2fVEQhTw51lKENdNrEqT3,16,13,9,2,7,0,4,0,35,5.0,3,0.0,0,9,2,7,13,0,0,4,0,18,17,1
8656,119006,4dfnEKxHCmGabkBCiKHt5nKr3H7Bwo1x,bWdj2GDclj5ofokWjzoa5jAwMkxCykd6,4,3,1,0,1,0,1,0,6,0.8571428571428571,1,0.0,1,1,0,1,2,0,0,1,0,3,3,1
8657,119018,YlBjTpSiRd0E60X9iyws01NkNrRpj13s,SpATywNh6bZuzm8s1ceuBUnMUAeoAHHw,27,30,13,22,8,0,3,0,76,10.857142857142858,2,0.0,11,13,21,8,19,0,1,3,0,53,23,1
8658,119032,1Y8zyxJNFqsbAxngaSR4MBCJMYy7aumA,bWdj2GDclj5ofokWjzoa5jAwMkxCykd6,1,0,0,0,0,0,1,0,1,0.14285714285714285,1,0.0,0,0,0,0,0,0,0,1,0,0,1,1
8659,119045,VXXH6vGXZQbtzT48oIYSMTaYkPq1TVm5,SpATywNh6bZuzm8s1ceuBUnMUAeoAHHw,32,33,19,24,12,6,12,1,107,15.285714285714286,4,0.0,5,19,22,12,28,6,2,12,1,58,49,0
8660,119053,fS72R3kjN9mNNeiYurwm3Uc8w1dF6aYm,SpATywNh6bZuzm8s1ceuBUnMUAeoAHHw,33,79,39,24,13,18,20,1,194,27.714285714285715,10,0.0,28,39,18,13,51,18,6,20,1,98,96,0
8661,119078,JMeqbYMJuCTPv5oP8GGGEcVIzkVIeo33,G8EPVSXsOYB5YQWZGiz1aVq5Pgr2GrQu,5,2,1,0,1,0,4,0,8,1.1428571428571428,1,0.0,0,1,0,1,2,0,0,4,0,2,6,1
8662,119081,GXJYNcNV7uKT2JtMLlsgpwRjSgogNoCV,SpATywNh6bZuzm8s1ceuBUnMUAeoAHHw,16,23,11,24,0,7,9,1,75,10.714285714285714,6,0.0,7,11,18,0,16,7,6,9,1,36,39,1
8663,119083,gqAkLU7vUDjTRzHCYv88c6gFo2DAkAbW,G8EPVSXsOYB5YQWZGiz1aVq5Pgr2GrQu,8,4,2,0,2,0,5,0,13,1.8571428571428572,2,0.0,1,2,0,2,3,0,0,5,0,5,8,1
8664,119099,AcUSYBssFtIXtGaa6RbLXgLyfwfDcCt8,SpATywNh6bZuzm8s1ceuBUnMUAeoAHHw,8,2,1,0,1,0,5,1,10,1.4285714285714286,1,0.0,0,1,0,1,2,0,0,5,1,2,8,1
8665,119114,99Z3XYkjkHbSSUTlX3TBtdd4he2ej5Yp,SpATywNh6bZuzm8s1ceuBUnMUAeoAHHw,6,3,1,0,1,0,2,0,7,1.0,2,0.0,0,1,0,1,3,0,0,2,0,2,5,1
8666,119116,syYCTgfx3QIfokZD3KllJs2hnCVUuN4D,G8EPVSXsOYB5YQWZGiz1aVq5Pgr2GrQu,52,127,56,0,39,0,11,0,233,33.285714285714285,7,0.0,0,56,0,39,127,0,0,11,0,95,138,1
8667,119118,oxh7qXSiU691JDzseRI3suXHok8L6Fau,SpATywNh6bZuzm8s1ceuBUnMUAeoAHHw,1,0,0,0,0,0,1,0,1,0.14285714285714285,1,0.0,0,0,0,0,0,0,0,1,0,0,1,1
8668,119119,t1xspb1k3lEGBshWKCwAoW44MsPqXHk5,SpATywNh6bZuzm8s1ceuBUnMUAeoAHHw,1,0,0,0,0,0,1,0,1,0.14285714285714285,1,0.0,0,0,0,0,0,0,0,1,0,0,1,1
8669,119122,2GmODuvdJOOWe3lnyYMmKWQOHBH828Cm,SpATywNh6bZuzm8s1ceuBUnMUAeoAHHw,21,21,9,18,7,0,3,0,58,8.285714285714286,2,0.0,10,9,17,7,11,0,1,3,0,43,15,1
8670,119128,OUbrW18OgibVb4I41eHFiFhkobpgjEP2,bWdj2GDclj5ofokWjzoa5jAwMkxCykd6,37,34,25,0,18,0,15,0,92,13.142857142857142,6,0.0,0,25,0,18,34,0,0,15,0,43,49,0
8671,119135,LU9kxt8aKnlOn8SnA2EuX2MLajf5Sg2a,RXDvfPUBYFlVdlueBFbLW0mhhAyGEqpt,10,7,4,0,3,0,5,0,19,2.7142857142857144,2,0.0,0,4,0,3,7,0,0,5,0,7,12,1
8672,119144,ppepyuI84wHcCSvA9T6Tm0AI9MVxK9O7,SpATywNh6bZuzm8s1ceuBUnMUAeoAHHw,45,70,31,46,17,27,23,6,220,31.428571428571427,6,0.0,30,31,38,17,40,27,8,23,6,116,104,0
8673,119156,M2R4IY0V8T0jxOaASirvYDTUV5jV2Rus,bWdj2GDclj5ofokWjzoa5jAwMkxCykd6,4,2,0,0,0,0,2,0,4,0.5714285714285714,1,0.0,0,0,0,0,2,0,0,2,0,0,4,1
8674,119158,y71lRBqIdu5iPiLn9Yi5PQm6GFIvgLwB,SpATywNh6bZuzm8s1ceuBUnMUAeoAHHw,22,62,30,34,2,0,16,0,144,20.571428571428573,6,0.0,17,30,29,2,45,0,5,16,0,78,66,0
8675,119168,ekf83KLNEhO9pLixPeJLFRG8dewqTHZv,A3fsA9Zfv1X2fVEQhTw51lKENdNrEqT3,41,39,16,72,7,1,17,2,154,22.0,1,0.0,4,16,57,7,35,1,15,17,2,84,70,1
8676,119181,mu7Zdr1ChN6xNMWE8Otd7Si7TQhm7pEQ,A3fsA9Zfv1X2fVEQhTw51lKENdNrEqT3,16,37,19,0,7,0,32,0,95,13.571428571428571,7,0.0,2,19,0,7,35,0,0,32,0,28,67,1
8677,119186,3RNLJ31M9nSB8CG0xpg62lnc8uIPaM9a,A3fsA9Zfv1X2fVEQhTw51lKENdNrEqT3,1,0,0,0,0,0,1,0,1,0.14285714285714285,1,0.0,0,0,0,0,0,0,0,1,0,0,1,1
8678,119189,OXg5CDewbDZIhWJ50yEsGOqULuWAjfkH,SpATywNh6bZuzm8s1ceuBUnMUAeoAHHw,58,85,34,45,19,5,20,2,210,30.0,8,0.0,43,34,44,19,42,5,1,20,2,140,70,0
8679,119210,MgBJbfRXH0QNEJmIiGY28SpmFvbhxSoF,SpATywNh6bZuzm8s1ceuBUnMUAeoAHHw,56,97,49,38,23,10,31,0,248,35.42857142857143,10,0.0,8,49,36,23,89,10,2,31,0,116,132,0
8680,119216,jFlacyEy6lTVCBjW1JtG8q0M3te6pg5n,SpATywNh6bZuzm8s1ceuBUnMUAeoAHHw,8,8,7,0,4,0,1,0,20,2.857142857142857,1,0.0,0,7,0,4,8,0,0,1,0,11,9,1
8681,119226,62W3eQBI1VOzt0BqCcwSBPoLO4GuQy3m,SpATywNh6bZuzm8s1ceuBUnMUAeoAHHw,2,0,0,0,0,0,2,0,2,0.2857142857142857,1,0.0,0,0,0,0,0,0,0,2,0,0,2,1
8682,119227,xxkjaaKQsdSI27nMseGDTa7U8FtH9OJW,SpATywNh6bZuzm8s1ceuBUnMUAeoAHHw,1,0,0,0,0,0,2,0,2,0.2857142857142857,2,0.0,0,0,0,0,0,0,0,2,0,0,2,0
8683,119231,eZgbWFMeI0otfUV1lMfDbtMKCRIv32Fs,bWdj2GDclj5ofokWjzoa5jAwMkxCykd6,4,2,1,0,1,0,1,0,5,0.7142857142857143,1,0.0,0,1,0,1,2,0,0,1,0,2,3,1
8684,119244,l5XRpi9H4fQ2XUHeEPRXRHL6Y4BckIOB,SpATywNh6bZuzm8s1ceuBUnMUAeoAHHw,5,2,1,0,1,0,2,0,6,0.8571428571428571,1,0.0,0,1,0,1,2,0,0,2,0,2,4,1
8685,119254,i0ksX07HnsV5rQlWqOr1uKEuc7yNU24c,SpATywNh6bZuzm8s1ceuBUnMUAeoAHHw,35,63,35,16,16,30,23,2,185,26.428571428571427,12,0.0,13,35,13,16,50,30,3,23,2,77,108,0
8686,119269,NLv4FgxnCzxez4sx4x5czDhMA2RThzip,bWdj2GDclj5ofokWjzoa5jAwMkxCykd6,5,2,1,0,1,0,2,0,6,0.8571428571428571,1,0.0,0,1,0,1,2,0,0,2,0,2,4,1
8687,119277,sBmxTL0paOf5h6iJST2iiGwB52qodqPr,bWdj2GDclj5ofokWjzoa5jAwMkxCykd6,22,42,21,78,4,36,35,3,219,31.285714285714285,8,0.0,8,21,76,4,34,36,2,35,3,109,110,0
8688,119279,FOCwtnRC84DvGRNwirqX2TIHG72pPbnw,SpATywNh6bZuzm8s1ceuBUnMUAeoAHHw,26,40,21,15,0,4,11,2,93,13.285714285714286,4,0.0,5,21,15,0,35,4,0,11,2,41,52,0
8689,119282,YoVBBM37O51IO7pPJxiQFT0wqXwSlTU1,SpATywNh6bZuzm8s1ceuBUnMUAeoAHHw,1,0,0,0,0,0,2,0,2,0.2857142857142857,1,0.0,0,0,0,0,0,0,0,2,0,0,2,1
8690,119302,YRQYtB97mu5D5o5X26cOj03m1GAHWWGU,A3fsA9Zfv1X2fVEQhTw51lKENdNrEqT3,1,0,0,0,0,0,1,0,1,0.14285714285714285,1,0.0,0,0,0,0,0,0,0,1,0,0,1,1
8691,119311,o5C13ZWWgtJ11zB44EfcDF5SUBXAMxu8,SpATywNh6bZuzm8s1ceuBUnMUAeoAHHw,20,25,5,10,4,2,17,2,65,9.285714285714286,5,0.0,2,5,8,4,23,2,2,17,2,19,46,0
8692,119315,ektlnuTUH55osIRyBZ2zIfPZcGRkwXyX,SpATywNh6bZuzm8s1ceuBUnMUAeoAHHw,6,2,1,0,1,0,2,0,6,0.8571428571428571,1,0.0,0,1,0,1,2,0,0,2,0,2,4,1
8693,119318,LKEJY5MvP0gj7M4NL5iRnXDBazXBKsOA,A3fsA9Zfv1X2fVEQhTw51lKENdNrEqT3,11,14,4,0,3,0,2,0,23,3.2857142857142856,1,0.0,0,4,0,3,14,0,0,2,0,7,16,1
8694,119333,om0KjvovtBK0gZUSboAPRv5A6Jkm00Ei,SpATywNh6bZuzm8s1ceuBUnMUAeoAHHw,2,0,0,0,0,0,2,0,2,0.2857142857142857,2,0.0,0,0,0,0,0,0,0,2,0,0,2,1
8695,119347,hpQLTEd5unsxchTVftQsLrZknN9z8sq4,bWdj2GDclj5ofokWjzoa5jAwMkxCykd6,6,4,1,0,1,0,2,0,8,1.1428571428571428,1,0.0,0,1,0,1,4,0,0,2,0,2,6,1
8696,119352,8EUVcR3i03tV4r6XHeEe98sUtzrKJPIp,SpATywNh6bZuzm8s1ceuBUnMUAeoAHHw,25,25,15,12,6,2,10,0,70,10.0,7,0.0,5,15,12,6,20,2,0,10,0,38,32,0
8697,119354,dTKURyZ9dyqGbe4l7wsUGgSU85JHBAFq,SpATywNh6bZuzm8s1ceuBUnMUAeoAHHw,32,30,17,30,8,0,4,0,89,12.714285714285714,4,0.0,4,17,27,8,26,0,3,4,0,56,33,0
8698,119356,a7ZVMpb0c7CARO4liNTBsp4hgkFIkG4C,bWdj2GDclj5ofokWjzoa5jAwMkxCykd6,1,0,0,0,0,0,2,0,2,0.2857142857142857,1,0.0,0,0,0,0,0,0,0,2,0,0,2,1
8699,119380,6CE4R3S7kL46D5t23wqANpKa4VUqa9S2,SpATywNh6bZuzm8s1ceuBUnMUAeoAHHw,22,25,1,19,2,0,5,0,52,7.428571428571429,3,0.0,3,1,16,2,22,0,3,5,0,22,30,1
8700,119386,nIvIddlMAmTQagaACOulbZ6PInxlyOy2,SpATywNh6bZuzm8s1ceuBUnMUAeoAHHw,25,41,22,24,8,5,8,1,109,15.571428571428571,3,0.0,14,22,24,8,27,5,0,8,1,68,41,1
8701,119390,hZR4MwcYec4g0GoOyJFngJGEyWOySpv2,A3fsA9Zfv1X2fVEQhTw51lKENdNrEqT3,10,16,10,0,6,15,16,0,63,9.0,7,0.0,0,10,0,6,16,15,0,16,0,16,47,0
8702,119391,mxHDkP66knN7zmdYEUQKDHYwEophbx3W,SpATywNh6bZuzm8s1ceuBUnMUAeoAHHw,46,81,28,25,17,135,22,4,312,44.57142857142857,9,0.0,15,28,23,17,66,135,2,22,4,83,229,0
8703,119429,OTXI4wiLpFntQK2eNytsM7PA1sOBHBSJ,G8EPVSXsOYB5YQWZGiz1aVq5Pgr2GrQu,14,39,3,40,6,7,2,0,97,13.857142857142858,2,0.0,23,3,32,6,16,7,8,2,0,64,33,0
8704,119430,dHUuZjpItF11lyBzOZmo46k7ssSyfCST,SpATywNh6bZuzm8s1ceuBUnMUAeoAHHw,7,5,3,0,2,0,2,0,12,1.7142857142857142,1,0.0,0,3,0,2,5,0,0,2,0,5,7,1
8705,119439,lzAfN1BunM1OtPEKsFi16ad7rFshkF39,A3fsA9Zfv1X2fVEQhTw51lKENdNrEqT3,10,5,3,0,2,0,7,0,17,2.4285714285714284,1,0.0,0,3,0,2,5,0,0,7,0,5,12,1
8706,119467,HTcH1TxkMChxNxwRHZ3kkRRHs5Azwnka,SpATywNh6bZuzm8s1ceuBUnMUAeoAHHw,14,47,7,24,1,10,19,0,108,15.428571428571429,3,0.0,14,7,20,1,33,10,4,19,0,42,66,0
8707,119487,pPq1reHOvROgjdMRqZ7zZoFjsUW0sHcE,SpATywNh6bZuzm8s1ceuBUnMUAeoAHHw,8,21,12,0,6,0,7,0,46,6.571428571428571,2,0.0,0,12,0,6,21,0,0,7,0,18,28,1
8708,119490,83cBV2IXkwoW1nUaa1kxaJ98L3bxFsPn,RXDvfPUBYFlVdlueBFbLW0mhhAyGEqpt,28,84,58,16,2,31,23,2,216,30.857142857142858,11,0.0,8,58,15,2,76,31,1,23,2,83,133,1
8709,119494,4SbF4DhXcYorYYyJ4XmwwPJZFVh1ZUhY,bWdj2GDclj5ofokWjzoa5jAwMkxCykd6,2,0,0,0,0,0,2,0,2,0.2857142857142857,1,0.0,0,0,0,0,0,0,0,2,0,0,2,1
8710,119495,QXg7RHDSlJliIBbIO3xqJ8cmekKDZLIJ,RXDvfPUBYFlVdlueBFbLW0mhhAyGEqpt,1,0,0,0,0,0,1,0,1,0.14285714285714285,1,0.0,0,0,0,0,0,0,0,1,0,0,1,1
8711,119499,j55CnsxXtuPHDTIgqOvx7oExU3RRtQ4I,bWdj2GDclj5ofokWjzoa5jAwMkxCykd6,1,0,0,0,0,0,1,0,1,0.14285714285714285,1,0.0,0,0,0,0,0,0,0,1,0,0,1,1
8712,119506,KouA4JUz2i1n0FC6Xu2JucWPd7vnGUb0,SpATywNh6bZuzm8s1ceuBUnMUAeoAHHw,53,137,22,43,15,1,42,0,260,37.142857142857146,14,0.0,12,22,37,15,125,1,6,42,0,86,174,0
8713,119509,8MuGb55gUM18pukCITXgZoTSobqXs9G4,SpATywNh6bZuzm8s1ceuBUnMUAeoAHHw,11,10,0,14,0,2,5,0,31,4.428571428571429,4,0.0,2,0,13,0,8,2,1,5,0,15,16,1
8714,119522,VC4hf15u71ct6dl0hPNvhbtubU19kXe5,RXDvfPUBYFlVdlueBFbLW0mhhAyGEqpt,8,17,2,0,3,0,4,0,26,3.7142857142857144,2,0.0,4,2,0,3,13,0,0,4,0,9,17,1
8715,119524,RRKT0H2BFDE1dQIQFr3IpZgVIVSJVg71,SpATywNh6bZuzm8s1ceuBUnMUAeoAHHw,56,104,44,47,15,12,30,1,253,36.142857142857146,13,0.0,30,44,39,15,74,12,8,30,1,128,125,0
8716,119543,Cf7GCeUZzG7WjvUIyGfwv9hfcwXPVq5G,G8EPVSXsOYB5YQWZGiz1aVq5Pgr2GrQu,154,332,12,423,10,0,37,1,815,116.42857142857143,15,0.0,62,12,351,10,270,0,72,37,1,435,380,0
8717,119566,TeehsynnhYxXCw31hnpNtyZisOmQoW1M,A3fsA9Zfv1X2fVEQhTw51lKENdNrEqT3,12,11,9,0,7,0,5,0,32,4.571428571428571,1,0.0,0,9,0,7,11,0,0,5,0,16,16,1
8718,119567,Dl433WBzpFXMdRxwA66dmtxmpsyN7fkX,SpATywNh6bZuzm8s1ceuBUnMUAeoAHHw,21,40,8,0,3,0,15,0,66,9.428571428571429,11,0.0,0,8,0,3,40,0,0,15,0,11,55,0
8719,119571,sZV7O4QepCcao3DEyr879t5mUWopWkVJ,SpATywNh6bZuzm8s1ceuBUnMUAeoAHHw,25,28,12,28,6,0,4,0,78,11.142857142857142,3,0.0,10,12,27,6,18,0,1,4,0,55,23,0
8720,119594,LKtddpPnbyASKztptrkj08yJIKu8wvyQ,SpATywNh6bZuzm8s1ceuBUnMUAeoAHHw,7,10,2,0,2,0,3,0,17,2.4285714285714284,2,0.0,0,2,0,2,10,0,0,3,0,4,13,1
8721,119600,SSpeewBDHUNKkvUJM5ASinNHvMXIOEwr,G8EPVSXsOYB5YQWZGiz1aVq5Pgr2GrQu,2,0,0,0,0,2,1,0,3,0.42857142857142855,1,0.0,0,0,0,0,0,2,0,1,0,0,3,1
8722,119618,nIvIddlMAmTQagaACOulbZ6PInxlyOy2,A3fsA9Zfv1X2fVEQhTw51lKENdNrEqT3,9,10,6,0,3,0,2,0,21,3.0,2,0.0,3,6,0,3,7,0,0,2,0,12,9,1
8723,119619,nIvIddlMAmTQagaACOulbZ6PInxlyOy2,bWdj2GDclj5ofokWjzoa5jAwMkxCykd6,5,2,1,0,1,0,3,0,7,1.0,2,0.0,0,1,0,1,2,0,0,3,0,2,5,1
8724,119631,ltVEinCK1OZ9CXJhcqdDg6iZlAvKKTwQ,SpATywNh6bZuzm8s1ceuBUnMUAeoAHHw,22,31,16,16,7,8,20,3,101,14.428571428571429,4,0.0,8,16,13,7,23,8,3,20,3,44,57,0
8725,119652,Zu9dYhL9acZhCeqBcc9hWzPmaWR78jEQ,SpATywNh6bZuzm8s1ceuBUnMUAeoAHHw,27,31,16,28,8,23,23,4,133,19.0,4,0.0,8,16,26,8,23,23,2,23,4,58,75,1
8726,119657,3uRdpkkFK8afBf0m3EhgoX6LxrN8Pbes,SpATywNh6bZuzm8s1ceuBUnMUAeoAHHw,7,4,2,0,1,0,2,0,9,1.2857142857142858,1,0.0,0,2,0,1,4,0,0,2,0,3,6,1
8727,119664,8pu9JNwVnUBnBwmPCcdXCPyTfkNF9IyH,SpATywNh6bZuzm8s1ceuBUnMUAeoAHHw,1,0,0,0,0,0,1,0,1,0.14285714285714285,1,0.0,0,0,0,0,0,0,0,1,0,0,1,1
8728,119695,EGp6xRzNCnsCPDRg0mfvtfy8t2jZt4I9,SpATywNh6bZuzm8s1ceuBUnMUAeoAHHw,61,152,45,76,24,14,19,0,330,47.142857142857146,8,0.0,96,45,64,24,56,14,12,19,0,229,101,0
8729,119701,dkqBzIxmPMIDvZ06VSkMjfODuMzZmTP8,A3fsA9Zfv1X2fVEQhTw51lKENdNrEqT3,17,33,21,0,12,0,5,0,71,10.142857142857142,5,0.0,0,21,0,12,33,0,0,5,0,33,38,1
8730,119717,uNXbTIc96Uw6O7qA5DEUx7vv6h22TWxF,SpATywNh6bZuzm8s1ceuBUnMUAeoAHHw,5,2,1,0,1,0,2,0,6,0.8571428571428571,1,0.0,0,1,0,1,2,0,0,2,0,2,4,1
8731,119722,xdLtxzmqjHKGxCxWUtaHyGHCjlQjqauy,SpATywNh6bZuzm8s1ceuBUnMUAeoAHHw,5,2,1,0,1,0,2,0,6,0.8571428571428571,1,0.0,0,1,0,1,2,0,0,2,0,2,4,1
8732,119745,UvgRbw5a5wuG6YWcUt1dwOeNyn0b7Smd,SpATywNh6bZuzm8s1ceuBUnMUAeoAHHw,12,19,3,4,3,0,6,0,35,5.0,6,0.0,3,3,4,3,16,0,0,6,0,13,22,1
8733,119756,xdLtxzmqjHKGxCxWUtaHyGHCjlQjqauy,RXDvfPUBYFlVdlueBFbLW0mhhAyGEqpt,6,1,1,0,1,0,3,0,6,0.8571428571428571,1,0.0,0,1,0,1,1,0,0,3,0,2,4,1
8734,119780,6r9w9XrCXpAInFHxfDIxOD9m18cX5jcd,bWdj2GDclj5ofokWjzoa5jAwMkxCykd6,1,0,0,0,0,0,1,0,1,0.14285714285714285,1,0.0,0,0,0,0,0,0,0,1,0,0,1,1
8735,119787,lWx0TIRF08ECAhAH5cUKSzERq6JEXGBg,A3fsA9Zfv1X2fVEQhTw51lKENdNrEqT3,1,0,0,0,0,0,1,0,1,0.14285714285714285,1,0.0,0,0,0,0,0,0,0,1,0,0,1,1
8736,119829,evMifCtMisukBDxvYkui0DyIUgVf4aQM,SpATywNh6bZuzm8s1ceuBUnMUAeoAHHw,1,0,0,0,0,0,1,0,1,0.14285714285714285,1,0.0,0,0,0,0,0,0,0,1,0,0,1,1
8737,119831,xrGttsK9FjNRictE1FckUAFqkfpHfKEh,bWdj2GDclj5ofokWjzoa5jAwMkxCykd6,13,14,8,64,3,2,4,2,97,13.857142857142858,1,0.0,1,8,63,3,13,2,1,4,2,75,22,1
8738,119853,uF2Lhc31StnMPtUmgamWrmnuCJ4n9iAe,bWdj2GDclj5ofokWjzoa5jAwMkxCykd6,7,2,1,0,1,1,5,1,11,1.5714285714285714,1,0.0,0,1,0,1,2,1,0,5,1,2,9,0
8739,119860,zvwdGnH0aGIXM4GZVb8XpCl4QdIDbhPS,G8EPVSXsOYB5YQWZGiz1aVq5Pgr2GrQu,71,139,68,67,47,34,39,4,398,56.857142857142854,8,0.0,38,68,59,47,101,34,8,39,4,212,186,1
8740,119863,C8zDhaG0vPsQegBtS55u3JZHiYuueFnE,A3fsA9Zfv1X2fVEQhTw51lKENdNrEqT3,22,28,3,14,1,3,29,3,81,11.571428571428571,9,0.0,0,3,12,1,28,3,2,29,3,16,65,0
8741,119864,i9tnH9kRJ3DOJJRtKKsLYacNrvT4eUwS,SpATywNh6bZuzm8s1ceuBUnMUAeoAHHw,1,0,0,0,0,0,1,0,1,0.14285714285714285,1,0.0,0,0,0,0,0,0,0,1,0,0,1,1
8742,119865,fl8sEptrcl2JvFWXejFcnsM7BqWtKl9w,SpATywNh6bZuzm8s1ceuBUnMUAeoAHHw,43,82,35,43,16,0,11,2,189,27.0,6,0.0,26,35,30,16,56,0,13,11,2,107,82,1
8743,119866,VLCI0RtMsYSrwlXRiyKxAF4TijVOF7sG,SpATywNh6bZuzm8s1ceuBUnMUAeoAHHw,23,83,14,18,2,15,11,2,145,20.714285714285715,6,0.0,34,14,18,2,49,15,0,11,2,68,77,0
8744,119941,5rpYxIaCTDb4PhszkJWpACOx5VMpNGcQ,RXDvfPUBYFlVdlueBFbLW0mhhAyGEqpt,1,0,0,0,0,0,1,0,1,0.14285714285714285,1,0.0,0,0,0,0,0,0,0,1,0,0,1,1
8745,119944,ico4mWfX6sj6OUii1pav0Sth51UYo7la,SpATywNh6bZuzm8s1ceuBUnMUAeoAHHw,43,48,32,26,21,0,5,0,132,18.857142857142858,4,0.0,12,32,24,21,36,0,2,5,0,89,43,1
8746,119957,u08BFRXkclhXgm6zX4b6QASKB5vRi3vI,G8EPVSXsOYB5YQWZGiz1aVq5Pgr2GrQu,84,140,83,539,31,28,30,2,853,121.85714285714286,7,0.0,42,83,510,31,98,28,29,30,2,666,187,1
8747,119963,CjBVUSApACPW9BPUvs2DTjIpAnotUs5g,SpATywNh6bZuzm8s1ceuBUnMUAeoAHHw,14,18,1,19,1,1,9,1,50,7.142857142857143,1,0.0,11,1,16,1,7,1,3,9,1,29,21,1
8748,119979,SplRKhPt7Yggv7MXNRiesXXwYzrLK9vJ,G8EPVSXsOYB5YQWZGiz1aVq5Pgr2GrQu,4,3,1,0,1,0,1,0,6,0.8571428571428571,3,0.0,0,1,0,1,3,0,0,1,0,2,4,1
8749,119986,EjqS3A2Iv9J8JTjinbKy3gdtrrXaSQyJ,A3fsA9Zfv1X2fVEQhTw51lKENdNrEqT3,27,45,18,42,0,0,2,0,107,15.285714285714286,2,0.0,3,18,39,0,42,0,3,2,0,60,47,1
8750,120002,12gMTBWTVUlnqCedZPd5qmMR4GGhf0zr,SpATywNh6bZuzm8s1ceuBUnMUAeoAHHw,5,4,2,0,0,0,2,1,9,1.2857142857142858,1,0.0,0,2,0,0,4,0,0,2,1,2,7,1
8751,120012,i2raPzmlvNePAOSFdEUwI0BA2bKyQ3vM,G8EPVSXsOYB5YQWZGiz1aVq5Pgr2GrQu,1,0,0,0,0,0,1,0,1,0.14285714285714285,1,0.0,0,0,0,0,0,0,0,1,0,0,1,1
8752,120030,OCy6YOUNXmqhix568ujBGQdiiP42aDkJ,A3fsA9Zfv1X2fVEQhTw51lKENdNrEqT3,2,0,0,0,0,0,2,0,2,0.2857142857142857,1,0.0,0,0,0,0,0,0,0,2,0,0,2,1
8753,120034,ZdyJOuWyQCEC2K6zkBmHBJ8KuSKqmluL,SpATywNh6bZuzm8s1ceuBUnMUAeoAHHw,1,0,0,0,0,0,1,0,1,0.14285714285714285,1,0.0,0,0,0,0,0,0,0,1,0,0,1,1
8754,120045,sUwmc6V8FwsEYMDv4tIg9OLo8ph5JoxU,SpATywNh6bZuzm8s1ceuBUnMUAeoAHHw,21,21,13,25,11,1,4,1,76,10.857142857142858,1,0.0,6,13,20,11,15,1,5,4,1,50,26,1
8755,120047,YeW4hKsNTCNPhFuRao1EDcfgQ0cnIKSL,SpATywNh6bZuzm8s1ceuBUnMUAeoAHHw,30,42,20,37,9,2,8,0,118,16.857142857142858,4,0.0,11,20,31,9,31,2,6,8,0,71,47,0
8756,120057,UUY3BPLR7A3Xa6FGsztMCn6xCbxtdCYu,RXDvfPUBYFlVdlueBFbLW0mhhAyGEqpt,1,0,0,0,0,0,1,0,1,0.14285714285714285,1,0.0,0,0,0,0,0,0,0,1,0,0,1,0
8757,120065,fFuKiCeoQQwOgD8VAud2ta198Mbq05KK,A3fsA9Zfv1X2fVEQhTw51lKENdNrEqT3,19,31,14,0,9,4,12,1,71,10.142857142857142,4,0.0,0,14,0,9,31,4,0,12,1,23,48,1
8758,120079,L8OTKfJAxDSZZQ12fQtkWrcZUlsGAJb9,RXDvfPUBYFlVdlueBFbLW0mhhAyGEqpt,18,29,9,24,5,4,15,0,86,12.285714285714286,3,0.0,8,9,24,5,21,4,0,15,0,46,40,1
8759,120090,ZOVfvlm206voHlGJ4V6McNGjtxTxB7JQ,bWdj2GDclj5ofokWjzoa5jAwMkxCykd6,5,4,2,0,1,0,3,0,10,1.4285714285714286,2,0.0,0,2,0,1,4,0,0,3,0,3,7,1
8760,120094,rn4nO5004kgupfgjaXh0qv5wJPGuOGCi,RXDvfPUBYFlVdlueBFbLW0mhhAyGEqpt,63,173,6,135,40,3,17,1,375,53.57142857142857,4,0.0,94,6,112,40,79,3,23,17,1,252,123,1
8761,120112,1mkiIDsUp1k3i5MLWwlZyMuhsxinTdaD,SpATywNh6bZuzm8s1ceuBUnMUAeoAHHw,2,0,0,0,0,0,2,0,2,0.2857142857142857,1,0.0,0,0,0,0,0,0,0,2,0,0,2,0
8762,120117,rZEWlNSgKDNaTi3a1r581EGtpdBLkfvY,bWdj2GDclj5ofokWjzoa5jAwMkxCykd6,4,2,1,0,1,6,1,0,11,1.5714285714285714,1,0.0,0,1,0,1,2,6,0,1,0,2,9,1
8763,120128,5cb6e9jDwVr8l5vkAvM3VmmyddxE34Qz,SpATywNh6bZuzm8s1ceuBUnMUAeoAHHw,13,8,5,13,3,0,1,0,30,4.285714285714286,1,0.0,2,5,13,3,6,0,0,1,0,23,7,1
8764,120139,n82RJkzFXSSDMIdkMmtipPuRNBWDUBXQ,SpATywNh6bZuzm8s1ceuBUnMUAeoAHHw,16,33,16,14,5,0,10,3,81,11.571428571428571,3,0.0,5,16,12,5,28,0,2,10,3,38,43,1
8765,120168,oXcCXnNaPGvzw5MpNzQ49lDnTqlhdcyO,A3fsA9Zfv1X2fVEQhTw51lKENdNrEqT3,8,5,3,0,2,0,3,0,13,1.8571428571428572,2,0.0,0,3,0,2,5,0,0,3,0,5,8,1
8766,120195,1LkX4t7QGG0LPbqqJvnwJmrweFNAYkvm,A3fsA9Zfv1X2fVEQhTw51lKENdNrEqT3,12,12,1,0,0,0,10,2,25,3.5714285714285716,4,0.0,0,1,0,0,12,0,0,10,2,1,24,1
8767,120215,UnBwSmlOPbYUmVq2fUKodPbT52jzjDn0,A3fsA9Zfv1X2fVEQhTw51lKENdNrEqT3,23,18,16,0,12,0,3,0,49,7.0,2,0.0,0,16,0,12,18,0,0,3,0,28,21,0
8768,120223,nrDkIZH2wqEVh6i4pBxcbRBJIMc9s20b,G8EPVSXsOYB5YQWZGiz1aVq5Pgr2GrQu,101,137,7,332,8,0,34,0,518,74.0,10,0.0,42,7,299,8,95,0,33,34,0,356,162,0
8769,120226,Y9zzxa8aT5mj3vCCOFRszZ8rRbH90TaX,SpATywNh6bZuzm8s1ceuBUnMUAeoAHHw,5,2,1,0,1,0,2,0,6,0.8571428571428571,1,0.0,0,1,0,1,2,0,0,2,0,2,4,1
8770,120232,RYd1k9DojojPZwrkV3NjsTI5OdZnPV9W,SpATywNh6bZuzm8s1ceuBUnMUAeoAHHw,12,21,0,12,2,0,5,0,40,5.714285714285714,2,0.0,2,0,12,2,19,0,0,5,0,16,24,0
8771,120235,RYd1k9DojojPZwrkV3NjsTI5OdZnPV9W,RXDvfPUBYFlVdlueBFbLW0mhhAyGEqpt,8,17,0,0,0,0,6,0,23,3.2857142857142856,4,0.0,0,0,0,0,17,0,0,6,0,0,23,1
8772,120239,80Av2RXrFoxNOdv7EQUM2TDOM0gyNH0J,SpATywNh6bZuzm8s1ceuBUnMUAeoAHHw,32,45,19,27,10,15,8,0,124,17.714285714285715,4,0.0,4,19,23,10,41,15,4,8,0,56,68,1
8773,120266,kV6dnmPo3GuG7esOG3uZN9iddNOehLbM,SpATywNh6bZuzm8s1ceuBUnMUAeoAHHw,18,30,2,7,1,4,14,2,60,8.571428571428571,3,0.0,5,2,7,1,25,4,0,14,2,15,45,1
8774,120275,wx3mAGKFM6cge9w8piWfsYKppmWVhkYO,A3fsA9Zfv1X2fVEQhTw51lKENdNrEqT3,20,25,13,0,9,0,5,0,52,7.428571428571429,4,0.0,0,13,0,9,25,0,0,5,0,22,30,1
8775,120282,nWkYRwHsKkKnBVjIvOv2LYBdEyL0lZTL,A3fsA9Zfv1X2fVEQhTw51lKENdNrEqT3,6,9,1,0,1,0,2,0,13,1.8571428571428572,1,0.0,0,1,0,1,9,0,0,2,0,2,11,1
8776,120288,MWFzxiL4ehMt7chFh9qPkkqOh2NLyxIv,bWdj2GDclj5ofokWjzoa5jAwMkxCykd6,2,0,0,0,0,0,2,0,2,0.2857142857142857,1,0.0,0,0,0,0,0,0,0,2,0,0,2,1
8777,120297,7xobbz91DmuqnSowtdCPvlArDkv1wvpY,bWdj2GDclj5ofokWjzoa5jAwMkxCykd6,20,22,3,36,5,1,23,2,92,13.142857142857142,5,0.0,6,3,32,5,16,1,4,23,2,46,46,0
8778,120300,8ZCGZdwxBMJVwPZ7vVYEdVzHcXfqVToG,SpATywNh6bZuzm8s1ceuBUnMUAeoAHHw,26,29,7,39,4,24,14,3,120,17.142857142857142,2,0.0,9,7,34,4,20,24,5,14,3,54,66,1
8779,120301,R65nId6muEQL5ltvz9x70wBSJAG43Ylw,SpATywNh6bZuzm8s1ceuBUnMUAeoAHHw,1,0,0,0,0,0,1,0,1,0.14285714285714285,1,0.0,0,0,0,0,0,0,0,1,0,0,1,1
8780,120312,1cbn6mbdbvkgaRHmtNkyztYkaJcKUMeq,A3fsA9Zfv1X2fVEQhTw51lKENdNrEqT3,26,6,4,88,1,0,9,0,108,15.428571428571429,2,0.0,2,4,73,1,4,0,15,9,0,80,28,1
8781,120319,SslryCWQFxjgJq7Qzkpxu4WYyOvHjfIA,SpATywNh6bZuzm8s1ceuBUnMUAeoAHHw,12,19,0,10,0,0,5,0,34,4.857142857142857,2,0.0,2,0,9,0,17,0,1,5,0,11,23,1
8782,120324,BFpj8Vxul230N4kCbxR9rjWJ12ZQLtAV,RXDvfPUBYFlVdlueBFbLW0mhhAyGEqpt,18,38,2,0,3,0,8,1,52,7.428571428571429,4,0.0,2,2,0,3,36,0,0,8,1,7,45,0
8783,120327,gxxdbeVvaQEKyOVBSC4fF8ei2zEnQClv,SpATywNh6bZuzm8s1ceuBUnMUAeoAHHw,7,3,3,0,2,0,3,0,11,1.5714285714285714,1,0.0,0,3,0,2,3,0,0,3,0,5,6,1
8784,120357,v5FeWqSlnditqY6z5ibAMUPKlbcY2Zcg,bWdj2GDclj5ofokWjzoa5jAwMkxCykd6,1,0,0,0,0,0,1,0,1,0.14285714285714285,1,0.0,0,0,0,0,0,0,0,1,0,0,1,1
8785,120395,jFlacyEy6lTVCBjW1JtG8q0M3te6pg5n,RXDvfPUBYFlVdlueBFbLW0mhhAyGEqpt,4,3,2,0,1,0,1,0,7,1.0,1,0.0,0,2,0,1,3,0,0,1,0,3,4,1
8786,120424,PazYalgu71qbC99y9FrRjNpcniWiR2x1,RXDvfPUBYFlVdlueBFbLW0mhhAyGEqpt,15,18,9,0,5,0,6,2,40,5.714285714285714,2,0.0,0,9,0,5,18,0,0,6,2,14,26,1
8787,120452,5PCeecJ7dPIRTUfiwjNNMWT45OJxiKsA,SpATywNh6bZuzm8s1ceuBUnMUAeoAHHw,24,37,19,43,7,0,5,0,111,15.857142857142858,3,0.0,13,19,34,7,24,0,9,5,0,73,38,1
8788,120497,pb5Jjq3Ash9pKloUfJAc3dsHOjXwUSUN,SpATywNh6bZuzm8s1ceuBUnMUAeoAHHw,4,8,0,0,0,0,5,0,13,1.8571428571428572,3,0.0,0,0,0,0,8,0,0,5,0,0,13,1
8789,120499,5scsz5bGh8T1roTXhO7UpMXlEDKIsK9l,SpATywNh6bZuzm8s1ceuBUnMUAeoAHHw,52,85,34,52,20,10,13,1,215,30.714285714285715,6,0.0,24,34,45,20,61,10,7,13,1,123,92,1
8790,120528,QHRLeTLFcpDFqErTvT3KvB62zPnO9tRZ,SpATywNh6bZuzm8s1ceuBUnMUAeoAHHw,4,4,0,0,0,0,1,0,5,0.7142857142857143,1,0.0,0,0,0,0,4,0,0,1,0,0,5,1
8791,120544,OektSQ9TNN3cEy3ZKuUs35c7BdSOqtaQ,bWdj2GDclj5ofokWjzoa5jAwMkxCykd6,7,11,6,0,1,0,9,0,27,3.857142857142857,2,0.0,0,6,0,1,11,0,0,9,0,7,20,1
8792,120579,s7QoBInBc5uVUNfTUCWn8dY2DMQUeNQJ,SpATywNh6bZuzm8s1ceuBUnMUAeoAHHw,6,1,1,0,1,1,3,1,8,1.1428571428571428,1,0.0,0,1,0,1,1,1,0,3,1,2,6,1
8793,120583,cOTtp4pVPpt9GEFdMZaLCIG1IBXouqo8,SpATywNh6bZuzm8s1ceuBUnMUAeoAHHw,2,0,0,0,0,0,2,0,2,0.2857142857142857,1,0.0,0,0,0,0,0,0,0,2,0,0,2,1
8794,120613,o5eh9IEuVj6wwGOFQd5A60hJwFcyh5aW,SpATywNh6bZuzm8s1ceuBUnMUAeoAHHw,2,0,0,0,0,0,2,0,2,0.2857142857142857,1,0.0,0,0,0,0,0,0,0,2,0,0,2,1
8795,120641,bVdTa6NU9Mptus5JV6dyU7pKOHw1EO1M,bWdj2GDclj5ofokWjzoa5jAwMkxCykd6,1,0,0,0,0,0,1,0,1,0.14285714285714285,1,0.0,0,0,0,0,0,0,0,1,0,0,1,1
8796,120666,NTsLMBrSdSgh32E5eAwn0TyewK2E1eGS,A3fsA9Zfv1X2fVEQhTw51lKENdNrEqT3,1,0,0,0,0,0,1,0,1,0.14285714285714285,1,0.0,0,0,0,0,0,0,0,1,0,0,1,1
8797,120674,cR6ka5k7tAsfYo9cLOUPkpzWO6OItcGJ,G8EPVSXsOYB5YQWZGiz1aVq5Pgr2GrQu,29,30,24,6,17,0,7,0,84,12.0,3,0.0,0,24,5,17,30,0,1,7,0,46,38,1
8798,120675,CaJSrSiICAfSlo2FFV44vmQh9prPvDrE,A3fsA9Zfv1X2fVEQhTw51lKENdNrEqT3,12,12,5,0,3,0,6,0,26,3.7142857142857144,1,0.0,0,5,0,3,12,0,0,6,0,8,18,1
8799,120686,u5ObOMoHUcvVsOQTGkiv0BRKKcn8v2w8,bWdj2GDclj5ofokWjzoa5jAwMkxCykd6,7,7,5,0,3,0,2,0,17,2.4285714285714284,2,0.0,0,5,0,3,7,0,0,2,0,8,9,1
8800,120697,FJyrOX14z7chWU6pIsUghN5yUhlIZ5Lj,SpATywNh6bZuzm8s1ceuBUnMUAeoAHHw,3,2,0,0,0,0,2,0,4,0.5714285714285714,1,0.0,0,0,0,0,2,0,0,2,0,0,4,0
8801,120703,4dodDlxC4kpDOhgavFhn4UZKBioEfZ2a,SpATywNh6bZuzm8s1ceuBUnMUAeoAHHw,17,46,2,20,2,18,37,5,130,18.571428571428573,4,0.0,25,2,17,2,21,18,3,37,5,46,84,1
8802,120716,RhtPF62U20vYvwTeCimLFb40aCkmO2cH,SpATywNh6bZuzm8s1ceuBUnMUAeoAHHw,5,2,1,0,1,0,2,0,6,0.8571428571428571,1,0.0,0,1,0,1,2,0,0,2,0,2,4,1
8803,120722,1R1zO9aMB7Mx1Lw84JzsChVEV5JpwmZv,G8EPVSXsOYB5YQWZGiz1aVq5Pgr2GrQu,75,113,21,166,17,12,26,0,355,50.714285714285715,10,0.0,37,21,121,17,76,12,45,26,0,196,159,1
8804,120751,fTZGf1uwMtb2LTyvoTILgCp8LRW0SKIe,RXDvfPUBYFlVdlueBFbLW0mhhAyGEqpt,11,21,9,18,8,0,1,0,57,8.142857142857142,4,0.0,9,9,15,8,12,0,3,1,0,41,16,1
8805,120759,yTPVosjRFgkyQAyVowXjYrsQYKByzY4B,A3fsA9Zfv1X2fVEQhTw51lKENdNrEqT3,20,19,1,56,0,29,7,1,113,16.142857142857142,3,0.0,4,1,44,0,15,29,12,7,1,49,64,1
8806,120771,IvdoAzckjyWWCkzCy6V0BjWvOwMyZEwg,bWdj2GDclj5ofokWjzoa5jAwMkxCykd6,30,36,20,63,8,14,22,2,165,23.571428571428573,7,0.0,7,20,62,8,29,14,1,22,2,97,68,1
8807,120774,7hx1Kw9WXBMDyaoF5WfFzTdCBmNZ2uMk,SpATywNh6bZuzm8s1ceuBUnMUAeoAHHw,26,66,12,18,6,20,39,4,165,23.571428571428573,7,0.0,18,12,15,6,48,20,3,39,4,51,114,1
8808,120788,qwhxcjW9iIMBAQoGSWDtst34AFkcFQoV,G8EPVSXsOYB5YQWZGiz1aVq5Pgr2GrQu,6,6,3,0,0,0,5,0,14,2.0,3,0.0,0,3,0,0,6,0,0,5,0,3,11,0
8809,120808,OTAUIgoWBEWsq2kd8lnvB0dKpj3SXEdR,SpATywNh6bZuzm8s1ceuBUnMUAeoAHHw,24,40,22,16,10,22,14,2,126,18.0,6,0.0,12,22,15,10,28,22,1,14,2,59,67,1
8810,120815,qwhxcjW9iIMBAQoGSWDtst34AFkcFQoV,A3fsA9Zfv1X2fVEQhTw51lKENdNrEqT3,14,41,21,0,5,1,15,0,83,11.857142857142858,6,0.0,0,21,0,5,41,1,0,15,0,26,57,0
8811,120818,hn9Zjyg7I7mBsVCg91jyZTDh6RPM5yRT,G8EPVSXsOYB5YQWZGiz1aVq5Pgr2GrQu,2,0,0,0,0,0,3,0,3,0.42857142857142855,3,0.0,0,0,0,0,0,0,0,3,0,0,3,0
8812,120824,tCQ9JALurTpI0v0jgUfmOoOzw21YvN4S,SpATywNh6bZuzm8s1ceuBUnMUAeoAHHw,1,0,0,0,0,0,1,0,1,0.14285714285714285,1,0.0,0,0,0,0,0,0,0,1,0,0,1,1
8813,120835,EaFWRMbtKR52j7nbPydGVwuzgPsml9aN,A3fsA9Zfv1X2fVEQhTw51lKENdNrEqT3,12,13,7,2,0,7,19,1,49,7.0,4,0.0,0,7,2,0,13,7,0,19,1,9,40,1
8814,120839,A1aBNAF3YIuzOOCwNaMQAGMwKE189BXm,bWdj2GDclj5ofokWjzoa5jAwMkxCykd6,6,5,1,38,2,0,2,0,48,6.857142857142857,1,0.0,3,1,36,2,2,0,2,2,0,42,6,1
8815,120845,W8fFTJpe1dBAUeFKonCjFttbIjzEdynN,bWdj2GDclj5ofokWjzoa5jAwMkxCykd6,1,0,0,0,0,0,1,0,1,0.14285714285714285,1,0.0,0,0,0,0,0,0,0,1,0,0,1,1
8816,120853,DPc69RrqfbFv98j4qSzKI4WCbxWESHfA,SpATywNh6bZuzm8s1ceuBUnMUAeoAHHw,5,2,1,0,1,0,2,0,6,0.8571428571428571,1,0.0,0,1,0,1,2,0,0,2,0,2,4,1
8817,120854,fl8sEptrcl2JvFWXejFcnsM7BqWtKl9w,A3fsA9Zfv1X2fVEQhTw51lKENdNrEqT3,7,5,1,0,1,0,4,0,11,1.5714285714285714,2,0.0,0,1,0,1,5,0,0,4,0,2,9,1
8818,120861,bRG3KNKPz8MtEb5G1Duc4i5IiNMa8ZLU,G8EPVSXsOYB5YQWZGiz1aVq5Pgr2GrQu,5,4,1,0,0,0,1,0,6,0.8571428571428571,1,0.0,0,1,0,0,4,0,0,1,0,1,5,1
8819,120866,mVNF27p0nlEqUBMpiQFD5RxVmxKtsSbe,bWdj2GDclj5ofokWjzoa5jAwMkxCykd6,1,0,0,0,0,0,1,0,1,0.14285714285714285,1,0.0,0,0,0,0,0,0,0,1,0,0,1,1
8820,120891,ABAPRQWSFErhHUFQsJmCoj4Rpg4DtQ8w,A3fsA9Zfv1X2fVEQhTw51lKENdNrEqT3,13,44,20,0,13,0,10,0,87,12.428571428571429,2,0.0,1,20,0,13,43,0,0,10,0,34,53,1
8821,120892,pAkhnLI0s5vboktZycO7Tobv6jbspULh,SpATywNh6bZuzm8s1ceuBUnMUAeoAHHw,45,79,54,0,32,0,24,1,190,27.142857142857142,15,0.0,0,54,0,32,79,0,0,24,1,86,104,1
8822,120894,dQweEcdBCmNmUPOeO7X4TTmH8zuMq2aJ,A3fsA9Zfv1X2fVEQhTw51lKENdNrEqT3,13,19,9,0,2,7,13,0,50,7.142857142857143,4,0.0,1,9,0,2,18,7,0,13,0,12,38,1
8823,120906,Z9nbZek76s4RBuA56w1WtME3e9ClZkaP,A3fsA9Zfv1X2fVEQhTw51lKENdNrEqT3,41,28,21,58,11,16,5,1,140,20.0,3,0.0,1,21,50,11,27,16,8,5,1,83,57,0
8824,120907,m83RtezfCwMfEmG0rXtpbc1svhl7ugt0,SpATywNh6bZuzm8s1ceuBUnMUAeoAHHw,4,3,1,0,1,0,1,0,6,0.8571428571428571,1,0.0,0,1,0,1,3,0,0,1,0,2,4,1
8825,120909,aldLXGpzmiip2CUSDhqN8A5UpGMVUHxY,A3fsA9Zfv1X2fVEQhTw51lKENdNrEqT3,68,54,40,118,13,0,17,0,242,34.57142857142857,11,0.0,4,40,111,13,50,0,7,17,0,168,74,0
8826,120915,i8nJS6rmQ6UIbavrvT6pTvkCZLUx9z01,SpATywNh6bZuzm8s1ceuBUnMUAeoAHHw,3,4,0,0,0,0,1,0,5,0.7142857142857143,1,0.0,0,0,0,0,4,0,0,1,0,0,5,1
8827,120928,sApH95kwlTdIi3RvuRD74A0dFhVPKais,SpATywNh6bZuzm8s1ceuBUnMUAeoAHHw,9,14,4,0,3,2,8,0,31,4.428571428571429,2,0.0,0,4,0,3,14,2,0,8,0,7,24,1
8828,120930,fHz7VQRoJHHTDfRPDpvJLuPlruuvrNnm,SpATywNh6bZuzm8s1ceuBUnMUAeoAHHw,23,30,1,29,1,0,15,0,76,10.857142857142858,3,0.0,11,1,26,1,19,0,3,15,0,39,37,1
8829,120937,qVkkNycc5Psi9bXy8jDUR44I6IjXsj9g,bWdj2GDclj5ofokWjzoa5jAwMkxCykd6,2,0,0,0,0,0,2,0,2,0.2857142857142857,1,0.0,0,0,0,0,0,0,0,2,0,0,2,1
8830,120944,jcYhugRahKquP2fynVIQQrbdtwxaAHse,G8EPVSXsOYB5YQWZGiz1aVq5Pgr2GrQu,1,0,0,0,0,0,1,0,1,0.14285714285714285,1,0.0,0,0,0,0,0,0,0,1,0,0,1,1
8831,120949,ONK0Esb7fhLc69POI06k3Sj1alNC6Fij,SpATywNh6bZuzm8s1ceuBUnMUAeoAHHw,43,41,23,39,17,13,36,0,169,24.142857142857142,13,0.0,17,23,36,17,24,13,3,36,0,93,76,0
8832,120966,JCDOEMgsanA2Wd8RJtg9ctpT52Gae7ak,bWdj2GDclj5ofokWjzoa5jAwMkxCykd6,7,8,2,0,1,0,5,0,16,2.2857142857142856,2,0.0,0,2,0,1,8,0,0,5,0,3,13,0
8833,120973,VsZvGrXbL1e6v6hmpJQH8MldIkCBO9P7,RXDvfPUBYFlVdlueBFbLW0mhhAyGEqpt,109,182,65,274,35,12,33,15,616,88.0,6,0.0,41,65,259,35,141,12,15,33,15,400,216,0
8834,120975,KjHOE07fI9pBFKqiwhrvCwjITj7tyFWN,G8EPVSXsOYB5YQWZGiz1aVq5Pgr2GrQu,40,44,22,12,16,0,23,1,118,16.857142857142858,5,0.0,9,22,10,16,35,0,2,23,1,57,61,1
8835,120979,VsZvGrXbL1e6v6hmpJQH8MldIkCBO9P7,A3fsA9Zfv1X2fVEQhTw51lKENdNrEqT3,63,52,25,132,14,4,22,1,250,35.714285714285715,4,0.0,1,25,119,14,51,4,13,22,1,159,91,1
8836,120982,JBjDnQZVwVLGdsvKJqTw57nrx9uYY0vn,A3fsA9Zfv1X2fVEQhTw51lKENdNrEqT3,14,35,3,0,2,0,12,1,53,7.571428571428571,4,0.0,0,3,0,2,35,0,0,12,1,5,48,0
8837,120999,evts3oSRq3OSuFymJPKdix8vzAStq0uA,G8EPVSXsOYB5YQWZGiz1aVq5Pgr2GrQu,2,0,0,0,0,0,2,0,2,0.2857142857142857,1,0.0,0,0,0,0,0,0,0,2,0,0,2,1
8838,121006,fiuPlQpFhdwy7ZB3d9YZTvFtxVmpTcZ2,SpATywNh6bZuzm8s1ceuBUnMUAeoAHHw,8,10,1,0,1,0,6,0,18,2.5714285714285716,2,0.0,0,1,0,1,10,0,0,6,0,2,16,1
8839,121019,bA4tnPZD0UU4XAL3OkL7nUjtkAzbgj9d,A3fsA9Zfv1X2fVEQhTw51lKENdNrEqT3,6,8,5,0,1,0,2,0,16,2.2857142857142856,2,0.0,1,5,0,1,7,0,0,2,0,7,9,1
8840,121023,TzRDOFjVsHxcJLvrJENTAv7iaJPhFHB5,SpATywNh6bZuzm8s1ceuBUnMUAeoAHHw,20,19,9,23,5,0,6,0,62,8.857142857142858,3,0.0,7,9,21,5,12,0,2,6,0,42,20,1
8841,121044,KkBPwixR7onoXlZ2HnK8cYokgUE3P396,A3fsA9Zfv1X2fVEQhTw51lKENdNrEqT3,1,0,0,0,0,0,1,0,1,0.14285714285714285,1,0.0,0,0,0,0,0,0,0,1,0,0,1,1
8842,121048,nwFT4lnmg30fCvHRB6tbALo9FpcanuLx,bWdj2GDclj5ofokWjzoa5jAwMkxCykd6,11,11,5,0,3,0,7,0,26,3.7142857142857144,5,0.0,0,5,0,3,11,0,0,7,0,8,18,0
8843,121066,gV1Y6A8RpgDuAD47r6UGF54v9TD2f7uU,bWdj2GDclj5ofokWjzoa5jAwMkxCykd6,6,3,1,0,1,0,2,0,7,1.0,1,0.0,0,1,0,1,3,0,0,2,0,2,5,1
8844,121100,8mYFryxeRH8GSnHog9hmhUPRk60LCyFI,SpATywNh6bZuzm8s1ceuBUnMUAeoAHHw,20,28,22,0,10,0,32,0,92,13.142857142857142,5,0.0,0,22,0,10,28,0,0,32,0,32,60,1
8845,121105,M8ur292SdHouJ1LnQyJMDkHJM5sUPxnX,SpATywNh6bZuzm8s1ceuBUnMUAeoAHHw,23,49,4,15,5,0,9,0,82,11.714285714285714,6,0.0,6,4,12,5,43,0,3,9,0,27,55,0
8846,121134,4IxaKtzWvkfFEFZ43UhJQOyIahcBxrF2,SpATywNh6bZuzm8s1ceuBUnMUAeoAHHw,27,49,6,26,3,0,10,0,94,13.428571428571429,6,0.0,4,6,23,3,45,0,3,10,0,36,58,1
8847,121136,kHp5QZURLzbWn4koqFYZnQmO0kliz5hb,SpATywNh6bZuzm8s1ceuBUnMUAeoAHHw,28,37,18,20,11,3,4,0,93,13.285714285714286,5,0.0,11,18,17,11,26,3,3,4,0,57,36,1
8848,121174,BK9rzOWePcPYHbJ23OB9suKImXFOyhRl,bWdj2GDclj5ofokWjzoa5jAwMkxCykd6,10,8,1,0,1,5,9,4,28,4.0,1,0.0,0,1,0,1,8,5,0,9,4,2,26,1
8849,121191,MbmumbK7FHZlEn2oNe4YMQEQzBas1u6w,bWdj2GDclj5ofokWjzoa5jAwMkxCykd6,29,39,20,39,8,14,13,2,135,19.285714285714285,4,0.0,6,20,34,8,33,14,5,13,2,68,67,0
8850,121196,VdaBmv5ItdWz4RwMA62FKAWjG3bRe1Fn,SpATywNh6bZuzm8s1ceuBUnMUAeoAHHw,4,3,1,0,1,0,1,0,6,0.8571428571428571,1,0.0,0,1,0,1,3,0,0,1,0,2,4,1
8851,121216,kepzW866hAW80jPanDRXCDYAup0gf1qr,bWdj2GDclj5ofokWjzoa5jAwMkxCykd6,4,2,1,0,1,0,1,0,5,0.7142857142857143,1,0.0,0,1,0,1,2,0,0,1,0,2,3,0
8852,121220,XOhs3C3hEbYCXLCkazKW0gKNbUWn1jg2,SpATywNh6bZuzm8s1ceuBUnMUAeoAHHw,8,6,3,0,3,0,4,0,16,2.2857142857142856,1,0.0,0,3,0,3,6,0,0,4,0,6,10,1
8853,121271,GAKCidUQ8hdeh0WMwEYlK9cUZXNPRN5R,SpATywNh6bZuzm8s1ceuBUnMUAeoAHHw,7,2,1,0,1,0,7,1,12,1.7142857142857142,2,0.0,0,1,0,1,2,0,0,7,1,2,10,1
8854,121284,Sb4VRiha9yR6Zwo717x7pWDjO7cnV2Bc,A3fsA9Zfv1X2fVEQhTw51lKENdNrEqT3,2,0,0,0,0,0,2,0,2,0.2857142857142857,1,0.0,0,0,0,0,0,0,0,2,0,0,2,1
8855,121303,33pzyjn4blqUcVq0e7rGSyVoVXsnplTp,SpATywNh6bZuzm8s1ceuBUnMUAeoAHHw,5,1,1,0,1,0,3,0,6,0.8571428571428571,1,0.0,0,1,0,1,1,0,0,3,0,2,4,1
8856,121304,WOGsOMHGMnkSlS91ohBsyVdWGOJVOnT1,G8EPVSXsOYB5YQWZGiz1aVq5Pgr2GrQu,2,0,0,0,0,0,2,0,2,0.2857142857142857,1,0.0,0,0,0,0,0,0,0,2,0,0,2,1
8857,121313,VrcAU2QLiPqVHHKHjhnkgJoQe1xmnYFr,SpATywNh6bZuzm8s1ceuBUnMUAeoAHHw,4,2,1,0,1,0,1,0,5,0.7142857142857143,1,0.0,0,1,0,1,2,0,0,1,0,2,3,1
8858,121328,o1wU0MfzmEznHSZOZDS8DejIhVczhoMt,A3fsA9Zfv1X2fVEQhTw51lKENdNrEqT3,1,0,0,0,0,0,3,0,3,0.42857142857142855,2,0.0,0,0,0,0,0,0,0,3,0,0,3,1
8859,121330,o1wU0MfzmEznHSZOZDS8DejIhVczhoMt,bWdj2GDclj5ofokWjzoa5jAwMkxCykd6,1,0,0,0,0,0,4,0,4,0.5714285714285714,2,0.0,0,0,0,0,0,0,0,4,0,0,4,1
8860,121339,oKz0rKWQtHW8DkPwxTgdemWb21NvE4BO,SpATywNh6bZuzm8s1ceuBUnMUAeoAHHw,33,48,1,48,0,10,13,0,120,17.142857142857142,5,0.0,19,1,45,0,29,10,3,13,0,65,55,1
8861,121345,ePaTLgBKhclwas3ClxzVVmTCgYzhx4go,SpATywNh6bZuzm8s1ceuBUnMUAeoAHHw,33,60,4,59,0,44,26,0,193,27.571428571428573,8,0.0,16,4,48,0,44,44,11,26,0,68,125,0
8862,121373,HSjT6fK4xHlufEG141acXPeMw5gqxgnK,G8EPVSXsOYB5YQWZGiz1aVq5Pgr2GrQu,6,1,1,0,1,0,3,1,7,1.0,1,0.0,0,1,0,1,1,0,0,3,1,2,5,1
8863,121391,7af3IyECXIPSWoeM4guaEGHMHNE9EYdr,A3fsA9Zfv1X2fVEQhTw51lKENdNrEqT3,1,0,0,0,0,0,1,0,1,0.14285714285714285,1,0.0,0,0,0,0,0,0,0,1,0,0,1,1
8864,121405,H8Mro2560yUzikYuATdEg57a9V5oxWPK,bWdj2GDclj5ofokWjzoa5jAwMkxCykd6,1,0,0,0,0,0,2,0,2,0.2857142857142857,1,0.0,0,0,0,0,0,0,0,2,0,0,2,1
8865,121415,5tRF7MIiw9rvKGI9GzHJVDzIS50Mqb8o,RXDvfPUBYFlVdlueBFbLW0mhhAyGEqpt,32,43,3,50,3,0,7,0,106,15.142857142857142,3,0.0,9,3,46,3,34,0,4,7,0,61,45,1
8866,121424,vthDe5chpuGwbDUyc90EI2Y8jHRBb15H,bWdj2GDclj5ofokWjzoa5jAwMkxCykd6,4,2,1,0,1,0,1,0,5,0.7142857142857143,1,0.0,0,1,0,1,2,0,0,1,0,2,3,1
8867,121438,3w2Xuq08gulsgNUr7oA3MOaceNv4Akte,bWdj2GDclj5ofokWjzoa5jAwMkxCykd6,15,27,11,50,7,5,7,0,107,15.285714285714286,3,0.0,8,11,46,7,19,5,4,7,0,72,35,1
8868,121446,Haz3G1DnETqwzmdUg5ALbCZo1Lv5wDs9,SpATywNh6bZuzm8s1ceuBUnMUAeoAHHw,28,30,19,30,10,3,8,0,100,14.285714285714286,5,0.0,6,19,27,10,24,3,3,8,0,62,38,1
8869,121452,NoyfNn91CGqIll5CyV3XCcTClgT3U7jT,A3fsA9Zfv1X2fVEQhTw51lKENdNrEqT3,2,0,0,0,0,0,2,0,2,0.2857142857142857,1,0.0,0,0,0,0,0,0,0,2,0,0,2,1
8870,121455,I8yPwCESlVyB1LCVpuWYAkN68pAAeUAB,G8EPVSXsOYB5YQWZGiz1aVq5Pgr2GrQu,4,3,2,0,2,0,1,0,8,1.1428571428571428,1,0.0,0,2,0,2,3,0,0,1,0,4,4,1
8871,121473,kEe7j5p6NF8FFSn6q8Y544hGSIcyGGey,G8EPVSXsOYB5YQWZGiz1aVq5Pgr2GrQu,1,0,0,0,0,0,1,0,1,0.14285714285714285,1,0.0,0,0,0,0,0,0,0,1,0,0,1,1
8872,121532,OUbh6hvaOJDp9RK7kgTBzzPmjzmkYhZF,A3fsA9Zfv1X2fVEQhTw51lKENdNrEqT3,57,33,0,190,0,2,11,1,237,33.857142857142854,2,0.0,2,0,171,0,31,2,19,11,1,173,64,1
8873,121540,Ys7L3fRt7UujHv4RzbntGwrrv6Omn2bm,A3fsA9Zfv1X2fVEQhTw51lKENdNrEqT3,11,3,2,0,2,0,7,1,15,2.142857142857143,1,0.0,0,2,0,2,3,0,0,7,1,4,11,1
8874,121576,RPsysYLHG9V8ibC4agPmUkz49odzJ61i,SpATywNh6bZuzm8s1ceuBUnMUAeoAHHw,25,22,6,20,4,11,4,0,67,9.571428571428571,2,0.0,5,6,18,4,17,11,2,4,0,33,34,0
8875,121625,ZULomXsITwM6vNxcJN8imzU1pyfKn8Cw,A3fsA9Zfv1X2fVEQhTw51lKENdNrEqT3,14,10,8,0,6,0,3,0,27,3.857142857142857,1,0.0,0,8,0,6,10,0,0,3,0,14,13,1
8876,121656,aVeyGdrz6Ir4LmiLkJqBoRjG1lQ7MsV8,bWdj2GDclj5ofokWjzoa5jAwMkxCykd6,37,87,37,84,5,20,26,2,261,37.285714285714285,13,0.0,17,37,72,5,70,20,12,26,2,131,130,0
8877,121711,5U79KRZxDDBIetuxjK0KXphUhzbxTzjr,A3fsA9Zfv1X2fVEQhTw51lKENdNrEqT3,12,7,5,0,1,0,9,1,23,3.2857142857142856,2,0.0,0,5,0,1,7,0,0,9,1,6,17,1
8878,121712,zdC6SE3iIVhpYTGT1Ftflp0F2V48NqFq,SpATywNh6bZuzm8s1ceuBUnMUAeoAHHw,32,73,27,24,9,3,19,1,156,22.285714285714285,6,0.0,29,27,23,9,44,3,1,19,1,88,68,1
8879,121721,RNEuStAlTxZHIZFwvfCfasMOM5Hny2Pn,SpATywNh6bZuzm8s1ceuBUnMUAeoAHHw,34,46,8,57,6,3,17,4,141,20.142857142857142,6,0.0,11,8,46,6,35,3,11,17,4,71,70,1
8880,121728,VeR8jO0l4tKfTebOc6UlIMBBM4qQ6Yxm,bWdj2GDclj5ofokWjzoa5jAwMkxCykd6,4,2,0,0,0,0,3,0,5,0.7142857142857143,1,0.0,0,0,0,0,2,0,0,3,0,0,5,1
8881,121730,qCS1MIh1oAUEDPfrxnKYyGX5hZIJFt3C,bWdj2GDclj5ofokWjzoa5jAwMkxCykd6,1,0,0,0,0,0,1,0,1,0.14285714285714285,1,0.0,0,0,0,0,0,0,0,1,0,0,1,1
8882,121731,wBp63rzsgy2LzOR2gkxDj87VT9Ja70XK,SpATywNh6bZuzm8s1ceuBUnMUAeoAHHw,30,39,19,42,8,18,19,3,148,21.142857142857142,3,0.0,11,19,35,8,28,18,7,19,3,73,75,1
8883,121738,V6LNlp0n6EiMGFhm98i6D7Pk9T5LWptM,SpATywNh6bZuzm8s1ceuBUnMUAeoAHHw,7,12,6,0,3,0,3,0,24,3.4285714285714284,2,0.0,0,6,0,3,12,0,0,3,0,9,15,1
8884,121743,bFBipIvg3ynAbrvo3mXNRP6i8NWVQRYx,A3fsA9Zfv1X2fVEQhTw51lKENdNrEqT3,16,13,9,0,5,2,17,3,49,7.0,2,0.0,1,9,0,5,12,2,0,17,3,15,34,1
8885,121746,bFBipIvg3ynAbrvo3mXNRP6i8NWVQRYx,bWdj2GDclj5ofokWjzoa5jAwMkxCykd6,15,21,9,52,6,5,11,1,105,15.0,2,0.0,7,9,51,6,14,5,1,11,1,73,32,1
8886,121766,EbdsJCzME79IdKcgnIKOnAggJJmkpV77,G8EPVSXsOYB5YQWZGiz1aVq5Pgr2GrQu,30,31,24,34,18,0,8,0,115,16.428571428571427,4,0.0,3,24,25,18,28,0,9,8,0,70,45,0
8887,121768,Zt3P4JGoAgyqFxw766ynWY30ef3EfJ1u,SpATywNh6bZuzm8s1ceuBUnMUAeoAHHw,20,31,11,26,4,10,14,2,98,14.0,2,0.0,15,11,23,4,16,10,3,14,2,53,45,0
8888,121771,mfnQ4udtiPturvDlSRmiBQpHTrOVoPze,G8EPVSXsOYB5YQWZGiz1aVq5Pgr2GrQu,5,2,1,0,1,0,2,0,6,0.8571428571428571,1,0.0,0,1,0,1,2,0,0,2,0,2,4,1
8889,121772,rwS7FTXVRFYQBGZ8fdPbUhnEsoTUJSWr,SpATywNh6bZuzm8s1ceuBUnMUAeoAHHw,6,3,2,0,1,0,3,0,9,1.2857142857142858,1,0.0,0,2,0,1,3,0,0,3,0,3,6,1
8890,121776,sOhMuZ2KPBl6wLWzfGcWvrQoSfIarVJv,SpATywNh6bZuzm8s1ceuBUnMUAeoAHHw,5,2,1,0,1,0,3,0,7,1.0,2,0.0,0,1,0,1,2,0,0,3,0,2,5,1
8891,121780,0P5PalAjTetGhnhGgd58OrrRVeAS6i1x,A3fsA9Zfv1X2fVEQhTw51lKENdNrEqT3,13,8,7,0,5,0,2,0,22,3.142857142857143,1,0.0,0,7,0,5,8,0,0,2,0,12,10,1
8892,121789,XC5tRBKME8ONyczymYjZjR1MyrCYegPM,G8EPVSXsOYB5YQWZGiz1aVq5Pgr2GrQu,27,50,16,56,7,1,3,0,133,19.0,2,0.0,31,16,44,7,19,1,12,3,0,98,35,0
8893,121824,VmpOwZ3zs5p6NuGKzo8TbAiFkD0EdD5q,SpATywNh6bZuzm8s1ceuBUnMUAeoAHHw,1,0,0,0,0,0,1,0,1,0.14285714285714285,1,0.0,0,0,0,0,0,0,0,1,0,0,1,1
8894,121827,LPuVvdpKRDBdr0DGqQ4yh9fw0WfNvnkW,SpATywNh6bZuzm8s1ceuBUnMUAeoAHHw,6,9,0,0,0,0,5,0,14,2.0,2,0.0,0,0,0,0,9,0,0,5,0,0,14,1
8895,121829,gOODBz9FfXPZcnKA2RT49UqbScA5gVkT,SpATywNh6bZuzm8s1ceuBUnMUAeoAHHw,14,16,10,0,6,0,4,0,36,5.142857142857143,2,0.0,0,10,0,6,16,0,0,4,0,16,20,1
8896,121870,iY0UWsKzM76w2sBfvkSz2A0A6313cEPM,SpATywNh6bZuzm8s1ceuBUnMUAeoAHHw,25,31,9,13,4,0,3,0,60,8.571428571428571,3,0.0,7,9,12,4,24,0,1,3,0,32,28,1
8897,121881,PUdcV8hfT4fAKFK5ZdHY1Ahxf6WKmDC8,bWdj2GDclj5ofokWjzoa5jAwMkxCykd6,5,3,1,0,1,0,2,0,7,1.0,1,0.0,0,1,0,1,3,0,0,2,0,2,5,1
8898,121915,QQOQ1mBFT0hbDG4vhxUnw8WQ7hq3XsN0,SpATywNh6bZuzm8s1ceuBUnMUAeoAHHw,19,19,13,3,10,0,2,0,47,6.714285714285714,2,0.0,3,13,3,10,16,0,0,2,0,29,18,1
8899,121927,7HtfIn2KlQH9UsbhFgGhveKOzfNOg6MC,SpATywNh6bZuzm8s1ceuBUnMUAeoAHHw,5,3,2,0,1,0,1,0,7,1.0,1,0.0,0,2,0,1,3,0,0,1,0,3,4,1
8900,121945,sTlxlEkJ3MbMUAeSajnaHOGfpyW9hgq1,RXDvfPUBYFlVdlueBFbLW0mhhAyGEqpt,5,3,1,0,1,0,2,0,7,1.0,1,0.0,0,1,0,1,3,0,0,2,0,2,5,1
8901,121953,ahM4WE7sAySvmZ0R8lWqo09z8fOCvKFZ,SpATywNh6bZuzm8s1ceuBUnMUAeoAHHw,11,10,4,0,2,1,12,1,30,4.285714285714286,3,0.0,3,4,0,2,7,1,0,12,1,9,21,1
8902,121987,8FfbeT2vcqiuyS9VPg4k7f5KonVLWvGH,A3fsA9Zfv1X2fVEQhTw51lKENdNrEqT3,14,5,0,12,0,1,8,1,27,3.857142857142857,1,0.0,0,0,12,0,5,1,0,8,1,12,15,1
8903,121994,u5RnzaYe9alTOldsdopsRhwom5jR9n5h,SpATywNh6bZuzm8s1ceuBUnMUAeoAHHw,5,2,1,0,1,0,3,0,7,1.0,1,0.0,0,1,0,1,2,0,0,3,0,2,5,1
8904,121997,qkTj1KHhnruIpJto1LtBmn4usHKfmPXZ,G8EPVSXsOYB5YQWZGiz1aVq5Pgr2GrQu,16,9,9,32,5,0,2,0,57,8.142857142857142,1,0.0,0,9,29,5,9,0,3,2,0,43,14,1
8905,122003,s25WPHgkqnodCLzw3vLGSH1CPEjHMBJ5,A3fsA9Zfv1X2fVEQhTw51lKENdNrEqT3,6,5,1,0,1,0,2,0,9,1.2857142857142858,2,0.0,0,1,0,1,5,0,0,2,0,2,7,1
8906,122051,PFXaSbylT2XRWmnFTzI7TT06KKEcrU02,SpATywNh6bZuzm8s1ceuBUnMUAeoAHHw,1,0,0,0,0,0,1,0,1,0.14285714285714285,1,0.0,0,0,0,0,0,0,0,1,0,0,1,1
8907,122058,zBcT1Z0xXooVqe1Y23Zi33CckLeXOFNF,A3fsA9Zfv1X2fVEQhTw51lKENdNrEqT3,2,0,0,0,0,0,2,0,2,0.2857142857142857,1,0.0,0,0,0,0,0,0,0,2,0,0,2,1
8908,122069,Cyazs2KNzeLH7rwO0YD9wLQWGHR2SXrB,RXDvfPUBYFlVdlueBFbLW0mhhAyGEqpt,5,8,4,0,1,0,4,0,17,2.4285714285714284,3,0.0,0,4,0,1,8,0,0,4,0,5,12,1
8909,124667,15vqe2Z6zLmyPR70QAa8Kn2V8zhvh9Uk,7GRhBDsirIGkRZBtSMEzNTyDr2JQm4xx,11,6,3,0,1,2,19,1,32,4.571428571428571,4,0.0,0,3,0,1,6,2,0,19,1,4,28,1
8910,124668,oARKFBU8ybRND8XMVu96YEHeW22LRUke,5X6FeZozNMgE2VRi3MJYjkkFK8SETtu2,3,2,0,0,0,0,2,0,4,0.5714285714285714,1,0.0,0,0,0,0,2,0,0,2,0,0,4,1
8911,124685,qwhxcjW9iIMBAQoGSWDtst34AFkcFQoV,7GRhBDsirIGkRZBtSMEzNTyDr2JQm4xx,9,25,11,4,2,0,8,0,50,7.142857142857143,6,0.0,1,11,3,2,24,0,1,8,0,17,33,0
8912,124687,eQeAZJfAlQDBFNhBayGkUGtYxXtMJqJ1,7GRhBDsirIGkRZBtSMEzNTyDr2JQm4xx,50,172,61,57,39,26,20,0,375,53.57142857142857,3,0.0,88,61,45,39,84,26,12,20,0,233,142,1
8913,124688,MTBFJm3bIEaE6OQdIPJiDEIIoJhDDIeA,7GRhBDsirIGkRZBtSMEzNTyDr2JQm4xx,33,36,12,33,19,3,14,0,117,16.714285714285715,4,0.0,16,12,31,19,20,3,2,14,0,78,39,0
8914,124717,Z5fT2dRmGZA6byuGIfmg4Qv99HwruaNQ,5X6FeZozNMgE2VRi3MJYjkkFK8SETtu2,1,0,0,0,0,0,1,0,1,0.14285714285714285,1,0.0,0,0,0,0,0,0,0,1,0,0,1,1
8915,124719,s1zoJG6TsTv8LP9PRWCYbeiv4OLIivpy,7GRhBDsirIGkRZBtSMEzNTyDr2JQm4xx,6,2,1,0,1,0,4,0,8,1.1428571428571428,2,0.0,0,1,0,1,2,0,0,4,0,2,6,1
8916,124723,pyk8IpgYoJC2oe3kCohOVZ3WNjOmgeaA,7GRhBDsirIGkRZBtSMEzNTyDr2JQm4xx,53,78,24,84,31,2,8,0,227,32.42857142857143,5,0.0,48,24,72,31,30,2,12,8,0,175,52,1
8917,124736,O5KBwdPnEkmA9netVr9aGipw3OlgkQS8,5X6FeZozNMgE2VRi3MJYjkkFK8SETtu2,9,5,1,0,1,1,13,1,22,3.142857142857143,2,0.0,0,1,0,1,5,1,0,13,1,2,20,1
8918,124845,r2BlY5kx3gPU1opGlfjFI0ngbnfS5jKE,5X6FeZozNMgE2VRi3MJYjkkFK8SETtu2,36,92,21,58,30,2,22,0,225,32.142857142857146,6,0.0,44,21,46,30,48,2,12,22,0,141,84,0
8919,124848,LsB37SHCi56YIWKTwUYRQPUU0IwClcqd,7GRhBDsirIGkRZBtSMEzNTyDr2JQm4xx,32,47,14,88,9,0,4,0,162,23.142857142857142,4,0.0,13,14,76,9,34,0,12,4,0,112,50,1
8920,124891,imMIajxyorSupzcO0ndqnctRXANxxhkV,5X6FeZozNMgE2VRi3MJYjkkFK8SETtu2,40,68,13,34,27,3,8,1,154,22.0,4,0.0,35,13,31,27,33,3,3,8,1,106,48,1
8921,124904,x2sgXnRqpzo0sPEyNVV2LCKHGLD7HPOD,7GRhBDsirIGkRZBtSMEzNTyDr2JQm4xx,4,0,0,0,0,0,4,0,4,0.5714285714285714,1,0.0,0,0,0,0,0,0,0,4,0,0,4,0
8922,124923,O4ePTyZvjwNQI9EDfljqO5u6UAawTsHN,7GRhBDsirIGkRZBtSMEzNTyDr2JQm4xx,1,0,0,0,0,0,1,0,1,0.14285714285714285,1,0.0,0,0,0,0,0,0,0,1,0,0,1,1
8923,124930,G9GKaCR68fEW2dhyNOCbPYXyvlYi1Jne,5X6FeZozNMgE2VRi3MJYjkkFK8SETtu2,15,9,1,14,4,1,4,1,34,4.857142857142857,1,0.0,7,1,12,4,2,1,2,4,1,24,10,1
8924,124975,Z4Ol2MWosmvKrLpBOUDzuhHb0EYhkqtT,7GRhBDsirIGkRZBtSMEzNTyDr2JQm4xx,39,97,36,87,35,4,24,0,283,40.42857142857143,8,0.0,47,36,75,35,50,4,12,24,0,193,90,1
8925,125017,xVQ88VrIuIA75ygDlevnROobNkwcFnsc,7GRhBDsirIGkRZBtSMEzNTyDr2JQm4xx,4,4,1,0,0,0,2,0,7,1.0,2,0.0,0,1,0,0,4,0,0,2,0,1,6,1
8926,125036,CUg5atNUld0AFLgUdvlLcFARmcmAn91I,7GRhBDsirIGkRZBtSMEzNTyDr2JQm4xx,1,0,0,0,0,0,1,0,1,0.14285714285714285,1,0.0,0,0,0,0,0,0,0,1,0,0,1,1
8927,125068,clB9MUAuqkslRUltlqk0A6RGOlCJEK6u,7GRhBDsirIGkRZBtSMEzNTyDr2JQm4xx,2,0,0,0,0,0,2,0,2,0.2857142857142857,1,0.0,0,0,0,0,0,0,0,2,0,0,2,1
8928,125071,PUBGBOFNCd7rxLxHUMk2Fsee5aukfpD6,7GRhBDsirIGkRZBtSMEzNTyDr2JQm4xx,15,17,8,18,3,0,5,1,52,7.428571428571429,2,0.0,3,8,14,3,14,0,4,5,1,28,24,1
8929,125098,69mjZoNGtUdd47OHaI2iQubsVwSBE5CT,5X6FeZozNMgE2VRi3MJYjkkFK8SETtu2,2,0,0,0,0,0,3,0,3,0.42857142857142855,1,0.0,0,0,0,0,0,0,0,3,0,0,3,1
8930,125099,OaNHFpAUQzcTX5ejR9Q1L6eDhuIDKh84,5X6FeZozNMgE2VRi3MJYjkkFK8SETtu2,7,3,2,0,2,0,2,0,9,1.2857142857142858,1,0.0,0,2,0,2,3,0,0,2,0,4,5,0
8931,125203,3JIXiiq1ThMv9bAgaUvatHYIhYMco1sB,5X6FeZozNMgE2VRi3MJYjkkFK8SETtu2,1,0,0,0,0,0,1,0,1,0.14285714285714285,1,0.0,0,0,0,0,0,0,0,1,0,0,1,1
8932,125241,6zXGZtvwHnFZCYFcS3Xzk5yrVH7CXdoJ,5X6FeZozNMgE2VRi3MJYjkkFK8SETtu2,1,0,0,0,0,0,1,0,1,0.14285714285714285,1,0.0,0,0,0,0,0,0,0,1,0,0,1,1
8933,125243,s0CuaMOyGbriaa9tGqsijSbS7imj3jdt,5X6FeZozNMgE2VRi3MJYjkkFK8SETtu2,2,0,0,0,0,0,2,0,2,0.2857142857142857,1,0.0,0,0,0,0,0,0,0,2,0,0,2,0
8934,125316,zQuOUrw5AhGHdFoJTVTDSPmJiftbKo67,7GRhBDsirIGkRZBtSMEzNTyDr2JQm4xx,2,0,0,0,0,0,2,0,2,0.2857142857142857,1,0.0,0,0,0,0,0,0,0,2,0,0,2,1
8935,125330,qCvAPTsWorFEreRKcqadivyOxQ7Qqyf8,7GRhBDsirIGkRZBtSMEzNTyDr2JQm4xx,2,0,0,0,0,0,2,0,2,0.2857142857142857,1,0.0,0,0,0,0,0,0,0,2,0,0,2,1
8936,125461,gk39jRVv7texY2FMD0lChVtgPwDbQSv3,5X6FeZozNMgE2VRi3MJYjkkFK8SETtu2,2,0,0,0,0,0,2,0,2,0.2857142857142857,1,0.0,0,0,0,0,0,0,0,2,0,0,2,1
8937,125477,rEGrLtnwjrNQJxABPiEg16R7c6zG1e99,7GRhBDsirIGkRZBtSMEzNTyDr2JQm4xx,1,0,0,0,0,0,1,0,1,0.14285714285714285,1,0.0,0,0,0,0,0,0,0,1,0,0,1,1
8938,125569,E4FyPOdTetglhG27zHn1AaZVeKlotKQC,7GRhBDsirIGkRZBtSMEzNTyDr2JQm4xx,1,0,0,0,0,0,1,0,1,0.14285714285714285,1,0.0,0,0,0,0,0,0,0,1,0,0,1,1
8939,125616,NdhfP9LezOw47EKstFkVNQYaCX8DmoQI,5X6FeZozNMgE2VRi3MJYjkkFK8SETtu2,1,0,0,0,0,0,1,0,1,0.14285714285714285,1,0.0,0,0,0,0,0,0,0,1,0,0,1,1
8940,125664,RFEAx8yelAgvfPsQekcPEQ1kwjrp5Mon,7GRhBDsirIGkRZBtSMEzNTyDr2JQm4xx,7,3,2,0,2,0,2,0,9,1.2857142857142858,1,0.0,0,2,0,2,3,0,0,2,0,4,5,1
8941,125668,bZtNzDzO2qmGZ75gSzCr8t2M40vhOtlI,7GRhBDsirIGkRZBtSMEzNTyDr2JQm4xx,5,4,2,0,1,0,2,0,9,1.2857142857142858,2,0.0,0,2,0,1,4,0,0,2,0,3,6,1
8942,125736,GsteHvxrvXPKxVJCWABqfywywLIH4L0X,5X6FeZozNMgE2VRi3MJYjkkFK8SETtu2,1,0,0,0,0,0,1,0,1,0.14285714285714285,1,0.0,0,0,0,0,0,0,0,1,0,0,1,1
8943,125824,AI4dmnjzjVX0N3Qdp7jyisM4h3f0FBmq,5X6FeZozNMgE2VRi3MJYjkkFK8SETtu2,8,10,4,0,2,0,2,0,18,2.5714285714285716,1,0.0,3,4,0,2,7,0,0,2,0,9,9,1
8944,125913,rPGMKO3AhLxN6LWflYbraX7SC5U9X2nK,7GRhBDsirIGkRZBtSMEzNTyDr2JQm4xx,10,4,1,4,2,12,13,2,38,5.428571428571429,3,0.0,2,1,3,2,2,12,1,13,2,8,30,1
8945,125940,66rxtelZjlVaBERuinHZ5AhHu9R6Idp5,5X6FeZozNMgE2VRi3MJYjkkFK8SETtu2,5,3,1,0,0,0,2,0,6,0.8571428571428571,1,0.0,0,1,0,0,3,0,0,2,0,1,5,1
8946,125976,okxt3sY9reE4jjoKn2yrA6i7c1T3ZGZn,7GRhBDsirIGkRZBtSMEzNTyDr2JQm4xx,4,0,0,0,0,6,4,0,10,1.4285714285714286,1,0.0,0,0,0,0,0,6,0,4,0,0,10,1
8947,126030,qPWCKd8S50IaPeOGkgV300kLADUtBMrm,3VkHkmOtom3jM2wCu94xgzzu1d6Dn7or,20,20,12,0,7,0,7,0,46,6.571428571428571,5,0.0,1,12,0,7,19,0,0,7,0,20,26,0
8948,126045,fijBSDSom6Hh0o1zTcCBpz1hgxUnPhnS,3VkHkmOtom3jM2wCu94xgzzu1d6Dn7or,5,2,0,0,0,0,5,0,7,1.0,1,0.0,0,0,0,0,2,0,0,5,0,0,7,1
8949,126058,7P8NyH1p0F9cBZAFhaYgNYWEMQktUpKo,3VkHkmOtom3jM2wCu94xgzzu1d6Dn7or,1,0,0,0,0,0,1,0,1,0.14285714285714285,1,0.0,0,0,0,0,0,0,0,1,0,0,1,1
8950,126145,dmVv4oc5Gy8IXIoX1c6y61vCY7ZjC5c1,3VkHkmOtom3jM2wCu94xgzzu1d6Dn7or,67,257,72,84,50,6,79,12,560,80.0,14,0.0,81,72,80,50,176,6,4,79,12,283,277,0
8951,126171,RhrWEWr9BJgTwAMiLH281tMjmArdfWGz,3VkHkmOtom3jM2wCu94xgzzu1d6Dn7or,6,8,3,0,2,0,3,0,16,2.2857142857142856,2,0.0,0,3,0,2,8,0,0,3,0,5,11,1
8952,126189,9LD2dY2JJUiq4N2gerCXLTVCO162xgQP,3VkHkmOtom3jM2wCu94xgzzu1d6Dn7or,1,0,0,0,0,0,1,0,1,0.14285714285714285,1,0.0,0,0,0,0,0,0,0,1,0,0,1,1
8953,126298,rEySukj9OF9DmmmaiDf8JBIJol4y1hJW,3VkHkmOtom3jM2wCu94xgzzu1d6Dn7or,4,0,0,0,0,1,3,0,4,0.5714285714285714,1,0.0,0,0,0,0,0,1,0,3,0,0,4,1
8954,126303,6CwZcMqc6epDab0l1TVtEsvlUkvhqRTK,3VkHkmOtom3jM2wCu94xgzzu1d6Dn7or,5,2,0,0,1,1,4,4,12,1.7142857142857142,1,0.0,0,0,0,1,2,1,0,4,4,1,11,1
8955,126380,2bfj1ryOHyN2ug5mVjQDlKn26erJunPx,3VkHkmOtom3jM2wCu94xgzzu1d6Dn7or,8,14,7,0,5,0,9,0,35,5.0,2,0.0,2,7,0,5,12,0,0,9,0,14,21,1
8956,126389,xosHpCClxDIdr7jC4105d18bvd0ljH6o,3VkHkmOtom3jM2wCu94xgzzu1d6Dn7or,4,2,1,0,1,0,1,0,5,0.7142857142857143,1,0.0,0,1,0,1,2,0,0,1,0,2,3,1
8957,126529,wodz58MkHQadBU30zkgGJ03KFU838ic3,3VkHkmOtom3jM2wCu94xgzzu1d6Dn7or,1,0,0,0,0,0,2,0,2,0.2857142857142857,2,0.0,0,0,0,0,0,0,0,2,0,0,2,1
8958,126566,baN6nF8FXfpysY1rIAQ77TmCuv25YzZW,3VkHkmOtom3jM2wCu94xgzzu1d6Dn7or,1,0,0,0,0,0,1,0,1,0.14285714285714285,1,0.0,0,0,0,0,0,0,0,1,0,0,1,1
8959,126608,2mKDVFSaTvGjvKpmkVudIwKZKKgWuPtT,3VkHkmOtom3jM2wCu94xgzzu1d6Dn7or,9,4,3,0,3,0,5,0,15,2.142857142857143,1,0.0,0,3,0,3,4,0,0,5,0,6,9,1
8960,126611,AoOeu50PBcRJGzXnTeyvy2HLmQU50HHC,fbPkOYLVPtPgIt0MxizjfFJov3JbHyAi,4,2,1,0,1,0,1,0,5,0.7142857142857143,1,0.0,0,1,0,1,2,0,0,1,0,2,3,1
8961,126619,ITwd7xpRvyZSfkB4lL2L6OmpyXYVHZGs,fbPkOYLVPtPgIt0MxizjfFJov3JbHyAi,7,9,6,0,0,7,8,1,31,4.428571428571429,1,0.0,0,6,0,0,9,7,0,8,1,6,25,1
8962,126622,27Xik6MkaFL4yWSO9zEEJwVQHW9Np8S6,fbPkOYLVPtPgIt0MxizjfFJov3JbHyAi,17,9,8,0,8,2,6,0,33,4.714285714285714,2,0.0,0,8,0,8,9,2,0,6,0,16,17,1
8963,126623,TiN4z0dSpp09iMKqN066qAoKwqCoLlNB,fbPkOYLVPtPgIt0MxizjfFJov3JbHyAi,6,3,2,0,2,2,1,0,10,1.4285714285714286,1,0.0,0,2,0,2,3,2,0,1,0,4,6,1
8964,126624,YRDulTOgIWgR8cFwTAVhhuxX46WtWav7,fbPkOYLVPtPgIt0MxizjfFJov3JbHyAi,9,9,5,0,3,0,7,1,25,3.5714285714285716,1,0.0,1,5,0,3,8,0,0,7,1,9,16,1
8965,126630,EDMSGPNYA9U08P3iZyDo7po9ZIKNfhJJ,fbPkOYLVPtPgIt0MxizjfFJov3JbHyAi,8,9,2,6,5,0,5,0,27,3.857142857142857,1,0.0,6,2,4,5,3,0,2,5,0,17,10,1
8966,126632,yjkClXSb67ZKWAEvHxmMMyNPfAsPBpjl,fbPkOYLVPtPgIt0MxizjfFJov3JbHyAi,8,6,3,0,3,0,7,0,19,2.7142857142857144,1,0.0,2,3,0,3,4,0,0,7,0,8,11,1
8967,126633,KmIlNo2pbRKBzhZUiCgI2YhiW6w8iosj,fbPkOYLVPtPgIt0MxizjfFJov3JbHyAi,4,2,1,0,1,0,3,0,7,1.0,1,0.0,0,1,0,1,2,0,0,3,0,2,5,1
8968,126641,z8UfBjDXGrDWc9AMM6dseoK9YyEoRq02,fbPkOYLVPtPgIt0MxizjfFJov3JbHyAi,6,3,2,0,2,0,1,0,8,1.1428571428571428,1,0.0,0,2,0,2,3,0,0,1,0,4,4,1
8969,126645,sUFqKFuTqKGNKIqwb0vqeiIMtCX1CVCE,fbPkOYLVPtPgIt0MxizjfFJov3JbHyAi,10,3,3,0,3,0,3,1,13,1.8571428571428572,1,0.0,0,3,0,3,3,0,0,3,1,6,7,1
8970,126648,j9gdcEQiWF4hz17rFxv9vKJSxkrv7Ewo,fbPkOYLVPtPgIt0MxizjfFJov3JbHyAi,14,31,18,1,12,18,17,0,97,13.857142857142858,6,0.0,5,18,1,12,26,18,0,17,0,36,61,1
8971,126652,pSX00XUyCx7VlmgWGN0d39OwC9BZ8bRV,fbPkOYLVPtPgIt0MxizjfFJov3JbHyAi,6,5,3,0,2,3,3,1,17,2.4285714285714284,2,0.0,0,3,0,2,5,3,0,3,1,5,12,1
8972,126653,gGWMG6Gfcgv0VgsqH5vhbRzqRTXFEicG,fbPkOYLVPtPgIt0MxizjfFJov3JbHyAi,14,5,5,0,5,1,3,0,19,2.7142857142857144,1,0.0,0,5,0,5,5,1,0,3,0,10,9,1
8973,126655,qoqukLLERBRiJBIq9ZPYNUr2ljNWoAkB,fbPkOYLVPtPgIt0MxizjfFJov3JbHyAi,1,0,0,0,0,0,1,0,1,0.14285714285714285,1,0.0,0,0,0,0,0,0,0,1,0,0,1,1
8974,126664,BX9KMh9DUbDRkGw8SYAs3wHv0hHJ990Z,fbPkOYLVPtPgIt0MxizjfFJov3JbHyAi,4,2,1,0,1,0,1,0,5,0.7142857142857143,1,0.0,0,1,0,1,2,0,0,1,0,2,3,1
8975,126666,VD3NZWF3TQVEEWjdXtLLn0PBfH2lUBVv,fbPkOYLVPtPgIt0MxizjfFJov3JbHyAi,4,2,1,0,1,0,1,0,5,0.7142857142857143,1,0.0,0,1,0,1,2,0,0,1,0,2,3,1
8976,126667,CRnzue1RDSVRfMQMEjwDVoUKh1AdXpZz,fbPkOYLVPtPgIt0MxizjfFJov3JbHyAi,10,7,5,0,4,1,8,0,25,3.5714285714285716,2,0.0,0,5,0,4,7,1,0,8,0,9,16,1
8977,126671,XirdNKPxR3QK6AqsS5xwiQuah55CHklz,fbPkOYLVPtPgIt0MxizjfFJov3JbHyAi,5,3,2,0,1,0,1,0,7,1.0,1,0.0,0,2,0,1,3,0,0,1,0,3,4,1
8978,126677,cjIjalOkynRvNiMkIirdnL3eRD5dBGGC,fbPkOYLVPtPgIt0MxizjfFJov3JbHyAi,18,26,11,18,8,0,7,0,70,10.0,2,0.0,11,11,13,8,15,0,5,7,0,43,27,1
8979,126678,txSjWYX3TEWx5QLOiaADcbFdCZMHt7yE,fbPkOYLVPtPgIt0MxizjfFJov3JbHyAi,1,0,0,0,0,0,1,0,1,0.14285714285714285,1,0.0,0,0,0,0,0,0,0,1,0,0,1,1
8980,126679,GQHwUvP1dMnkB7BOvyel6l6pMIROCScP,fbPkOYLVPtPgIt0MxizjfFJov3JbHyAi,9,5,3,0,3,1,7,1,20,2.857142857142857,1,0.0,1,3,0,3,4,1,0,7,1,7,13,1
8981,126680,xnRmrsH4zMsCSnzjnexftwj0rbTRSH4o,fbPkOYLVPtPgIt0MxizjfFJov3JbHyAi,2,0,0,0,0,0,5,0,5,0.7142857142857143,1,0.0,0,0,0,0,0,0,0,5,0,0,5,1
8982,126681,Ed4keAaeu2f9Adr8MAUlkgc9PEPDZ5XH,fbPkOYLVPtPgIt0MxizjfFJov3JbHyAi,10,7,3,0,4,4,5,0,23,3.2857142857142856,1,0.0,3,3,0,4,4,4,0,5,0,10,13,1
8983,126683,1aQRKQfEUKBCXZxsytzFHSfkOMz94sSd,fbPkOYLVPtPgIt0MxizjfFJov3JbHyAi,5,2,1,0,1,0,3,0,7,1.0,1,0.0,0,1,0,1,2,0,0,3,0,2,5,1
8984,126685,kv9R1giIEQZwW9B0426lejYI0Lidtzlp,fbPkOYLVPtPgIt0MxizjfFJov3JbHyAi,1,0,0,0,0,0,1,0,1,0.14285714285714285,1,0.0,0,0,0,0,0,0,0,1,0,0,1,1
8985,126688,Ot1qGo61IYwNj80zMpFrqao7vUDTpF4u,fbPkOYLVPtPgIt0MxizjfFJov3JbHyAi,11,9,5,0,3,7,5,1,30,4.285714285714286,1,0.0,0,5,0,3,9,7,0,5,1,8,22,1
8986,126689,JYjqQWzRkQGlz0fASDON6Nnhdq6VSXiT,fbPkOYLVPtPgIt0MxizjfFJov3JbHyAi,1,0,0,0,0,0,1,0,1,0.14285714285714285,1,0.0,0,0,0,0,0,0,0,1,0,0,1,0
8987,126691,PUmV9uRuFVROTlnbrxJwOENyVx54i3f7,fbPkOYLVPtPgIt0MxizjfFJov3JbHyAi,4,2,1,0,1,0,1,0,5,0.7142857142857143,1,0.0,0,1,0,1,2,0,0,1,0,2,3,1
8988,126692,Sfke50zBDjAoEapgUNGacTteD024syFJ,fbPkOYLVPtPgIt0MxizjfFJov3JbHyAi,4,2,0,0,0,0,7,0,9,1.2857142857142858,1,0.0,0,0,0,0,2,0,0,7,0,0,9,1
8989,126697,ER1xz0N5sLgbnEZoIss9jV4E4vyRYggy,fbPkOYLVPtPgIt0MxizjfFJov3JbHyAi,11,25,9,0,7,18,4,0,63,9.0,2,0.0,2,9,0,7,23,18,0,4,0,18,45,1
8990,126699,AGXZupnvuozaRzZmgdrKKyAy6oGdUdjZ,fbPkOYLVPtPgIt0MxizjfFJov3JbHyAi,20,27,13,0,9,3,14,0,66,9.428571428571429,2,0.0,5,13,0,9,22,3,0,14,0,27,39,1
8991,126701,ZflTj2bpwRqbD9BtY63IMMYDj3wgOSNe,fbPkOYLVPtPgIt0MxizjfFJov3JbHyAi,7,6,2,0,2,6,11,0,27,3.857142857142857,2,0.0,0,2,0,2,6,6,0,11,0,4,23,1
8992,126703,6HmdNYWkOfKPcsSkwkqnh7uY2Gqe1cX7,fbPkOYLVPtPgIt0MxizjfFJov3JbHyAi,5,7,4,0,2,3,2,0,18,2.5714285714285716,2,0.0,0,4,0,2,7,3,0,2,0,6,12,0
8993,126705,gVGEUb9jfMmddRlcGqXsnz4ZV26w6q4e,fbPkOYLVPtPgIt0MxizjfFJov3JbHyAi,1,0,0,0,0,0,1,0,1,0.14285714285714285,1,0.0,0,0,0,0,0,0,0,1,0,0,1,1
8994,126708,1i94xoT1OVM1lTP3R294JlD5odSrEcP5,fbPkOYLVPtPgIt0MxizjfFJov3JbHyAi,28,67,37,12,27,1,15,1,160,22.857142857142858,6,0.0,13,37,10,27,54,1,2,15,1,87,73,1
8995,126711,dTyb50y12ITIbvAI5f6oE5PPvIq2Oszo,fbPkOYLVPtPgIt0MxizjfFJov3JbHyAi,7,3,2,0,2,0,2,0,9,1.2857142857142858,1,0.0,0,2,0,2,3,0,0,2,0,4,5,1
8996,126712,0Au7FrQGJI1dB5PAH0C5RtkL9GE7xsrQ,fbPkOYLVPtPgIt0MxizjfFJov3JbHyAi,27,25,16,0,13,0,6,0,60,8.571428571428571,4,0.0,1,16,0,13,24,0,0,6,0,30,30,1
8997,126713,hIFTaIv0NzQ1m69V2AIINZ2J51nUdfKB,fbPkOYLVPtPgIt0MxizjfFJov3JbHyAi,5,2,1,0,1,0,3,0,7,1.0,1,0.0,0,1,0,1,2,0,0,3,0,2,5,1
8998,126714,E3YF9AxDXKzlOoePQC9jwZYlzCkx0nRD,fbPkOYLVPtPgIt0MxizjfFJov3JbHyAi,1,0,0,0,0,0,1,0,1,0.14285714285714285,1,0.0,0,0,0,0,0,0,0,1,0,0,1,1
8999,126715,Z7UOgoOv3zZwU9zvjSxLYTFWLOhyMpWi,fbPkOYLVPtPgIt0MxizjfFJov3JbHyAi,12,33,15,6,8,0,11,0,73,10.428571428571429,3,0.0,10,15,6,8,23,0,0,11,0,39,34,1
9000,126717,k0sYEKzK3c3rv35gACdjIcc2Y8cPzQsK,fbPkOYLVPtPgIt0MxizjfFJov3JbHyAi,10,6,5,0,4,0,2,0,17,2.4285714285714284,1,0.0,0,5,0,4,6,0,0,2,0,9,8,1
9001,126718,H3ilxL6ewH8ns8mJBuSJ1FZhvBCjmjMc,fbPkOYLVPtPgIt0MxizjfFJov3JbHyAi,8,2,1,0,1,1,5,1,11,1.5714285714285714,1,0.0,0,1,0,1,2,1,0,5,1,2,9,1
9002,126722,tzAUOAeBXYCK0qh741cOA4XmhuNpOqLn,fbPkOYLVPtPgIt0MxizjfFJov3JbHyAi,7,6,3,0,3,0,2,0,14,2.0,1,0.0,2,3,0,3,4,0,0,2,0,8,6,1
9003,126724,SuzQYmo3OPVDT9qC8VJnnRm1Cxq00x1u,fbPkOYLVPtPgIt0MxizjfFJov3JbHyAi,6,6,5,0,5,0,1,0,17,2.4285714285714284,1,0.0,0,5,0,5,6,0,0,1,0,10,7,1
9004,126728,REzwc4szUdXMxC6Nuk8XTJfPS15NQoOL,fbPkOYLVPtPgIt0MxizjfFJov3JbHyAi,8,6,4,0,3,0,7,0,20,2.857142857142857,1,0.0,0,4,0,3,6,0,0,7,0,7,13,1
9005,126729,eNsbOW0YP21FZLJqRprbqTldsfqGKDug,fbPkOYLVPtPgIt0MxizjfFJov3JbHyAi,4,2,0,0,0,0,3,0,5,0.7142857142857143,1,0.0,0,0,0,0,2,0,0,3,0,0,5,1
9006,126730,K5koBmqwsfMijOIDdKHMgmXnCecYfcPf,fbPkOYLVPtPgIt0MxizjfFJov3JbHyAi,9,3,2,0,2,2,8,2,19,2.7142857142857144,1,0.0,0,2,0,2,3,2,0,8,2,4,15,1
9007,126731,DFFDn6kzjxm3QeQyKXF89GDFKDcalqmY,fbPkOYLVPtPgIt0MxizjfFJov3JbHyAi,1,0,0,0,0,0,2,0,2,0.2857142857142857,1,0.0,0,0,0,0,0,0,0,2,0,0,2,1
9008,126737,vaWLVKWyrsUzDV0qs20ZUq8M3VNW01Uk,fbPkOYLVPtPgIt0MxizjfFJov3JbHyAi,1,0,0,0,0,0,1,0,1,0.14285714285714285,1,0.0,0,0,0,0,0,0,0,1,0,0,1,1
9009,126739,8LFa90D8AIcBXO1V4uhC5TnOcq5mvsUm,fbPkOYLVPtPgIt0MxizjfFJov3JbHyAi,8,3,2,0,2,0,3,0,10,1.4285714285714286,2,0.0,0,2,0,2,3,0,0,3,0,4,6,1
9010,126742,B1Gq6e77yv7kkDqJ7SH2TygdPDzPBwQh,fbPkOYLVPtPgIt0MxizjfFJov3JbHyAi,63,111,61,37,35,13,37,3,297,42.42857142857143,12,0.0,32,61,30,35,79,13,7,37,3,158,139,1
9011,126746,waB7QF553HzTXuwTUim6Y0QTXghcJvpK,fbPkOYLVPtPgIt0MxizjfFJov3JbHyAi,5,2,1,0,1,0,2,0,6,0.8571428571428571,1,0.0,0,1,0,1,2,0,0,2,0,2,4,1
9012,126748,NDe8spAMYp0FsctHBGO44DCP0jh5ivtW,fbPkOYLVPtPgIt0MxizjfFJov3JbHyAi,7,5,2,0,1,15,3,0,26,3.7142857142857144,2,0.0,0,2,0,1,5,15,0,3,0,3,23,1
9013,126750,bpsYUsj9C1SHgZpkPYxDXsRDOrg2cbuw,fbPkOYLVPtPgIt0MxizjfFJov3JbHyAi,20,36,19,1,15,2,9,0,82,11.714285714285714,4,0.0,10,19,1,15,26,2,0,9,0,45,37,1
9014,126751,XYrC5UYcATLlP8wN3KwZIBFYvNYdBJrS,fbPkOYLVPtPgIt0MxizjfFJov3JbHyAi,4,3,1,0,0,0,3,0,7,1.0,1,0.0,0,1,0,0,3,0,0,3,0,1,6,1
9015,126753,bo2onan1tteC9PtOvOwWhHvlR04pcJEI,fbPkOYLVPtPgIt0MxizjfFJov3JbHyAi,1,0,0,0,0,0,1,0,1,0.14285714285714285,1,0.0,0,0,0,0,0,0,0,1,0,0,1,1
9016,126756,UQ2ITfvqEyrVlMsMiud1odTDb3yeUeeN,fbPkOYLVPtPgIt0MxizjfFJov3JbHyAi,10,11,5,0,5,0,3,0,24,3.4285714285714284,2,0.0,4,5,0,5,7,0,0,3,0,14,10,1
9017,126759,J0Jr0TKZ0YD8uJCfONhkS8KssytjG3hc,fbPkOYLVPtPgIt0MxizjfFJov3JbHyAi,2,0,0,0,0,0,2,0,2,0.2857142857142857,1,0.0,0,0,0,0,0,0,0,2,0,0,2,1
9018,126761,hqsJGd5HdE81psGb4B1N1K2xygUelqqn,fbPkOYLVPtPgIt0MxizjfFJov3JbHyAi,6,4,1,0,1,0,2,0,8,1.1428571428571428,1,0.0,0,1,0,1,4,0,0,2,0,2,6,1
9019,126765,yPVm3gMP0Ua9286Fd70ELAKAMFUpJIch,fbPkOYLVPtPgIt0MxizjfFJov3JbHyAi,1,0,0,0,0,0,1,0,1,0.14285714285714285,1,0.0,0,0,0,0,0,0,0,1,0,0,1,1
9020,126769,woczpAN6oIjjbcNjAQmIX9goIrlwr2g9,fbPkOYLVPtPgIt0MxizjfFJov3JbHyAi,10,13,1,0,1,5,7,2,29,4.142857142857143,1,0.0,0,1,0,1,13,5,0,7,2,2,27,1
9021,126770,QFN96cQBPcYAoDio3PD3qLU8mHPVFQ0T,fbPkOYLVPtPgIt0MxizjfFJov3JbHyAi,6,4,2,0,1,0,5,0,12,1.7142857142857142,3,0.0,0,2,0,1,4,0,0,5,0,3,9,1
9022,126772,uyZkiVvKwTUQeuXVbvnxcY0xXv0uj7Ou,fbPkOYLVPtPgIt0MxizjfFJov3JbHyAi,1,0,0,0,0,0,1,0,1,0.14285714285714285,1,0.0,0,0,0,0,0,0,0,1,0,0,1,1
9023,126775,MAbW0tb6J6Ti6Kh8CYUUbPwQNXH2uKzn,fbPkOYLVPtPgIt0MxizjfFJov3JbHyAi,11,6,4,0,2,0,6,0,18,2.5714285714285716,1,0.0,0,4,0,2,6,0,0,6,0,6,12,1
9024,126776,TEQ7zDYP3udNYg4MKBEvplriqU11dJpm,fbPkOYLVPtPgIt0MxizjfFJov3JbHyAi,1,0,0,0,0,0,1,0,1,0.14285714285714285,1,0.0,0,0,0,0,0,0,0,1,0,0,1,1
9025,126777,8KYOYZWZbeVcKwsAhVG92wVYE0ZslgMQ,fbPkOYLVPtPgIt0MxizjfFJov3JbHyAi,5,2,1,0,1,0,2,0,6,0.8571428571428571,1,0.0,0,1,0,1,2,0,0,2,0,2,4,1
9026,126779,eyG4WSrJfjS4SfFmzFCbTyf0yLzdGMxZ,fbPkOYLVPtPgIt0MxizjfFJov3JbHyAi,1,0,0,0,0,0,1,0,1,0.14285714285714285,1,0.0,0,0,0,0,0,0,0,1,0,0,1,1
9027,126781,u3SPm1HFwlhJpJKaAvQIjwvJr5QcuOph,fbPkOYLVPtPgIt0MxizjfFJov3JbHyAi,5,4,0,0,0,0,3,0,7,1.0,1,0.0,0,0,0,0,4,0,0,3,0,0,7,0
9028,126782,TbkRfFxVYcq9Rq8GnS46iBuAWkShuGej,fbPkOYLVPtPgIt0MxizjfFJov3JbHyAi,7,5,1,0,0,1,5,0,12,1.7142857142857142,3,0.0,0,1,0,0,5,1,0,5,0,1,11,0
9029,126784,jQGozXgCDEtih8n0QNDjwOxHGubLTjEt,fbPkOYLVPtPgIt0MxizjfFJov3JbHyAi,1,0,0,0,0,0,1,0,1,0.14285714285714285,1,0.0,0,0,0,0,0,0,0,1,0,0,1,1
9030,126785,bBtpKgA1DDqVgPxBOPJD6FyVYlM8yP8k,fbPkOYLVPtPgIt0MxizjfFJov3JbHyAi,7,5,4,0,4,0,2,0,15,2.142857142857143,1,0.0,0,4,0,4,5,0,0,2,0,8,7,1
9031,126797,vGSY3dMMulNZBhg7BC3Q8zuYArSKaMtG,fbPkOYLVPtPgIt0MxizjfFJov3JbHyAi,7,3,2,0,2,0,2,0,9,1.2857142857142858,1,0.0,0,2,0,2,3,0,0,2,0,4,5,1
9032,126798,YHm4iQLswg3Pw6HtKnjyefCEQG0rl9m6,fbPkOYLVPtPgIt0MxizjfFJov3JbHyAi,10,6,4,0,3,0,5,1,19,2.7142857142857144,2,0.0,0,4,0,3,6,0,0,5,1,7,12,1
9033,126801,Fa7tOqP1WKllvNDMgvUWmTzPr8J8vhy8,fbPkOYLVPtPgIt0MxizjfFJov3JbHyAi,1,0,0,0,0,0,1,0,1,0.14285714285714285,1,0.0,0,0,0,0,0,0,0,1,0,0,1,1
9034,126806,XnwSWp6D0m9yaPyTk2anmJeLluFnRetD,fbPkOYLVPtPgIt0MxizjfFJov3JbHyAi,6,3,1,0,1,0,2,0,7,1.0,1,0.0,0,1,0,1,3,0,0,2,0,2,5,0
9035,126810,YJTfq6mzE4rimmKGzMEkvlYd7pAv6QtE,fbPkOYLVPtPgIt0MxizjfFJov3JbHyAi,14,19,7,4,8,0,7,0,45,6.428571428571429,1,0.0,8,7,4,8,11,0,0,7,0,27,18,1
9036,126811,xwDnH1SlgpccyWc0HLXDPtkJbN2m4BgP,fbPkOYLVPtPgIt0MxizjfFJov3JbHyAi,10,5,4,0,3,3,5,1,21,3.0,1,0.0,0,4,0,3,5,3,0,5,1,7,14,1
9037,126813,sGprTXM41u2VOQkjfWkUju8jW985WAIG,fbPkOYLVPtPgIt0MxizjfFJov3JbHyAi,5,2,1,0,1,0,2,0,6,0.8571428571428571,1,0.0,0,1,0,1,2,0,0,2,0,2,4,1
9038,126814,8ecFqxBT7B9wx9rsVeuCI9d8eEGRfTVR,fbPkOYLVPtPgIt0MxizjfFJov3JbHyAi,1,0,0,0,0,0,1,0,1,0.14285714285714285,1,0.0,0,0,0,0,0,0,0,1,0,0,1,1
9039,126815,TjWuVHmc0AB9gfvtbCmyYG1vTFdPfyIz,fbPkOYLVPtPgIt0MxizjfFJov3JbHyAi,8,3,2,0,2,0,3,0,10,1.4285714285714286,1,0.0,0,2,0,2,3,0,0,3,0,4,6,1
9040,126816,QlvFciinGDGt7csjDmjYPPZqFlKAzfUP,fbPkOYLVPtPgIt0MxizjfFJov3JbHyAi,9,5,2,0,2,0,5,0,14,2.0,1,0.0,0,2,0,2,5,0,0,5,0,4,10,1
9041,126817,8n73BBd3mvRJq2a0KZ4WJWTYj65s8f61,fbPkOYLVPtPgIt0MxizjfFJov3JbHyAi,1,0,0,0,0,0,1,0,1,0.14285714285714285,1,0.0,0,0,0,0,0,0,0,1,0,0,1,1
9042,129012,H4tEokgMlszMZU1ZAtEtgm2cAVIuDe9k,3VkHkmOtom3jM2wCu94xgzzu1d6Dn7or,98,203,57,90,78,32,29,5,494,70.57142857142857,11,0.0,121,57,87,78,82,32,3,29,5,343,151,1
9043,129020,xd3R9FpcIKhYRXFLFLDzZPRPvMMXOj1o,3VkHkmOtom3jM2wCu94xgzzu1d6Dn7or,17,23,11,6,6,3,5,4,58,8.285714285714286,3,0.0,6,11,6,6,17,3,0,5,4,29,29,1
9044,129034,QPoypIc1fBONo2zEXZGrqFPP68plPMOG,3VkHkmOtom3jM2wCu94xgzzu1d6Dn7or,22,27,16,11,12,0,4,0,70,10.0,3,0.0,8,16,7,12,19,0,4,4,0,43,27,0
9045,129061,nHB64kOB4WkqVwzYXTNxA6Ua5OuQHxmI,3VkHkmOtom3jM2wCu94xgzzu1d6Dn7or,1,0,0,0,0,0,1,0,1,0.14285714285714285,1,0.0,0,0,0,0,0,0,0,1,0,0,1,1
9046,129098,J2Ryyq6g6TjnFue1VPNlM9zNmZVB3792,3VkHkmOtom3jM2wCu94xgzzu1d6Dn7or,10,16,8,0,4,0,5,0,33,4.714285714285714,3,0.0,3,8,0,4,13,0,0,5,0,15,18,1
9047,129108,b2ohpFiEgZaZsBBPqUMnfjpywCAbNR88,3VkHkmOtom3jM2wCu94xgzzu1d6Dn7or,56,103,34,51,21,43,12,0,264,37.714285714285715,3,0.0,28,34,51,21,75,43,0,12,0,134,130,0
9048,129202,nWqEZjeBvF0165As6jqET8hLOfVFKWbf,3VkHkmOtom3jM2wCu94xgzzu1d6Dn7or,2,0,0,0,0,0,3,0,3,0.42857142857142855,1,0.0,0,0,0,0,0,0,0,3,0,0,3,1
9049,129218,BDud1mxU3XXQ1MjhXRWgHusVav3PnqPN,3VkHkmOtom3jM2wCu94xgzzu1d6Dn7or,1,0,0,0,0,0,1,0,1,0.14285714285714285,1,0.0,0,0,0,0,0,0,0,1,0,0,1,1
9050,129404,Y1SqyJfqZFFczMWE0rhcGtRccr3y209e,3VkHkmOtom3jM2wCu94xgzzu1d6Dn7or,4,3,0,0,0,0,2,0,5,0.7142857142857143,1,0.0,1,0,0,0,2,0,0,2,0,1,4,0
9051,129407,TG3ZuEJuEwKy3hkCPL590sfXZmiZZmKY,3VkHkmOtom3jM2wCu94xgzzu1d6Dn7or,6,4,2,0,1,0,4,0,11,1.5714285714285714,2,0.0,0,2,0,1,4,0,0,4,0,3,8,1
9052,129412,WQBkuTNjtyUymeQ1faPduUvsPbZ8z9iy,3VkHkmOtom3jM2wCu94xgzzu1d6Dn7or,1,0,0,0,0,0,1,0,1,0.14285714285714285,1,0.0,0,0,0,0,0,0,0,1,0,0,1,1
9053,129478,d8eTRWMSYvWbG76uUcrxeacgOqbOV0Us,3VkHkmOtom3jM2wCu94xgzzu1d6Dn7or,10,6,5,0,4,0,2,0,17,2.4285714285714284,1,0.0,0,5,0,4,6,0,0,2,0,9,8,0
9054,129504,IZKkIC52B1S5icmdVH39329jtcYFvz5C,3VkHkmOtom3jM2wCu94xgzzu1d6Dn7or,1,0,0,0,0,0,1,0,1,0.14285714285714285,1,0.0,0,0,0,0,0,0,0,1,0,0,1,1
9055,129525,ykFKZMBVwdYfhaervJkzUsSpOvUY6zAv,3VkHkmOtom3jM2wCu94xgzzu1d6Dn7or,1,0,0,0,0,0,1,0,1,0.14285714285714285,1,0.0,0,0,0,0,0,0,0,1,0,0,1,1
9056,129576,bUyOVoZ9Hyd2m2r7LIQyI4wvcTKWeUpC,5Gyp41oLVo7Gg7vF4vpmggWP5MU70QO6,1,0,0,0,0,0,1,0,1,0.14285714285714285,1,0.0,0,0,0,0,0,0,0,1,0,0,1,1
9057,129586,2hFnq94PJL4XDwPjj8ZoE3JMQah41FEA,5Gyp41oLVo7Gg7vF4vpmggWP5MU70QO6,1,0,0,0,0,0,1,0,1,0.14285714285714285,1,0.0,0,0,0,0,0,0,0,1,0,0,1,1
9058,129606,l1rg3D8Gp1lv7dbBBYKvzTS3OZ5DRjWH,5Gyp41oLVo7Gg7vF4vpmggWP5MU70QO6,1,0,0,0,0,0,1,0,1,0.14285714285714285,1,0.0,0,0,0,0,0,0,0,1,0,0,1,1
9059,129655,2viub6InFwMLthqb8hJjmGF9NgF8w6Xs,5Gyp41oLVo7Gg7vF4vpmggWP5MU70QO6,6,5,0,0,0,0,3,0,8,1.1428571428571428,1,0.0,0,0,0,0,5,0,0,3,0,0,8,1
9060,129656,b7a8MINp9dmqKVbHeE4hG21HrnpB7u9G,5Gyp41oLVo7Gg7vF4vpmggWP5MU70QO6,22,38,24,19,8,3,10,0,102,14.571428571428571,5,0.0,7,24,13,8,31,3,6,10,0,52,50,0
9061,129761,rs4TcQqev4WGQPheqEKUDx5pHXZIAB6V,5Gyp41oLVo7Gg7vF4vpmggWP5MU70QO6,1,0,0,0,0,0,1,0,1,0.14285714285714285,1,0.0,0,0,0,0,0,0,0,1,0,0,1,1
9062,129842,el15cFEaxCdIHMAGefcdFdhRQ7MvBqC9,5Gyp41oLVo7Gg7vF4vpmggWP5MU70QO6,5,2,0,0,0,0,3,0,5,0.7142857142857143,1,0.0,0,0,0,0,2,0,0,3,0,0,5,0
9063,129845,Q6o5bW0qV0zSfYIpheiDZNlIXQMlvYYV,5Gyp41oLVo7Gg7vF4vpmggWP5MU70QO6,4,2,1,0,1,0,1,0,5,0.7142857142857143,1,0.0,0,1,0,1,2,0,0,1,0,2,3,1
9064,129868,H683tMkQp6lFNh1xHTfMz81b5h1W7bC1,5Gyp41oLVo7Gg7vF4vpmggWP5MU70QO6,13,15,12,0,1,0,4,0,32,4.571428571428571,3,0.0,0,12,0,1,15,0,0,4,0,13,19,1
9065,129870,DrolXxynktOsAUhkf2q3qgLe9PvqdRq3,5Gyp41oLVo7Gg7vF4vpmggWP5MU70QO6,6,5,3,0,1,0,2,0,11,1.5714285714285714,2,0.0,0,3,0,1,5,0,0,2,0,4,7,0
9066,129908,5kEshmgSAUGvBEOsnsKU8IViB0lkOwoD,5Gyp41oLVo7Gg7vF4vpmggWP5MU70QO6,13,27,12,0,9,0,5,0,53,7.571428571428571,3,0.0,5,12,0,9,22,0,0,5,0,26,27,0
9067,129910,SBNXBfto5KlwjjRWIWllPOHRdAIe9bjA,5Gyp41oLVo7Gg7vF4vpmggWP5MU70QO6,4,2,1,0,1,0,1,0,5,0.7142857142857143,1,0.0,0,1,0,1,2,0,0,1,0,2,3,1
9068,129917,tNz1Ij4PdCaNvy7fotw6BT1EaWCMciYH,5Gyp41oLVo7Gg7vF4vpmggWP5MU70QO6,7,2,1,0,1,5,5,1,15,2.142857142857143,1,0.0,0,1,0,1,2,5,0,5,1,2,13,1
9069,129952,bBdjMMZYfTKEWQmbqaPHvQg5nayvALN5,5Gyp41oLVo7Gg7vF4vpmggWP5MU70QO6,18,41,14,19,7,3,9,0,93,13.285714285714286,7,0.0,13,14,14,7,28,3,5,9,0,48,45,0
9070,129955,eCN2e5jTmvSB4oxzfYLyitV0JYfWmmDS,5Gyp41oLVo7Gg7vF4vpmggWP5MU70QO6,1,0,0,0,0,0,1,0,1,0.14285714285714285,1,0.0,0,0,0,0,0,0,0,1,0,0,1,1
9071,129969,Q6XyNzlE8rkF2yqmhzSLHfW6ZlWw606P,5Gyp41oLVo7Gg7vF4vpmggWP5MU70QO6,10,8,2,0,2,4,18,2,36,5.142857142857143,2,0.0,1,2,0,2,7,4,0,18,2,5,31,0
9072,129970,K97ztksPeTsMHohAca3SFDp9OflICmgg,5Gyp41oLVo7Gg7vF4vpmggWP5MU70QO6,10,3,2,0,2,5,7,1,20,2.857142857142857,1,0.0,0,2,0,2,3,5,0,7,1,4,16,1
9073,130036,pw2VRiQ4AyyioSYfxtFG0lrMfZvxwfmW,7GRhBDsirIGkRZBtSMEzNTyDr2JQm4xx,7,8,0,0,0,0,2,0,10,1.4285714285714286,1,0.0,0,0,0,0,8,0,0,2,0,0,10,0
9074,130061,kJKPmsgnAo2a0lGHjzSIUIt3KbVa9yEm,7GRhBDsirIGkRZBtSMEzNTyDr2JQm4xx,5,2,1,0,1,0,2,0,6,0.8571428571428571,1,0.0,0,1,0,1,2,0,0,2,0,2,4,1
9075,130067,X1uDfIBgkW4iN9gq82vUBXjiG0caTomy,7GRhBDsirIGkRZBtSMEzNTyDr2JQm4xx,9,6,3,2,1,2,4,0,18,2.5714285714285716,1,0.0,1,3,2,1,5,2,0,4,0,7,11,1
9076,130073,IGWRz8xQdPwjKqBNKTjONoXgcj0XdulM,7GRhBDsirIGkRZBtSMEzNTyDr2JQm4xx,86,137,7,161,24,10,46,1,386,55.142857142857146,15,0.0,76,7,133,24,61,10,28,46,1,240,146,0
9077,130079,HePRyod5aTSIcFeoVudB8huyR12d5o5i,7GRhBDsirIGkRZBtSMEzNTyDr2JQm4xx,26,27,1,14,6,0,4,0,52,7.428571428571429,2,0.0,13,1,7,6,14,0,7,4,0,27,25,1
9078,130086,42XWMvZdooK2bfqSrGDd5b8CKP3qTWuq,7GRhBDsirIGkRZBtSMEzNTyDr2JQm4xx,1,0,0,0,0,0,1,0,1,0.14285714285714285,1,0.0,0,0,0,0,0,0,0,1,0,0,1,1
9079,130090,xhoMHYDn0DYj6NEexX867ukahPmWhSwf,7GRhBDsirIGkRZBtSMEzNTyDr2JQm4xx,78,69,36,0,55,0,9,0,169,24.142857142857142,3,0.0,27,36,0,55,42,0,0,9,0,118,51,1
9080,130097,vZKUVN7akOfrg3MUhYWywDO96JKSOuQ6,7GRhBDsirIGkRZBtSMEzNTyDr2JQm4xx,1,0,0,0,0,0,1,0,1,0.14285714285714285,1,0.0,0,0,0,0,0,0,0,1,0,0,1,1
9081,130151,oaoj9be4jW2Hot8wYgYrzLRvB0RU4KYy,7GRhBDsirIGkRZBtSMEzNTyDr2JQm4xx,42,69,30,85,27,0,9,0,220,31.428571428571427,3,0.0,35,30,61,27,34,0,24,9,0,153,67,0
9082,130203,LXcV10npJRfqlWppXMKHh0qKrwexnute,7GRhBDsirIGkRZBtSMEzNTyDr2JQm4xx,17,21,6,8,4,0,5,0,44,6.285714285714286,1,0.0,13,6,4,4,8,0,4,5,0,27,17,1
9083,130242,Zam8m971nnqnufY6B6yjQg8Ac9iYnqaH,7GRhBDsirIGkRZBtSMEzNTyDr2JQm4xx,5,2,1,0,1,0,2,0,6,0.8571428571428571,1,0.0,0,1,0,1,2,0,0,2,0,2,4,1
9084,130315,p4bGPX0iGz12ZxxYlsOIjappHLYmKQJV,7GRhBDsirIGkRZBtSMEzNTyDr2JQm4xx,1,0,0,0,0,0,1,0,1,0.14285714285714285,1,0.0,0,0,0,0,0,0,0,1,0,0,1,1
9085,130320,ZtUzakjuKRDqOWlwK060v0k740lpF7MK,7GRhBDsirIGkRZBtSMEzNTyDr2JQm4xx,1,0,0,0,0,0,1,0,1,0.14285714285714285,1,0.0,0,0,0,0,0,0,0,1,0,0,1,1
9086,130384,WieFM9Wzak9WsTtSRlJq61lD6faDgSUK,7GRhBDsirIGkRZBtSMEzNTyDr2JQm4xx,1,0,0,0,0,0,1,0,1,0.14285714285714285,1,0.0,0,0,0,0,0,0,0,1,0,0,1,1
9087,130390,fh0UainSPUU5TsARoOfplicce0ntsxfp,5Gyp41oLVo7Gg7vF4vpmggWP5MU70QO6,5,5,3,0,1,0,2,0,11,1.5714285714285714,1,0.0,1,3,0,1,4,0,0,2,0,5,6,1
9088,130407,hXDR8WbSHyxrkc04cKCPP35adA2b4olL,5Gyp41oLVo7Gg7vF4vpmggWP5MU70QO6,24,56,26,14,24,2,9,1,132,18.857142857142858,7,0.0,22,26,11,24,34,2,3,9,1,83,49,1
9089,130408,mjw3GUEcVXrTrbwLTyOBl0brkRiJJKl1,5Gyp41oLVo7Gg7vF4vpmggWP5MU70QO6,7,10,4,0,3,0,3,0,20,2.857142857142857,3,0.0,0,4,0,3,10,0,0,3,0,7,13,1
9090,130420,YrnAzMp4JcyXVbokCMtLBRAQ1vi4YZZE,5Gyp41oLVo7Gg7vF4vpmggWP5MU70QO6,14,37,19,0,10,6,16,1,89,12.714285714285714,7,0.0,1,19,0,10,36,6,0,16,1,30,59,1
9091,130440,MbuXqf7C13S68Qf0iCIWEHpPecEoxyR2,5Gyp41oLVo7Gg7vF4vpmggWP5MU70QO6,18,16,10,0,6,5,14,2,53,7.571428571428571,3,0.0,1,10,0,6,15,5,0,14,2,17,36,0
9092,130451,EyBRRLQ9lC714P9pZPb13KmtdxaOzX2x,5Gyp41oLVo7Gg7vF4vpmggWP5MU70QO6,11,12,4,0,4,1,7,0,28,4.0,3,0.0,1,4,0,4,11,1,0,7,0,9,19,1
9093,130473,XE05vZThEHf17O6FM08AySNf2qZFgNWa,5Gyp41oLVo7Gg7vF4vpmggWP5MU70QO6,30,57,31,17,23,0,4,0,132,18.857142857142858,2,0.0,22,31,15,23,35,0,2,4,0,91,41,1
9094,130482,7ZQaIDzSJzw00mkFN7jwyjy0u4cN8LCV,5Gyp41oLVo7Gg7vF4vpmggWP5MU70QO6,1,0,0,0,0,0,1,0,1,0.14285714285714285,1,0.0,0,0,0,0,0,0,0,1,0,0,1,1
9095,130550,nVktdU2hPjrulp1NoJo2DLy3TGZQ0Uld,5Gyp41oLVo7Gg7vF4vpmggWP5MU70QO6,9,19,10,0,6,9,4,0,48,6.857142857142857,4,0.0,0,10,0,6,19,9,0,4,0,16,32,0
9096,130556,1QdJpYXkKKN8xPym5F8yPuZvkOxYcl3M,5Gyp41oLVo7Gg7vF4vpmggWP5MU70QO6,28,129,69,30,6,134,27,8,403,57.57142857142857,6,0.0,34,69,23,6,95,134,7,27,8,132,271,1
9097,130580,gYi43xr3NINMe9pnjsgYTwfmSH3gyxRj,5Gyp41oLVo7Gg7vF4vpmggWP5MU70QO6,34,55,24,28,16,28,20,1,172,24.571428571428573,7,0.0,12,24,18,16,43,28,10,20,1,70,102,0
9098,130613,J8NkUmSvsrLHkKNXPhFg7o0pG3K7Aywh,5Gyp41oLVo7Gg7vF4vpmggWP5MU70QO6,23,28,13,8,12,15,4,0,80,11.428571428571429,3,0.0,10,13,6,12,18,15,2,4,0,41,39,1
9099,130638,hOR2bCCLFk6wxhHuPZBSgvjYinCMMey8,5Gyp41oLVo7Gg7vF4vpmggWP5MU70QO6,7,3,2,0,2,0,2,0,9,1.2857142857142858,1,0.0,0,2,0,2,3,0,0,2,0,4,5,1
9100,130641,W4K0rgt56uxlLcFDkCAN3yIGeiFMXHWm,5Gyp41oLVo7Gg7vF4vpmggWP5MU70QO6,7,6,4,0,0,1,4,0,15,2.142857142857143,2,0.0,0,4,0,0,6,1,0,4,0,4,11,1
9101,130651,wqJVfyaCwf6JZB5zIYeMip9GWXKaguK7,5Gyp41oLVo7Gg7vF4vpmggWP5MU70QO6,12,10,6,8,3,0,2,0,29,4.142857142857143,2,0.0,1,6,5,3,9,0,3,2,0,15,14,1
9102,130690,7fH8lDsmHFsCAcoTycb5mpkxuj5ii0on,5Gyp41oLVo7Gg7vF4vpmggWP5MU70QO6,7,5,3,0,2,0,4,0,14,2.0,2,0.0,0,3,0,2,5,0,0,4,0,5,9,1
9103,130700,JyOwpTqxlZyOZXFXAlv3kcbVV4zSYrRf,5Gyp41oLVo7Gg7vF4vpmggWP5MU70QO6,36,73,46,1,18,0,12,0,150,21.428571428571427,7,0.0,11,46,1,18,62,0,0,12,0,76,74,1
9104,130719,XNkmquOCIOKVQlufJYaGLATxv204FVab,5Gyp41oLVo7Gg7vF4vpmggWP5MU70QO6,43,200,104,42,56,76,48,2,528,75.42857142857143,9,0.0,57,104,37,56,143,76,5,48,2,254,274,0
9105,130757,aGaqi9cnQPCgRc9cproX6qrgPoZwH926,5Gyp41oLVo7Gg7vF4vpmggWP5MU70QO6,33,81,32,8,15,3,10,0,149,21.285714285714285,5,0.0,25,32,5,15,56,3,3,10,0,77,72,1
9106,130766,OqeQvPHDeSPpa3vUHatLW7ynQapzzDzU,5Gyp41oLVo7Gg7vF4vpmggWP5MU70QO6,1,0,0,0,0,0,1,0,1,0.14285714285714285,1,0.0,0,0,0,0,0,0,0,1,0,0,1,1
9107,130769,VoGvhaJGXYIgQr660bRlWV61m6ihBVHX,5Gyp41oLVo7Gg7vF4vpmggWP5MU70QO6,10,7,4,0,3,0,4,0,18,2.5714285714285716,3,0.0,1,4,0,3,6,0,0,4,0,8,10,1
9108,130778,nGgyxqebKuHTPdYhSowDx2GZk9erlH2Z,5Gyp41oLVo7Gg7vF4vpmggWP5MU70QO6,29,36,14,10,19,3,6,0,88,12.571428571428571,4,0.0,11,14,6,19,25,3,4,6,0,50,38,0
9109,130786,uHzYuHuQRXAr1exd4W7B5yQO5lg5Kd8d,5Gyp41oLVo7Gg7vF4vpmggWP5MU70QO6,23,51,29,16,11,28,12,2,149,21.285714285714285,5,0.0,10,29,13,11,41,28,3,12,2,63,86,0
9110,130790,koffG72zNzMWAAbo1kaArxxqPmsGQsJp,5Gyp41oLVo7Gg7vF4vpmggWP5MU70QO6,41,160,74,93,9,1,29,1,367,52.42857142857143,15,0.0,51,74,79,9,109,1,14,29,1,213,154,1
9111,130796,ow2oX1tGYY5hdod8Bena1bbGOlgMvREE,5Gyp41oLVo7Gg7vF4vpmggWP5MU70QO6,5,2,1,0,1,0,2,0,6,0.8571428571428571,1,0.0,0,1,0,1,2,0,0,2,0,2,4,1
9112,130830,WV3YkTyrIBT24sYf1NcBchbLSWfuPseq,5Gyp41oLVo7Gg7vF4vpmggWP5MU70QO6,54,211,115,74,56,98,25,1,580,82.85714285714286,15,0.0,59,115,65,56,152,98,9,25,1,295,285,0
9113,130874,uqeVvezN3jh1cA0k5AKW1dfEGJzBOqHc,5Gyp41oLVo7Gg7vF4vpmggWP5MU70QO6,4,2,1,0,0,0,2,0,5,0.7142857142857143,1,0.0,0,1,0,0,2,0,0,2,0,1,4,1
9114,130876,Smz6QVjudf9J3ZYU2ZIKVlB0HiqlM9Ly,5Gyp41oLVo7Gg7vF4vpmggWP5MU70QO6,13,27,15,3,5,0,11,0,61,8.714285714285714,3,0.0,4,15,2,5,23,0,1,11,0,26,35,1
9115,130884,ikX72CHxEGhdeCUCpL9omQYpqM8MqHTI,5Gyp41oLVo7Gg7vF4vpmggWP5MU70QO6,7,10,1,0,2,0,2,0,15,2.142857142857143,2,0.0,1,1,0,2,9,0,0,2,0,4,11,1
9116,130899,y8cUu1XxDUCcOgxzUYyZz3iICamX1w7w,5Gyp41oLVo7Gg7vF4vpmggWP5MU70QO6,30,60,39,39,11,17,26,3,195,27.857142857142858,4,0.0,6,39,33,11,54,17,6,26,3,89,106,1
9117,130917,PtpZzYnFVB0EAGJrLQw5AfTDLDGLSqgY,5Gyp41oLVo7Gg7vF4vpmggWP5MU70QO6,11,22,10,0,6,12,8,0,58,8.285714285714286,3,0.0,5,10,0,6,17,12,0,8,0,21,37,1
9118,130938,7RIgMHzHpMzY7qBXHPj6WiDKK3U9H2Wz,5Gyp41oLVo7Gg7vF4vpmggWP5MU70QO6,5,4,2,0,1,0,2,0,9,1.2857142857142858,2,0.0,0,2,0,1,4,0,0,2,0,3,6,1
9119,130974,aAZaBYI2B8G7c2icF8GyQQjSqvcS26rD,5Gyp41oLVo7Gg7vF4vpmggWP5MU70QO6,5,2,0,0,1,0,2,0,5,0.7142857142857143,1,0.0,0,0,0,1,2,0,0,2,0,1,4,1
9120,131000,yzyLIDnRMJLamhEVzGYQIek8GP4CsGht,5Gyp41oLVo7Gg7vF4vpmggWP5MU70QO6,1,0,0,0,0,0,1,0,1,0.14285714285714285,1,0.0,0,0,0,0,0,0,0,1,0,0,1,1
9121,131009,QIQR6VwK3cpUKM5lDzadEKeQATM23w8z,5Gyp41oLVo7Gg7vF4vpmggWP5MU70QO6,7,24,1,0,1,0,1,0,27,3.857142857142857,1,0.0,10,1,0,1,14,0,0,1,0,12,15,1
9122,131027,gK3XDdBxJJXAYJgDo42Lu6DpWYFShLP7,5Gyp41oLVo7Gg7vF4vpmggWP5MU70QO6,4,4,3,0,0,0,3,0,10,1.4285714285714286,1,0.0,0,3,0,0,4,0,0,3,0,3,7,1
9123,131094,BDLXGrCEFzv2QDIDPW2amzBLrTOOGTmn,5Gyp41oLVo7Gg7vF4vpmggWP5MU70QO6,7,2,1,0,1,0,9,0,13,1.8571428571428572,2,0.0,0,1,0,1,2,0,0,9,0,2,11,1
9124,131099,XGm7X3dJTvaV78gJb3qqWyYMOzb4KNWc,5Gyp41oLVo7Gg7vF4vpmggWP5MU70QO6,16,27,10,4,5,1,6,0,53,7.571428571428571,2,0.0,11,10,2,5,16,1,2,6,0,28,25,1
9125,131173,5Pu7cWcFtLFiRZTplFnKu2qWuQ4rAwRa,5Gyp41oLVo7Gg7vF4vpmggWP5MU70QO6,12,14,7,7,3,4,7,0,42,6.0,2,0.0,4,7,5,3,10,4,2,7,0,19,23,1
9126,131194,43KrXQWA5nPYKCMGBRnIKMf2ytZWgrcW,5Gyp41oLVo7Gg7vF4vpmggWP5MU70QO6,12,20,5,3,4,0,6,0,38,5.428571428571429,3,0.0,4,5,2,4,16,0,1,6,0,15,23,1
9127,131222,h39dpjdvVbPQ6zfRX7tyjmchh8nPem2g,5Gyp41oLVo7Gg7vF4vpmggWP5MU70QO6,6,2,1,0,1,0,3,0,7,1.0,1,0.0,0,1,0,1,2,0,0,3,0,2,5,1
9128,131246,bJt9TTbFDYmRC8qapqKfPz3fKvRwaX67,5Gyp41oLVo7Gg7vF4vpmggWP5MU70QO6,16,27,12,0,2,1,11,0,53,7.571428571428571,2,0.0,9,12,0,2,18,1,0,11,0,23,30,1
9129,131250,TNVJ3cJUpM3QJlElfPs5M5WdkwQ2pltF,5Gyp41oLVo7Gg7vF4vpmggWP5MU70QO6,9,11,4,0,2,0,2,0,19,2.7142857142857144,1,0.0,0,4,0,2,11,0,0,2,0,6,13,1
9130,131328,ts0EaKyAxTvfiWPI8iMTLKRxho1uLmjs,5Gyp41oLVo7Gg7vF4vpmggWP5MU70QO6,9,14,8,0,3,7,28,1,61,8.714285714285714,5,0.0,0,8,0,3,14,7,0,28,1,11,50,0
9131,131330,qB7uX9PTKvJKyMfI8P2VS08zJ3k1bFD8,5Gyp41oLVo7Gg7vF4vpmggWP5MU70QO6,9,7,4,0,3,0,2,0,16,2.2857142857142856,1,0.0,0,4,0,3,7,0,0,2,0,7,9,1
9132,131340,keyV9nPgTAWptajZXLslaeIkOfczLyJH,5Gyp41oLVo7Gg7vF4vpmggWP5MU70QO6,25,120,9,47,2,15,22,1,216,30.857142857142858,7,0.0,35,9,41,2,85,15,6,22,1,87,129,1
9133,131347,j8NiIVsE4clxUArccoUEv3yDo7sCD1t3,5Gyp41oLVo7Gg7vF4vpmggWP5MU70QO6,20,31,15,15,7,0,8,0,76,10.857142857142858,5,0.0,9,15,11,7,22,0,4,8,0,42,34,1
9134,131349,fyN7sTjm86IwKs15MRI9xS2BA1QeaB2u,5Gyp41oLVo7Gg7vF4vpmggWP5MU70QO6,8,15,8,0,4,2,5,0,34,4.857142857142857,2,0.0,0,8,0,4,15,2,0,5,0,12,22,1
9135,131355,W33EE7unOY54q9z4VEWWrUPkAAUnkTRs,5Gyp41oLVo7Gg7vF4vpmggWP5MU70QO6,16,25,10,0,8,0,4,0,47,6.714285714285714,3,0.0,6,10,0,8,19,0,0,4,0,24,23,1
9136,131361,jZTK26BTfBLHQKFhPE9kcyNEiSpfCkRJ,5Gyp41oLVo7Gg7vF4vpmggWP5MU70QO6,6,4,2,0,1,0,3,0,10,1.4285714285714286,2,0.0,0,2,0,1,4,0,0,3,0,3,7,1
9137,131378,4OmHGujA2hhASXOuyK0VTrDAmjgn5CTc,5Gyp41oLVo7Gg7vF4vpmggWP5MU70QO6,32,62,36,28,17,34,21,10,208,29.714285714285715,4,0.0,18,36,19,17,44,34,9,21,10,90,118,1
9138,131380,Y5zB0T2K5mJuSWoJzZha51yyGwLdXbtV,5Gyp41oLVo7Gg7vF4vpmggWP5MU70QO6,17,28,10,20,4,11,13,1,87,12.428571428571429,2,0.0,10,10,13,4,18,11,7,13,1,37,50,1
9139,131384,V5yRdaEPt7GW3hq3KhrUY9AEknMr09q2,5Gyp41oLVo7Gg7vF4vpmggWP5MU70QO6,7,4,3,0,1,0,2,0,10,1.4285714285714286,1,0.0,0,3,0,1,4,0,0,2,0,4,6,1
9140,131399,DnbEU5fJzs8Mmed27x4lbJX96rD7FcVo,5Gyp41oLVo7Gg7vF4vpmggWP5MU70QO6,11,8,5,8,3,5,4,0,33,4.714285714285714,2,0.0,1,5,5,3,7,5,3,4,0,14,19,0
9141,131403,hbzMHGarvLe3PTqWPbLXgPXbq3BgvYsO,5Gyp41oLVo7Gg7vF4vpmggWP5MU70QO6,30,66,10,26,0,3,45,2,152,21.714285714285715,9,0.0,11,10,22,0,55,3,4,45,2,43,109,1
9142,131412,Zl23fvvMHDHkGe16GjZx0L7tSLK1ARxE,5Gyp41oLVo7Gg7vF4vpmggWP5MU70QO6,16,18,8,9,4,3,9,2,53,7.571428571428571,2,0.0,5,8,6,4,13,3,3,9,2,23,30,1
9143,131504,6uVIhHqcI4x28sqhjQxrN6olj7DlNEsQ,5Gyp41oLVo7Gg7vF4vpmggWP5MU70QO6,21,32,10,22,6,7,4,1,82,11.714285714285714,3,0.0,7,10,16,6,25,7,6,4,1,39,43,1
9144,131522,DxPgV2DsHShM2ySjb2i9ObZkJr6k1o5D,5Gyp41oLVo7Gg7vF4vpmggWP5MU70QO6,42,68,35,34,16,20,20,9,202,28.857142857142858,9,0.0,12,35,26,16,56,20,8,20,9,89,113,0
9145,131595,tEv4BoLlr0dBgGPraxSbNQaBzkeTtB9W,5Gyp41oLVo7Gg7vF4vpmggWP5MU70QO6,41,88,21,34,20,14,18,1,196,28.0,4,0.0,13,21,27,20,75,14,7,18,1,81,115,1
9146,131602,wsHwZ3NkY1tqHKUuOn0buAOnr2acx1MP,5Gyp41oLVo7Gg7vF4vpmggWP5MU70QO6,2,0,0,0,0,0,2,0,2,0.2857142857142857,2,0.0,0,0,0,0,0,0,0,2,0,0,2,0
9147,131603,Xf8Rm9Od3sFpqFLzTqQbZGr496dUD0aI,5Gyp41oLVo7Gg7vF4vpmggWP5MU70QO6,5,3,1,0,2,0,2,0,8,1.1428571428571428,1,0.0,0,1,0,2,3,0,0,2,0,3,5,1
9148,131657,JhqXqTDDCNKGAy1ZAkKGroaTL2D3J2UP,5Gyp41oLVo7Gg7vF4vpmggWP5MU70QO6,24,24,15,16,7,0,2,0,64,9.142857142857142,3,0.0,6,15,11,7,18,0,5,2,0,39,25,1
9149,131694,pfOsJuHWb0tCShV2tfjxlenGYXv9QGCF,5Gyp41oLVo7Gg7vF4vpmggWP5MU70QO6,9,5,2,0,1,0,5,0,13,1.8571428571428572,2,0.0,0,2,0,1,5,0,0,5,0,3,10,1
9150,131695,bLGCO0LzqYqrv4E17LUKBZyDAIvTEUwU,5Gyp41oLVo7Gg7vF4vpmggWP5MU70QO6,4,2,1,0,1,0,1,0,5,0.7142857142857143,1,0.0,0,1,0,1,2,0,0,1,0,2,3,1
9151,131712,9APdRoqpAZVbJfuWp4zlzd8Py7KWCQpy,5Gyp41oLVo7Gg7vF4vpmggWP5MU70QO6,17,25,12,4,6,0,5,0,52,7.428571428571429,3,0.0,11,12,3,6,14,0,1,5,0,32,20,1
9152,131737,m7ppZFqoqxq4drq32V7wzPII9oNFXP01,5Gyp41oLVo7Gg7vF4vpmggWP5MU70QO6,34,197,78,30,23,42,14,0,384,54.857142857142854,7,0.0,47,78,23,23,150,42,7,14,0,171,213,1
9153,131739,R0QpoGjtADF0I1Axo5DlzbSL8vsaM736,5Gyp41oLVo7Gg7vF4vpmggWP5MU70QO6,10,8,6,0,3,0,2,0,19,2.7142857142857144,1,0.0,1,6,0,3,7,0,0,2,0,10,9,1
9154,131744,y1x8e9Sqq47SjNlkaBvMyt0S6tF2mWwv,5Gyp41oLVo7Gg7vF4vpmggWP5MU70QO6,4,3,1,0,0,0,2,0,6,0.8571428571428571,1,0.0,0,1,0,0,3,0,0,2,0,1,5,1
9155,131782,3EXQpH44dmXe1KuNCn9IRB8zLxVzdC0Z,5Gyp41oLVo7Gg7vF4vpmggWP5MU70QO6,24,34,18,11,9,0,7,0,79,11.285714285714286,5,0.0,10,18,7,9,24,0,4,7,0,44,35,1
9156,131805,SXd9BYBZPMmjo3TQYqcwaqxl3DiSUxvi,5Gyp41oLVo7Gg7vF4vpmggWP5MU70QO6,14,16,10,16,4,25,11,2,84,12.0,2,0.0,3,10,15,4,13,25,1,11,2,32,52,1
9157,131816,1c7Cukk2MxZbKsBARUEyyKrdP5ZLxBnR,5Gyp41oLVo7Gg7vF4vpmggWP5MU70QO6,26,105,11,22,2,19,13,1,173,24.714285714285715,4,0.0,27,11,19,2,78,19,3,13,1,59,114,1
9158,131820,5CW0dW9ZlVdln4ywkh3tNexTpuV4z0gh,5Gyp41oLVo7Gg7vF4vpmggWP5MU70QO6,11,11,5,0,3,12,10,1,42,6.0,2,0.0,0,5,0,3,11,12,0,10,1,8,34,1
9159,131855,M2AmcvqhvMtUlyRV6vMvvoM2IhrMmAwT,5Gyp41oLVo7Gg7vF4vpmggWP5MU70QO6,6,5,2,0,2,0,7,0,16,2.2857142857142856,3,0.0,0,2,0,2,5,0,0,7,0,4,12,1
9160,131873,bbm8yYJyAbMhdjy6Bh1qmHkJg51nIMGA,5Gyp41oLVo7Gg7vF4vpmggWP5MU70QO6,1,0,0,0,0,0,1,0,1,0.14285714285714285,1,0.0,0,0,0,0,0,0,0,1,0,0,1,1
9161,131879,8xYLLlbmIrGkd1CsLlZ6SUCUl7DASCOB,5Gyp41oLVo7Gg7vF4vpmggWP5MU70QO6,8,3,2,0,2,1,4,0,12,1.7142857142857142,1,0.0,0,2,0,2,3,1,0,4,0,4,8,1
9162,131892,zopUGlKgUg69s1rzZoMdsUvam179akTf,5Gyp41oLVo7Gg7vF4vpmggWP5MU70QO6,49,122,57,44,37,20,34,2,316,45.142857142857146,9,0.0,45,57,33,37,77,20,11,34,2,172,144,1
9163,131910,LYbJIF5P9Tku2dhEfjAlbdESdZCIX94V,5Gyp41oLVo7Gg7vF4vpmggWP5MU70QO6,18,45,26,2,8,0,9,0,90,12.857142857142858,6,0.0,8,26,1,8,37,0,1,9,0,43,47,1
9164,131944,F16OuTgaH1ZbsvG4bVnrHtSG2xmdMXNR,5Gyp41oLVo7Gg7vF4vpmggWP5MU70QO6,19,10,0,0,5,3,9,1,28,4.0,2,0.0,0,0,0,5,10,3,0,9,1,5,23,1
9165,131971,rEshrXNp0EMe0kgk6a6QvKN0GvvqP09g,5Gyp41oLVo7Gg7vF4vpmggWP5MU70QO6,5,1,1,0,0,0,3,0,5,0.7142857142857143,1,0.0,0,1,0,0,1,0,0,3,0,1,4,1
9166,131996,SXrnj1e7is63ySeBmVxcG3AQIXrfu0P1,5Gyp41oLVo7Gg7vF4vpmggWP5MU70QO6,10,6,4,0,3,0,3,0,16,2.2857142857142856,1,0.0,0,4,0,3,6,0,0,3,0,7,9,1
9167,132003,LwWEpDPDSnf5fex4u9elAVKzOCsEA2BH,5Gyp41oLVo7Gg7vF4vpmggWP5MU70QO6,3,3,1,0,0,0,1,0,5,0.7142857142857143,1,0.0,0,1,0,0,3,0,0,1,0,1,4,1
9168,132046,v1yqPjxvlDjDstQpp2P9NuO9mCUHsDtx,5Gyp41oLVo7Gg7vF4vpmggWP5MU70QO6,7,3,2,0,2,0,2,0,9,1.2857142857142858,1,0.0,0,2,0,2,3,0,0,2,0,4,5,1
9169,132050,A91LmigajlYmUThAUOB9zyztzjWVIi6k,5Gyp41oLVo7Gg7vF4vpmggWP5MU70QO6,1,0,0,0,0,0,1,0,1,0.14285714285714285,1,0.0,0,0,0,0,0,0,0,1,0,0,1,1
9170,132078,0ciTPUCdCl6053ofk1VnorJgHJzysGWh,5Gyp41oLVo7Gg7vF4vpmggWP5MU70QO6,7,4,3,0,3,0,3,0,13,1.8571428571428572,1,0.0,0,3,0,3,4,0,0,3,0,6,7,1
9171,132112,wodz58MkHQadBU30zkgGJ03KFU838ic3,5Gyp41oLVo7Gg7vF4vpmggWP5MU70QO6,11,15,7,0,4,0,5,0,31,4.428571428571429,3,0.0,2,7,0,4,13,0,0,5,0,13,18,1
9172,132143,dJDejiH7U6IIQkmZAYSYsbGTbsOmnz42,5Gyp41oLVo7Gg7vF4vpmggWP5MU70QO6,7,6,4,0,3,0,2,0,15,2.142857142857143,2,0.0,0,4,0,3,6,0,0,2,0,7,8,1
9173,132165,Eb1mIPZ0KhigdFpE9ChqAfIpfrjfpix8,5Gyp41oLVo7Gg7vF4vpmggWP5MU70QO6,19,69,26,14,1,8,24,1,143,20.428571428571427,5,0.0,17,26,10,1,52,8,4,24,1,54,89,0
9174,132180,8BQYtdVuq0mFTCN9duQN6kZR8TREJ89L,5Gyp41oLVo7Gg7vF4vpmggWP5MU70QO6,9,4,3,0,3,4,9,2,25,3.5714285714285716,2,0.0,0,3,0,3,4,4,0,9,2,6,19,1
9175,132200,MTBKFXeMl374P880k9VePnhSWnznGeS2,5Gyp41oLVo7Gg7vF4vpmggWP5MU70QO6,5,0,0,0,0,2,4,1,7,1.0,1,0.0,0,0,0,0,0,2,0,4,1,0,7,1
9176,132224,CUHsvexAAfaCEMKsM3644JTxXL5DgSss,5Gyp41oLVo7Gg7vF4vpmggWP5MU70QO6,7,2,1,0,1,1,9,0,14,2.0,1,0.0,0,1,0,1,2,1,0,9,0,2,12,1
9177,132248,9m85UD02jbhgpeincAAvgVQkzb9sCXlF,5Gyp41oLVo7Gg7vF4vpmggWP5MU70QO6,1,0,0,0,0,0,1,0,1,0.14285714285714285,1,0.0,0,0,0,0,0,0,0,1,0,0,1,1
9178,132281,kL9QKMHnydkmQKCDQRgleUAavzMbM8XG,5Gyp41oLVo7Gg7vF4vpmggWP5MU70QO6,31,66,40,14,25,7,6,1,159,22.714285714285715,9,0.0,18,40,9,25,48,7,5,6,1,92,67,1
9179,132325,tZjbcx0Le1zQWUOBuj8QARHWw1tgsE24,5Gyp41oLVo7Gg7vF4vpmggWP5MU70QO6,3,0,0,0,0,2,3,0,5,0.7142857142857143,1,0.0,0,0,0,0,0,2,0,3,0,0,5,1
9180,132337,nKmHMMCiSZTSjj45mRupTwWfpHzvUHK8,5Gyp41oLVo7Gg7vF4vpmggWP5MU70QO6,15,40,21,1,9,15,16,0,102,14.571428571428571,3,0.0,5,21,1,9,35,15,0,16,0,36,66,1
9181,132380,x0AlHvqNogu6fpjyTMPAv6SbVNr5iz8A,5Gyp41oLVo7Gg7vF4vpmggWP5MU70QO6,16,53,25,2,9,3,21,3,116,16.571428571428573,6,0.0,16,25,1,9,37,3,1,21,3,51,65,1
9182,132388,RP5IKI5SVXZdpe75SUsUdO2MLCTQcx9c,5Gyp41oLVo7Gg7vF4vpmggWP5MU70QO6,1,0,0,0,0,0,1,0,1,0.14285714285714285,1,0.0,0,0,0,0,0,0,0,1,0,0,1,1
9183,132406,Ax8ieqNjdDJL2m4TR7JMUbvxGU6T4Uzt,5Gyp41oLVo7Gg7vF4vpmggWP5MU70QO6,17,15,9,4,3,2,5,1,39,5.571428571428571,2,0.0,3,9,2,3,12,2,2,5,1,17,22,1
9184,132407,7uYtYieXVdovhdVtTxyxFreDB9cgs1c9,5Gyp41oLVo7Gg7vF4vpmggWP5MU70QO6,18,24,14,0,13,0,7,0,58,8.285714285714286,4,0.0,6,14,0,13,18,0,0,7,0,33,25,0
9185,132418,He3dmXXAyTEoh2CkYGl3GVTmezR6vfVu,5Gyp41oLVo7Gg7vF4vpmggWP5MU70QO6,14,15,6,0,4,0,4,0,29,4.142857142857143,4,0.0,1,6,0,4,14,0,0,4,0,11,18,1
9186,132419,eosk3dY7502Pbg6Dsnx0qWKWUpRTliXK,5Gyp41oLVo7Gg7vF4vpmggWP5MU70QO6,26,36,25,5,10,1,10,0,87,12.428571428571429,6,0.0,2,25,3,10,34,1,2,10,0,40,47,1
9187,132434,YPrwpvfXsBDGAl9mBUenTv0vxHRoreGY,5Gyp41oLVo7Gg7vF4vpmggWP5MU70QO6,1,0,0,0,0,0,1,0,1,0.14285714285714285,1,0.0,0,0,0,0,0,0,0,1,0,0,1,1
9188,132450,ko6uXLGpSTF08zVsdhFmDvgPNLaJOo1o,5Gyp41oLVo7Gg7vF4vpmggWP5MU70QO6,1,0,0,0,0,0,1,0,1,0.14285714285714285,1,0.0,0,0,0,0,0,0,0,1,0,0,1,1
9189,132479,kxygIhpaaZ3PJ4cUkB7uXqGox4OFtNxP,5Gyp41oLVo7Gg7vF4vpmggWP5MU70QO6,9,17,8,0,5,0,5,0,35,5.0,3,0.0,1,8,0,5,16,0,0,5,0,14,21,1
9190,132484,aLMJdr3poOybmwxdbLisljmwiTgCx40t,5Gyp41oLVo7Gg7vF4vpmggWP5MU70QO6,11,8,4,0,5,1,15,0,33,4.714285714285714,2,0.0,2,4,0,5,6,1,0,15,0,11,22,1
9191,132486,YNGYgoeSeYnXDcLFGpC8kMKhHO3mh1hj,5Gyp41oLVo7Gg7vF4vpmggWP5MU70QO6,32,46,20,14,13,15,6,0,114,16.285714285714285,2,0.0,14,20,9,13,32,15,5,6,0,56,58,1
9192,132523,92DRngBnz9eYlBng8rYmQ1zqJi3nHrTg,5Gyp41oLVo7Gg7vF4vpmggWP5MU70QO6,5,2,1,0,1,0,2,0,6,0.8571428571428571,1,0.0,0,1,0,1,2,0,0,2,0,2,4,1
9193,132541,Is3MGErrniCcO5dYPdwXFvVXWaYlygPn,5Gyp41oLVo7Gg7vF4vpmggWP5MU70QO6,26,84,40,19,15,34,30,4,226,32.285714285714285,7,0.0,26,40,11,15,58,34,8,30,4,92,134,1
9194,132543,vRQ3LtbERKPZ8Tl6Ek1qquKxg61fZYCA,5Gyp41oLVo7Gg7vF4vpmggWP5MU70QO6,8,7,5,0,4,0,3,0,19,2.7142857142857144,2,0.0,0,5,0,4,7,0,0,3,0,9,10,1
9195,132573,6Ypoz1HptUjxpuR7fZtuIow2vA2n53uM,5Gyp41oLVo7Gg7vF4vpmggWP5MU70QO6,5,4,2,0,1,0,2,0,9,1.2857142857142858,2,0.0,0,2,0,1,4,0,0,2,0,3,6,1
9196,132582,IrA5M9dNHysg7vRsj0oG84kl9SjifMt1,5Gyp41oLVo7Gg7vF4vpmggWP5MU70QO6,13,11,6,0,3,0,11,0,31,4.428571428571429,2,0.0,1,6,0,3,10,0,0,11,0,10,21,1
9197,132598,cYj2Kix5LwS34n1djiEF2yp2Z1EAdVvF,5Gyp41oLVo7Gg7vF4vpmggWP5MU70QO6,12,9,5,0,3,4,8,9,38,5.428571428571429,1,0.0,2,5,0,3,7,4,0,8,9,10,28,1
9198,132652,dhuAs0ipxVSTXv3LoNDtuzpwxQjaYkG4,5Gyp41oLVo7Gg7vF4vpmggWP5MU70QO6,5,2,1,0,1,0,3,0,7,1.0,1,0.0,0,1,0,1,2,0,0,3,0,2,5,1
9199,132665,oPz83Tur5MkzNcFWvDyvFHFtbqwdcnI2,5Gyp41oLVo7Gg7vF4vpmggWP5MU70QO6,9,8,4,0,4,1,1,0,18,2.5714285714285716,1,0.0,0,4,0,4,8,1,0,1,0,8,10,1
9200,132670,E3rUTd8QKBAWbDGNzVkauwwCc821vcEL,5Gyp41oLVo7Gg7vF4vpmggWP5MU70QO6,1,0,0,0,0,0,3,0,3,0.42857142857142855,3,0.0,0,0,0,0,0,0,0,3,0,0,3,1
9201,132718,lHM7vQGZOBeekTuCVhrRECtVqDAppRah,5Gyp41oLVo7Gg7vF4vpmggWP5MU70QO6,11,10,6,0,4,0,5,0,25,3.5714285714285716,1,0.0,1,6,0,4,9,0,0,5,0,11,14,1
9202,132747,zBiultU9CebUoD46IJPKuNDT62F2VJnh,5Gyp41oLVo7Gg7vF4vpmggWP5MU70QO6,6,3,2,0,2,0,1,0,8,1.1428571428571428,1,0.0,0,2,0,2,3,0,0,1,0,4,4,0
9203,132754,UJzmrw0Uok7c5QcFXwdJlJnRO18e46kw,5Gyp41oLVo7Gg7vF4vpmggWP5MU70QO6,49,99,43,59,24,34,26,2,287,41.0,9,0.0,25,43,48,24,74,34,11,26,2,140,147,1
9204,132780,yqcwkKO0v8H7BNYfyLRaSnVP0uvb1l7l,5Gyp41oLVo7Gg7vF4vpmggWP5MU70QO6,6,3,2,0,2,0,1,0,8,1.1428571428571428,1,0.0,0,2,0,2,3,0,0,1,0,4,4,1
9205,132836,dQCqpXh6bSjQMiiCmgsAGJibQooxCVHx,5Gyp41oLVo7Gg7vF4vpmggWP5MU70QO6,1,0,0,0,0,0,1,0,1,0.14285714285714285,1,0.0,0,0,0,0,0,0,0,1,0,0,1,1
9206,132843,C9NWzqG5VbpKyAa5BJ7vh1T8bQqRBluD,5Gyp41oLVo7Gg7vF4vpmggWP5MU70QO6,13,16,7,0,4,5,10,0,42,6.0,3,0.0,0,7,0,4,16,5,0,10,0,11,31,1
9207,132845,G2OMNMX7YizNWZt8n4FGjdU4ZDefPdme,5Gyp41oLVo7Gg7vF4vpmggWP5MU70QO6,7,3,2,0,2,0,3,0,10,1.4285714285714286,1,0.0,0,2,0,2,3,0,0,3,0,4,6,1
9208,132851,q8lkEz5ux7ymuY9onzKT3TgKTkowCnbu,5Gyp41oLVo7Gg7vF4vpmggWP5MU70QO6,21,24,10,4,11,4,10,1,64,9.142857142857142,2,0.0,11,10,3,11,13,4,1,10,1,35,29,1
9209,132854,3QRWazv1MB7UvBYZ0mTQZIXJueMGJ85k,5Gyp41oLVo7Gg7vF4vpmggWP5MU70QO6,15,58,24,35,0,13,23,6,159,22.714285714285715,5,0.0,18,24,25,0,40,13,10,23,6,67,92,1
9210,132870,0HvazwOy4SOde7XhFx88Am86BQsUAErP,5Gyp41oLVo7Gg7vF4vpmggWP5MU70QO6,24,58,12,23,5,2,18,12,130,18.571428571428573,3,0.0,17,12,15,5,41,2,8,18,12,49,81,1
9211,132899,tCaaBJWExrSBwfO7jaOkCN6P5oM8kOgT,5Gyp41oLVo7Gg7vF4vpmggWP5MU70QO6,28,54,36,40,13,0,10,1,154,22.0,3,0.0,13,36,24,13,41,0,16,10,1,86,68,0
9212,132956,cbKRb3sP1zVAfa9Zatv3RkWNfcW2zkBa,5Gyp41oLVo7Gg7vF4vpmggWP5MU70QO6,5,4,2,0,0,0,2,0,8,1.1428571428571428,1,0.0,0,2,0,0,4,0,0,2,0,2,6,1
9213,132961,SIYCK8ATsKzkptD3U3uig9bh8DBamXxY,5Gyp41oLVo7Gg7vF4vpmggWP5MU70QO6,20,35,15,0,18,0,7,0,75,10.714285714285714,4,0.0,15,15,0,18,20,0,0,7,0,48,27,0
9214,132971,DOaBjaIUR8EKUl1c6qN6cFAfQ2a4tFw5,5Gyp41oLVo7Gg7vF4vpmggWP5MU70QO6,1,0,0,0,0,0,1,0,1,0.14285714285714285,1,0.0,0,0,0,0,0,0,0,1,0,0,1,1
9215,133008,z9IJK1H3SfF2B12kwDvfcSB1ThWvraIJ,5Gyp41oLVo7Gg7vF4vpmggWP5MU70QO6,20,57,23,23,7,23,16,3,152,21.714285714285715,6,0.0,17,23,16,7,40,23,7,16,3,63,89,1
9216,133010,VzBpUg1iDEGcx0TVgzByc2Ga25gtHxK4,5Gyp41oLVo7Gg7vF4vpmggWP5MU70QO6,11,14,6,0,3,1,6,1,31,4.428571428571429,1,0.0,0,6,0,3,14,1,0,6,1,9,22,0
9217,133125,TigSXIZ3l1yiTHn0dCXNXs74pLSKNppc,5Gyp41oLVo7Gg7vF4vpmggWP5MU70QO6,30,71,40,34,23,11,16,4,199,28.428571428571427,9,0.0,21,40,25,23,50,11,9,16,4,109,90,1
9218,133131,TlWZZCkE66jOCXoa4aSVNx14pMBEd33v,5Gyp41oLVo7Gg7vF4vpmggWP5MU70QO6,8,4,2,0,1,0,4,1,12,1.7142857142857142,1,0.0,1,2,0,1,3,0,0,4,1,4,8,1
9219,133164,n7ad9aSATtX9NdHV2NBgff8LjuVUEyxS,5Gyp41oLVo7Gg7vF4vpmggWP5MU70QO6,9,2,2,0,1,2,10,1,18,2.5714285714285716,1,0.0,0,2,0,1,2,2,0,10,1,3,15,1
9220,133174,yfSRXUXIq6SsIbv2yHfkbd1lMI4MUQuG,5Gyp41oLVo7Gg7vF4vpmggWP5MU70QO6,10,7,4,1,2,0,5,0,19,2.7142857142857144,1,0.0,1,4,1,2,6,0,0,5,0,8,11,1
9221,133190,Z0BVFzsmuTfwpPZa3KK0vNiQpnGQvB7P,5Gyp41oLVo7Gg7vF4vpmggWP5MU70QO6,7,4,3,0,3,0,2,0,12,1.7142857142857142,1,0.0,0,3,0,3,4,0,0,2,0,6,6,1
9222,133193,qciW3eHpuKm9iUPQVKuwWV8dfW8XAZ18,5Gyp41oLVo7Gg7vF4vpmggWP5MU70QO6,19,53,27,0,7,13,16,0,116,16.571428571428573,12,0.0,6,27,0,7,47,13,0,16,0,40,76,1
9223,133200,BKfnFDMm8snkyQWQxLALiUCxnWj3j64N,5Gyp41oLVo7Gg7vF4vpmggWP5MU70QO6,4,2,1,0,0,0,2,0,5,0.7142857142857143,1,0.0,0,1,0,0,2,0,0,2,0,1,4,1
9224,133203,23oixcFTyMb5yEChATjRs45rlurHDtZg,5Gyp41oLVo7Gg7vF4vpmggWP5MU70QO6,5,1,1,0,0,1,4,0,7,1.0,1,0.0,0,1,0,0,1,1,0,4,0,1,6,1
9225,133226,BX8KZktSpp7qRNeftrJD7dKRaVhtg4o2,5Gyp41oLVo7Gg7vF4vpmggWP5MU70QO6,5,2,1,0,1,0,3,0,7,1.0,1,0.0,0,1,0,1,2,0,0,3,0,2,5,1
9226,133234,R8i15NDgSXCxnHS0gE9L3by2MtCSeEIc,5Gyp41oLVo7Gg7vF4vpmggWP5MU70QO6,6,4,3,0,1,0,1,0,9,1.2857142857142858,1,0.0,0,3,0,1,4,0,0,1,0,4,5,1
9227,133249,cjIjalOkynRvNiMkIirdnL3eRD5dBGGC,5Gyp41oLVo7Gg7vF4vpmggWP5MU70QO6,8,6,2,0,1,0,11,0,20,2.857142857142857,5,0.0,0,2,0,1,6,0,0,11,0,3,17,1
9228,133261,03LL3Qts3sw7LfZgogCHsUXr6C3yxlnd,5Gyp41oLVo7Gg7vF4vpmggWP5MU70QO6,10,3,3,0,3,0,8,1,18,2.5714285714285716,1,0.0,0,3,0,3,3,0,0,8,1,6,12,1
9229,133263,k7UuP7854KwiR2G5Rvk90CqeMYmrVmLp,5Gyp41oLVo7Gg7vF4vpmggWP5MU70QO6,14,32,14,16,6,15,9,0,92,13.142857142857142,2,0.0,11,14,12,6,21,15,4,9,0,43,49,1
9230,133345,azsfvKoTKLQ8ipwpPOtqZMAvWCpOjcns,5Gyp41oLVo7Gg7vF4vpmggWP5MU70QO6,8,4,3,0,2,0,3,0,12,1.7142857142857142,2,0.0,0,3,0,2,4,0,0,3,0,5,7,1
9231,133352,XgjQoYTAIZUQmEkeBN1q8wGOZcMHBH63,5Gyp41oLVo7Gg7vF4vpmggWP5MU70QO6,3,2,0,0,0,0,1,0,3,0.42857142857142855,1,0.0,0,0,0,0,2,0,0,1,0,0,3,1
9232,133357,tyqJZzEML3JHaVtb5u1xmf4a7Of5P3tA,5Gyp41oLVo7Gg7vF4vpmggWP5MU70QO6,9,6,4,0,2,0,4,0,16,2.2857142857142856,1,0.0,0,4,0,2,6,0,0,4,0,6,10,1
9233,133358,BD1myLDsp1cWJRs3OVKHuveNwgVTzT9S,5Gyp41oLVo7Gg7vF4vpmggWP5MU70QO6,8,9,3,0,2,0,3,0,17,2.4285714285714284,2,0.0,0,3,0,2,9,0,0,3,0,5,12,1
9234,133372,IAfLUodwXUDQZ7fHMTbvgcyqIHlBdURZ,5Gyp41oLVo7Gg7vF4vpmggWP5MU70QO6,6,3,1,0,1,0,3,0,8,1.1428571428571428,1,0.0,0,1,0,1,3,0,0,3,0,2,6,1
9235,133373,tmDCjfvFzsLXNJOsSalKtMeHilqBCK5i,5Gyp41oLVo7Gg7vF4vpmggWP5MU70QO6,9,6,3,0,2,0,5,0,16,2.2857142857142856,3,0.0,0,3,0,2,6,0,0,5,0,5,11,1
9236,133379,0d6GVIoz6wgxFRQyqZwP8S5bKktUshxJ,5Gyp41oLVo7Gg7vF4vpmggWP5MU70QO6,1,0,0,0,0,0,1,0,1,0.14285714285714285,1,0.0,0,0,0,0,0,0,0,1,0,0,1,1
9237,133402,T9568NbVeTbUTmE4rk1xM0kbLMHudWM2,5Gyp41oLVo7Gg7vF4vpmggWP5MU70QO6,4,2,1,0,1,0,1,0,5,0.7142857142857143,1,0.0,0,1,0,1,2,0,0,1,0,2,3,1
9238,133403,9NtQ7PjkuhRpKAXpOSS5PoVkdaWYCjac,5Gyp41oLVo7Gg7vF4vpmggWP5MU70QO6,1,0,0,0,0,0,2,0,2,0.2857142857142857,1,0.0,0,0,0,0,0,0,0,2,0,0,2,1
9239,133412,nnAFgrjzFRJhpmRSWYDef5PvUtf0piIv,5Gyp41oLVo7Gg7vF4vpmggWP5MU70QO6,6,1,1,0,1,0,4,0,7,1.0,1,0.0,0,1,0,1,1,0,0,4,0,2,5,1
9240,133424,8rI72y7lNYBVrRyE6hS0uBCfocFsM80l,5Gyp41oLVo7Gg7vF4vpmggWP5MU70QO6,22,59,19,6,11,2,10,0,107,15.285714285714286,3,0.0,20,19,6,11,39,2,0,10,0,56,51,1
9241,133508,bWkoiaX3qYePD2I6BiCrFyAyCl2ds7KU,5Gyp41oLVo7Gg7vF4vpmggWP5MU70QO6,1,0,0,0,0,0,1,0,1,0.14285714285714285,1,0.0,0,0,0,0,0,0,0,1,0,0,1,1
9242,133535,yjxhxXzkMkPSCxXcQ3QOPUmqjUCbiXsw,5Gyp41oLVo7Gg7vF4vpmggWP5MU70QO6,1,0,0,0,0,0,1,0,1,0.14285714285714285,1,0.0,0,0,0,0,0,0,0,1,0,0,1,1
9243,133551,cMU7RK63TPqPAq4a6icli8lzOkQ3VauZ,5Gyp41oLVo7Gg7vF4vpmggWP5MU70QO6,7,3,2,0,2,0,5,0,12,1.7142857142857142,2,0.0,0,2,0,2,3,0,0,5,0,4,8,1
9244,133575,VgX5Bev4AVzFoIGqTO3nKDRUm7GXUXqQ,5Gyp41oLVo7Gg7vF4vpmggWP5MU70QO6,15,32,16,6,5,4,10,2,75,10.714285714285714,2,0.0,6,16,4,5,26,4,2,10,2,31,44,1
9245,133615,2K5xqqC4Eq68C8x6EHoN1vuQVGlHvK86,5Gyp41oLVo7Gg7vF4vpmggWP5MU70QO6,12,22,13,32,4,12,4,0,87,12.428571428571429,1,0.0,6,13,19,4,16,12,13,4,0,42,45,1
9246,133635,geyYxnlqDtNpjstCYyrTeWLmk3gVcwKX,5Gyp41oLVo7Gg7vF4vpmggWP5MU70QO6,9,13,6,0,4,2,6,0,31,4.428571428571429,2,0.0,4,6,0,4,9,2,0,6,0,14,17,1
9247,133661,WpV2Wlof9MraqpUtf0YtVcSV1vZvNCQB,5Gyp41oLVo7Gg7vF4vpmggWP5MU70QO6,9,7,3,4,4,0,1,0,19,2.7142857142857144,1,0.0,3,3,2,4,4,0,2,1,0,12,7,1
9248,133694,6Rsqjmf5ottzWRdYfF7VLLIdh5beRdNj,5Gyp41oLVo7Gg7vF4vpmggWP5MU70QO6,1,0,0,0,0,0,1,0,1,0.14285714285714285,1,0.0,0,0,0,0,0,0,0,1,0,0,1,1
9249,133709,nE23LYiQpabdXkj6YvKSja9sZnHRizmo,5Gyp41oLVo7Gg7vF4vpmggWP5MU70QO6,12,39,13,0,9,6,9,1,77,11.0,3,0.0,9,13,0,9,30,6,0,9,1,31,46,1
9250,133712,t3ySM4Gbs4aIhGFWYbt2nw6OG5oriaOF,5Gyp41oLVo7Gg7vF4vpmggWP5MU70QO6,16,16,12,2,4,1,6,0,41,5.857142857142857,2,0.0,1,12,1,4,15,1,1,6,0,18,23,0
9251,133725,y1j2BJeUX3clfpIS8z8YGMmOflVcd268,5Gyp41oLVo7Gg7vF4vpmggWP5MU70QO6,6,6,3,0,1,0,5,0,15,2.142857142857143,3,0.0,0,3,0,1,6,0,0,5,0,4,11,1
9252,133727,cjAGPVLksLUH2S2TlVLen0Rma4ZtMpJ0,5Gyp41oLVo7Gg7vF4vpmggWP5MU70QO6,16,13,11,0,5,0,4,0,33,4.714285714285714,2,0.0,0,11,0,5,13,0,0,4,0,16,17,1
9253,133732,W1VI3sqHrUlEcaB1jLOlWmlomraJVsFV,5Gyp41oLVo7Gg7vF4vpmggWP5MU70QO6,10,7,5,0,4,8,9,2,35,5.0,1,0.0,0,5,0,4,7,8,0,9,2,9,26,1
9254,133761,wTjeh5kqsxGUEAu30OJ2FVzPxkqRYfsX,5Gyp41oLVo7Gg7vF4vpmggWP5MU70QO6,11,17,0,11,2,0,2,0,32,4.571428571428571,1,0.0,9,0,8,2,8,0,3,2,0,19,13,1
9255,133765,aldLXGpzmiip2CUSDhqN8A5UpGMVUHxY,5Gyp41oLVo7Gg7vF4vpmggWP5MU70QO6,13,29,18,5,7,0,7,0,66,9.428571428571429,4,0.0,5,18,3,7,24,0,2,7,0,33,33,1
9256,133770,faTFbhzc3mhNTFTqM92hVZkx0r9f7ol4,5Gyp41oLVo7Gg7vF4vpmggWP5MU70QO6,1,0,0,0,0,0,1,0,1,0.14285714285714285,1,0.0,0,0,0,0,0,0,0,1,0,0,1,1
9257,133773,ovvuiEhj0QBv4xi11GVjXr8JhlCgaPmd,5Gyp41oLVo7Gg7vF4vpmggWP5MU70QO6,24,41,23,34,11,0,18,0,127,18.142857142857142,4,0.0,15,23,24,11,26,0,10,18,0,73,54,0
9258,133778,X9IKf8GgqS6dvoKX3VBo51mIr8yb4uFC,5Gyp41oLVo7Gg7vF4vpmggWP5MU70QO6,1,0,0,0,0,0,1,0,1,0.14285714285714285,1,0.0,0,0,0,0,0,0,0,1,0,0,1,1
9259,133834,Ml4sacNrRuYKCZt13mrJhwNSftih0uvX,5Gyp41oLVo7Gg7vF4vpmggWP5MU70QO6,7,11,7,0,3,0,3,0,24,3.4285714285714284,2,0.0,1,7,0,3,10,0,0,3,0,11,13,1
9260,133875,DxH75iZ2vwK7RWdx8JWNqysBZPhRedJP,5Gyp41oLVo7Gg7vF4vpmggWP5MU70QO6,10,10,6,0,4,0,4,0,24,3.4285714285714284,2,0.0,0,6,0,4,10,0,0,4,0,10,14,1
9261,133982,xAn64qd6elbFZJJcszNUW2n3zQLlhEwM,5Gyp41oLVo7Gg7vF4vpmggWP5MU70QO6,1,0,0,0,0,0,1,0,1,0.14285714285714285,1,0.0,0,0,0,0,0,0,0,1,0,0,1,1
9262,134051,2mxSfvrV4dprNDPX9sOXqPpvnwSid2Cc,5Gyp41oLVo7Gg7vF4vpmggWP5MU70QO6,10,12,6,6,3,3,3,0,33,4.714285714285714,2,0.0,3,6,4,3,9,3,2,3,0,16,17,1
9263,134075,3Lm0MGQaaapsScRaTvcsyp7k33RXoGQK,5Gyp41oLVo7Gg7vF4vpmggWP5MU70QO6,5,2,2,0,2,0,2,0,8,1.1428571428571428,2,0.0,0,2,0,2,2,0,0,2,0,4,4,1
9264,134078,pMvI3GodgpgPSXQ0MPCwiqmmXOZLm2f3,5Gyp41oLVo7Gg7vF4vpmggWP5MU70QO6,8,3,2,0,2,0,4,0,11,1.5714285714285714,1,0.0,0,2,0,2,3,0,0,4,0,4,7,1
9265,134101,5uNVqz3akJM39GMi4L72zo2iwNTdRLcd,5Gyp41oLVo7Gg7vF4vpmggWP5MU70QO6,1,0,0,0,0,0,1,0,1,0.14285714285714285,1,0.0,0,0,0,0,0,0,0,1,0,0,1,1
9266,134103,5eLv42QNHH4xOv2fRiDesiSc1hAZtDPF,5Gyp41oLVo7Gg7vF4vpmggWP5MU70QO6,1,0,0,0,0,0,1,0,1,0.14285714285714285,1,0.0,0,0,0,0,0,0,0,1,0,0,1,1
9267,134114,vkVcAL32x89gCUbijn0COpSie0zSVcTg,5Gyp41oLVo7Gg7vF4vpmggWP5MU70QO6,12,19,8,1,6,6,10,1,51,7.285714285714286,5,0.0,1,8,1,6,18,6,0,10,1,16,35,1
9268,134120,nBPo5EhaP0gkjW850tZUTuZiIJfWNxJW,5Gyp41oLVo7Gg7vF4vpmggWP5MU70QO6,1,0,0,0,0,0,1,0,1,0.14285714285714285,1,0.0,0,0,0,0,0,0,0,1,0,0,1,1
9269,134150,m6zBjlzTm9i43E1MJ5Zz1er2kLxNazQn,5Gyp41oLVo7Gg7vF4vpmggWP5MU70QO6,4,2,1,0,1,0,1,0,5,0.7142857142857143,1,0.0,0,1,0,1,2,0,0,1,0,2,3,1
9270,134198,egpXv13dykaiU64GCgTaQGg1ErRD7Rsb,5Gyp41oLVo7Gg7vF4vpmggWP5MU70QO6,5,2,1,0,1,1,2,0,7,1.0,1,0.0,0,1,0,1,2,1,0,2,0,2,5,1
9271,134209,z4d2NsCc0hNwoqw5mRmP28xZ3tEFcThU,5Gyp41oLVo7Gg7vF4vpmggWP5MU70QO6,1,0,0,0,0,0,1,0,1,0.14285714285714285,1,0.0,0,0,0,0,0,0,0,1,0,0,1,1
9272,134215,3OiI63m3MT3NUNFqZaAImnuYkxAn963I,5Gyp41oLVo7Gg7vF4vpmggWP5MU70QO6,1,0,0,0,0,0,1,0,1,0.14285714285714285,1,0.0,0,0,0,0,0,0,0,1,0,0,1,1
9273,134220,jt9bBApOzSH9euvQei6FRx8YbWJCqV7e,5Gyp41oLVo7Gg7vF4vpmggWP5MU70QO6,36,90,49,21,26,100,24,8,318,45.42857142857143,4,0.0,27,49,14,26,63,100,7,24,8,116,202,1
9274,134276,Y3ZpN8DOQK8YTfD0eUtklxiZfpWuBIeU,5Gyp41oLVo7Gg7vF4vpmggWP5MU70QO6,11,16,8,2,5,0,5,0,36,5.142857142857143,5,0.0,1,8,1,5,15,0,1,5,0,15,21,1
9275,134284,suNv6s4qyxf9N0tzvwEfVP5WvS3f14Ct,5Gyp41oLVo7Gg7vF4vpmggWP5MU70QO6,10,9,4,0,2,1,12,0,28,4.0,1,0.0,3,4,0,2,6,1,0,12,0,9,19,1
9276,134306,O6XAdqAZFVBAUEpdhD9kWD0CFc9DXbDC,5Gyp41oLVo7Gg7vF4vpmggWP5MU70QO6,3,3,1,0,0,0,1,0,5,0.7142857142857143,1,0.0,0,1,0,0,3,0,0,1,0,1,4,0
9277,134308,CqWhDDeGW7h5JgvzJmQmXBexDHXnQAzm,5Gyp41oLVo7Gg7vF4vpmggWP5MU70QO6,11,23,13,7,9,0,5,0,57,8.142857142857142,3,0.0,6,13,5,9,17,0,2,5,0,33,24,1
9278,134387,4NJSDA3iz7Etb6QbBYbJSN7TbV2jAaSn,5Gyp41oLVo7Gg7vF4vpmggWP5MU70QO6,5,2,1,0,1,0,2,0,6,0.8571428571428571,1,0.0,0,1,0,1,2,0,0,2,0,2,4,1
9279,134407,qe6VOiR93QevgvLihSI3D1o8mQwi8vSS,5Gyp41oLVo7Gg7vF4vpmggWP5MU70QO6,18,33,17,27,4,22,10,1,114,16.285714285714285,2,0.0,5,17,22,4,28,22,5,10,1,48,66,1
9280,134417,5lbqOJbZSZ6HXtO2ffOGMTGFEi1gpAqu,5Gyp41oLVo7Gg7vF4vpmggWP5MU70QO6,13,14,5,8,3,2,5,0,37,5.285714285714286,4,0.0,3,5,5,3,11,2,3,5,0,16,21,0
9281,134422,2nldnsy5rbVYOoSRF9wOfZBPQ2SkCsmR,5Gyp41oLVo7Gg7vF4vpmggWP5MU70QO6,7,1,1,0,1,4,5,1,13,1.8571428571428572,2,0.0,0,1,0,1,1,4,0,5,1,2,11,1
9282,134423,8EJCCc65R0KMbJuROvvgWCHEphC2dl1r,5Gyp41oLVo7Gg7vF4vpmggWP5MU70QO6,8,19,1,0,0,1,4,1,26,3.7142857142857144,4,0.0,2,1,0,0,17,1,0,4,1,3,23,1
9283,134429,IR9p9WuPGPaaA4f6RkgkUYRRmOTg8aPE,5Gyp41oLVo7Gg7vF4vpmggWP5MU70QO6,5,5,3,0,0,0,2,0,10,1.4285714285714286,2,0.0,0,3,0,0,5,0,0,2,0,3,7,1
9284,134445,0NCTyOo901OVKDz27kIQS9Y956NzR3lw,5Gyp41oLVo7Gg7vF4vpmggWP5MU70QO6,1,0,0,0,0,0,1,0,1,0.14285714285714285,1,0.0,0,0,0,0,0,0,0,1,0,0,1,1
9285,134466,JsqrqubnjjSuqmmuivzKTDyASkdX1tsp,5Gyp41oLVo7Gg7vF4vpmggWP5MU70QO6,15,24,11,13,6,18,37,5,114,16.285714285714285,5,0.0,6,11,8,6,18,18,5,37,5,31,83,1
9286,134472,uPCPOUDpxWJduDoVPsy1fYZmO6054lHN,5Gyp41oLVo7Gg7vF4vpmggWP5MU70QO6,6,10,5,0,0,0,5,0,20,2.857142857142857,1,0.0,2,5,0,0,8,0,0,5,0,7,13,1
9287,134480,R2m4YrxCqiiAHfIiEC5uncyqARtSGS0y,5Gyp41oLVo7Gg7vF4vpmggWP5MU70QO6,19,38,16,4,6,2,10,1,77,11.0,3,0.0,14,16,2,6,24,2,2,10,1,38,39,1
9288,134531,4n0eavxCNp4F6LlqtEg5gsmyBVEbRBeE,5Gyp41oLVo7Gg7vF4vpmggWP5MU70QO6,5,6,2,0,0,0,2,0,10,1.4285714285714286,2,0.0,0,2,0,0,6,0,0,2,0,2,8,1
9289,134532,28yg84GTsqSiqbTwC56qeBzdvnj4wMZv,5Gyp41oLVo7Gg7vF4vpmggWP5MU70QO6,7,2,2,0,2,1,2,0,9,1.2857142857142858,1,0.0,0,2,0,2,2,1,0,2,0,4,5,1
9290,134541,avoglTQYC4DCKpMnGcRw7Ok57lEHfs0W,5Gyp41oLVo7Gg7vF4vpmggWP5MU70QO6,3,2,0,0,0,0,1,0,3,0.42857142857142855,1,0.0,0,0,0,0,2,0,0,1,0,0,3,1
9291,134556,80FzckKMcjX2YzXWS8il05lgsWZtocLs,5Gyp41oLVo7Gg7vF4vpmggWP5MU70QO6,4,3,1,0,1,0,1,0,6,0.8571428571428571,1,0.0,0,1,0,1,3,0,0,1,0,2,4,1
9292,134588,LPMhjI3h6mFXpXBZjU0jtQZvPuOgNRuf,5Gyp41oLVo7Gg7vF4vpmggWP5MU70QO6,13,8,4,20,2,0,3,0,37,5.285714285714286,1,0.0,3,4,13,2,5,0,7,3,0,22,15,1
9293,134595,gJUfHJ2wWISOJgd5TbsWe9Siq0yQvk0W,5Gyp41oLVo7Gg7vF4vpmggWP5MU70QO6,7,3,2,0,2,0,8,0,15,2.142857142857143,2,0.0,0,2,0,2,3,0,0,8,0,4,11,1
9294,134606,Prrs6qy7xXui2Ej7yuJXKp7kQw6K0nqs,5Gyp41oLVo7Gg7vF4vpmggWP5MU70QO6,1,0,0,0,0,0,2,0,2,0.2857142857142857,1,0.0,0,0,0,0,0,0,0,2,0,0,2,1
9295,134616,1YxknoiTrSwQgclDlSAh4oMYHRyARhLv,5Gyp41oLVo7Gg7vF4vpmggWP5MU70QO6,12,20,11,4,6,0,5,0,46,6.571428571428571,4,0.0,4,11,3,6,16,0,1,5,0,24,22,1
9296,134673,CdvI2pWKjGfqwnwuVxKzSINgvBVPDdaK,5Gyp41oLVo7Gg7vF4vpmggWP5MU70QO6,5,2,1,0,1,0,2,0,6,0.8571428571428571,1,0.0,0,1,0,1,2,0,0,2,0,2,4,1
9297,134682,AXqr0LdPJZsdJteg9sqYmDFslCYWC1PW,5Gyp41oLVo7Gg7vF4vpmggWP5MU70QO6,4,0,0,0,0,1,4,0,5,0.7142857142857143,1,0.0,0,0,0,0,0,1,0,4,0,0,5,1
9298,134688,98r1yyZ02P5Yb7DOkeUA6eb8RHK6juvp,5Gyp41oLVo7Gg7vF4vpmggWP5MU70QO6,40,51,21,29,3,0,15,0,119,17.0,4,0.0,25,21,25,3,26,0,4,15,0,74,45,0
9299,134769,DaPZ04CzdmZpYNv6D5HKU5y6m7fiHdwl,5Gyp41oLVo7Gg7vF4vpmggWP5MU70QO6,13,8,5,0,7,4,4,1,29,4.142857142857143,1,0.0,2,5,0,7,6,4,0,4,1,14,15,1
9300,134785,nHbx8yX1YYdHfiz0xMuE9LDMpuoeGBJU,5Gyp41oLVo7Gg7vF4vpmggWP5MU70QO6,1,0,0,0,0,0,1,0,1,0.14285714285714285,1,0.0,0,0,0,0,0,0,0,1,0,0,1,1
9301,134787,r7waeiZCMRqIGgK89BcNGxoITAFygxso,5Gyp41oLVo7Gg7vF4vpmggWP5MU70QO6,6,4,2,0,1,0,4,0,11,1.5714285714285714,1,0.0,0,2,0,1,4,0,0,4,0,3,8,1
9302,134796,Z4kedXjIF6f3uubwtldCvvLQcT4vIEro,5Gyp41oLVo7Gg7vF4vpmggWP5MU70QO6,5,4,2,0,1,0,2,0,9,1.2857142857142858,2,0.0,0,2,0,1,4,0,0,2,0,3,6,1
9303,134810,3C0mHGKR8yeSwkl2DOw1ueYpCB49HMxe,5Gyp41oLVo7Gg7vF4vpmggWP5MU70QO6,1,0,0,0,0,0,1,0,1,0.14285714285714285,1,0.0,0,0,0,0,0,0,0,1,0,0,1,1
9304,134811,5Dk7QJtqh7ATnN1jDaFE4dN4E1GugvAr,5Gyp41oLVo7Gg7vF4vpmggWP5MU70QO6,8,6,4,0,3,0,3,0,16,2.2857142857142856,2,0.0,0,4,0,3,6,0,0,3,0,7,9,1
9305,134872,PxG7IoSWl51ORQBfTGOZMHMVnXiWDk5u,5Gyp41oLVo7Gg7vF4vpmggWP5MU70QO6,6,5,3,0,2,0,4,0,14,2.0,1,0.0,0,3,0,2,5,0,0,4,0,5,9,1
9306,134875,8XstJLDa8agdHppUFVVZbvtgkIjc1hSo,5Gyp41oLVo7Gg7vF4vpmggWP5MU70QO6,15,44,23,10,8,2,17,0,104,14.857142857142858,11,0.0,4,23,5,8,40,2,5,17,0,40,64,1
9307,134885,Ybc642CAm4ubx0xh2F3kNoipp1rEZVzf,5Gyp41oLVo7Gg7vF4vpmggWP5MU70QO6,1,0,0,0,0,0,1,0,1,0.14285714285714285,1,0.0,0,0,0,0,0,0,0,1,0,0,1,1
9308,134896,EkpYyl5FvOIbAuPgHjdTptqbWAlVTTOe,5Gyp41oLVo7Gg7vF4vpmggWP5MU70QO6,1,0,0,0,0,0,1,0,1,0.14285714285714285,1,0.0,0,0,0,0,0,0,0,1,0,0,1,1
9309,134911,6ne76rFv6J6TLXUe0mStK4MXCR4J8Kt5,bWdj2GDclj5ofokWjzoa5jAwMkxCykd6,5,1,1,0,1,0,2,0,5,0.7142857142857143,1,0.0,0,1,0,1,1,0,0,2,0,2,3,1
9310,134914,yNC8T7gdWO96Y2q3tzTQeJUMY0F51xnO,SpATywNh6bZuzm8s1ceuBUnMUAeoAHHw,23,41,21,27,5,0,15,0,109,15.571428571428571,8,0.0,10,21,25,5,31,0,2,15,0,61,48,0
9311,134937,9CJfWVOWO2uvtgL9sMlN6s46G91IqAvr,A3fsA9Zfv1X2fVEQhTw51lKENdNrEqT3,4,2,1,0,1,2,2,0,8,1.1428571428571428,1,0.0,0,1,0,1,2,2,0,2,0,2,6,1
9312,134938,1ryg7vHF3PEsYEqZENe5bXv9yZs2dA3V,SpATywNh6bZuzm8s1ceuBUnMUAeoAHHw,4,1,0,0,0,0,4,0,5,0.7142857142857143,1,0.0,0,0,0,0,1,0,0,4,0,0,5,1
9313,134943,YfHmALaAUVJkTXPVPoa3sijNQuWgYS7R,G8EPVSXsOYB5YQWZGiz1aVq5Pgr2GrQu,15,20,9,12,7,0,1,0,49,7.0,1,0.0,9,9,6,7,11,0,6,1,0,31,18,1
9314,134957,oaNAVS5nMmZPkgC88QZyCkxZpo6GIFQk,G8EPVSXsOYB5YQWZGiz1aVq5Pgr2GrQu,16,34,27,14,12,0,6,0,93,13.285714285714286,4,0.0,0,27,13,12,34,0,1,6,0,52,41,1
9315,134996,mr6SHndrMUFTgJeI3Xsa4qtu794cguyo,bWdj2GDclj5ofokWjzoa5jAwMkxCykd6,14,15,3,40,6,0,1,0,65,9.285714285714286,1,0.0,11,3,39,6,4,0,1,1,0,59,6,1
9316,135000,nToY9YbKok17BpaPlTxZF9mLZdFu0iiS,SpATywNh6bZuzm8s1ceuBUnMUAeoAHHw,5,2,1,0,1,0,2,0,6,0.8571428571428571,1,0.0,0,1,0,1,2,0,0,2,0,2,4,1
9317,135012,BTEY71NgAZGYnRCsSAITWHUZps70gyN4,A3fsA9Zfv1X2fVEQhTw51lKENdNrEqT3,3,0,0,0,0,2,4,2,8,1.1428571428571428,1,0.0,0,0,0,0,0,2,0,4,2,0,8,1
9318,135013,BTEY71NgAZGYnRCsSAITWHUZps70gyN4,bWdj2GDclj5ofokWjzoa5jAwMkxCykd6,1,0,0,0,0,0,1,0,1,0.14285714285714285,1,0.0,0,0,0,0,0,0,0,1,0,0,1,1
9319,135029,aLOGAfDRvmZG085q2HFFKLaRHVWlMbeZ,A3fsA9Zfv1X2fVEQhTw51lKENdNrEqT3,11,5,4,0,3,3,10,2,27,3.857142857142857,1,0.0,0,4,0,3,5,3,0,10,2,7,20,1
9320,135036,wFvodFqghxL7iISMFbYXkYNq6P6eK5gH,A3fsA9Zfv1X2fVEQhTw51lKENdNrEqT3,1,0,0,0,0,0,1,0,1,0.14285714285714285,1,0.0,0,0,0,0,0,0,0,1,0,0,1,1
9321,135043,XoKIP4RGpnZk163890vUyWhLOIUSaapU,A3fsA9Zfv1X2fVEQhTw51lKENdNrEqT3,121,96,49,340,23,7,17,0,532,76.0,5,0.0,10,49,269,23,86,7,71,17,0,351,181,1
9322,135068,L0MAfJMwT0DciI5hH53QWdE0NS8GzvBn,A3fsA9Zfv1X2fVEQhTw51lKENdNrEqT3,6,3,2,0,2,0,1,0,8,1.1428571428571428,1,0.0,0,2,0,2,3,0,0,1,0,4,4,1
9323,135069,bgBLWArC7sr7mZdIi75AaJrBI0yN4gRx,SpATywNh6bZuzm8s1ceuBUnMUAeoAHHw,41,124,12,51,10,26,62,5,290,41.42857142857143,11,0.0,41,12,42,10,83,26,9,62,5,105,185,0
9324,135071,5OhdzLluLI4b0UetZ6QtwaKcHtelD4GM,A3fsA9Zfv1X2fVEQhTw51lKENdNrEqT3,25,11,11,0,11,0,3,0,36,5.142857142857143,1,0.0,0,11,0,11,11,0,0,3,0,22,14,1
9325,135077,ml2yAwYHzufxZ6xJCtzUFr2eNYyPECGG,bWdj2GDclj5ofokWjzoa5jAwMkxCykd6,7,5,3,0,1,2,3,0,14,2.0,1,0.0,0,3,0,1,5,2,0,3,0,4,10,1
9326,135103,gZWf27ETcHz4bBmwZPjiPumw55JZ4IOR,RXDvfPUBYFlVdlueBFbLW0mhhAyGEqpt,2,0,0,0,0,0,2,0,2,0.2857142857142857,2,0.0,0,0,0,0,0,0,0,2,0,0,2,1
9327,135109,EJXR6GjvUW4ftcdNw7M6s3AjFADQ5nWH,G8EPVSXsOYB5YQWZGiz1aVq5Pgr2GrQu,20,36,0,46,0,4,12,1,99,14.142857142857142,2,0.0,6,0,42,0,30,4,4,12,1,48,51,1
9328,135110,czraR8jl3tjb5vvHKbMcAmZkpcCxXmtq,SpATywNh6bZuzm8s1ceuBUnMUAeoAHHw,6,4,2,0,1,0,2,0,9,1.2857142857142858,1,0.0,0,2,0,1,4,0,0,2,0,3,6,1
9329,135114,lPsprPvnz2KazNU0HiuebkPap36Sy8nd,A3fsA9Zfv1X2fVEQhTw51lKENdNrEqT3,7,3,2,0,2,0,2,0,9,1.2857142857142858,1,0.0,0,2,0,2,3,0,0,2,0,4,5,1
9330,135124,NOmOOlAJE5nKLDW211ZOVqBtRY1AgNoT,A3fsA9Zfv1X2fVEQhTw51lKENdNrEqT3,21,24,2,0,2,1,8,1,38,5.428571428571429,1,0.0,0,2,0,2,24,1,0,8,1,4,34,1
9331,135142,XoKIP4RGpnZk163890vUyWhLOIUSaapU,bWdj2GDclj5ofokWjzoa5jAwMkxCykd6,10,10,2,28,0,0,1,0,41,5.857142857142857,1,0.0,3,2,23,0,7,0,5,1,0,28,13,1
9332,135159,yAxjMvvPF3HDitgCGIcnFlXrbnOszGcQ,bWdj2GDclj5ofokWjzoa5jAwMkxCykd6,9,18,5,114,1,0,6,0,144,20.571428571428573,4,0.0,3,5,112,1,15,0,2,6,0,121,23,1
9333,135164,jRV8IFAqLHlnm6Yo5f3lbOm8y9FKnSQS,SpATywNh6bZuzm8s1ceuBUnMUAeoAHHw,32,32,18,31,9,2,8,1,101,14.428571428571429,3,0.0,10,18,27,9,22,2,4,8,1,64,37,1
9334,135165,72z519PMt8GGBXLvF1FG0oMJuciCSWYJ,G8EPVSXsOYB5YQWZGiz1aVq5Pgr2GrQu,7,7,3,0,1,0,9,0,20,2.857142857142857,5,0.0,0,3,0,1,7,0,0,9,0,4,16,1
9335,135210,XPNYQB8BXxVJKoqXsnIXNkzgmqWM9Jf1,A3fsA9Zfv1X2fVEQhTw51lKENdNrEqT3,1,0,0,0,0,0,1,0,1,0.14285714285714285,1,0.0,0,0,0,0,0,0,0,1,0,0,1,1
9336,135236,8JTz84ZDdJm6tvsd7hgyCl1RB6wU6r2e,bWdj2GDclj5ofokWjzoa5jAwMkxCykd6,10,8,4,2,3,5,7,1,30,4.285714285714286,2,0.0,2,4,2,3,6,5,0,7,1,11,19,0
9337,135266,orkLWN7Jw88UrSJVImY9WyAA9wO3axVi,SpATywNh6bZuzm8s1ceuBUnMUAeoAHHw,29,28,17,24,9,3,8,1,90,12.857142857142858,1,0.0,4,17,19,9,24,3,5,8,1,49,41,1
9338,135270,orkLWN7Jw88UrSJVImY9WyAA9wO3axVi,bWdj2GDclj5ofokWjzoa5jAwMkxCykd6,1,0,0,0,0,0,1,0,1,0.14285714285714285,1,0.0,0,0,0,0,0,0,0,1,0,0,1,1
9339,135274,FJJqBn1iTJmAbav7Ov5Y4ycyF65fvY1E,SpATywNh6bZuzm8s1ceuBUnMUAeoAHHw,13,9,7,0,3,2,7,2,30,4.285714285714286,2,0.0,0,7,0,3,9,2,0,7,2,10,20,0
9340,135285,ORZA67vQIOSB05DsIbFIoGl0EWiKz8Mx,RXDvfPUBYFlVdlueBFbLW0mhhAyGEqpt,22,34,5,0,3,13,2,0,57,8.142857142857142,4,0.0,2,5,0,3,32,13,0,2,0,10,47,1
9341,135289,eXv6ACzt62C4hMSoDSIQMvmz4LEnGBtm,A3fsA9Zfv1X2fVEQhTw51lKENdNrEqT3,13,7,5,0,3,0,7,0,22,3.142857142857143,2,0.0,0,5,0,3,7,0,0,7,0,8,14,1
9342,135321,x6BtQH70uuLHaxqzHA21U9wmfT0SxzD9,G8EPVSXsOYB5YQWZGiz1aVq5Pgr2GrQu,21,20,0,14,0,0,17,0,51,7.285714285714286,6,0.0,4,0,10,0,16,0,4,17,0,14,37,1
9343,135333,Hmy7IERSuMBFx0LPTwulENadvjRMvkqo,SpATywNh6bZuzm8s1ceuBUnMUAeoAHHw,26,42,13,37,4,10,6,0,112,16.0,4,0.0,10,13,35,4,32,10,2,6,0,62,50,1
9344,135370,DpB3NoJLarAGiHUaBV6zvSP8bR0qw4yk,bWdj2GDclj5ofokWjzoa5jAwMkxCykd6,11,7,6,0,5,0,1,0,19,2.7142857142857144,2,0.0,0,6,0,5,7,0,0,1,0,11,8,1
9345,135376,lg9ClFc1WU5afD4IeCy9GllsKX7cYoEB,A3fsA9Zfv1X2fVEQhTw51lKENdNrEqT3,5,2,0,0,0,0,6,0,8,1.1428571428571428,1,0.0,0,0,0,0,2,0,0,6,0,0,8,1
9346,135378,0G28t6RwNA6XV451Zq3Rvj4OEqQwVjgc,SpATywNh6bZuzm8s1ceuBUnMUAeoAHHw,4,3,1,0,0,0,2,0,6,0.8571428571428571,1,0.0,1,1,0,0,2,0,0,2,0,2,4,1
9347,135405,1R1zO9aMB7Mx1Lw84JzsChVEV5JpwmZv,bWdj2GDclj5ofokWjzoa5jAwMkxCykd6,6,15,4,0,3,0,6,0,28,4.0,6,0.0,4,4,0,3,11,0,0,6,0,11,17,1
9348,135422,GR5uAqC8TkTRctStVcrTSN6GkRpM0Sgw,bWdj2GDclj5ofokWjzoa5jAwMkxCykd6,20,23,14,20,11,8,8,0,84,12.0,3,0.0,4,14,19,11,19,8,1,8,0,48,36,1
9349,135435,WK0Fgs86cA55qEjGdACCPsAyup9yYjBW,SpATywNh6bZuzm8s1ceuBUnMUAeoAHHw,3,2,0,0,0,0,1,0,3,0.42857142857142855,1,0.0,0,0,0,0,2,0,0,1,0,0,3,1
9350,135449,MzVpgt6eIu33aOAUbbblQyleNNMrWM7t,SpATywNh6bZuzm8s1ceuBUnMUAeoAHHw,6,5,3,0,1,0,1,0,10,1.4285714285714286,1,0.0,0,3,0,1,5,0,0,1,0,4,6,1
9351,135466,JX7kh5ZfjpOmdoUQ8rczM8ziszP4alom,SpATywNh6bZuzm8s1ceuBUnMUAeoAHHw,14,18,7,0,4,0,6,1,36,5.142857142857143,1,0.0,4,7,0,4,14,0,0,6,1,15,21,1
9352,135498,hnr1SrvwKs73pIl4Y8iA8BBWZr0Bh6Qj,SpATywNh6bZuzm8s1ceuBUnMUAeoAHHw,16,19,0,14,0,1,7,1,42,6.0,1,0.0,6,0,12,0,13,1,2,7,1,18,24,1
9353,135509,cVCoN7HidGGECgrwLZ0Mg4plpA9ST0kb,A3fsA9Zfv1X2fVEQhTw51lKENdNrEqT3,1,0,0,0,0,0,1,0,1,0.14285714285714285,1,0.0,0,0,0,0,0,0,0,1,0,0,1,1
9354,135519,0oRPUvEsJVbkR952hI1neMgRcrJImgj3,A3fsA9Zfv1X2fVEQhTw51lKENdNrEqT3,16,9,8,0,7,0,2,0,26,3.7142857142857144,1,0.0,0,8,0,7,9,0,0,2,0,15,11,1
9355,135527,kF53IpFKMxCV7VctlhpV2lrkHuEbgiU3,RXDvfPUBYFlVdlueBFbLW0mhhAyGEqpt,46,44,20,80,11,12,13,10,190,27.142857142857142,3,0.0,20,20,74,11,24,12,6,13,10,125,65,0
9356,135549,N1UAN9F5SFtgblynTSPZlPcIrBcrhldq,A3fsA9Zfv1X2fVEQhTw51lKENdNrEqT3,17,12,11,0,11,5,4,1,44,6.285714285714286,1,0.0,0,11,0,11,12,5,0,4,1,22,22,1
9357,135559,LPkDtPFF5RxOnDnsqEeKxwZe2JS0rusW,SpATywNh6bZuzm8s1ceuBUnMUAeoAHHw,31,43,20,32,13,0,5,0,113,16.142857142857142,3,0.0,13,20,28,13,30,0,4,5,0,74,39,1
9358,135574,KNNMSW3oLxGqEqv2czanNkhQgdUkOWgY,A3fsA9Zfv1X2fVEQhTw51lKENdNrEqT3,8,5,4,0,4,0,1,0,14,2.0,1,0.0,0,4,0,4,5,0,0,1,0,8,6,1
9359,135578,WAeA3Wxi4ox0P2eDgiY2JLtPyMIFhfp0,bWdj2GDclj5ofokWjzoa5jAwMkxCykd6,18,35,15,16,15,2,15,2,100,14.285714285714286,2,0.0,14,15,13,15,21,2,3,15,2,57,43,1
9360,135583,ix15aF6FOEF1waZCSZt01VrPOuPGJ3yM,bWdj2GDclj5ofokWjzoa5jAwMkxCykd6,1,0,0,0,0,0,1,0,1,0.14285714285714285,1,0.0,0,0,0,0,0,0,0,1,0,0,1,1
9361,135586,dH1fJFd4EUa9cDGkzaH97LNe2YTOAGRI,SpATywNh6bZuzm8s1ceuBUnMUAeoAHHw,5,4,0,0,0,0,3,0,7,1.0,1,0.0,0,0,0,0,4,0,0,3,0,0,7,1
9362,135592,pO9i2Ab1by3uoxklbewkfKRXc2dQyl5M,SpATywNh6bZuzm8s1ceuBUnMUAeoAHHw,5,3,2,0,2,0,2,0,9,1.2857142857142858,1,0.0,0,2,0,2,3,0,0,2,0,4,5,1
9363,135593,rFiKT35F4vi8a7NpfY1bEgz4HT50lSZd,SpATywNh6bZuzm8s1ceuBUnMUAeoAHHw,8,9,2,0,2,0,4,0,17,2.4285714285714284,3,0.0,0,2,0,2,9,0,0,4,0,4,13,1
9364,135594,gikp9GqTKNuof6stdLjZVJv1OHEXFMyZ,G8EPVSXsOYB5YQWZGiz1aVq5Pgr2GrQu,81,144,62,203,0,0,5,0,414,59.142857142857146,8,0.0,77,62,136,0,67,0,67,5,0,275,139,0
9365,135604,MFpshextOJLHhySF4C6u9eWxWZPDeRiA,G8EPVSXsOYB5YQWZGiz1aVq5Pgr2GrQu,1,0,0,0,0,0,1,0,1,0.14285714285714285,1,0.0,0,0,0,0,0,0,0,1,0,0,1,1
9366,135605,Ql4EosuzRo0tVj3lvTLhkLOyEsWZly6m,A3fsA9Zfv1X2fVEQhTw51lKENdNrEqT3,1,0,0,0,0,0,1,0,1,0.14285714285714285,1,0.0,0,0,0,0,0,0,0,1,0,0,1,1
9367,135618,8vBpgDrBoNVwqQQYIlW93nRYlEk72d2F,A3fsA9Zfv1X2fVEQhTw51lKENdNrEqT3,2,0,0,0,0,0,3,0,3,0.42857142857142855,1,0.0,0,0,0,0,0,0,0,3,0,0,3,1
9368,135620,xe0pnwtsOXCGbwfmaX74fYK9PfsU6JPN,SpATywNh6bZuzm8s1ceuBUnMUAeoAHHw,1,0,0,0,0,0,1,0,1,0.14285714285714285,1,0.0,0,0,0,0,0,0,0,1,0,0,1,1
9369,135625,OQFJERUfDkJREmuh848c2NVEfKc13k0Z,SpATywNh6bZuzm8s1ceuBUnMUAeoAHHw,14,10,8,0,6,0,3,0,27,3.857142857142857,2,0.0,0,8,0,6,10,0,0,3,0,14,13,1
9370,135636,Or5tbal17XyYWYBFOcz5Axiks4gsj2rC,SpATywNh6bZuzm8s1ceuBUnMUAeoAHHw,27,27,12,39,7,0,3,0,88,12.571428571428571,3,0.0,14,12,33,7,13,0,6,3,0,66,22,1
9371,135644,9w2MJQeZHeyFkqwhaftUSXLuvPN6lDkw,SpATywNh6bZuzm8s1ceuBUnMUAeoAHHw,11,33,11,0,3,0,2,0,49,7.0,2,0.0,20,11,0,3,13,0,0,2,0,34,15,1
9372,135671,rmx82oLaycREVuiUJS5poc97xd1UWvXB,SpATywNh6bZuzm8s1ceuBUnMUAeoAHHw,5,2,1,0,1,0,2,0,6,0.8571428571428571,1,0.0,0,1,0,1,2,0,0,2,0,2,4,1
9373,135673,5ZrPblaWYg1V0nkRfCyVA4ssWqd4pnQb,SpATywNh6bZuzm8s1ceuBUnMUAeoAHHw,11,5,2,4,2,0,16,1,30,4.285714285714286,3,0.0,0,2,4,2,5,0,0,16,1,8,22,0
9374,135674,zILXfIGJjWXm6dA2MrEQWr2XeEUry8lN,A3fsA9Zfv1X2fVEQhTw51lKENdNrEqT3,11,12,7,0,3,0,8,0,30,4.285714285714286,3,0.0,0,7,0,3,12,0,0,8,0,10,20,1
9375,135676,f8veUZRhdgLfRgcJyscv3SPrRGXUYeUM,bWdj2GDclj5ofokWjzoa5jAwMkxCykd6,1,0,0,0,0,0,4,0,4,0.5714285714285714,1,0.0,0,0,0,0,0,0,0,4,0,0,4,1
9376,135688,dXV6CXhMuL2MovsaBcVnWuwVAfDnBy3D,bWdj2GDclj5ofokWjzoa5jAwMkxCykd6,1,0,0,0,0,0,1,0,1,0.14285714285714285,1,0.0,0,0,0,0,0,0,0,1,0,0,1,1
9377,135691,ZtI7VkDL2OGaTLjYGXUs2OJh9j1CJRBG,bWdj2GDclj5ofokWjzoa5jAwMkxCykd6,1,0,0,0,0,0,3,0,3,0.42857142857142855,1,0.0,0,0,0,0,0,0,0,3,0,0,3,1
9378,135705,HHLCfoI58dWnfKs7QJD7m07PMcmUWFLH,bWdj2GDclj5ofokWjzoa5jAwMkxCykd6,1,0,0,0,0,0,1,0,1,0.14285714285714285,1,0.0,0,0,0,0,0,0,0,1,0,0,1,1
9379,135715,Gur5FuhE9EyV9K1F0qLPk7AenhoY8PBS,RXDvfPUBYFlVdlueBFbLW0mhhAyGEqpt,1,0,0,0,0,0,1,0,1,0.14285714285714285,1,0.0,0,0,0,0,0,0,0,1,0,0,1,1
9380,135719,bkOkn0C7FOzFPypI63kak65ajOi43hAv,SpATywNh6bZuzm8s1ceuBUnMUAeoAHHw,4,3,2,0,2,0,1,0,8,1.1428571428571428,1,0.0,0,2,0,2,3,0,0,1,0,4,4,1
9381,135721,pvAe37z1FjLTGYdwlJFjXex25zlpyHtu,G8EPVSXsOYB5YQWZGiz1aVq5Pgr2GrQu,10,8,1,0,1,0,8,0,18,2.5714285714285716,4,0.0,0,1,0,1,8,0,0,8,0,2,16,1
9382,135723,AQfzx8ZlEOE2Pwd3sng1DQ0krIzvYrKM,RXDvfPUBYFlVdlueBFbLW0mhhAyGEqpt,2,0,0,0,0,0,2,0,2,0.2857142857142857,1,0.0,0,0,0,0,0,0,0,2,0,0,2,1
9383,135757,oj8ZT8gny2t1bI3zTIIqiwK9yqWuzw78,SpATywNh6bZuzm8s1ceuBUnMUAeoAHHw,3,2,0,0,0,0,2,0,4,0.5714285714285714,1,0.0,0,0,0,0,2,0,0,2,0,0,4,1
9384,135766,lOkl9iaUDyjk0zbwJLRgFqBRBNNBSRwr,SpATywNh6bZuzm8s1ceuBUnMUAeoAHHw,48,114,11,40,4,21,28,3,221,31.571428571428573,12,0.0,24,11,37,4,90,21,3,28,3,76,145,0
9385,135784,UsP8UHahXGHaChNTAHL4dZh6OmvP94L7,A3fsA9Zfv1X2fVEQhTw51lKENdNrEqT3,1,0,0,0,0,0,1,0,1,0.14285714285714285,1,0.0,0,0,0,0,0,0,0,1,0,0,1,1
9386,135807,mgLL2TOXKEK8di2v3UUyM4FMUqEuj4kl,SpATywNh6bZuzm8s1ceuBUnMUAeoAHHw,34,56,40,21,25,0,10,0,152,21.714285714285715,8,0.0,4,40,18,25,52,0,3,10,0,87,65,0
9387,135811,5sps38f5Y5pZOFcONQeuy3Uw9461fahZ,SpATywNh6bZuzm8s1ceuBUnMUAeoAHHw,18,41,17,12,7,1,11,1,90,12.857142857142858,4,0.0,8,17,10,7,33,1,2,11,1,42,48,1
9388,135817,E47JGU8OIEWEHQErVOIbVuBKL7eug9kL,SpATywNh6bZuzm8s1ceuBUnMUAeoAHHw,1,0,0,0,0,0,1,0,1,0.14285714285714285,1,0.0,0,0,0,0,0,0,0,1,0,0,1,1
9389,135825,ETvKJXrBLwN7msxC91B5PIQrzaf0kAW1,bWdj2GDclj5ofokWjzoa5jAwMkxCykd6,1,0,0,0,0,0,1,0,1,0.14285714285714285,1,0.0,0,0,0,0,0,0,0,1,0,0,1,1
9390,135833,7g2GzVvD3LDPJ9xtZLHYL8K6mvN9vWmD,SpATywNh6bZuzm8s1ceuBUnMUAeoAHHw,10,8,0,5,0,0,2,0,15,2.142857142857143,2,0.0,0,0,5,0,8,0,0,2,0,5,10,0
9391,135839,ALhsVcYDfp1SfoZTdAG25el890E5rBOs,SpATywNh6bZuzm8s1ceuBUnMUAeoAHHw,9,19,5,0,3,0,3,0,30,4.285714285714286,2,0.0,0,5,0,3,19,0,0,3,0,8,22,1
9392,135850,8BfLX4VWbjk8AKJGATzTPj7dIWenapT9,5X6FeZozNMgE2VRi3MJYjkkFK8SETtu2,7,2,1,0,1,6,5,1,16,2.2857142857142856,1,0.0,0,1,0,1,2,6,0,5,1,2,14,1
9393,135853,XBCkMYdRHaBwbyaKg5wVLPpzX1Jqu9p0,A3fsA9Zfv1X2fVEQhTw51lKENdNrEqT3,8,5,3,0,2,0,3,0,13,1.8571428571428572,2,0.0,0,3,0,2,5,0,0,3,0,5,8,1
9394,135854,up6Dm3KbNQ1ouTMs5v0fwblubVxwKJMi,7GRhBDsirIGkRZBtSMEzNTyDr2JQm4xx,16,9,9,0,9,0,6,0,33,4.714285714285714,2,0.0,0,9,0,9,9,0,0,6,0,18,15,1
9395,135855,eydQH4GkYYah3jlT3RLO9bqY3W7KkeyU,SpATywNh6bZuzm8s1ceuBUnMUAeoAHHw,16,19,1,15,0,0,2,0,37,5.285714285714286,1,0.0,2,1,12,0,17,0,3,2,0,15,22,1
9396,135858,mTOoYxpCIgV1V8PFGNgwuxdFg8JU7kb9,7GRhBDsirIGkRZBtSMEzNTyDr2JQm4xx,12,3,2,0,2,1,7,1,16,2.2857142857142856,1,0.0,0,2,0,2,3,1,0,7,1,4,12,1
9397,135870,24fGHeKkFcKUohpd2rziJRSIJ4SrDKtC,SpATywNh6bZuzm8s1ceuBUnMUAeoAHHw,1,0,0,0,0,0,1,0,1,0.14285714285714285,1,0.0,0,0,0,0,0,0,0,1,0,0,1,0
9398,135949,LwkReFLt4qKjmPs2qOJfW5b8aCxwqX6W,SpATywNh6bZuzm8s1ceuBUnMUAeoAHHw,29,30,16,23,7,0,4,0,80,11.428571428571429,2,0.0,10,16,20,7,20,0,3,4,0,53,27,0
9399,135960,3CBjdaShVtIGJnXeJieywzhdVFld7ctv,bWdj2GDclj5ofokWjzoa5jAwMkxCykd6,8,12,8,56,3,0,1,0,80,11.428571428571429,5,0.0,1,8,55,3,11,0,1,1,0,67,13,1
9400,135961,7C9uw52M5by38Fl70ZT1JWeDrRlogBlC,SpATywNh6bZuzm8s1ceuBUnMUAeoAHHw,1,0,0,0,0,5,0,0,5,0.7142857142857143,1,0.0,0,0,0,0,0,5,0,0,0,0,5,1
9401,135966,xZnb7uXmxIWQ7sisovgxwTXG7X7Be4Tl,A3fsA9Zfv1X2fVEQhTw51lKENdNrEqT3,1,0,0,0,0,0,1,0,1,0.14285714285714285,1,0.0,0,0,0,0,0,0,0,1,0,0,1,1
9402,135974,aGEULe4U5LmUUpJzsyEy4WDvVRNa2tI4,SpATywNh6bZuzm8s1ceuBUnMUAeoAHHw,2,0,0,0,0,0,2,0,2,0.2857142857142857,1,0.0,0,0,0,0,0,0,0,2,0,0,2,1
9403,135989,raEniJ6EzR1YxtHjYjnp7R4NA13wfMDR,5X6FeZozNMgE2VRi3MJYjkkFK8SETtu2,23,36,1,40,4,1,6,0,88,12.571428571428571,1,0.0,26,1,35,4,10,1,5,6,0,66,22,1
9404,136007,fKIYKEAGjFjOVTaUhIbkE3jtMMjkLesA,bWdj2GDclj5ofokWjzoa5jAwMkxCykd6,6,5,2,0,3,0,2,0,12,1.7142857142857142,2,0.0,2,2,0,3,3,0,0,2,0,7,5,1
9405,136032,vX9PpvehRTgTkIr6tSKODV93gbmBGfye,SpATywNh6bZuzm8s1ceuBUnMUAeoAHHw,7,10,4,0,2,0,2,0,18,2.5714285714285716,1,0.0,0,4,0,2,10,0,0,2,0,6,12,0
9406,136038,P38VxMH253jjoDZHRNefTKyEAydphpb2,SpATywNh6bZuzm8s1ceuBUnMUAeoAHHw,38,57,29,43,13,18,23,3,186,26.571428571428573,7,0.0,17,29,37,13,40,18,6,23,3,96,90,1
9407,136064,o3T0K8ec78cQHSHsSLzMA1PbvYi8mwTI,7GRhBDsirIGkRZBtSMEzNTyDr2JQm4xx,16,44,10,30,0,31,13,2,130,18.571428571428573,3,0.0,20,10,26,0,24,31,4,13,2,56,74,1
9408,136087,vJoyr5IRehWaBOVbIIDwhxeWe6B6APfd,SpATywNh6bZuzm8s1ceuBUnMUAeoAHHw,5,3,2,0,2,0,2,0,9,1.2857142857142858,1,0.0,0,2,0,2,3,0,0,2,0,4,5,1
9409,136096,msM56OM0TrhCVyicpbYafJdknfubqkzk,7GRhBDsirIGkRZBtSMEzNTyDr2JQm4xx,8,9,2,6,2,1,3,1,24,3.4285714285714284,1,0.0,3,2,5,2,6,1,1,3,1,12,12,1
9410,136098,YQZ85qW2KiDmX9GD2Tq3oRYH6ucmQmKe,7GRhBDsirIGkRZBtSMEzNTyDr2JQm4xx,16,42,0,22,4,1,2,0,71,10.142857142857142,1,0.0,24,0,19,4,18,1,3,2,0,47,24,1
9411,136139,zUMa6hLi66lg2p8YxrG1ESZeR6OgI34u,SpATywNh6bZuzm8s1ceuBUnMUAeoAHHw,16,27,2,20,1,0,6,0,56,8.0,3,0.0,10,2,18,1,17,0,2,6,0,31,25,0
9412,136142,DyBJksrD7cQnd1w4SoDlp91ezRBSPAYk,5X6FeZozNMgE2VRi3MJYjkkFK8SETtu2,24,56,21,20,6,30,12,2,147,21.0,1,0.0,23,21,18,6,33,30,2,12,2,68,79,1
9413,136143,hnr1SrvwKs73pIl4Y8iA8BBWZr0Bh6Qj,G8EPVSXsOYB5YQWZGiz1aVq5Pgr2GrQu,9,18,1,8,3,0,6,0,36,5.142857142857143,2,0.0,6,1,5,3,12,0,3,6,0,15,21,0
9414,136149,St6usTSSgX5U9v7wchuMWqmBKoCcDwN2,SpATywNh6bZuzm8s1ceuBUnMUAeoAHHw,38,58,2,38,2,0,16,0,116,16.571428571428573,6,0.0,19,2,36,2,39,0,2,16,0,59,57,0
9415,136152,FmYyMdFUePtcDBVgDdhDyxnbGBctrwZJ,SpATywNh6bZuzm8s1ceuBUnMUAeoAHHw,37,38,24,20,13,0,12,2,109,15.571428571428571,4,0.0,6,24,19,13,32,0,1,12,2,62,47,0
9416,136157,JVItRyTCnb3b4TFpkbmaBDRTUqAJVd1k,SpATywNh6bZuzm8s1ceuBUnMUAeoAHHw,7,3,1,0,1,0,3,1,9,1.2857142857142858,1,0.0,0,1,0,1,3,0,0,3,1,2,7,1
9417,136164,wXz4TbCpuPApw4hHC9Aow8xAscaoMUnc,5X6FeZozNMgE2VRi3MJYjkkFK8SETtu2,1,0,0,0,0,0,2,0,2,0.2857142857142857,2,0.0,0,0,0,0,0,0,0,2,0,0,2,0
9418,136176,aGEdGizI9oXgMerMCvDqcaaIvZBHQncC,SpATywNh6bZuzm8s1ceuBUnMUAeoAHHw,21,33,14,18,7,2,7,0,81,11.571428571428571,1,0.0,15,14,17,7,18,2,1,7,0,53,28,1
9419,136184,xxd1UUpRh1yQGgGLMyjshPknKZCNEYlg,SpATywNh6bZuzm8s1ceuBUnMUAeoAHHw,1,0,0,0,0,0,1,0,1,0.14285714285714285,1,0.0,0,0,0,0,0,0,0,1,0,0,1,0
9420,136186,2NUZ5sFwBGaVOU21jGvUQkuVbUQhglLS,SpATywNh6bZuzm8s1ceuBUnMUAeoAHHw,1,0,0,0,0,0,1,0,1,0.14285714285714285,1,0.0,0,0,0,0,0,0,0,1,0,0,1,1
9421,136193,ct3ZFc3dYzkZrA1pmvZdNHcuNKAGoE3e,SpATywNh6bZuzm8s1ceuBUnMUAeoAHHw,44,24,20,7,17,0,7,1,76,10.857142857142858,3,0.0,0,20,6,17,24,0,1,7,1,43,33,1
9422,136198,oibZPbiJJqoMwq4D1fIJH3UgEiqKbAw2,5X6FeZozNMgE2VRi3MJYjkkFK8SETtu2,1,0,0,0,0,0,1,0,1,0.14285714285714285,1,0.0,0,0,0,0,0,0,0,1,0,0,1,1
9423,136209,oGK3c8nk6Ftl3V2u1zOvslszD4LDLr3w,G8EPVSXsOYB5YQWZGiz1aVq5Pgr2GrQu,35,61,26,39,17,0,9,0,152,21.714285714285715,5,0.0,22,26,28,17,39,0,11,9,0,93,59,1
9424,136210,bIjd8KK4L7j9O8VoOs8qHKzlQRCxHLCH,SpATywNh6bZuzm8s1ceuBUnMUAeoAHHw,47,64,3,56,3,6,20,1,153,21.857142857142858,9,0.0,18,3,53,3,46,6,3,20,1,77,76,0
9425,136228,ZjYHCTVP9J8Ll4M7bRt1mvNwKg1uuKeM,A3fsA9Zfv1X2fVEQhTw51lKENdNrEqT3,17,43,22,0,16,0,13,1,95,13.571428571428571,2,0.0,0,22,0,16,43,0,0,13,1,38,57,0
9426,136230,FZEwaAUaiR6zemazrUHMMvDLCgHez3sb,SpATywNh6bZuzm8s1ceuBUnMUAeoAHHw,12,26,11,19,1,21,12,1,91,13.0,3,0.0,6,11,16,1,20,21,3,12,1,34,57,1
9427,136239,Ovk8jBBHwwhBttek79ARCgIpAVxMH1wF,RXDvfPUBYFlVdlueBFbLW0mhhAyGEqpt,2,0,0,0,0,0,2,0,2,0.2857142857142857,1,0.0,0,0,0,0,0,0,0,2,0,0,2,1
9428,136247,8FGs2DlahZoB3KBpV3eIicZF3v5DtTbf,SpATywNh6bZuzm8s1ceuBUnMUAeoAHHw,41,59,34,33,8,2,17,1,154,22.0,5,0.0,17,34,23,8,42,2,10,17,1,82,72,0
9429,136253,GdGI6ZUeHNfDd16CDy7Y3YMvqdJfsIRh,5X6FeZozNMgE2VRi3MJYjkkFK8SETtu2,6,11,0,0,0,0,3,0,14,2.0,1,0.0,0,0,0,0,11,0,0,3,0,0,14,1
9430,136263,jyfYy8sfAOty2dpLhVOhL2aPccvug6UT,5X6FeZozNMgE2VRi3MJYjkkFK8SETtu2,14,11,4,14,5,4,4,1,43,6.142857142857143,1,0.0,7,4,12,5,4,4,2,4,1,28,15,1
9431,136264,u427dT2PrJSPY0vA5y1MW0KDFWyOjXZY,5X6FeZozNMgE2VRi3MJYjkkFK8SETtu2,2,0,0,0,0,0,2,0,2,0.2857142857142857,1,0.0,0,0,0,0,0,0,0,2,0,0,2,1
9432,136265,7fwVXF5ctPhb8pPmrNYDi2ycSDGABklq,SpATywNh6bZuzm8s1ceuBUnMUAeoAHHw,5,5,0,0,0,0,2,0,7,1.0,2,0.0,0,0,0,0,5,0,0,2,0,0,7,1
9433,136277,XWv59N7sAYbp3z6NAMpnTA06Qc1dakFb,SpATywNh6bZuzm8s1ceuBUnMUAeoAHHw,1,0,0,0,0,0,1,0,1,0.14285714285714285,1,0.0,0,0,0,0,0,0,0,1,0,0,1,1
9434,136285,fIxQAi8V5pbdcqYQSrNcVmHhfSlfCyxT,bWdj2GDclj5ofokWjzoa5jAwMkxCykd6,10,8,4,0,3,0,5,0,20,2.857142857142857,1,0.0,0,4,0,3,8,0,0,5,0,7,13,1
9435,136290,uXyiNHzEVwnpCSssM0aWRjomS3dwzYaL,bWdj2GDclj5ofokWjzoa5jAwMkxCykd6,6,5,1,0,1,0,2,0,9,1.2857142857142858,1,0.0,0,1,0,1,5,0,0,2,0,2,7,1
9436,136310,Pjnlkp8XQVpplsjp936AKfGr0trx7Z15,A3fsA9Zfv1X2fVEQhTw51lKENdNrEqT3,2,0,0,0,0,0,2,0,2,0.2857142857142857,1,0.0,0,0,0,0,0,0,0,2,0,0,2,1
9437,136312,DysXuoUoTtoCjfxHxEQdZhXHC6tNfwru,7GRhBDsirIGkRZBtSMEzNTyDr2JQm4xx,34,37,18,44,20,0,12,0,131,18.714285714285715,4,0.0,19,18,36,20,18,0,8,12,0,93,38,1
9438,136316,l8uPir1doTLOU3QiCXJvPr5i6VmozOBb,SpATywNh6bZuzm8s1ceuBUnMUAeoAHHw,4,2,1,0,1,0,1,0,5,0.7142857142857143,1,0.0,0,1,0,1,2,0,0,1,0,2,3,1
9439,136317,PSnfBRJFzUH9xyPpWKLqfkQbVy7w07sO,SpATywNh6bZuzm8s1ceuBUnMUAeoAHHw,33,49,4,41,1,1,20,1,117,16.714285714285715,4,0.0,19,4,34,1,30,1,7,20,1,58,59,1
9440,136327,xFOMKgrHGqKyL5uPk9RcNRWczzZxvoeN,7GRhBDsirIGkRZBtSMEzNTyDr2JQm4xx,1,0,0,0,0,0,1,0,1,0.14285714285714285,1,0.0,0,0,0,0,0,0,0,1,0,0,1,1
9441,136353,xFOMKgrHGqKyL5uPk9RcNRWczzZxvoeN,RXDvfPUBYFlVdlueBFbLW0mhhAyGEqpt,1,0,0,0,0,0,1,0,1,0.14285714285714285,1,0.0,0,0,0,0,0,0,0,1,0,0,1,1
9442,136357,KCeIMOjpHLluvXS6RWqa6XtVXcPd3TxR,SpATywNh6bZuzm8s1ceuBUnMUAeoAHHw,1,0,0,0,0,0,1,0,1,0.14285714285714285,1,0.0,0,0,0,0,0,0,0,1,0,0,1,1
9443,136363,lhlon92qtIm50z28ydik0v6JhWIxsC1U,SpATywNh6bZuzm8s1ceuBUnMUAeoAHHw,62,105,56,64,30,0,20,1,276,39.42857142857143,4,0.0,36,56,50,30,69,0,14,20,1,172,104,0
9444,136375,QzQWYrrIVOUqhShDM2t03rN3byjq3J7w,SpATywNh6bZuzm8s1ceuBUnMUAeoAHHw,17,38,5,18,1,4,10,0,76,10.857142857142858,3,0.0,11,5,15,1,27,4,3,10,0,32,44,0
9445,136395,5KlLtazjcjJXBl2pdXu4H41a6obdv1J2,SpATywNh6bZuzm8s1ceuBUnMUAeoAHHw,8,5,3,0,2,0,4,0,14,2.0,1,0.0,0,3,0,2,5,0,0,4,0,5,9,1
9446,136398,gtKTzkXHwS41ljYVmjlLLf4WyQSkK02q,7GRhBDsirIGkRZBtSMEzNTyDr2JQm4xx,26,45,16,64,0,0,6,0,131,18.714285714285715,3,0.0,23,16,54,0,22,0,10,6,0,93,38,1
9447,136413,SAZKFz2NUOxVKdkBgcAx84BjxoboQOlS,SpATywNh6bZuzm8s1ceuBUnMUAeoAHHw,32,46,7,26,3,10,21,0,113,16.142857142857142,7,0.0,5,7,26,3,41,10,0,21,0,41,72,0
9448,136445,qtck8S6SMYpkxbIZosuQoFSB26vuEbBy,7GRhBDsirIGkRZBtSMEzNTyDr2JQm4xx,2,0,0,0,0,0,2,0,2,0.2857142857142857,1,0.0,0,0,0,0,0,0,0,2,0,0,2,1
9449,136463,8cfJnU0jXErKE14ASkG1nYCbKcKidUol,SpATywNh6bZuzm8s1ceuBUnMUAeoAHHw,8,7,4,0,3,0,4,0,18,2.5714285714285716,1,0.0,0,4,0,3,7,0,0,4,0,7,11,1
9450,136468,YVboeUnAYRezL6JF0VMVpiapYahgjIwn,SpATywNh6bZuzm8s1ceuBUnMUAeoAHHw,31,54,26,27,11,22,20,2,162,23.142857142857142,6,0.0,13,26,24,11,41,22,3,20,2,74,88,0
9451,136471,VDenzJIuXt8CZgPYymaTQtlPj7WCFclP,G8EPVSXsOYB5YQWZGiz1aVq5Pgr2GrQu,40,36,19,101,8,8,14,9,195,27.857142857142858,4,0.0,3,19,87,8,33,8,14,14,9,117,78,0
9452,136500,AAAvWauitKfXD0xRpNsfpOKQu223kCXG,bWdj2GDclj5ofokWjzoa5jAwMkxCykd6,12,12,9,0,5,0,5,0,31,4.428571428571429,3,0.0,0,9,0,5,12,0,0,5,0,14,17,1
9453,136509,SZXfR7h2rkxFAPPaFk4ZqU1S4Hh3WECW,SpATywNh6bZuzm8s1ceuBUnMUAeoAHHw,18,24,0,21,0,0,6,0,51,7.285714285714286,1,0.0,10,0,20,0,14,0,1,6,0,30,21,0
9454,136515,ODBJIDcvWCzkG2XoiGFYE0mdoqG7tfRb,A3fsA9Zfv1X2fVEQhTw51lKENdNrEqT3,2,0,0,0,0,0,2,0,2,0.2857142857142857,1,0.0,0,0,0,0,0,0,0,2,0,0,2,1
9455,136524,i15PHia6n9agkYRoEhdWcUwrhqvX8pmC,bWdj2GDclj5ofokWjzoa5jAwMkxCykd6,4,3,0,0,0,0,2,0,5,0.7142857142857143,1,0.0,0,0,0,0,3,0,0,2,0,0,5,1
9456,136540,hZR4MwcYec4g0GoOyJFngJGEyWOySpv2,7GRhBDsirIGkRZBtSMEzNTyDr2JQm4xx,7,4,2,0,0,19,24,1,50,7.142857142857143,8,0.0,0,2,0,0,4,19,0,24,1,2,48,0
9457,136547,LkEFlCqQYkjvIKgJmv3NaW67JKbg7cls,SpATywNh6bZuzm8s1ceuBUnMUAeoAHHw,36,23,18,18,14,0,4,0,77,11.0,2,0.0,1,18,18,14,22,0,0,4,0,51,26,0
9458,136564,JHhY30IKFzw4LWcyrHuTEglWNqRkqdDU,SpATywNh6bZuzm8s1ceuBUnMUAeoAHHw,16,9,3,22,0,0,11,0,45,6.428571428571429,4,0.0,6,3,22,0,3,0,0,11,0,31,14,1
9459,136587,XvNNzv39b8VqKid0q4fV9ms2wVNAdWks,RXDvfPUBYFlVdlueBFbLW0mhhAyGEqpt,3,3,1,0,0,0,1,0,5,0.7142857142857143,1,0.0,0,1,0,0,3,0,0,1,0,1,4,1
9460,136592,JHhY30IKFzw4LWcyrHuTEglWNqRkqdDU,RXDvfPUBYFlVdlueBFbLW0mhhAyGEqpt,83,49,30,290,5,1,12,0,387,55.285714285714285,4,0.0,18,30,251,5,31,1,39,12,0,304,83,1
9461,136596,YqY5WPa8kwIoLBKGaVnXfSZOMvkSrEdU,SpATywNh6bZuzm8s1ceuBUnMUAeoAHHw,59,95,56,38,29,55,34,0,307,43.857142857142854,11,0.0,17,56,35,29,78,55,3,34,0,137,170,0
9462,136602,YqY5WPa8kwIoLBKGaVnXfSZOMvkSrEdU,A3fsA9Zfv1X2fVEQhTw51lKENdNrEqT3,8,9,5,0,1,0,5,0,20,2.857142857142857,4,0.0,0,5,0,1,9,0,0,5,0,6,14,1
9463,136608,YiJlfkoFk5UHEgOEqTYEMOMrDPkHWWsr,G8EPVSXsOYB5YQWZGiz1aVq5Pgr2GrQu,5,2,1,0,1,0,5,0,9,1.2857142857142858,1,0.0,0,1,0,1,2,0,0,5,0,2,7,1
9464,136621,JFLfO8Ojp07FwLFnPoEnOEQ2cuPQxeUo,SpATywNh6bZuzm8s1ceuBUnMUAeoAHHw,6,3,1,0,1,0,2,0,7,1.0,1,0.0,0,1,0,1,3,0,0,2,0,2,5,1
9465,136623,MF5edVvM6lCZDxnMdHelos9TUh3KERjn,A3fsA9Zfv1X2fVEQhTw51lKENdNrEqT3,17,23,10,0,7,1,12,0,53,7.571428571428571,3,0.0,0,10,0,7,23,1,0,12,0,17,36,0
9466,136631,Ol2x0ZxbBMe9mHlTofrTcxHzfpLJITAv,SpATywNh6bZuzm8s1ceuBUnMUAeoAHHw,14,11,2,0,2,0,3,0,18,2.5714285714285716,2,0.0,0,2,0,2,11,0,0,3,0,4,14,1
9467,136635,jedE3nTKdlUnNjeeZxONdSIgUVRjrOri,7GRhBDsirIGkRZBtSMEzNTyDr2JQm4xx,8,4,2,4,2,2,2,0,16,2.2857142857142856,2,0.0,1,2,3,2,3,2,1,2,0,8,8,1
9468,136650,o9SIyzF4ZVmP6xyBxbALfe2BPg3mc4Rf,RXDvfPUBYFlVdlueBFbLW0mhhAyGEqpt,6,3,1,0,1,0,2,0,7,1.0,1,0.0,0,1,0,1,3,0,0,2,0,2,5,1
9469,136652,qU5mfkjhD9M0R49RmBMaCeXLeTqIOyhm,7GRhBDsirIGkRZBtSMEzNTyDr2JQm4xx,4,4,0,0,0,0,1,0,5,0.7142857142857143,1,0.0,0,0,0,0,4,0,0,1,0,0,5,1
9470,136673,St6usTSSgX5U9v7wchuMWqmBKoCcDwN2,A3fsA9Zfv1X2fVEQhTw51lKENdNrEqT3,18,19,1,20,1,4,12,1,58,8.285714285714286,5,0.0,0,1,19,1,19,4,1,12,1,21,37,1
9471,136679,oVbgF80NIAxYzCtFttiq6BjlrneHU8IM,5X6FeZozNMgE2VRi3MJYjkkFK8SETtu2,2,0,0,0,0,0,2,0,2,0.2857142857142857,1,0.0,0,0,0,0,0,0,0,2,0,0,2,1
9472,136725,HmthpKrRMRfAgIx5u0jDQnXVTODkBXAh,5X6FeZozNMgE2VRi3MJYjkkFK8SETtu2,6,4,0,0,0,0,3,0,7,1.0,2,0.0,0,0,0,0,4,0,0,3,0,0,7,1
9473,136731,8mWm5xzce8wK28AEpPpWzDCgRcswbNyu,SpATywNh6bZuzm8s1ceuBUnMUAeoAHHw,7,6,3,0,3,0,2,0,14,2.0,1,0.0,2,3,0,3,4,0,0,2,0,8,6,1
9474,136742,2p1NtqJLJU7uLfrCQDiRWD2YMKpjai8W,SpATywNh6bZuzm8s1ceuBUnMUAeoAHHw,14,8,5,6,3,1,10,0,33,4.714285714285714,2,0.0,0,5,5,3,8,1,1,10,0,13,20,1
9475,136743,PV4ahNYgW8Lcd9nNe0xrpkqG7Ws3zMb1,SpATywNh6bZuzm8s1ceuBUnMUAeoAHHw,58,78,51,37,22,19,63,6,276,39.42857142857143,8,0.0,10,51,32,22,68,19,5,63,6,115,161,0
9476,136752,YUPaOsEEFOH7xpyMBcCkViDpUqkz1A5I,7GRhBDsirIGkRZBtSMEzNTyDr2JQm4xx,1,0,0,0,0,0,1,0,1,0.14285714285714285,1,0.0,0,0,0,0,0,0,0,1,0,0,1,1
9477,136755,Cun565mofxXDvKnAWY9DLeMetfYrusOd,5X6FeZozNMgE2VRi3MJYjkkFK8SETtu2,1,0,0,0,0,0,2,0,2,0.2857142857142857,1,0.0,0,0,0,0,0,0,0,2,0,0,2,1
9478,136758,Cun565mofxXDvKnAWY9DLeMetfYrusOd,SpATywNh6bZuzm8s1ceuBUnMUAeoAHHw,1,0,0,0,0,0,1,0,1,0.14285714285714285,1,0.0,0,0,0,0,0,0,0,1,0,0,1,1
9479,136771,9NQzSeXWhYO5onk53eYyqP6ECizmGBQ1,SpATywNh6bZuzm8s1ceuBUnMUAeoAHHw,1,0,0,0,0,0,1,0,1,0.14285714285714285,1,0.0,0,0,0,0,0,0,0,1,0,0,1,1
9480,136785,nsbeAj5BI7VK72NYmPa0cGgkMq0PU2h6,SpATywNh6bZuzm8s1ceuBUnMUAeoAHHw,24,24,11,0,10,0,5,0,50,7.142857142857143,5,0.0,0,11,0,10,24,0,0,5,0,21,29,0
9481,136797,uXoi7oqvj5HXbvnVGMMeQOqZvw3BW3QM,G8EPVSXsOYB5YQWZGiz1aVq5Pgr2GrQu,54,107,4,132,8,3,21,5,280,40.0,6,0.0,59,4,105,8,48,3,27,21,5,176,104,0
9482,136799,HycevJIm7cBjf1oJ5QCBMMXEBTG8jyRF,G8EPVSXsOYB5YQWZGiz1aVq5Pgr2GrQu,7,8,3,0,2,0,3,0,16,2.2857142857142856,2,0.0,3,3,0,2,5,0,0,3,0,8,8,1
9483,136822,LKQx76DscP8cMaadDZLCOsushv3ygeRX,bWdj2GDclj5ofokWjzoa5jAwMkxCykd6,1,0,0,0,0,0,4,0,4,0.5714285714285714,2,0.0,0,0,0,0,0,0,0,4,0,0,4,1
9484,136838,U8h5v4h0FTivdwhWGH1jLw0ZcR0Q7clk,G8EPVSXsOYB5YQWZGiz1aVq5Pgr2GrQu,1,0,0,0,0,0,1,0,1,0.14285714285714285,1,0.0,0,0,0,0,0,0,0,1,0,0,1,1
9485,136841,LOj6EKhQZdloEcDYeBGg0mw1M8oTbRIG,SpATywNh6bZuzm8s1ceuBUnMUAeoAHHw,9,3,2,0,1,1,5,1,13,1.8571428571428572,1,0.0,0,2,0,1,3,1,0,5,1,3,10,1
9486,136860,5NKHIcFKbvZvjnI6x0vdD0R4rE65640c,SpATywNh6bZuzm8s1ceuBUnMUAeoAHHw,31,65,5,38,3,16,33,3,163,23.285714285714285,6,0.0,17,5,33,3,48,16,5,33,3,58,105,0
9487,136861,BoXSuGXDZEH8EQNVPHOVOXaNZkjSq3cI,SpATywNh6bZuzm8s1ceuBUnMUAeoAHHw,5,4,1,0,1,0,1,0,7,1.0,1,0.0,0,1,0,1,4,0,0,1,0,2,5,1
9488,136874,P6rNkkuxGZS8wdNcuNCJoPQNsegCUIqx,7GRhBDsirIGkRZBtSMEzNTyDr2JQm4xx,2,0,0,0,0,0,2,0,2,0.2857142857142857,1,0.0,0,0,0,0,0,0,0,2,0,0,2,1
9489,136882,5KBUyFUobvfAu8D7u7bO9wAPV4vuXQZU,5X6FeZozNMgE2VRi3MJYjkkFK8SETtu2,4,3,0,0,0,0,3,0,6,0.8571428571428571,1,0.0,0,0,0,0,3,0,0,3,0,0,6,1
9490,136885,SsiBwdLtgBlftQTMaumuPfeXEp9eUN1X,SpATywNh6bZuzm8s1ceuBUnMUAeoAHHw,17,11,8,11,7,0,3,0,40,5.714285714285714,2,0.0,2,8,11,7,9,0,0,3,0,28,12,0
9491,136897,xNcMMIyB0y99dNaEOIqDnvCMrU2SAEOP,G8EPVSXsOYB5YQWZGiz1aVq5Pgr2GrQu,41,44,20,64,13,1,18,1,161,23.0,8,0.0,15,20,45,13,29,1,19,18,1,93,68,0
9492,136902,3zCxXtKsxr4Va4aHW0QJdJglnVCQNojy,bWdj2GDclj5ofokWjzoa5jAwMkxCykd6,14,17,8,54,6,0,8,0,93,13.285714285714286,2,0.0,4,8,53,6,13,0,1,8,0,71,22,0
9493,136920,HjlZu5CgYZQVUJqRZv1KCIOR0lFMSkiS,7GRhBDsirIGkRZBtSMEzNTyDr2JQm4xx,10,9,0,10,0,0,7,0,26,3.7142857142857144,2,0.0,2,0,8,0,7,0,2,7,0,10,16,1
9494,136927,bEa4GPfWyDDoCQ0l4pJUKvEvdEIRkNUb,SpATywNh6bZuzm8s1ceuBUnMUAeoAHHw,7,8,3,0,2,0,3,0,16,2.2857142857142856,1,0.0,0,3,0,2,8,0,0,3,0,5,11,0
9495,136936,hh9sxcCkDcNCk3fgQSDTsATrvTypYDNd,SpATywNh6bZuzm8s1ceuBUnMUAeoAHHw,1,0,0,0,0,0,1,0,1,0.14285714285714285,1,0.0,0,0,0,0,0,0,0,1,0,0,1,1
9496,136942,BJcIgaOnWdAOKf7jzUg9DKOlERmjwn2s,7GRhBDsirIGkRZBtSMEzNTyDr2JQm4xx,1,0,0,0,0,0,2,0,2,0.2857142857142857,1,0.0,0,0,0,0,0,0,0,2,0,0,2,1
9497,136958,hWIkfeUSCOyKe93IaOMW8L1TfkIW79I7,SpATywNh6bZuzm8s1ceuBUnMUAeoAHHw,1,0,0,0,0,0,1,0,1,0.14285714285714285,1,0.0,0,0,0,0,0,0,0,1,0,0,1,1
9498,136960,BJcIgaOnWdAOKf7jzUg9DKOlERmjwn2s,5X6FeZozNMgE2VRi3MJYjkkFK8SETtu2,1,0,0,0,0,0,1,0,1,0.14285714285714285,1,0.0,0,0,0,0,0,0,0,1,0,0,1,1
9499,136975,jAN47XfFw4MlopVK3qz6aOPpVjzNFA72,SpATywNh6bZuzm8s1ceuBUnMUAeoAHHw,28,16,14,0,13,0,4,0,47,6.714285714285714,2,0.0,0,14,0,13,16,0,0,4,0,27,20,1
9500,136984,KG9OHXXHmvu7A5D5AL2urTyy68HjxVcf,bWdj2GDclj5ofokWjzoa5jAwMkxCykd6,10,9,4,0,2,0,5,0,20,2.857142857142857,2,0.0,0,4,0,2,9,0,0,5,0,6,14,0
9501,136990,9BCEccsmIZjFkvP5Wn5sri87n0uRi11S,SpATywNh6bZuzm8s1ceuBUnMUAeoAHHw,39,43,23,33,10,0,6,0,115,16.428571428571427,4,0.0,15,23,26,10,28,0,7,6,0,74,41,0
9502,137002,lqaXGZwMzd5OqVUoM1LTFPECTwauskRk,bWdj2GDclj5ofokWjzoa5jAwMkxCykd6,21,2,2,34,0,9,9,1,57,8.142857142857142,2,0.0,0,2,26,0,2,9,8,9,1,28,29,1
9503,137013,DTg7EG4lfjPjfkpYaGZXFcsjykgIpZH4,SpATywNh6bZuzm8s1ceuBUnMUAeoAHHw,31,42,24,0,20,0,21,1,108,15.428571428571429,4,0.0,0,24,0,20,42,0,0,21,1,44,64,0
9504,137016,00bDiL0A6W9npxn52kzhmAfK2Yag1Gik,bWdj2GDclj5ofokWjzoa5jAwMkxCykd6,39,33,18,58,9,19,8,1,146,20.857142857142858,4,0.0,12,18,57,9,21,19,1,8,1,96,50,0
9505,137032,8WaKIrns0KwXg2bg0CbmKADdcmfehL2Q,5X6FeZozNMgE2VRi3MJYjkkFK8SETtu2,1,0,0,0,0,0,1,0,1,0.14285714285714285,1,0.0,0,0,0,0,0,0,0,1,0,0,1,1
9506,137033,xwVxmiN6s5Ty9myiVUNDBrV8mOb9D8yx,5X6FeZozNMgE2VRi3MJYjkkFK8SETtu2,1,0,0,0,0,0,1,0,1,0.14285714285714285,1,0.0,0,0,0,0,0,0,0,1,0,0,1,0
9507,137036,H11gBGo9MHSSmlSVhF8hMNcBAJe3AuL3,bWdj2GDclj5ofokWjzoa5jAwMkxCykd6,5,2,0,0,0,9,6,1,18,2.5714285714285716,1,0.0,0,0,0,0,2,9,0,6,1,0,18,0
9508,137061,3Jy6jx0sNeFLpP5Q6xPf2pYaHlNBhC9M,A3fsA9Zfv1X2fVEQhTw51lKENdNrEqT3,1,0,0,0,0,0,1,0,1,0.14285714285714285,1,0.0,0,0,0,0,0,0,0,1,0,0,1,1
9509,137076,g7u6ac7DR9jMW4aOouB4W8Gur81b4cDe,bWdj2GDclj5ofokWjzoa5jAwMkxCykd6,1,0,0,0,0,0,1,0,1,0.14285714285714285,1,0.0,0,0,0,0,0,0,0,1,0,0,1,0
9510,137077,xIsNJgqYQ4WcvbQ1A0Us7q1c1NYtR1tF,bWdj2GDclj5ofokWjzoa5jAwMkxCykd6,74,36,16,121,12,0,5,0,190,27.142857142857142,4,0.0,12,16,110,12,24,0,11,5,0,150,40,0
9511,137085,A7splZdp3CZV6tKUIRVHnnLOftJO8UXC,5X6FeZozNMgE2VRi3MJYjkkFK8SETtu2,1,0,0,0,0,0,1,0,1,0.14285714285714285,1,0.0,0,0,0,0,0,0,0,1,0,0,1,1
9512,137087,TFu3qaPZIYv7KLXu3pTvSATW0VeXRtF9,SpATywNh6bZuzm8s1ceuBUnMUAeoAHHw,1,0,0,0,0,0,1,0,1,0.14285714285714285,1,0.0,0,0,0,0,0,0,0,1,0,0,1,1
9513,137104,ISRJxWtuG9U7GF6GcMl2UZgUHAWLyOgM,5X6FeZozNMgE2VRi3MJYjkkFK8SETtu2,7,2,1,0,1,8,8,1,21,3.0,2,0.0,0,1,0,1,2,8,0,8,1,2,19,1
9514,137113,p9pL8JfmTYOMYYseo2SSQ9sWORIDdbKq,5X6FeZozNMgE2VRi3MJYjkkFK8SETtu2,6,6,4,0,2,0,9,0,21,3.0,1,0.0,0,4,0,2,6,0,0,9,0,6,15,1
9515,137179,fg94lpeYtceQf2gnwTTGybnIJZZS1MZL,SpATywNh6bZuzm8s1ceuBUnMUAeoAHHw,20,40,17,60,2,11,12,0,142,20.285714285714285,1,0.0,17,17,47,2,23,11,13,12,0,83,59,0
9516,137190,PmtrviA6hBub1PH85YXqVyZgghNsuc4g,SpATywNh6bZuzm8s1ceuBUnMUAeoAHHw,11,8,6,0,4,0,1,0,19,2.7142857142857144,3,0.0,1,6,0,4,7,0,0,1,0,11,8,1
9517,137199,p9pL8JfmTYOMYYseo2SSQ9sWORIDdbKq,SpATywNh6bZuzm8s1ceuBUnMUAeoAHHw,1,0,0,0,0,0,1,0,1,0.14285714285714285,1,0.0,0,0,0,0,0,0,0,1,0,0,1,1
9518,137200,EWCtjEAyugZmgyZfRj1CnWJoYkKUEbbn,A3fsA9Zfv1X2fVEQhTw51lKENdNrEqT3,9,10,0,0,0,0,3,0,13,1.8571428571428572,1,0.0,0,0,0,0,10,0,0,3,0,0,13,1
9519,137214,nmlYjXdaqWSjPWm2kQhmjZqjjBKhkQAm,A3fsA9Zfv1X2fVEQhTw51lKENdNrEqT3,48,74,33,0,26,0,7,0,140,20.0,5,0.0,0,33,0,26,74,0,0,7,0,59,81,1
9520,137247,cnKlhFP86QmSR2VWsPl9LF1ZQFaVjGih,SpATywNh6bZuzm8s1ceuBUnMUAeoAHHw,2,0,0,0,0,0,3,0,3,0.42857142857142855,1,0.0,0,0,0,0,0,0,0,3,0,0,3,1
9521,137249,QtcaqP1Oq08hvIX3wqGcQDC13eo6FjVm,bWdj2GDclj5ofokWjzoa5jAwMkxCykd6,4,2,1,0,0,0,2,0,5,0.7142857142857143,1,0.0,0,1,0,0,2,0,0,2,0,1,4,1
9522,137250,Cwj6oMWOpzGKPlqMvZWx3f8M3qp0flmr,G8EPVSXsOYB5YQWZGiz1aVq5Pgr2GrQu,29,23,19,22,15,0,13,0,92,13.142857142857142,4,0.0,0,19,19,15,23,0,3,13,0,53,39,0
9523,137290,RmlLLXW8yVeVv6IlxP4h82on7YcnLjlC,fbPkOYLVPtPgIt0MxizjfFJov3JbHyAi,5,2,0,0,0,0,19,1,22,3.142857142857143,1,0.0,0,0,0,0,2,0,0,19,1,0,22,1
9524,137292,1nw5LJsxTSlYBcpPAO0FPean8WSWknnT,fbPkOYLVPtPgIt0MxizjfFJov3JbHyAi,5,2,0,0,0,4,6,0,12,1.7142857142857142,1,0.0,0,0,0,0,2,4,0,6,0,0,12,1
9525,137296,bJ8AAxZ3JuvigCWd3VGvoJ2Ns2zJszXZ,fbPkOYLVPtPgIt0MxizjfFJov3JbHyAi,10,28,14,1,9,0,3,0,55,7.857142857142857,2,0.0,10,14,1,9,18,0,0,3,0,34,21,1
9526,137299,fQ2qYe5HNta8P0G8uXdGrvFPejbwucPN,fbPkOYLVPtPgIt0MxizjfFJov3JbHyAi,18,25,11,0,7,14,9,0,66,9.428571428571429,1,0.0,0,11,0,7,25,14,0,9,0,18,48,1
9527,137300,O5osNpvARQ134oncM7N5QGhst9sMjRtB,fbPkOYLVPtPgIt0MxizjfFJov3JbHyAi,4,2,1,0,1,7,1,0,12,1.7142857142857142,1,0.0,0,1,0,1,2,7,0,1,0,2,10,1
9528,137301,h774wdF6vIIcl50Js74gckwUtlv9SBGH,fbPkOYLVPtPgIt0MxizjfFJov3JbHyAi,26,83,40,13,24,8,10,0,178,25.428571428571427,4,0.0,21,40,11,24,62,8,2,10,0,96,82,1
9529,137304,fV9PFchRO9NFkeyKqjI60ieBb4YfIgSO,fbPkOYLVPtPgIt0MxizjfFJov3JbHyAi,4,3,0,0,0,16,4,0,23,3.2857142857142856,1,0.0,0,0,0,0,3,16,0,4,0,0,23,1
9530,137306,CTPK2LGRvMaPvlFasZdjTmXOqyM1Lmi8,fbPkOYLVPtPgIt0MxizjfFJov3JbHyAi,23,25,14,14,15,7,3,0,78,11.142857142857142,1,0.0,10,14,13,15,15,7,1,3,0,52,26,1
9531,137308,UAggpZPNL1hZ0kLwEDSUplsT3ghk1d6y,fbPkOYLVPtPgIt0MxizjfFJov3JbHyAi,9,5,3,0,1,2,6,1,18,2.5714285714285716,2,0.0,0,3,0,1,5,2,0,6,1,4,14,1
9532,137309,gL1o6jsIwD6Ip8uBaHnoUMfUbsYcrCmr,fbPkOYLVPtPgIt0MxizjfFJov3JbHyAi,7,3,2,0,2,3,3,1,14,2.0,1,0.0,0,2,0,2,3,3,0,3,1,4,10,1
9533,137313,n1ESpvyobZkFsfrWJhKOuY4URaa1sUc5,fbPkOYLVPtPgIt0MxizjfFJov3JbHyAi,5,2,1,0,1,0,4,0,8,1.1428571428571428,1,0.0,0,1,0,1,2,0,0,4,0,2,6,1
9534,137315,f0jKRSnLVIejbfFzT0M2iiXUyVwMVp4e,fbPkOYLVPtPgIt0MxizjfFJov3JbHyAi,5,3,2,0,2,0,2,0,9,1.2857142857142858,1,0.0,0,2,0,2,3,0,0,2,0,4,5,1
9535,137319,glXXkvEu5VWOG069hJZn4a1ogKzxsZqy,fbPkOYLVPtPgIt0MxizjfFJov3JbHyAi,2,0,0,0,0,0,6,0,6,0.8571428571428571,1,0.0,0,0,0,0,0,0,0,6,0,0,6,1
9536,137321,owHNspB8DrsecsPRNmUB7UBdqXOlW955,fbPkOYLVPtPgIt0MxizjfFJov3JbHyAi,7,8,3,0,2,0,1,0,14,2.0,1,0.0,0,3,0,2,8,0,0,1,0,5,9,1
9537,137323,iTjfGmkhI7qYgG8rBAfSzNVyjUvKbeUV,fbPkOYLVPtPgIt0MxizjfFJov3JbHyAi,4,2,1,0,1,0,1,0,5,0.7142857142857143,1,0.0,0,1,0,1,2,0,0,1,0,2,3,1
9538,137324,nyH7Jx4kN1AdDJdwkZQoUDqYoovHgbk5,fbPkOYLVPtPgIt0MxizjfFJov3JbHyAi,13,14,8,2,6,11,8,1,50,7.142857142857143,3,0.0,2,8,2,6,12,11,0,8,1,18,32,0
9539,137325,8WSLblwPqv9lrYeGgJiG7aFvD2e5FjPW,fbPkOYLVPtPgIt0MxizjfFJov3JbHyAi,2,0,0,0,0,0,2,0,2,0.2857142857142857,1,0.0,0,0,0,0,0,0,0,2,0,0,2,1
9540,137326,3cVj7hdkALbjY726IM3M6Ud07m4las2t,fbPkOYLVPtPgIt0MxizjfFJov3JbHyAi,9,3,2,0,2,4,6,1,18,2.5714285714285716,1,0.0,0,2,0,2,3,4,0,6,1,4,14,1
9541,137329,LnsTOCnKQwSd834VWj8Se5P6LDNk8RHo,fbPkOYLVPtPgIt0MxizjfFJov3JbHyAi,5,7,0,0,0,0,1,0,8,1.1428571428571428,1,0.0,0,0,0,0,7,0,0,1,0,0,8,1
9542,137331,5fdjSFb0UnHfjLD83iptHyG30XcBntML,fbPkOYLVPtPgIt0MxizjfFJov3JbHyAi,8,6,2,0,3,0,3,0,14,2.0,1,0.0,2,2,0,3,4,0,0,3,0,7,7,1
9543,137332,V5n4KmrCt6qTaNCHvn8AZsixldOhtrqM,fbPkOYLVPtPgIt0MxizjfFJov3JbHyAi,8,5,3,0,2,5,4,0,19,2.7142857142857144,2,0.0,0,3,0,2,5,5,0,4,0,5,14,1
9544,137335,b2ohpFiEgZaZsBBPqUMnfjpywCAbNR88,fbPkOYLVPtPgIt0MxizjfFJov3JbHyAi,11,11,4,0,4,0,4,0,23,3.2857142857142856,2,0.0,0,4,0,4,11,0,0,4,0,8,15,1
9545,137336,D35Hr8NmMeH1abGin8hsVg1eeYI1rkMx,fbPkOYLVPtPgIt0MxizjfFJov3JbHyAi,19,15,11,0,9,0,5,2,42,6.0,1,0.0,0,11,0,9,15,0,0,5,2,20,22,1
9546,137339,Q4RfMohp0VyMzzF8aoHnH7xFgkQEGrSz,fbPkOYLVPtPgIt0MxizjfFJov3JbHyAi,5,2,1,0,1,0,3,0,7,1.0,1,0.0,0,1,0,1,2,0,0,3,0,2,5,1
9547,137340,7RIgMHzHpMzY7qBXHPj6WiDKK3U9H2Wz,fbPkOYLVPtPgIt0MxizjfFJov3JbHyAi,11,12,8,0,5,2,5,0,32,4.571428571428571,3,0.0,0,8,0,5,12,2,0,5,0,13,19,1
9548,137341,EVRzOGDcK6HIoRC4TyM175kAEkfMvm8k,fbPkOYLVPtPgIt0MxizjfFJov3JbHyAi,6,5,2,0,3,0,3,0,13,1.8571428571428572,1,0.0,2,2,0,3,3,0,0,3,0,7,6,1
9549,137342,G3uUdYmcbUGjsucepMY504O6KIKoDegj,fbPkOYLVPtPgIt0MxizjfFJov3JbHyAi,2,0,0,0,0,0,7,0,7,1.0,1,0.0,0,0,0,0,0,0,0,7,0,0,7,1
9550,137343,cquObqcJUxOFEWJ4OzhgFktpn4MuuvGh,fbPkOYLVPtPgIt0MxizjfFJov3JbHyAi,2,0,0,0,0,0,2,0,2,0.2857142857142857,1,0.0,0,0,0,0,0,0,0,2,0,0,2,1
9551,137345,MCZHS6CBpJ75tmAXNSc4ArD5vu4UQMmf,fbPkOYLVPtPgIt0MxizjfFJov3JbHyAi,2,0,0,0,0,0,6,0,6,0.8571428571428571,1,0.0,0,0,0,0,0,0,0,6,0,0,6,1
9552,137348,T5moiKfoqYwkBJrrQj3QEFYZxN8QkHfc,fbPkOYLVPtPgIt0MxizjfFJov3JbHyAi,8,5,2,0,1,9,6,1,24,3.4285714285714284,1,0.0,0,2,0,1,5,9,0,6,1,3,21,1
9553,137353,0yZD4fjReiCp5h9L5wxeZCsj4C8snJgU,fbPkOYLVPtPgIt0MxizjfFJov3JbHyAi,2,0,0,0,0,0,3,0,3,0.42857142857142855,1,0.0,0,0,0,0,0,0,0,3,0,0,3,1
9554,137355,UaIcSFKSsXMkLJoEB18mPucIS2F5HMZt,fbPkOYLVPtPgIt0MxizjfFJov3JbHyAi,4,2,1,0,0,0,2,0,5,0.7142857142857143,1,0.0,0,1,0,0,2,0,0,2,0,1,4,1
9555,137357,Dxumuu0iESds4rdkin6IFLqksHFKYmBa,fbPkOYLVPtPgIt0MxizjfFJov3JbHyAi,2,0,0,0,0,0,3,0,3,0.42857142857142855,1,0.0,0,0,0,0,0,0,0,3,0,0,3,1
9556,137358,htmCxkgAOIvbjO4xq8D0LMRC4XX4uXb4,fbPkOYLVPtPgIt0MxizjfFJov3JbHyAi,7,3,2,0,2,0,3,0,10,1.4285714285714286,1,0.0,0,2,0,2,3,0,0,3,0,4,6,1
9557,137361,c3Q7zBkcz9A9C9axYIiO1QysEG1V4UAO,fbPkOYLVPtPgIt0MxizjfFJov3JbHyAi,9,5,4,0,3,0,5,0,17,2.4285714285714284,1,0.0,0,4,0,3,5,0,0,5,0,7,10,1
9558,137370,qNDvS5AGNuAWPmsY8v3e0mmJNktcZlln,fbPkOYLVPtPgIt0MxizjfFJov3JbHyAi,7,8,2,0,2,0,7,0,19,2.7142857142857144,1,0.0,4,2,0,2,4,0,0,7,0,8,11,1
9559,137372,lOBLdw8F0Df8BSa1UipMpaST2r1WwJcV,fbPkOYLVPtPgIt0MxizjfFJov3JbHyAi,9,4,3,0,3,6,6,1,23,3.2857142857142856,1,0.0,0,3,0,3,4,6,0,6,1,6,17,1
9560,137373,sndae06qc0KQXBA5AxxztXDWy4HQwsmF,fbPkOYLVPtPgIt0MxizjfFJov3JbHyAi,10,15,6,10,7,0,5,0,43,6.142857142857143,1,0.0,6,6,6,7,9,0,4,5,0,25,18,1
9561,137375,CKl647uBpzhaV8Bs4OjoA2KfJg2713it,fbPkOYLVPtPgIt0MxizjfFJov3JbHyAi,9,11,4,4,5,0,3,0,27,3.857142857142857,1,0.0,6,4,3,5,5,0,1,3,0,18,9,1
9562,137377,Ep4Q95tKnG1eQgBqFXbKyAx3i4zRNHfc,fbPkOYLVPtPgIt0MxizjfFJov3JbHyAi,1,0,0,0,0,0,1,0,1,0.14285714285714285,1,0.0,0,0,0,0,0,0,0,1,0,0,1,1
9563,137379,QuG2234wZAOXxXJpYa4PWsH3trXo84qK,fbPkOYLVPtPgIt0MxizjfFJov3JbHyAi,8,4,3,0,3,0,1,0,11,1.5714285714285714,1,0.0,0,3,0,3,4,0,0,1,0,6,5,1
9564,137383,yukNWaYJAZyHIfSpFgr2lENAGZdY7HBJ,fbPkOYLVPtPgIt0MxizjfFJov3JbHyAi,7,5,3,0,2,8,1,0,19,2.7142857142857144,1,0.0,0,3,0,2,5,8,0,1,0,5,14,1
9565,137384,EKfl5y1NkN1Xn8ASWOcqUOIlKCaC7Rgd,fbPkOYLVPtPgIt0MxizjfFJov3JbHyAi,1,0,0,0,0,0,1,0,1,0.14285714285714285,1,0.0,0,0,0,0,0,0,0,1,0,0,1,1
9566,137386,5XQirr9i0TWpiYbsECZzYQuaZyvNkBXn,fbPkOYLVPtPgIt0MxizjfFJov3JbHyAi,8,11,2,0,1,0,8,0,22,3.142857142857143,3,0.0,0,2,0,1,11,0,0,8,0,3,19,1
9567,137388,5FX74tSsqVOdvsPJFln5AHRuURmp41HT,fbPkOYLVPtPgIt0MxizjfFJov3JbHyAi,8,6,3,0,2,0,4,0,15,2.142857142857143,2,0.0,1,3,0,2,5,0,0,4,0,6,9,0
9568,137391,m6Zwht6K5r3XL6tnCyfbnnByGD7T5f2R,fbPkOYLVPtPgIt0MxizjfFJov3JbHyAi,5,2,1,0,1,0,2,0,6,0.8571428571428571,1,0.0,0,1,0,1,2,0,0,2,0,2,4,1
9569,137397,Qv1iNPNlhVNOmWMs92FkzrrHMbJaVyPk,fbPkOYLVPtPgIt0MxizjfFJov3JbHyAi,8,4,2,0,1,1,11,1,20,2.857142857142857,1,0.0,0,2,0,1,4,1,0,11,1,3,17,1
9570,137399,mqVpGUWCMkNcDZMRD2pJxKGV8oQAE2Qj,fbPkOYLVPtPgIt0MxizjfFJov3JbHyAi,8,4,3,0,2,0,4,0,13,1.8571428571428572,1,0.0,1,3,0,2,3,0,0,4,0,6,7,1
9571,137405,yLjINTUbScao5ufShTGxxbbMK1JbRcNK,fbPkOYLVPtPgIt0MxizjfFJov3JbHyAi,7,6,2,0,3,0,3,0,14,2.0,1,0.0,2,2,0,3,4,0,0,3,0,7,7,1
9572,137406,e4YalnUrFKcUfgQELCwKNGRSXvIfj3rn,fbPkOYLVPtPgIt0MxizjfFJov3JbHyAi,2,0,0,0,0,0,3,0,3,0.42857142857142855,1,0.0,0,0,0,0,0,0,0,3,0,0,3,1
9573,137407,xeJgmT2GlcKPs7xiwWbHClhY602CtyUx,fbPkOYLVPtPgIt0MxizjfFJov3JbHyAi,5,1,1,0,1,0,2,0,5,0.7142857142857143,1,0.0,0,1,0,1,1,0,0,2,0,2,3,1
9574,137408,7ZpK2Qdkfg6qjiDNvxUiqNClV9f1rdSE,fbPkOYLVPtPgIt0MxizjfFJov3JbHyAi,27,24,18,0,14,26,10,2,94,13.428571428571429,3,0.0,0,18,0,14,24,26,0,10,2,32,62,1
9575,137410,cp3YBtv3LBPQsC9KSWwASci6TDzE2JIe,fbPkOYLVPtPgIt0MxizjfFJov3JbHyAi,1,0,0,0,0,0,1,0,1,0.14285714285714285,1,0.0,0,0,0,0,0,0,0,1,0,0,1,1
9576,137411,RDChRApYRv6Sfe9dw6iFymmd1hK0JhGY,fbPkOYLVPtPgIt0MxizjfFJov3JbHyAi,1,0,0,0,0,0,1,0,1,0.14285714285714285,1,0.0,0,0,0,0,0,0,0,1,0,0,1,1
9577,137412,qZpXWzENd8vPQkANcwupj0acfmacGtsr,fbPkOYLVPtPgIt0MxizjfFJov3JbHyAi,16,9,8,0,8,0,1,0,26,3.7142857142857144,1,0.0,0,8,0,8,9,0,0,1,0,16,10,1
9578,137414,DTvfa3fS3ROp7pjogLjRtY4RzKRlF9Cy,fbPkOYLVPtPgIt0MxizjfFJov3JbHyAi,6,8,1,0,2,0,5,0,16,2.2857142857142856,1,0.0,3,1,0,2,5,0,0,5,0,6,10,1
9579,137415,zs8AbWxu3oihhi0RdSLs1xmLXXgmhkzY,fbPkOYLVPtPgIt0MxizjfFJov3JbHyAi,23,47,2,20,6,20,9,2,106,15.142857142857142,2,0.0,29,2,18,6,18,20,2,9,2,55,51,1
9580,137417,bCFz6hqpGZgCTv9FmzDlmLq86tdtyvtb,fbPkOYLVPtPgIt0MxizjfFJov3JbHyAi,6,4,1,0,1,2,3,0,11,1.5714285714285714,1,0.0,0,1,0,1,4,2,0,3,0,2,9,1
9581,137418,y71lRBqIdu5iPiLn9Yi5PQm6GFIvgLwB,fbPkOYLVPtPgIt0MxizjfFJov3JbHyAi,5,4,2,0,1,4,2,0,13,1.8571428571428572,1,0.0,0,2,0,1,4,4,0,2,0,3,10,1
9582,137420,vuqFPhnjwQKBPhmOAdfWdPVUnftTeBnB,fbPkOYLVPtPgIt0MxizjfFJov3JbHyAi,5,2,1,0,1,0,3,0,7,1.0,1,0.0,0,1,0,1,2,0,0,3,0,2,5,1
9583,137421,3y3fLWnaqy4gjWzUuftSoOxerFuYM9Ss,fbPkOYLVPtPgIt0MxizjfFJov3JbHyAi,7,4,2,0,2,0,2,0,10,1.4285714285714286,1,0.0,0,2,0,2,4,0,0,2,0,4,6,1
9584,137427,g5cfvDvYqz1BC4LMGanzPaVPPBmwbapa,fbPkOYLVPtPgIt0MxizjfFJov3JbHyAi,36,32,24,0,18,4,11,0,89,12.714285714285714,5,0.0,3,24,0,18,29,4,0,11,0,45,44,0
9585,137429,JdJ1SwT93OWgPbpS5GdJzD3RLASaE4SR,fbPkOYLVPtPgIt0MxizjfFJov3JbHyAi,6,6,2,0,2,1,1,0,12,1.7142857142857142,1,0.0,1,2,0,2,5,1,0,1,0,5,7,1
9586,137431,c9KdNBnieysx6xfzwOvt0c21meENYGDu,fbPkOYLVPtPgIt0MxizjfFJov3JbHyAi,1,0,0,0,0,0,4,0,4,0.5714285714285714,1,0.0,0,0,0,0,0,0,0,4,0,0,4,1
9587,137434,ibNm0O3c3f87o7PAtnGdJbl2Dgr9gb8M,fbPkOYLVPtPgIt0MxizjfFJov3JbHyAi,13,9,4,0,4,1,7,1,26,3.7142857142857144,1,0.0,0,4,0,4,9,1,0,7,1,8,18,1
9588,137438,fE8AsLCA0TCwN2lFIpEAgt949Oz2zi2M,fbPkOYLVPtPgIt0MxizjfFJov3JbHyAi,5,6,1,0,1,0,2,0,10,1.4285714285714286,1,0.0,4,1,0,1,2,0,0,2,0,6,4,1
9589,137440,zHooznrj1lbipo0SwGxaARgac1BP3h4H,fbPkOYLVPtPgIt0MxizjfFJov3JbHyAi,37,75,32,48,15,5,13,0,188,26.857142857142858,3,0.0,19,32,42,15,56,5,6,13,0,108,80,1
9590,137443,HHjw6PARN0UbkiffbOwvG4RULtVIyY0R,fbPkOYLVPtPgIt0MxizjfFJov3JbHyAi,9,7,5,0,4,14,3,0,33,4.714285714285714,1,0.0,0,5,0,4,7,14,0,3,0,9,24,1
9591,137446,qqhQVv0ytFz6QcrUJzKAl8hETJ9ZzkHe,fbPkOYLVPtPgIt0MxizjfFJov3JbHyAi,6,3,2,0,2,0,1,0,8,1.1428571428571428,1,0.0,0,2,0,2,3,0,0,1,0,4,4,1
9592,137449,NRHQ3tSUEv4DHf8jZg8RV7YWaKkLB0Yk,fbPkOYLVPtPgIt0MxizjfFJov3JbHyAi,7,3,1,0,1,0,9,0,14,2.0,1,0.0,0,1,0,1,3,0,0,9,0,2,12,1
9593,137451,aIezEPAtj2Pok0cm2TtbLS3CmQjoEYqT,fbPkOYLVPtPgIt0MxizjfFJov3JbHyAi,2,0,0,0,0,0,4,0,4,0.5714285714285714,1,0.0,0,0,0,0,0,0,0,4,0,0,4,1
9594,137453,gSg4PIaWl0hBhOgVlpN9o8YrQn4pTOeq,fbPkOYLVPtPgIt0MxizjfFJov3JbHyAi,9,12,7,0,2,1,4,0,26,3.7142857142857144,1,0.0,1,7,0,2,11,1,0,4,0,10,16,1
9595,137471,bRHB3zBOPKwppEH2jjC2WgssvXC1msz1,5Gyp41oLVo7Gg7vF4vpmggWP5MU70QO6,6,5,2,0,1,0,2,0,10,1.4285714285714286,1,0.0,3,2,0,1,2,0,0,2,0,6,4,1
9596,137490,Bg3IlobMeEnDXrcofRLwVsSu1ZqdXs37,5Gyp41oLVo7Gg7vF4vpmggWP5MU70QO6,1,0,0,0,0,0,1,0,1,0.14285714285714285,1,0.0,0,0,0,0,0,0,0,1,0,0,1,1
9597,137504,5pZkgPIxnBOORIliJ8n3jg55IKTU9MXC,5Gyp41oLVo7Gg7vF4vpmggWP5MU70QO6,19,37,25,7,7,4,15,3,98,14.0,4,0.0,6,25,5,7,31,4,2,15,3,43,55,1
9598,137508,2kNInSJ3uqvLvhYTOvaIkQm0oXn9XX4a,5Gyp41oLVo7Gg7vF4vpmggWP5MU70QO6,36,180,96,42,52,9,50,1,430,61.42857142857143,8,0.0,34,96,26,52,146,9,16,50,1,208,222,1
9599,137522,yFgrzwwjtpsjhKHIOZXuFR9O2ZYbMMNa,5Gyp41oLVo7Gg7vF4vpmggWP5MU70QO6,10,19,4,0,2,2,7,1,35,5.0,3,0.0,0,4,0,2,19,2,0,7,1,6,29,1
9600,137529,Zxs1RumGHONRCjjtlqlZeQ4V6CgOxVWH,5Gyp41oLVo7Gg7vF4vpmggWP5MU70QO6,1,0,0,0,0,0,1,0,1,0.14285714285714285,1,0.0,0,0,0,0,0,0,0,1,0,0,1,1
9601,137540,KHhx19dsa0jlK0KSwU5Y4cPoRyGsbykO,5Gyp41oLVo7Gg7vF4vpmggWP5MU70QO6,1,0,0,0,0,0,1,0,1,0.14285714285714285,1,0.0,0,0,0,0,0,0,0,1,0,0,1,1
9602,137592,VL0rdkFTRaRvYW02oZ1fEazY0Pyp6eKe,5Gyp41oLVo7Gg7vF4vpmggWP5MU70QO6,5,2,1,0,1,0,2,0,6,0.8571428571428571,1,0.0,0,1,0,1,2,0,0,2,0,2,4,1
9603,137623,lvaMHvq36xKtzAaVtM1gVToh26FqxOq2,5Gyp41oLVo7Gg7vF4vpmggWP5MU70QO6,17,27,9,12,3,0,8,1,60,8.571428571428571,1,0.0,7,9,6,3,20,0,6,8,1,25,35,1
9604,137628,EY8iKTJrEMSI2rdDZZ99LpQO14yMkcx7,5Gyp41oLVo7Gg7vF4vpmggWP5MU70QO6,21,41,23,6,12,13,16,4,115,16.428571428571427,3,0.0,6,23,3,12,35,13,3,16,4,44,71,1
9605,137632,rrBwc9DqMP8jnv9AB7ljubWYdmiLkI0q,5Gyp41oLVo7Gg7vF4vpmggWP5MU70QO6,1,0,0,0,0,0,1,0,1,0.14285714285714285,1,0.0,0,0,0,0,0,0,0,1,0,0,1,1
9606,137638,CQ2N12ploVcZUAUn102rtsaEWH0dRUqg,5Gyp41oLVo7Gg7vF4vpmggWP5MU70QO6,7,5,2,0,1,0,4,0,12,1.7142857142857142,1,0.0,0,2,0,1,5,0,0,4,0,3,9,1
9607,137651,ghyVPfJiysGexkLu74m61UB1GHHehYBW,5Gyp41oLVo7Gg7vF4vpmggWP5MU70QO6,8,5,3,0,3,1,3,0,15,2.142857142857143,1,0.0,1,3,0,3,4,1,0,3,0,7,8,1
9608,137682,rWeQbQybYpipcE4MtqdndKPuNPE34gTm,5Gyp41oLVo7Gg7vF4vpmggWP5MU70QO6,26,53,29,8,13,25,19,3,150,21.428571428571427,6,0.0,11,29,5,13,42,25,3,19,3,58,92,1
9609,137683,LvwHRWeYnZCL5LxnyQVxHpXzMFj4I2kd,5Gyp41oLVo7Gg7vF4vpmggWP5MU70QO6,1,0,0,0,0,0,1,0,1,0.14285714285714285,1,0.0,0,0,0,0,0,0,0,1,0,0,1,1
9610,137701,0QFADiD6IvsCiGKcRzsLQbDvaZGh6BVG,5Gyp41oLVo7Gg7vF4vpmggWP5MU70QO6,13,14,5,10,4,6,4,1,44,6.285714285714286,1,0.0,7,5,5,4,7,6,5,4,1,21,23,0
9611,137742,blQKCpClzsxilnQtKRruTVl5WFjEiUZ7,5Gyp41oLVo7Gg7vF4vpmggWP5MU70QO6,3,2,0,0,0,0,3,0,5,0.7142857142857143,1,0.0,1,0,0,0,1,0,0,3,0,1,4,1
9612,137795,qL8pzfxUmvBPhYspGX5TlcL0EdDEftN5,5Gyp41oLVo7Gg7vF4vpmggWP5MU70QO6,12,5,4,0,4,5,6,1,25,3.5714285714285716,1,0.0,0,4,0,4,5,5,0,6,1,8,17,1
9613,137804,Iy2c4LLD7WheZKvirMXjibEfTHkFFvkr,5Gyp41oLVo7Gg7vF4vpmggWP5MU70QO6,27,41,17,39,4,3,13,1,118,16.857142857142858,2,0.0,7,17,24,4,34,3,15,13,1,52,66,0
9614,137824,dADOrE6FAWkIPcnZuLBj5KGmzjdxSunH,5Gyp41oLVo7Gg7vF4vpmggWP5MU70QO6,5,2,1,0,1,2,6,0,12,1.7142857142857142,2,0.0,0,1,0,1,2,2,0,6,0,2,10,1
9615,137826,zOBIpcmftAStMdFAPFHRhNH5I6q8BynQ,5Gyp41oLVo7Gg7vF4vpmggWP5MU70QO6,2,0,0,0,0,0,3,0,3,0.42857142857142855,2,0.0,0,0,0,0,0,0,0,3,0,0,3,1
9616,137853,8AXj6lcLIX035dfDrWyWyYakHzYd5MDT,5Gyp41oLVo7Gg7vF4vpmggWP5MU70QO6,12,14,6,4,2,2,6,2,36,5.142857142857143,2,0.0,6,6,2,2,8,2,2,6,2,16,20,1
9617,137867,bUYYjtmXeuDpNg5r7ztprL0yQKhgzHDz,5Gyp41oLVo7Gg7vF4vpmggWP5MU70QO6,7,4,3,0,2,0,1,0,10,1.4285714285714286,1,0.0,0,3,0,2,4,0,0,1,0,5,5,1
9618,137881,kKps6h7sWc5sZeyAwx04ucbfq9EUC5TI,5Gyp41oLVo7Gg7vF4vpmggWP5MU70QO6,6,3,2,0,2,0,4,0,11,1.5714285714285714,1,0.0,0,2,0,2,3,0,0,4,0,4,7,1
9619,137907,HUdGvoMbBNNA1ZqsKSrSpFS4asnWhnvB,5Gyp41oLVo7Gg7vF4vpmggWP5MU70QO6,2,0,0,0,0,0,2,0,2,0.2857142857142857,1,0.0,0,0,0,0,0,0,0,2,0,0,2,1
9620,137909,q3oJZTJoJk5u14gJETUYRvW78tAwypRq,5Gyp41oLVo7Gg7vF4vpmggWP5MU70QO6,1,0,0,0,0,0,1,0,1,0.14285714285714285,1,0.0,0,0,0,0,0,0,0,1,0,0,1,1
9621,137910,xy8Pu3m8OtRxFLhTfix6XvZn0H18zyZc,5Gyp41oLVo7Gg7vF4vpmggWP5MU70QO6,8,6,4,0,2,0,3,0,15,2.142857142857143,2,0.0,0,4,0,2,6,0,0,3,0,6,9,1
9622,137938,d0Fkzc1s1K2YYTpSpPctaD4RWDrIXUTL,5Gyp41oLVo7Gg7vF4vpmggWP5MU70QO6,2,0,0,0,0,0,2,0,2,0.2857142857142857,1,0.0,0,0,0,0,0,0,0,2,0,0,2,1
9623,137953,mV4YsIiA8Oc8PxZhA2HzdmyhI1ZXRUSS,3VkHkmOtom3jM2wCu94xgzzu1d6Dn7or,76,150,57,85,40,0,19,0,351,50.142857142857146,6,0.0,29,57,78,40,121,0,7,19,0,204,147,1
9624,137966,NBV94ih7LcieajGdTDi3QH2JtZbXI2x1,3VkHkmOtom3jM2wCu94xgzzu1d6Dn7or,1,0,0,0,0,0,1,0,1,0.14285714285714285,1,0.0,0,0,0,0,0,0,0,1,0,0,1,1
9625,137997,qXIGeC2zEbEwKt7gMNBfCicZkRbanHO1,3VkHkmOtom3jM2wCu94xgzzu1d6Dn7or,10,6,2,3,2,3,7,1,24,3.4285714285714284,2,0.0,1,2,3,2,5,3,0,7,1,8,16,1
9626,138024,GEpbyyj6BQaV9LZDEZGPce9LJLPY7dNC,3VkHkmOtom3jM2wCu94xgzzu1d6Dn7or,1,0,0,0,0,0,1,0,1,0.14285714285714285,1,0.0,0,0,0,0,0,0,0,1,0,0,1,1
9627,138048,qb9Qr4ZV1ds9lE5SIWlnoMsvAsje2CsE,3VkHkmOtom3jM2wCu94xgzzu1d6Dn7or,84,197,68,63,67,91,57,15,558,79.71428571428571,6,0.0,100,68,60,67,97,91,3,57,15,295,263,0
9628,138049,Kt2RSgvwDX1UzjS7GFmQPOgcvgXVu2eH,3VkHkmOtom3jM2wCu94xgzzu1d6Dn7or,2,0,0,0,0,0,2,0,2,0.2857142857142857,1,0.0,0,0,0,0,0,0,0,2,0,0,2,1
9629,138090,3LYXSPIknSPP5L9tYGH6TdV4JRyff2yh,3VkHkmOtom3jM2wCu94xgzzu1d6Dn7or,1,0,0,0,0,0,1,0,1,0.14285714285714285,1,0.0,0,0,0,0,0,0,0,1,0,0,1,1
9630,138124,lcxEu4F2dIRGolbGM8J7dkDro6hPXvBJ,3VkHkmOtom3jM2wCu94xgzzu1d6Dn7or,83,136,80,37,49,22,39,7,370,52.857142857142854,10,0.0,34,80,37,49,102,22,0,39,7,200,170,0
9631,138139,qjVw5zdLNaHgDeIlRwuWiy2ktW0DybEV,3VkHkmOtom3jM2wCu94xgzzu1d6Dn7or,4,4,1,0,0,0,2,0,7,1.0,2,0.0,0,1,0,0,4,0,0,2,0,1,6,1
9632,138149,MtLecFHHqh9FK31xwdSHWGy7YvfdLTDA,3VkHkmOtom3jM2wCu94xgzzu1d6Dn7or,1,0,0,0,0,0,2,0,2,0.2857142857142857,1,0.0,0,0,0,0,0,0,0,2,0,0,2,1
9633,138153,mjUISFCMgCqY1IWingfuG4ekI9R53uIK,3VkHkmOtom3jM2wCu94xgzzu1d6Dn7or,49,72,39,0,24,0,8,0,143,20.428571428571427,4,0.0,0,39,0,24,72,0,0,8,0,63,80,0
9634,138173,XmTGlWu1nFYDf360lZ5nqwhv1GH6p6fl,7GRhBDsirIGkRZBtSMEzNTyDr2JQm4xx,3,0,0,0,0,0,4,0,4,0.5714285714285714,2,0.0,0,0,0,0,0,0,0,4,0,0,4,1
9635,138176,dFJ5slXqGymdZnNlAUvtsyJDritH7dGq,7GRhBDsirIGkRZBtSMEzNTyDr2JQm4xx,48,94,28,53,21,9,10,0,215,30.714285714285715,3,0.0,55,28,38,21,39,9,15,10,0,142,73,1
9636,138177,yGll7cBEK4l513wg08W8WjrXiINZSUwd,7GRhBDsirIGkRZBtSMEzNTyDr2JQm4xx,1,0,0,0,0,0,1,0,1,0.14285714285714285,1,0.0,0,0,0,0,0,0,0,1,0,0,1,1
9637,138189,AuvP8ZOL6WtgYZTed2Zwusm6F2UVjDCF,7GRhBDsirIGkRZBtSMEzNTyDr2JQm4xx,17,68,47,2,31,5,19,0,172,24.571428571428573,4,0.0,1,47,2,31,67,5,0,19,0,81,91,0
9638,138195,wn9ozQViYqj1KJxs4FuSKb0vCeNtcWYJ,7GRhBDsirIGkRZBtSMEzNTyDr2JQm4xx,1,0,0,0,0,0,1,0,1,0.14285714285714285,1,0.0,0,0,0,0,0,0,0,1,0,0,1,1
9639,138202,JvCyyatgxKHz9VFtDJVVBL31IMYHuDOZ,7GRhBDsirIGkRZBtSMEzNTyDr2JQm4xx,5,4,1,0,0,0,5,0,10,1.4285714285714286,2,0.0,0,1,0,0,4,0,0,5,0,1,9,1
9640,138203,SUOXvpdIRQJm9cEGkdcCVcGfiGC9WR0Q,7GRhBDsirIGkRZBtSMEzNTyDr2JQm4xx,1,0,0,0,0,0,1,0,1,0.14285714285714285,1,0.0,0,0,0,0,0,0,0,1,0,0,1,1
9641,138204,oanYJczRVsQsFyE3TEwPYW17rzmwBQIL,7GRhBDsirIGkRZBtSMEzNTyDr2JQm4xx,8,7,3,0,2,0,2,0,14,2.0,2,0.0,0,3,0,2,7,0,0,2,0,5,9,1
9642,138209,dSGnj6srDjb9PWIgErMSQXx2qQzyzYUX,7GRhBDsirIGkRZBtSMEzNTyDr2JQm4xx,1,0,0,0,0,0,1,0,1,0.14285714285714285,1,0.0,0,0,0,0,0,0,0,1,0,0,1,1
9643,138214,adfbW7xBPY784GRXAIq3fInFogIbD6ro,7GRhBDsirIGkRZBtSMEzNTyDr2JQm4xx,58,99,34,52,16,0,6,0,207,29.571428571428573,5,0.0,56,34,43,16,43,0,9,6,0,149,58,0
9644,138220,s1Q2cr9WUv6ymraZFi4Kx4UjpYZdQMAO,7GRhBDsirIGkRZBtSMEzNTyDr2JQm4xx,2,0,0,0,0,0,2,0,2,0.2857142857142857,1,0.0,0,0,0,0,0,0,0,2,0,0,2,0
9645,138226,xBRGHAvkTfDDok4cH7N9aC7OMTMv6n3O,7GRhBDsirIGkRZBtSMEzNTyDr2JQm4xx,9,4,3,0,3,0,4,0,14,2.0,2,0.0,0,3,0,3,4,0,0,4,0,6,8,1
9646,138239,JEJrnVrKGVjrX2yiet4Z0AOP8Myw4oGI,7GRhBDsirIGkRZBtSMEzNTyDr2JQm4xx,1,0,0,0,0,0,1,0,1,0.14285714285714285,1,0.0,0,0,0,0,0,0,0,1,0,0,1,1
9647,138241,JEJrnVrKGVjrX2yiet4Z0AOP8Myw4oGI,bWdj2GDclj5ofokWjzoa5jAwMkxCykd6,1,0,0,0,0,0,1,0,1,0.14285714285714285,1,0.0,0,0,0,0,0,0,0,1,0,0,1,1
9648,138243,DKNUSy56RJeSuYO3Dp6WYMwUBdoAcQ0a,7GRhBDsirIGkRZBtSMEzNTyDr2JQm4xx,5,2,1,0,1,0,3,0,7,1.0,2,0.0,0,1,0,1,2,0,0,3,0,2,5,1
9649,138244,DKNUSy56RJeSuYO3Dp6WYMwUBdoAcQ0a,A3fsA9Zfv1X2fVEQhTw51lKENdNrEqT3,2,0,0,0,0,0,5,0,5,0.7142857142857143,2,0.0,0,0,0,0,0,0,0,5,0,0,5,1
9650,138245,23wd4TSvccQ5i0TXkpg2or3OurpyZgtJ,bWdj2GDclj5ofokWjzoa5jAwMkxCykd6,14,34,24,0,20,8,3,0,89,12.714285714285714,2,0.0,7,24,0,20,27,8,0,3,0,51,38,1
9651,138250,szmVnhPypUPoSdN8Z8D02a6M8Gjrnwmf,A3fsA9Zfv1X2fVEQhTw51lKENdNrEqT3,65,44,30,162,19,0,9,0,264,37.714285714285715,6,0.0,4,30,136,19,40,0,26,9,0,189,75,1
9652,138251,xk5bwSTEAMNKyEU3iNkOO0oTip8zPc6K,SpATywNh6bZuzm8s1ceuBUnMUAeoAHHw,11,9,4,0,2,0,7,1,23,3.2857142857142856,1,0.0,4,4,0,2,5,0,0,7,1,10,13,1
9653,138254,KYRH4WW7qsAOiOmj346TRF2odLv2Stw0,A3fsA9Zfv1X2fVEQhTw51lKENdNrEqT3,1,0,0,0,0,0,1,0,1,0.14285714285714285,1,0.0,0,0,0,0,0,0,0,1,0,0,1,1
9654,138261,JL9rcevmVnCXKLKkXE87B1mrZmlYAcd1,SpATywNh6bZuzm8s1ceuBUnMUAeoAHHw,63,113,55,50,22,65,30,1,336,48.0,9,0.0,37,55,44,22,76,65,6,30,1,158,178,0
9655,138263,qlnTBDOgseVRcQc5nkjCE7nCQ5SaoF4b,SpATywNh6bZuzm8s1ceuBUnMUAeoAHHw,7,15,0,0,0,0,3,0,18,2.5714285714285716,1,0.0,4,0,0,0,11,0,0,3,0,4,14,0
9656,138287,UJP97i2EJO4yjxI3DoA9AGA9qgzPRSeL,SpATywNh6bZuzm8s1ceuBUnMUAeoAHHw,16,23,5,5,2,0,15,8,58,8.285714285714286,5,0.0,0,5,5,2,23,0,0,15,8,12,46,0
9657,138295,Dt8GK32H2MKtd6RVUxAk9cGVg15c101a,SpATywNh6bZuzm8s1ceuBUnMUAeoAHHw,1,0,0,0,0,0,2,0,2,0.2857142857142857,1,0.0,0,0,0,0,0,0,0,2,0,0,2,1
9658,138343,ekYJdZlodJJPGitBh9pJscwF42WGcv9J,SpATywNh6bZuzm8s1ceuBUnMUAeoAHHw,25,26,9,55,1,0,9,0,100,14.285714285714286,3,0.0,16,9,52,1,10,0,3,9,0,78,22,1
9659,138355,ancEkQokkVyJAjklV2PDvj1zIb7dKLV4,SpATywNh6bZuzm8s1ceuBUnMUAeoAHHw,23,13,9,8,7,0,2,0,39,5.571428571428571,1,0.0,2,9,8,7,11,0,0,2,0,26,13,1
9660,138357,NWaycxyjC99lvvlBzZhN9tb7U8fdoRvb,SpATywNh6bZuzm8s1ceuBUnMUAeoAHHw,61,87,41,65,23,91,31,0,338,48.285714285714285,7,0.0,29,41,53,23,58,91,12,31,0,146,192,0
9661,138371,uq5cRZDN2ZW7GTU6WfEkZYQCsqLxl96C,SpATywNh6bZuzm8s1ceuBUnMUAeoAHHw,16,20,12,0,6,0,7,0,45,6.428571428571429,3,0.0,5,12,0,6,15,0,0,7,0,23,22,0
9662,138380,0I055s9vaRQ6PXqeLKyD6l9kPxlReBT2,bWdj2GDclj5ofokWjzoa5jAwMkxCykd6,1,0,0,0,0,0,1,0,1,0.14285714285714285,1,0.0,0,0,0,0,0,0,0,1,0,0,1,1
9663,138385,R6r85AVni0tNGUvDSXb5ztmJaVo4FSr1,G8EPVSXsOYB5YQWZGiz1aVq5Pgr2GrQu,55,56,3,12,4,0,7,0,82,11.714285714285714,5,0.0,7,3,6,4,49,0,6,7,0,20,62,0
9664,138387,vLDUFKClgtT31VAwcYV5sIfp3TdS79BU,SpATywNh6bZuzm8s1ceuBUnMUAeoAHHw,4,2,1,0,1,0,1,0,5,0.7142857142857143,1,0.0,0,1,0,1,2,0,0,1,0,2,3,1
9665,138392,U1Nl2HcAAPdRP1Sw1krEueSkSr1F7plD,7GRhBDsirIGkRZBtSMEzNTyDr2JQm4xx,21,28,17,0,12,1,10,1,69,9.857142857142858,2,0.0,1,17,0,12,27,1,0,10,1,30,39,1
9666,138411,MF5edVvM6lCZDxnMdHelos9TUh3KERjn,G8EPVSXsOYB5YQWZGiz1aVq5Pgr2GrQu,30,32,19,8,15,0,6,0,80,11.428571428571429,3,0.0,10,19,5,15,22,0,3,6,0,49,31,1
9667,138412,9BgQxlrJHLSftkwUDKA3hmgF0QPDtIyc,G8EPVSXsOYB5YQWZGiz1aVq5Pgr2GrQu,2,0,0,0,0,0,2,0,2,0.2857142857142857,1,0.0,0,0,0,0,0,0,0,2,0,0,2,1
9668,138414,5mNJWEGtR9vdITQL1nnAvZIW2PAaTXsY,bWdj2GDclj5ofokWjzoa5jAwMkxCykd6,6,7,1,0,1,0,3,0,12,1.7142857142857142,2,0.0,0,1,0,1,7,0,0,3,0,2,10,1
9669,138422,PBT0xI17u81InQO08yLXpu6kSLQPC6l6,SpATywNh6bZuzm8s1ceuBUnMUAeoAHHw,37,57,5,54,3,2,20,3,144,20.571428571428573,10,0.0,9,5,44,3,48,2,10,20,3,61,83,0
9670,138432,4iRTdFrWnotIGLB21xnhMmvH623uk9Hg,SpATywNh6bZuzm8s1ceuBUnMUAeoAHHw,42,39,25,33,13,5,6,0,121,17.285714285714285,3,0.0,9,25,33,13,30,5,0,6,0,80,41,0
9671,138471,fZ0oG5LBFzyKBjVittCXSe5AVrs1RLoH,bWdj2GDclj5ofokWjzoa5jAwMkxCykd6,8,5,3,0,2,0,4,1,15,2.142857142857143,1,0.0,0,3,0,2,5,0,0,4,1,5,10,1
9672,138479,SVARW24mXzqWXiwQp4WEGlIIe2iZEl67,SpATywNh6bZuzm8s1ceuBUnMUAeoAHHw,11,14,0,15,0,0,2,0,31,4.428571428571429,1,0.0,8,0,12,0,6,0,3,2,0,20,11,0
9673,138483,h3tZErnQrcWD68hy7YWeUF3OyjhWokHu,SpATywNh6bZuzm8s1ceuBUnMUAeoAHHw,1,0,0,0,0,0,1,0,1,0.14285714285714285,1,0.0,0,0,0,0,0,0,0,1,0,0,1,1
9674,138491,NXEwBXbU6vvce77sujWgRB6LivhFJvRb,7GRhBDsirIGkRZBtSMEzNTyDr2JQm4xx,6,6,3,0,1,0,4,0,14,2.0,3,0.0,0,3,0,1,6,0,0,4,0,4,10,1
9675,138496,mSXZKJ9e3RCTXopgrFUphpxYgeKp7tlG,SpATywNh6bZuzm8s1ceuBUnMUAeoAHHw,61,94,49,32,18,1,20,1,215,30.714285714285715,9,0.0,26,49,31,18,68,1,1,20,1,124,91,0
9676,138503,hWYoTdCS0YLADoWfxXH71olbwetTTuPX,A3fsA9Zfv1X2fVEQhTw51lKENdNrEqT3,9,42,2,0,0,0,7,0,51,7.285714285714286,3,0.0,0,2,0,0,42,0,0,7,0,2,49,1
9677,138518,SVfMOf78rQIhc5bUdZbaTCmOKKmn1NJW,7GRhBDsirIGkRZBtSMEzNTyDr2JQm4xx,1,0,0,0,0,0,1,0,1,0.14285714285714285,1,0.0,0,0,0,0,0,0,0,1,0,0,1,1
9678,138520,SVfMOf78rQIhc5bUdZbaTCmOKKmn1NJW,SpATywNh6bZuzm8s1ceuBUnMUAeoAHHw,10,5,4,0,3,0,2,0,14,2.0,1,0.0,0,4,0,3,5,0,0,2,0,7,7,1
9679,138536,dfuq1nLFAi23gUE5vCmhP6T2naLzIcA3,SpATywNh6bZuzm8s1ceuBUnMUAeoAHHw,1,0,0,0,0,0,1,0,1,0.14285714285714285,1,0.0,0,0,0,0,0,0,0,1,0,0,1,1
9680,138544,K5kT5J7jKlVkFTVXY5IK3L2ReisrBiVS,RXDvfPUBYFlVdlueBFbLW0mhhAyGEqpt,12,14,7,29,3,0,2,0,55,7.857142857142857,1,0.0,6,7,21,3,8,0,8,2,0,37,18,1
9681,138545,S5iRqyOmmXNAeHlaI33tGlS1KWic6aj1,bWdj2GDclj5ofokWjzoa5jAwMkxCykd6,6,9,2,0,4,0,4,0,19,2.7142857142857144,1,0.0,6,2,0,4,3,0,0,4,0,12,7,1
9682,138554,Px8gWLqn4P0S59C09B0pkBi24hj9iKEG,7GRhBDsirIGkRZBtSMEzNTyDr2JQm4xx,14,17,6,7,3,0,19,0,52,7.428571428571429,5,0.0,5,6,4,3,12,0,3,19,0,18,34,1
9683,138561,0jMvKl4f4yq4swqJtBTb4m7rvyBg43HC,SpATywNh6bZuzm8s1ceuBUnMUAeoAHHw,5,4,2,0,1,0,2,0,9,1.2857142857142858,1,0.0,0,2,0,1,4,0,0,2,0,3,6,1
9684,138569,H68GXqsnvE2fb3Idf2i1DH8yakiWVkwR,A3fsA9Zfv1X2fVEQhTw51lKENdNrEqT3,7,5,2,0,2,0,2,0,11,1.5714285714285714,1,0.0,0,2,0,2,5,0,0,2,0,4,7,1
9685,138583,lhWBAeHfXafZlHCmXNLhsmCoHIt1IQ7L,SpATywNh6bZuzm8s1ceuBUnMUAeoAHHw,5,2,1,0,1,0,3,0,7,1.0,1,0.0,0,1,0,1,2,0,0,3,0,2,5,1
9686,138589,7KTA3JttmyRh7woCe5mVgkjc6Qjso7i4,SpATywNh6bZuzm8s1ceuBUnMUAeoAHHw,1,0,0,0,0,0,1,0,1,0.14285714285714285,1,0.0,0,0,0,0,0,0,0,1,0,0,1,1
9687,138602,TlFcqTzRzzK0wdjPXKgY6Grw7xbgRspB,7GRhBDsirIGkRZBtSMEzNTyDr2JQm4xx,1,0,0,0,0,0,1,0,1,0.14285714285714285,1,0.0,0,0,0,0,0,0,0,1,0,0,1,1
9688,138613,ONe4iInwtHkZ5gtlbWN831JopVHbaD8L,G8EPVSXsOYB5YQWZGiz1aVq5Pgr2GrQu,25,51,21,0,12,0,3,0,87,12.428571428571429,2,0.0,0,21,0,12,51,0,0,3,0,33,54,1
9689,138616,fUQHFT4QEMRSPqJAQlXlvlyNwca9Q0dU,A3fsA9Zfv1X2fVEQhTw51lKENdNrEqT3,7,4,0,0,0,0,3,0,7,1.0,1,0.0,0,0,0,0,4,0,0,3,0,0,7,1
9690,138626,fCpCrSs2mKjLscSCn1FHIkvQbSv4LbYE,bWdj2GDclj5ofokWjzoa5jAwMkxCykd6,1,0,0,0,0,0,1,0,1,0.14285714285714285,1,0.0,0,0,0,0,0,0,0,1,0,0,1,1
9691,138631,4D11IEAbvt5M4yzWoODDtOFh00iJuVTK,SpATywNh6bZuzm8s1ceuBUnMUAeoAHHw,25,41,1,19,1,0,3,0,65,9.285714285714286,2,0.0,18,1,17,1,23,0,2,3,0,37,28,0
9692,138632,UcanAXkT95ylp5ubNi37V7psHMFxiz1f,RXDvfPUBYFlVdlueBFbLW0mhhAyGEqpt,58,72,1,143,2,45,14,2,279,39.857142857142854,1,0.0,14,1,134,2,58,45,9,14,2,151,128,0
9693,138641,247FLfH4Mb594RFNNow4NoO1PsYj55Me,RXDvfPUBYFlVdlueBFbLW0mhhAyGEqpt,11,5,1,0,1,0,5,0,12,1.7142857142857142,1,0.0,0,1,0,1,5,0,0,5,0,2,10,1
9694,138643,QiZHycbjNbbRnz73j2CxBu0cfmT0MxFq,7GRhBDsirIGkRZBtSMEzNTyDr2JQm4xx,2,0,0,0,0,0,2,0,2,0.2857142857142857,1,0.0,0,0,0,0,0,0,0,2,0,0,2,1
9695,138644,klFfeIWt13kJyzZ8QBX8igiJe3NNykgD,SpATywNh6bZuzm8s1ceuBUnMUAeoAHHw,11,24,11,18,3,9,4,0,69,9.857142857142858,4,0.0,7,11,15,3,17,9,3,4,0,36,33,1
9696,138649,xd3R9FpcIKhYRXFLFLDzZPRPvMMXOj1o,SpATywNh6bZuzm8s1ceuBUnMUAeoAHHw,41,56,33,38,0,17,15,2,161,23.0,2,0.0,18,33,35,0,38,17,3,15,2,86,75,0
9697,138695,dbtlJh8uWixqUAz5pHAMwXOZNVVUTuzi,SpATywNh6bZuzm8s1ceuBUnMUAeoAHHw,4,2,0,0,0,0,2,0,4,0.5714285714285714,1,0.0,0,0,0,0,2,0,0,2,0,0,4,1
9698,138699,p5RtwcA9vuKdWJZrb7lEE3M3hOjsWHJi,A3fsA9Zfv1X2fVEQhTw51lKENdNrEqT3,61,29,2,191,0,0,10,1,233,33.285714285714285,1,0.0,9,2,163,0,20,0,28,10,1,174,59,1
9699,138700,URDT7UEnATnBeUQYxPwZ1xbRtpHzMsBO,SpATywNh6bZuzm8s1ceuBUnMUAeoAHHw,47,38,26,19,17,0,7,0,107,15.285714285714286,5,0.0,2,26,16,17,36,0,3,7,0,61,46,0
9700,138707,F0EH5ewON9VykhUnDQqIKLqtLDoqhPsI,bWdj2GDclj5ofokWjzoa5jAwMkxCykd6,12,21,7,0,0,2,10,1,41,5.857142857142857,1,0.0,6,7,0,0,15,2,0,10,1,13,28,0
9701,138741,6bJug3laIIWWCaCLyBLU00ZUhfOCair3,G8EPVSXsOYB5YQWZGiz1aVq5Pgr2GrQu,2,0,0,0,0,0,2,0,2,0.2857142857142857,1,0.0,0,0,0,0,0,0,0,2,0,0,2,1
9702,138785,O1Ztz9KIKs4JpSImKRRrzfUM0dpj0hIe,SpATywNh6bZuzm8s1ceuBUnMUAeoAHHw,22,36,1,51,0,49,15,0,152,21.714285714285715,5,0.0,13,1,43,0,23,49,8,15,0,57,95,0
9703,138790,dw62ngoCoOUMjCVivRFAShXF5gbGsZWV,SpATywNh6bZuzm8s1ceuBUnMUAeoAHHw,5,4,1,0,1,0,2,0,8,1.1428571428571428,1,0.0,0,1,0,1,4,0,0,2,0,2,6,1
9704,138791,a19tMY1HS7MdnIZIQ0I2umOGQttKJ1uy,RXDvfPUBYFlVdlueBFbLW0mhhAyGEqpt,13,14,5,9,6,0,5,1,40,5.714285714285714,1,0.0,6,5,9,6,8,0,0,5,1,26,14,1
9705,138800,OhEerYX6jubgMlujry1FJzH6tFAkAkV2,7GRhBDsirIGkRZBtSMEzNTyDr2JQm4xx,7,4,1,0,0,3,4,1,13,1.8571428571428572,1,0.0,0,1,0,0,4,3,0,4,1,1,12,1
9706,138818,okqN4nBVKRYYrkYonKicKGOmPqVGYjZh,RXDvfPUBYFlVdlueBFbLW0mhhAyGEqpt,10,24,10,0,0,17,21,0,72,10.285714285714286,4,0.0,0,10,0,0,24,17,0,21,0,10,62,0
9707,138839,AYb0mQx5aj7cvHvgDba3CV4jlkuCTKMg,7GRhBDsirIGkRZBtSMEzNTyDr2JQm4xx,4,2,0,0,0,0,2,0,4,0.5714285714285714,1,0.0,0,0,0,0,2,0,0,2,0,0,4,1
9708,138847,MAd8tH47KthSEzVrLAKG5qRX6SRuj7GJ,5X6FeZozNMgE2VRi3MJYjkkFK8SETtu2,17,44,8,16,13,0,5,0,86,12.285714285714286,4,0.0,30,8,14,13,14,0,2,5,0,65,21,1
9709,138865,AYiGvgKDaGiBpYEcJ7Espvi6dQy2aiFd,SpATywNh6bZuzm8s1ceuBUnMUAeoAHHw,44,114,14,33,1,2,15,1,180,25.714285714285715,10,0.0,41,14,33,1,73,2,0,15,1,89,91,0
9710,138887,LVgGKe8GEjU3xNkkgcLCws2DFML8rckJ,bWdj2GDclj5ofokWjzoa5jAwMkxCykd6,1,0,0,0,0,0,1,0,1,0.14285714285714285,1,0.0,0,0,0,0,0,0,0,1,0,0,1,1
9711,138891,a9MMqUpuUSR3IzgW99lgUm9PMVCCff15,SpATywNh6bZuzm8s1ceuBUnMUAeoAHHw,5,2,1,0,1,0,2,0,6,0.8571428571428571,1,0.0,0,1,0,1,2,0,0,2,0,2,4,1
9712,138900,bHqXWqN9pt89j5bH9fnt5jMZVOQZImRj,7GRhBDsirIGkRZBtSMEzNTyDr2JQm4xx,1,0,0,0,0,0,2,0,2,0.2857142857142857,2,0.0,0,0,0,0,0,0,0,2,0,0,2,1
9713,138909,a9MMqUpuUSR3IzgW99lgUm9PMVCCff15,A3fsA9Zfv1X2fVEQhTw51lKENdNrEqT3,5,2,1,0,1,0,2,0,6,0.8571428571428571,1,0.0,0,1,0,1,2,0,0,2,0,2,4,1
9714,138910,mIHD2jrknaRciO3CSsk0UVjwF79EIvXO,RXDvfPUBYFlVdlueBFbLW0mhhAyGEqpt,4,2,0,0,0,4,2,0,8,1.1428571428571428,1,0.0,0,0,0,0,2,4,0,2,0,0,8,1
9715,138918,TRryTScYmrJYu9foqAm7Z1ALNBOdlA1X,SpATywNh6bZuzm8s1ceuBUnMUAeoAHHw,14,29,0,12,0,0,9,2,52,7.428571428571429,2,0.0,17,0,11,0,12,0,1,9,2,28,24,1
9716,138941,OqoyGVhMdqCmcn9uCtXU2u6JDkNgnUSS,SpATywNh6bZuzm8s1ceuBUnMUAeoAHHw,29,22,18,0,16,0,4,0,60,8.571428571428571,2,0.0,0,18,0,16,22,0,0,4,0,34,26,1
9717,138946,b9kku2PsSG5AAAeEY7DQePn7yzD0gmyo,G8EPVSXsOYB5YQWZGiz1aVq5Pgr2GrQu,19,15,4,20,3,0,1,0,43,6.142857142857143,1,0.0,10,4,10,3,5,0,10,1,0,27,16,0
9718,138947,2Ueq99WOxFkvLjKvdAbi1TRY9isnfhGR,SpATywNh6bZuzm8s1ceuBUnMUAeoAHHw,8,6,4,0,3,2,4,0,19,2.7142857142857144,3,0.0,2,4,0,3,4,2,0,4,0,9,10,1
9719,138957,LDYjWqhrIxv22jlLe9In731UT9Ne6fvw,SpATywNh6bZuzm8s1ceuBUnMUAeoAHHw,31,21,11,26,7,3,27,0,95,13.571428571428571,10,0.0,7,11,25,7,14,3,1,27,0,50,45,1
9720,138958,SstKsQWEBJfXpsf5A46CO9g706uArlpY,RXDvfPUBYFlVdlueBFbLW0mhhAyGEqpt,5,3,0,0,0,1,2,0,6,0.8571428571428571,1,0.0,0,0,0,0,3,1,0,2,0,0,6,0
9721,138962,NKKgqSSwnJpenRYnE59UQVVdasPdam0Z,SpATywNh6bZuzm8s1ceuBUnMUAeoAHHw,20,18,10,14,5,5,11,2,65,9.285714285714286,3,0.0,5,10,11,5,13,5,3,11,2,31,34,1
9722,138973,v7pdrt6SOAQ5FMXohVYmR0yZQdsegJw7,bWdj2GDclj5ofokWjzoa5jAwMkxCykd6,8,8,2,0,2,0,5,0,17,2.4285714285714284,4,0.0,0,2,0,2,8,0,0,5,0,4,13,0
9723,138974,ouL32O71NoAWgx7epnnVebKIsbBDnj9P,SpATywNh6bZuzm8s1ceuBUnMUAeoAHHw,61,98,49,65,33,58,36,8,347,49.57142857142857,5,0.0,27,49,51,33,71,58,14,36,8,160,187,0
9724,138993,mLD9g4ezOv6SvPMWLaj047DaKrptKosJ,5X6FeZozNMgE2VRi3MJYjkkFK8SETtu2,1,0,0,0,0,0,1,0,1,0.14285714285714285,1,0.0,0,0,0,0,0,0,0,1,0,0,1,1
9725,138994,8zO55rr0YRpKXIkdnMjpGC4LQsXgWFT5,5X6FeZozNMgE2VRi3MJYjkkFK8SETtu2,1,0,0,0,0,0,1,0,1,0.14285714285714285,1,0.0,0,0,0,0,0,0,0,1,0,0,1,1
9726,139004,aKtqxPEfMnVhEPAMX3aHrnYTfbYN9i8f,A3fsA9Zfv1X2fVEQhTw51lKENdNrEqT3,7,3,0,0,0,3,6,0,12,1.7142857142857142,2,0.0,0,0,0,0,3,3,0,6,0,0,12,1
9727,139006,3wXMZkXBm1ATxVfwmh0YqzBsBRzhFw8P,SpATywNh6bZuzm8s1ceuBUnMUAeoAHHw,19,26,13,16,4,0,13,1,73,10.428571428571429,3,0.0,9,13,14,4,17,0,2,13,1,40,33,0
9728,139013,ucdoEtZyBMBpMuHw7eldMzgNsB5u9NZD,A3fsA9Zfv1X2fVEQhTw51lKENdNrEqT3,2,0,0,0,0,0,5,0,5,0.7142857142857143,1,0.0,0,0,0,0,0,0,0,5,0,0,5,1
9729,139018,FbUvC9kIlbjOWJZkNuNKPe74SYVSmlJl,SpATywNh6bZuzm8s1ceuBUnMUAeoAHHw,6,3,2,0,2,0,1,0,8,1.1428571428571428,1,0.0,0,2,0,2,3,0,0,1,0,4,4,1
9730,139035,nd6sluT5nIbtyItOnd1zUbNlfRFXkzgp,5X6FeZozNMgE2VRi3MJYjkkFK8SETtu2,5,2,1,0,1,0,2,0,6,0.8571428571428571,1,0.0,0,1,0,1,2,0,0,2,0,2,4,1
9731,139049,2NNFHRZmwsPe1B99Qw8qhCzLBWZ750pt,bWdj2GDclj5ofokWjzoa5jAwMkxCykd6,10,9,4,0,2,3,14,3,35,5.0,1,0.0,2,4,0,2,7,3,0,14,3,8,27,1
9732,139057,nqLRPpborGO3IzbD5YxVONrZGqxfXpwO,A3fsA9Zfv1X2fVEQhTw51lKENdNrEqT3,5,5,1,0,1,0,1,0,8,1.1428571428571428,1,0.0,0,1,0,1,5,0,0,1,0,2,6,0
9733,139060,3RamXhwDB6su3FqsOEul2F9rEiIGtftu,bWdj2GDclj5ofokWjzoa5jAwMkxCykd6,4,3,1,0,1,0,6,0,11,1.5714285714285714,1,0.0,0,1,0,1,3,0,0,6,0,2,9,1
9734,139071,a7ZVMpb0c7CARO4liNTBsp4hgkFIkG4C,A3fsA9Zfv1X2fVEQhTw51lKENdNrEqT3,10,8,6,0,3,10,6,0,33,4.714285714285714,3,0.0,0,6,0,3,8,10,0,6,0,9,24,1
9735,139073,r2VP84vIhleP2JRhufK44gQkfMu0ayYL,A3fsA9Zfv1X2fVEQhTw51lKENdNrEqT3,7,4,3,0,3,0,3,0,13,1.8571428571428572,1,0.0,0,3,0,3,4,0,0,3,0,6,7,1
9736,139075,a7ZVMpb0c7CARO4liNTBsp4hgkFIkG4C,5X6FeZozNMgE2VRi3MJYjkkFK8SETtu2,7,9,4,0,5,0,3,0,21,3.0,2,0.0,4,4,0,5,5,0,0,3,0,13,8,1
9737,139081,AUQbcN6sP8jOc3r7pDcomR6R8baoxLvG,RXDvfPUBYFlVdlueBFbLW0mhhAyGEqpt,114,243,142,250,37,14,34,2,722,103.14285714285714,11,0.0,52,142,221,37,191,14,29,34,2,452,270,0
9738,139085,heVJWbQBtCN8obfXQBAbcR0I5MnOvCPs,G8EPVSXsOYB5YQWZGiz1aVq5Pgr2GrQu,109,150,58,270,30,13,44,10,575,82.14285714285714,11,0.0,48,58,220,30,102,13,50,44,10,356,219,0
9739,139090,y8bZlCtdeIdFsLmd09IvS19n3aRTkHSW,bWdj2GDclj5ofokWjzoa5jAwMkxCykd6,6,6,1,0,1,0,2,0,10,1.4285714285714286,2,0.0,0,1,0,1,6,0,0,2,0,2,8,1
9740,139109,CbHE8hCSYPvdgYMpDUO4zyKrMGfMTSJS,5X6FeZozNMgE2VRi3MJYjkkFK8SETtu2,1,0,0,0,0,0,1,0,1,0.14285714285714285,1,0.0,0,0,0,0,0,0,0,1,0,0,1,1
9741,139119,FIYIY0le6IgAtT64SQdOQ9wlHEZCwQOO,A3fsA9Zfv1X2fVEQhTw51lKENdNrEqT3,5,2,1,0,1,0,3,0,7,1.0,1,0.0,0,1,0,1,2,0,0,3,0,2,5,1
9742,139120,bjR8VCa57HhC9FMIDzdply9YThOSMqPi,5X6FeZozNMgE2VRi3MJYjkkFK8SETtu2,6,3,1,0,1,0,2,0,7,1.0,1,0.0,0,1,0,1,3,0,0,2,0,2,5,0
9743,139134,tS8frxV0M3TGWaoIiOl49ThYexkN4UpR,7GRhBDsirIGkRZBtSMEzNTyDr2JQm4xx,8,14,5,0,3,0,7,0,29,4.142857142857143,3,0.0,0,5,0,3,14,0,0,7,0,8,21,1
9744,139135,qQva6iW8x8zRei3swvtJZM6WawbenNEN,G8EPVSXsOYB5YQWZGiz1aVq5Pgr2GrQu,15,6,5,0,5,1,9,2,28,4.0,1,0.0,1,5,0,5,5,1,0,9,2,11,17,1
9745,139144,CeskLH9m953bFnFMALF6StQidFq10Eca,SpATywNh6bZuzm8s1ceuBUnMUAeoAHHw,6,6,4,0,1,0,1,0,12,1.7142857142857142,1,0.0,1,4,0,1,5,0,0,1,0,6,6,1
9746,139149,UA8vU3s92g3lXc62U363PEO0xor6Mpeg,SpATywNh6bZuzm8s1ceuBUnMUAeoAHHw,38,29,23,2,19,0,3,0,76,10.857142857142858,2,0.0,3,23,2,19,26,0,0,3,0,47,29,0
9747,139170,gBe7EORYc8tWLPpy5CEZ7VaeCy9UzNag,SpATywNh6bZuzm8s1ceuBUnMUAeoAHHw,6,3,1,0,0,0,4,1,9,1.2857142857142858,1,0.0,0,1,0,0,3,0,0,4,1,1,8,1
9748,139181,arqk7DTh1VGICIY90l0CngaLIKuIO724,RXDvfPUBYFlVdlueBFbLW0mhhAyGEqpt,28,44,25,40,2,6,5,0,122,17.428571428571427,2,0.0,2,25,34,2,42,6,6,5,0,63,59,0
9749,139194,xSaKZnAMCNpefu5juxSqjRpkUhr14wlR,A3fsA9Zfv1X2fVEQhTw51lKENdNrEqT3,6,4,0,0,0,1,5,0,10,1.4285714285714286,1,0.0,0,0,0,0,4,1,0,5,0,0,10,1
9750,139196,XaDObnlcjPgfFvrsAMoLqKp3YSHBUNeu,5X6FeZozNMgE2VRi3MJYjkkFK8SETtu2,5,0,0,0,0,1,7,1,9,1.2857142857142858,1,0.0,0,0,0,0,0,1,0,7,1,0,9,1
9751,139241,mR38LOzPkDgy4Z7CZO92yHt4TSlNwfzC,A3fsA9Zfv1X2fVEQhTw51lKENdNrEqT3,10,8,1,0,0,0,12,1,22,3.142857142857143,2,0.0,0,1,0,0,8,0,0,12,1,1,21,1
9752,139243,St6usTSSgX5U9v7wchuMWqmBKoCcDwN2,7GRhBDsirIGkRZBtSMEzNTyDr2JQm4xx,2,0,0,0,0,0,2,0,2,0.2857142857142857,1,0.0,0,0,0,0,0,0,0,2,0,0,2,1
9753,139257,UBhVC0WaVWM4P6ieHzAF19GMdFyBLfD4,SpATywNh6bZuzm8s1ceuBUnMUAeoAHHw,59,68,47,53,37,13,6,0,224,32.0,3,0.0,12,47,47,37,56,13,6,6,0,143,81,0
9754,139259,izfjE6NG3af26sY3NuLKpzoBmikc8i1O,bWdj2GDclj5ofokWjzoa5jAwMkxCykd6,9,4,3,0,2,0,3,0,12,1.7142857142857142,1,0.0,0,3,0,2,4,0,0,3,0,5,7,1
9755,139276,bPNiwUCUO5XdlJjasSfnyvxXSu8K1h7Q,RXDvfPUBYFlVdlueBFbLW0mhhAyGEqpt,1,0,0,0,0,0,1,0,1,0.14285714285714285,1,0.0,0,0,0,0,0,0,0,1,0,0,1,1
9756,139288,IWTpJo3Xdx5l8YSxAjWkfR932wmDoCRC,SpATywNh6bZuzm8s1ceuBUnMUAeoAHHw,5,7,2,0,1,2,3,0,15,2.142857142857143,1,0.0,0,2,0,1,7,2,0,3,0,3,12,1
9757,139293,SL3jxjEQk6v82n0aWfLP80T9svpvrAxv,5X6FeZozNMgE2VRi3MJYjkkFK8SETtu2,7,7,3,0,3,0,2,0,15,2.142857142857143,2,0.0,2,3,0,3,5,0,0,2,0,8,7,1
9758,139298,gejpeIdpjStfIOq4XQNQvvNIbDoDOFhN,bWdj2GDclj5ofokWjzoa5jAwMkxCykd6,5,2,1,0,1,0,4,0,8,1.1428571428571428,1,0.0,0,1,0,1,2,0,0,4,0,2,6,0
9759,139302,mFcnZc9xJHpcsnNSqrnt1TraJ39cAeOG,SpATywNh6bZuzm8s1ceuBUnMUAeoAHHw,23,38,6,6,3,5,17,1,76,10.857142857142858,3,0.0,2,6,5,3,36,5,1,17,1,16,60,0
9760,139312,vlarE7zCdES78rsfbZ9s0PTdwVr1rAk4,A3fsA9Zfv1X2fVEQhTw51lKENdNrEqT3,18,58,6,0,5,1,13,3,86,12.285714285714286,7,0.0,1,6,0,5,57,1,0,13,3,12,74,1
9761,139325,Wn6M5pDE1BQQohcN99ynI9TPsF44SXAJ,5X6FeZozNMgE2VRi3MJYjkkFK8SETtu2,9,6,4,0,3,0,1,0,14,2.0,1,0.0,0,4,0,3,6,0,0,1,0,7,7,1
9762,139337,yQGwQkQvYmsNm3l8iENxe5EfvwaWshI7,SpATywNh6bZuzm8s1ceuBUnMUAeoAHHw,1,0,0,0,0,0,1,0,1,0.14285714285714285,1,0.0,0,0,0,0,0,0,0,1,0,0,1,1
9763,139354,QXg7RHDSlJliIBbIO3xqJ8cmekKDZLIJ,7GRhBDsirIGkRZBtSMEzNTyDr2JQm4xx,8,9,5,0,0,0,4,0,18,2.5714285714285716,1,0.0,1,5,0,0,8,0,0,4,0,6,12,1
9764,139361,sA2rUsJ0NxTB8HUngN94aqlC0TKNyhII,A3fsA9Zfv1X2fVEQhTw51lKENdNrEqT3,7,0,0,0,0,1,8,1,10,1.4285714285714286,1,0.0,0,0,0,0,0,1,0,8,1,0,10,1
9765,139363,8CgFwutv1MXk0sIfiSIZYIfZCkRfaV3H,5X6FeZozNMgE2VRi3MJYjkkFK8SETtu2,5,2,1,0,1,0,2,0,6,0.8571428571428571,1,0.0,0,1,0,1,2,0,0,2,0,2,4,1
9766,139366,tRdx0tRHXkoW2WJ4mnzpdZfXXXIdX04T,SpATywNh6bZuzm8s1ceuBUnMUAeoAHHw,27,63,1,24,1,2,9,0,100,14.285714285714286,4,0.0,18,1,24,1,45,2,0,9,0,44,56,0
9767,139387,FlAkKX6ow9SvOzk0dTWPWgnX5766zY29,RXDvfPUBYFlVdlueBFbLW0mhhAyGEqpt,5,4,2,0,1,0,1,0,8,1.1428571428571428,1,0.0,0,2,0,1,4,0,0,1,0,3,5,1
9768,139391,iLtON4OdzeG1y617iqhiryM9G4xoGAr5,SpATywNh6bZuzm8s1ceuBUnMUAeoAHHw,35,85,21,92,4,35,36,8,281,40.142857142857146,5,0.0,37,21,80,4,48,35,12,36,8,142,139,0
9769,139417,Eu8Qqpqb0GF09dcSDaIzMqGOvyPF0qRO,SpATywNh6bZuzm8s1ceuBUnMUAeoAHHw,1,0,0,0,0,0,1,0,1,0.14285714285714285,1,0.0,0,0,0,0,0,0,0,1,0,0,1,0
9770,139427,RilPnDVnlT9lfSJkTtPGJBpYx1VNW6Lv,SpATywNh6bZuzm8s1ceuBUnMUAeoAHHw,7,5,3,0,2,0,4,0,14,2.0,1,0.0,0,3,0,2,5,0,0,4,0,5,9,0
9771,139450,Ae22hvALqv0MxUz0BtfyFRCZH8Unzasl,G8EPVSXsOYB5YQWZGiz1aVq5Pgr2GrQu,4,3,0,0,0,0,1,0,4,0.5714285714285714,1,0.0,0,0,0,0,3,0,0,1,0,0,4,1
9772,139461,h1ztb0p8BMq619bNmxNVQh8qv21IVm55,SpATywNh6bZuzm8s1ceuBUnMUAeoAHHw,33,26,21,0,13,0,7,0,67,9.571428571428571,3,0.0,0,21,0,13,26,0,0,7,0,34,33,0
9773,139463,htakCdKp1xnLFWo197VQ9qXnetvOXP4f,G8EPVSXsOYB5YQWZGiz1aVq5Pgr2GrQu,11,10,4,2,3,0,3,0,22,3.142857142857143,1,0.0,5,4,1,3,5,0,1,3,0,13,9,1
9774,139479,cDV3uv01OqR28HAw8WapmztMslx9jbkZ,A3fsA9Zfv1X2fVEQhTw51lKENdNrEqT3,10,12,5,0,0,1,11,1,30,4.285714285714286,4,0.0,1,5,0,0,11,1,0,11,1,6,24,1
9775,139497,CQdAGcIvDdIBklDWFKtch5fpBdl4NTjN,SpATywNh6bZuzm8s1ceuBUnMUAeoAHHw,17,27,13,18,4,0,7,1,70,10.0,3,0.0,10,13,14,4,17,0,4,7,1,41,29,1
9776,139502,hLHRmItIrBAAjPponbejbmcuRqVRIxcd,G8EPVSXsOYB5YQWZGiz1aVq5Pgr2GrQu,47,52,15,158,8,1,12,1,247,35.285714285714285,2,0.0,32,15,125,8,20,1,33,12,1,180,67,1
9777,139513,kQH8Ov2DffXYcWaAu4MH2EnCh6Qd1rUK,SpATywNh6bZuzm8s1ceuBUnMUAeoAHHw,2,0,0,0,0,0,2,0,2,0.2857142857142857,1,0.0,0,0,0,0,0,0,0,2,0,0,2,1
9778,139516,4CoGSxhhHWTO7EDjl5nO5mW4CLM3ADy3,SpATywNh6bZuzm8s1ceuBUnMUAeoAHHw,7,4,3,0,3,0,2,0,12,1.7142857142857142,1,0.0,0,3,0,3,4,0,0,2,0,6,6,0
9779,139529,eAoTqcSoJiOhBe2Vk1sWGAt0rJFMTxVe,5X6FeZozNMgE2VRi3MJYjkkFK8SETtu2,7,9,1,3,2,0,3,0,18,2.5714285714285716,1,0.0,7,1,3,2,2,0,0,3,0,13,5,1
9780,139551,EPVEir3f8DxjouE65Q4kYI9YaQMxGE89,SpATywNh6bZuzm8s1ceuBUnMUAeoAHHw,1,0,0,0,0,0,1,0,1,0.14285714285714285,1,0.0,0,0,0,0,0,0,0,1,0,0,1,1
9781,139559,6nz65mCAfg32rdc5I4EhrQzO2XWyRRBx,SpATywNh6bZuzm8s1ceuBUnMUAeoAHHw,7,3,2,0,2,0,2,0,9,1.2857142857142858,1,0.0,0,2,0,2,3,0,0,2,0,4,5,0
9782,139575,j4fKJGSFGeDK8KfTLiburPdJXY2cNIyf,7GRhBDsirIGkRZBtSMEzNTyDr2JQm4xx,5,2,1,0,1,0,2,0,6,0.8571428571428571,1,0.0,0,1,0,1,2,0,0,2,0,2,4,1
9783,139599,Fvf4nP4NQpA7TLxnLfVBCjH25x0B5J5v,A3fsA9Zfv1X2fVEQhTw51lKENdNrEqT3,6,1,1,0,1,0,4,0,7,1.0,1,0.0,0,1,0,1,1,0,0,4,0,2,5,0
9784,139603,mpVn51vIxcFHSSmrFHwBhXrXBYaAZHXF,A3fsA9Zfv1X2fVEQhTw51lKENdNrEqT3,22,11,2,24,2,1,16,1,57,8.142857142857142,2,0.0,0,2,20,2,11,1,4,16,1,24,33,1
9785,139610,9pq6iUHzjk4QDwVV6xT371Bi8wqYPvWa,5X6FeZozNMgE2VRi3MJYjkkFK8SETtu2,6,2,1,0,1,0,5,0,9,1.2857142857142858,2,0.0,0,1,0,1,2,0,0,5,0,2,7,1
9786,139616,kbYq8zrS6JfKuFI6mRE75tGmcW5U6pfr,SpATywNh6bZuzm8s1ceuBUnMUAeoAHHw,1,0,0,0,0,0,1,0,1,0.14285714285714285,1,0.0,0,0,0,0,0,0,0,1,0,0,1,1
9787,139625,NHjxa47feJ9sWQnmg6HoO6L78eHIRwnl,7GRhBDsirIGkRZBtSMEzNTyDr2JQm4xx,1,0,0,0,0,0,4,0,4,0.5714285714285714,2,0.0,0,0,0,0,0,0,0,4,0,0,4,0
9788,139636,ZiYtsb1Ak7GaNNWvoedvbdRDNHLU7j7m,RXDvfPUBYFlVdlueBFbLW0mhhAyGEqpt,1,0,0,0,0,0,1,0,1,0.14285714285714285,1,0.0,0,0,0,0,0,0,0,1,0,0,1,1
9789,139638,ZiYtsb1Ak7GaNNWvoedvbdRDNHLU7j7m,A3fsA9Zfv1X2fVEQhTw51lKENdNrEqT3,1,0,0,0,0,0,1,0,1,0.14285714285714285,1,0.0,0,0,0,0,0,0,0,1,0,0,1,1
9790,139640,S33lH053HmB7Cz0IWipiL27cwx1QXBWr,7GRhBDsirIGkRZBtSMEzNTyDr2JQm4xx,3,2,0,0,0,0,1,0,3,0.42857142857142855,1,0.0,0,0,0,0,2,0,0,1,0,0,3,1
9791,139657,eC4StSuQwImpW962lXYQQlRlP4Dxmsjm,7GRhBDsirIGkRZBtSMEzNTyDr2JQm4xx,2,0,0,0,0,0,2,0,2,0.2857142857142857,1,0.0,0,0,0,0,0,0,0,2,0,0,2,1
9792,139670,oS7SUTBKh1bu6CNWHLkErC6YcVXZ37hg,SpATywNh6bZuzm8s1ceuBUnMUAeoAHHw,4,4,0,0,0,0,1,0,5,0.7142857142857143,1,0.0,0,0,0,0,4,0,0,1,0,0,5,0
9793,139675,Lk947zUxODvAz9uAzr7LhEhqya4oVnNV,A3fsA9Zfv1X2fVEQhTw51lKENdNrEqT3,4,0,0,0,0,0,7,1,8,1.1428571428571428,2,0.0,0,0,0,0,0,0,0,7,1,0,8,1
9794,139682,uhXQuUUUVKIwun4V8mG56AtnRcH7YsHS,A3fsA9Zfv1X2fVEQhTw51lKENdNrEqT3,6,1,1,0,0,1,6,0,9,1.2857142857142858,1,0.0,0,1,0,0,1,1,0,6,0,1,8,1
9795,139690,LUdeI1OPyNrX5I5cHCiKlVYRtO8YM2cA,SpATywNh6bZuzm8s1ceuBUnMUAeoAHHw,1,0,0,0,0,0,1,0,1,0.14285714285714285,1,0.0,0,0,0,0,0,0,0,1,0,0,1,1
9796,139701,bDbKEMrZzcFQTQT7Qrji0QYF25s6ADsY,7GRhBDsirIGkRZBtSMEzNTyDr2JQm4xx,1,0,0,0,0,0,1,0,1,0.14285714285714285,1,0.0,0,0,0,0,0,0,0,1,0,0,1,1
9797,139710,wEM6o12i41X2Ow06y98SfdLhUndMStOe,SpATywNh6bZuzm8s1ceuBUnMUAeoAHHw,16,18,10,2,7,0,5,0,42,6.0,4,0.0,1,10,2,7,17,0,0,5,0,20,22,1
9798,139716,eluOlYcZJVTTjykOpIIga4LwzNLu5APk,bWdj2GDclj5ofokWjzoa5jAwMkxCykd6,1,0,0,0,0,0,1,0,1,0.14285714285714285,1,0.0,0,0,0,0,0,0,0,1,0,0,1,1
9799,139720,bKykRXJRwKOU9QAaF96MqPLjXHCHEd7I,SpATywNh6bZuzm8s1ceuBUnMUAeoAHHw,37,18,17,0,17,0,2,0,54,7.714285714285714,2,0.0,0,17,0,17,18,0,0,2,0,34,20,1
9800,139721,YI82gOPk3osjTxu9r38iyjq6I3W2WIaD,RXDvfPUBYFlVdlueBFbLW0mhhAyGEqpt,14,13,9,0,5,0,6,0,33,4.714285714285714,4,0.0,0,9,0,5,13,0,0,6,0,14,19,0
9801,139760,qgQSG0aNbfBR28zJCPMHQYzbWLePLKUp,3VkHkmOtom3jM2wCu94xgzzu1d6Dn7or,1,0,0,0,0,0,1,0,1,0.14285714285714285,1,0.0,0,0,0,0,0,0,0,1,0,0,1,1
9802,139774,9MnIXVsvTDWVJ7Z8AvvQensotFfvlnnr,3VkHkmOtom3jM2wCu94xgzzu1d6Dn7or,1,0,0,0,0,0,1,0,1,0.14285714285714285,1,0.0,0,0,0,0,0,0,0,1,0,0,1,1
9803,139798,zf6I9KCPDTFVvRzyp9MXEc3K2I0azEBn,3VkHkmOtom3jM2wCu94xgzzu1d6Dn7or,1,0,0,0,0,0,2,0,2,0.2857142857142857,1,0.0,0,0,0,0,0,0,0,2,0,0,2,1
9804,139830,L1uEqjh9bbx3ogOtGkLvKNeCjzBYq8Tq,3VkHkmOtom3jM2wCu94xgzzu1d6Dn7or,20,64,17,26,0,21,6,0,134,19.142857142857142,4,0.0,42,17,25,0,22,21,1,6,0,84,50,1
9805,139922,fdtlxfecJaTaUhFaVnkgbPVAFcCJCGg3,3VkHkmOtom3jM2wCu94xgzzu1d6Dn7or,13,29,7,10,10,10,4,0,70,10.0,2,0.0,17,7,8,10,12,10,2,4,0,42,28,1
9806,139931,GNebghHXijuzxEsXtntIHVMx6jOB2h7A,3VkHkmOtom3jM2wCu94xgzzu1d6Dn7or,1,0,0,0,0,0,1,0,1,0.14285714285714285,1,0.0,0,0,0,0,0,0,0,1,0,0,1,1
9807,139933,CtmnSkOsrY9YY7Ca6ml9l0vbxEV8uB6o,3VkHkmOtom3jM2wCu94xgzzu1d6Dn7or,9,11,4,2,4,5,8,0,34,4.857142857142857,2,0.0,5,4,2,4,6,5,0,8,0,15,19,1
9808,140009,ddEC3CsG89EhQvHi1ngbvid0LNFnS4V6,3VkHkmOtom3jM2wCu94xgzzu1d6Dn7or,1,0,0,0,0,0,1,0,1,0.14285714285714285,1,0.0,0,0,0,0,0,0,0,1,0,0,1,1
9809,140016,eQCN30DKWc08tkJSA1YTQyesUPW0sBxe,3VkHkmOtom3jM2wCu94xgzzu1d6Dn7or,5,2,1,0,1,1,2,0,7,1.0,1,0.0,0,1,0,1,2,1,0,2,0,2,5,1
9810,140065,dFl7W8v50SymmEmQgkm3ydIWaA60KgIR,5X6FeZozNMgE2VRi3MJYjkkFK8SETtu2,6,3,2,0,2,0,1,0,8,1.1428571428571428,1,0.0,0,2,0,2,3,0,0,1,0,4,4,0
9811,140092,Kj9Et9zogxYDw98nFXPSMQhkkCBlhXs5,7GRhBDsirIGkRZBtSMEzNTyDr2JQm4xx,2,0,0,0,0,0,3,0,3,0.42857142857142855,2,0.0,0,0,0,0,0,0,0,3,0,0,3,1
9812,140100,okqN4nBVKRYYrkYonKicKGOmPqVGYjZh,5X6FeZozNMgE2VRi3MJYjkkFK8SETtu2,25,94,24,0,8,0,31,0,157,22.428571428571427,5,0.0,29,24,0,8,65,0,0,31,0,61,96,0
9813,140185,FC4TBMak6GE4IpwU5zXd14C2OrRKgJpt,5X6FeZozNMgE2VRi3MJYjkkFK8SETtu2,9,8,3,0,1,1,8,1,22,3.142857142857143,1,0.0,0,3,0,1,8,1,0,8,1,4,18,1
9814,140220,D0DS3PcqkWtMhWmrWYDI3H9xnPeFgKco,7GRhBDsirIGkRZBtSMEzNTyDr2JQm4xx,6,8,3,0,0,0,4,0,15,2.142857142857143,2,0.0,2,3,0,0,6,0,0,4,0,5,10,1
9815,140241,Un3EzEE4Sz8i5Z84q9e50URbIAEkkVSB,7GRhBDsirIGkRZBtSMEzNTyDr2JQm4xx,2,0,0,0,0,0,3,0,3,0.42857142857142855,1,0.0,0,0,0,0,0,0,0,3,0,0,3,1
9816,140242,jIzMRPWbR6wQjHcSJahgc6djKC15z8AV,5X6FeZozNMgE2VRi3MJYjkkFK8SETtu2,2,0,0,0,0,0,2,0,2,0.2857142857142857,1,0.0,0,0,0,0,0,0,0,2,0,0,2,0
9817,140247,R9YTqKiRQtfCswOmsq4jluMVxY0uToJG,7GRhBDsirIGkRZBtSMEzNTyDr2JQm4xx,53,63,31,43,12,4,17,2,172,24.571428571428573,4,0.0,29,31,36,12,34,4,7,17,2,108,64,0
9818,140274,fb2hdXt8pnk8ljm4Tpi5PWJyJ7R8YxLU,7GRhBDsirIGkRZBtSMEzNTyDr2JQm4xx,34,44,4,0,3,1,7,0,59,8.428571428571429,2,0.0,5,4,0,3,39,1,0,7,0,12,47,1
9819,140283,HePRyod5aTSIcFeoVudB8huyR12d5o5i,5X6FeZozNMgE2VRi3MJYjkkFK8SETtu2,5,3,1,0,1,0,2,0,7,1.0,1,0.0,1,1,0,1,2,0,0,2,0,3,4,1
9820,140288,MdVSD7oG0mERo7XaQwvRtC5hdVN6DJiQ,7GRhBDsirIGkRZBtSMEzNTyDr2JQm4xx,11,9,1,0,3,0,2,0,15,2.142857142857143,1,0.0,3,1,0,3,6,0,0,2,0,7,8,0
9821,140333,bqWpav7ocOhCfb3xc4QgAvBDK5g8BmiZ,7GRhBDsirIGkRZBtSMEzNTyDr2JQm4xx,52,77,33,45,25,0,13,0,193,27.571428571428573,7,0.0,32,33,39,25,45,0,6,13,0,129,64,1
9822,140338,vixag6bpwzwtdrSKIAHFpP8XohE3IVGO,7GRhBDsirIGkRZBtSMEzNTyDr2JQm4xx,70,137,49,173,25,58,28,0,470,67.14285714285714,6,0.0,41,49,145,25,96,58,28,28,0,260,210,0
9823,140347,aHSKyCYZ3S78IWGt7i6sBG1NSuBlIQiC,5X6FeZozNMgE2VRi3MJYjkkFK8SETtu2,2,0,0,0,0,0,3,0,3,0.42857142857142855,1,0.0,0,0,0,0,0,0,0,3,0,0,3,1
9824,140362,DpqUZKEZpIFvZzvEXk8oaJMRAbEfypNN,7GRhBDsirIGkRZBtSMEzNTyDr2JQm4xx,18,11,8,0,9,0,8,0,36,5.142857142857143,3,0.0,3,8,0,9,8,0,0,8,0,20,16,1
9825,140367,8mYK8nQ83ZErmFKnq8H8JUuesjrFIgSa,3VkHkmOtom3jM2wCu94xgzzu1d6Dn7or,83,126,56,68,41,37,53,6,387,55.285714285714285,11,0.0,42,56,58,41,84,37,10,53,6,197,190,0
9826,140372,2MeGOniySv4rbriRNtvstDvzzbUBuokH,3VkHkmOtom3jM2wCu94xgzzu1d6Dn7or,1,0,0,0,0,0,1,0,1,0.14285714285714285,1,0.0,0,0,0,0,0,0,0,1,0,0,1,0
9827,140383,X9p0TKSy4D9xN7rqEbdDvtJVgVqlCcpo,3VkHkmOtom3jM2wCu94xgzzu1d6Dn7or,1,0,0,0,0,0,1,0,1,0.14285714285714285,1,0.0,0,0,0,0,0,0,0,1,0,0,1,1
9828,140386,QBY91TeHUAzVGyJB2ZPPWccvYj8dHE9S,3VkHkmOtom3jM2wCu94xgzzu1d6Dn7or,1,0,0,0,0,0,1,0,1,0.14285714285714285,1,0.0,0,0,0,0,0,0,0,1,0,0,1,1
9829,140394,AWBtHXao8tWJheBWLlX6I03BGwcgqhr7,3VkHkmOtom3jM2wCu94xgzzu1d6Dn7or,15,15,7,0,4,2,19,0,47,6.714285714285714,2,0.0,3,7,0,4,12,2,0,19,0,14,33,1
9830,140412,W2usuZhdd6NOhI9FEyVJGuapulLbt0Ni,3VkHkmOtom3jM2wCu94xgzzu1d6Dn7or,1,0,0,0,0,0,2,0,2,0.2857142857142857,1,0.0,0,0,0,0,0,0,0,2,0,0,2,1
9831,140426,k0OsMx8Z5O4spyalEaxTLlgaPlQcGseN,3VkHkmOtom3jM2wCu94xgzzu1d6Dn7or,1,0,0,0,0,0,1,0,1,0.14285714285714285,1,0.0,0,0,0,0,0,0,0,1,0,0,1,1
9832,140434,6UoSDV0X1L9MlGVMan41YIDbZTXbLKRe,3VkHkmOtom3jM2wCu94xgzzu1d6Dn7or,8,14,0,0,1,5,9,1,30,4.285714285714286,2,0.0,3,0,0,1,11,5,0,9,1,4,26,1
9833,140440,QfR0jIBNgwDWAlolWFsw2k28xvZm81Li,3VkHkmOtom3jM2wCu94xgzzu1d6Dn7or,6,4,2,0,1,0,4,0,11,1.5714285714285714,2,0.0,0,2,0,1,4,0,0,4,0,3,8,1
9834,140442,M4ZErUfwHYj5OXVgTBrfDNh3oNvQb92M,3VkHkmOtom3jM2wCu94xgzzu1d6Dn7or,18,36,14,29,9,16,23,1,128,18.285714285714285,2,0.0,8,14,27,9,28,16,2,23,1,58,70,1
9835,140444,B7ak2ZV4xi81eSiTWPbE5WxB8UoL19b7,3VkHkmOtom3jM2wCu94xgzzu1d6Dn7or,1,0,0,0,0,0,1,0,1,0.14285714285714285,1,0.0,0,0,0,0,0,0,0,1,0,0,1,1
9836,140461,IOitTfHwo1kXI97YU6fliIcTu2VODhM7,3VkHkmOtom3jM2wCu94xgzzu1d6Dn7or,5,5,1,6,2,7,1,0,22,3.142857142857143,1,0.0,3,1,4,2,2,7,2,1,0,10,12,1
9837,140518,PMkZTQovf4dyR4mK2UbNwrhFIlkDMtO5,7GRhBDsirIGkRZBtSMEzNTyDr2JQm4xx,4,2,1,0,1,0,1,0,5,0.7142857142857143,2,0.0,0,1,0,1,2,0,0,1,0,2,3,1
9838,140526,hMlAqXOYa7gY3ygXTo1yQWN2YN8wqI1H,7GRhBDsirIGkRZBtSMEzNTyDr2JQm4xx,5,1,1,0,1,0,2,0,5,0.7142857142857143,1,0.0,0,1,0,1,1,0,0,2,0,2,3,1
9839,140538,ivQxpA3T4qXcNV0IuvLDkzJLb00vpKY1,7GRhBDsirIGkRZBtSMEzNTyDr2JQm4xx,6,6,5,0,5,0,1,0,17,2.4285714285714284,1,0.0,0,5,0,5,6,0,0,1,0,10,7,1
9840,140555,TfgVRC9skFsGu3qq14caEQmfjmrp7rot,7GRhBDsirIGkRZBtSMEzNTyDr2JQm4xx,4,2,0,0,0,0,3,0,5,0.7142857142857143,2,0.0,0,0,0,0,2,0,0,3,0,0,5,1
9841,140564,ZIMCP6WBWK3qXQfNStRYM5gxyC5A3FHs,7GRhBDsirIGkRZBtSMEzNTyDr2JQm4xx,6,6,2,0,2,0,1,0,11,1.5714285714285714,1,0.0,0,2,0,2,6,0,0,1,0,4,7,1
9842,140567,GcUfN5HIs7MIOMCOSkKXJjHKO0aQwdDB,7GRhBDsirIGkRZBtSMEzNTyDr2JQm4xx,1,0,0,0,0,0,1,0,1,0.14285714285714285,1,0.0,0,0,0,0,0,0,0,1,0,0,1,1
9843,140571,PQkWevD3d0oRYo5mywsIaSsfEsqdcqoj,7GRhBDsirIGkRZBtSMEzNTyDr2JQm4xx,6,2,1,0,1,0,4,0,8,1.1428571428571428,2,0.0,0,1,0,1,2,0,0,4,0,2,6,1
9844,140586,H7wQq68VgsnXYKOgXKXD2z0yXvbrWDzD,7GRhBDsirIGkRZBtSMEzNTyDr2JQm4xx,4,1,0,0,0,0,5,0,6,0.8571428571428571,2,0.0,0,0,0,0,1,0,0,5,0,0,6,1
9845,140606,RthO8kTkOrnZ3vUDn574hHyfG3vroBt1,7GRhBDsirIGkRZBtSMEzNTyDr2JQm4xx,10,17,10,0,4,0,10,0,41,5.857142857142857,2,0.0,2,10,0,4,15,0,0,10,0,16,25,0
9846,140625,4f8jLRXqSCdB2uiZvxNaCELloSkIP9xi,7GRhBDsirIGkRZBtSMEzNTyDr2JQm4xx,26,24,12,10,11,2,7,0,66,9.428571428571429,2,0.0,11,12,5,11,13,2,5,7,0,39,27,1
9847,140631,ah26WailHR7EV3M12BWTgtjGcr75lRFT,7GRhBDsirIGkRZBtSMEzNTyDr2JQm4xx,45,88,20,139,10,4,5,0,266,38.0,4,0.0,42,20,121,10,46,4,18,5,0,193,73,1
9848,140632,ZgIRqTHKDbnMlUiyoVebquxs1Y8vzQoE,7GRhBDsirIGkRZBtSMEzNTyDr2JQm4xx,1,0,0,0,0,0,2,0,2,0.2857142857142857,1,0.0,0,0,0,0,0,0,0,2,0,0,2,1
9849,140640,WpH6LiZngGAOmL0pzdoYGfKbqcUQKXCx,7GRhBDsirIGkRZBtSMEzNTyDr2JQm4xx,1,0,0,0,0,0,1,0,1,0.14285714285714285,1,0.0,0,0,0,0,0,0,0,1,0,0,1,0
9850,140642,ykhGFpMDsllOl7GPw7P0ZWB0y2EKSHqD,7GRhBDsirIGkRZBtSMEzNTyDr2JQm4xx,2,0,0,0,0,0,6,0,6,0.8571428571428571,1,0.0,0,0,0,0,0,0,0,6,0,0,6,1
9851,140649,S8e3GdQkqIUsS8mmPO18XdoLgfzz9lmN,7GRhBDsirIGkRZBtSMEzNTyDr2JQm4xx,5,2,1,0,1,0,4,0,8,1.1428571428571428,1,0.0,0,1,0,1,2,0,0,4,0,2,6,1
9852,140666,DB1URyLII1znnmxnZlmmkOEalzIpmvtZ,7GRhBDsirIGkRZBtSMEzNTyDr2JQm4xx,2,0,0,0,0,0,2,0,2,0.2857142857142857,1,0.0,0,0,0,0,0,0,0,2,0,0,2,1
9853,140693,EurC1doc3uihnMqzQDbAhuG6797G4iw2,7GRhBDsirIGkRZBtSMEzNTyDr2JQm4xx,5,6,1,0,0,0,2,0,9,1.2857142857142858,1,0.0,0,1,0,0,6,0,0,2,0,1,8,1
9854,140704,th4zdTX2AjmI63dQaTjbmtQmRHWeQKT8,7GRhBDsirIGkRZBtSMEzNTyDr2JQm4xx,2,0,0,0,0,0,2,0,2,0.2857142857142857,1,0.0,0,0,0,0,0,0,0,2,0,0,2,1
9855,140708,loyRVr8UBWCy5Avm2TXeF6yiTZHXsnTV,7GRhBDsirIGkRZBtSMEzNTyDr2JQm4xx,1,0,0,0,0,0,1,0,1,0.14285714285714285,1,0.0,0,0,0,0,0,0,0,1,0,0,1,1
9856,140709,98UEGByxiN7tned6NDQeKfQDq4HCSGvQ,7GRhBDsirIGkRZBtSMEzNTyDr2JQm4xx,6,5,2,0,2,0,5,0,14,2.0,2,0.0,0,2,0,2,5,0,0,5,0,4,10,1
9857,142587,DvIU0dGgUjhf9phNubhYOgC3dPrxcm0S,5Gyp41oLVo7Gg7vF4vpmggWP5MU70QO6,1,0,0,0,0,0,1,0,1,0.14285714285714285,1,0.0,0,0,0,0,0,0,0,1,0,0,1,1
9858,142589,l750mduiFiLPfRSsAl255O3mIZA6Ifby,5Gyp41oLVo7Gg7vF4vpmggWP5MU70QO6,7,3,2,0,2,0,2,0,9,1.2857142857142858,1,0.0,0,2,0,2,3,0,0,2,0,4,5,1
9859,142594,CYkbKNZ2lTPrZiFK1E4i1CflG2OM8gXX,5Gyp41oLVo7Gg7vF4vpmggWP5MU70QO6,7,3,2,0,2,0,3,0,10,1.4285714285714286,2,0.0,0,2,0,2,3,0,0,3,0,4,6,1
9860,142602,2Vqke266H027IIATfc2Fz8akv1wFvzRY,5Gyp41oLVo7Gg7vF4vpmggWP5MU70QO6,14,15,11,0,6,0,5,0,37,5.285714285714286,2,0.0,0,11,0,6,15,0,0,5,0,17,20,1
9861,142611,vrIS3rOFH8II8t7yTEWKp29B27kjVKhm,5Gyp41oLVo7Gg7vF4vpmggWP5MU70QO6,5,2,1,0,1,15,2,0,21,3.0,1,0.0,0,1,0,1,2,15,0,2,0,2,19,1
9862,142613,EC764qsGUcXuJJOqh2Cai0xBRNCMY6Db,5Gyp41oLVo7Gg7vF4vpmggWP5MU70QO6,10,10,6,3,3,0,4,0,26,3.7142857142857144,2,0.0,1,6,2,3,9,0,1,4,0,12,14,0
9863,142614,4G31JkuuWxQoMwYLKWmTZsOhrqR0raRg,5Gyp41oLVo7Gg7vF4vpmggWP5MU70QO6,10,8,6,0,4,0,8,0,26,3.7142857142857144,3,0.0,1,6,0,4,7,0,0,8,0,11,15,1
9864,142615,muFfPUIUTXBK2cEaqzvOvCev9GDghb1a,5Gyp41oLVo7Gg7vF4vpmggWP5MU70QO6,2,0,0,0,0,0,2,0,2,0.2857142857142857,1,0.0,0,0,0,0,0,0,0,2,0,0,2,1
9865,142622,hne1Z7uPNxHKtOSgT2rxpmt4dGtlsF3d,5Gyp41oLVo7Gg7vF4vpmggWP5MU70QO6,9,13,5,0,2,0,7,0,27,3.857142857142857,3,0.0,0,5,0,2,13,0,0,7,0,7,20,1
9866,142629,fNSiZi73xL4M2bPW8ibFW938cSZEdX30,5Gyp41oLVo7Gg7vF4vpmggWP5MU70QO6,21,33,11,18,10,9,13,1,95,13.571428571428571,2,0.0,20,11,14,10,13,9,4,13,1,55,40,1
9867,142630,tTC605LBGlqqGzWy1b2L3n60FKitrcCL,5Gyp41oLVo7Gg7vF4vpmggWP5MU70QO6,9,15,6,6,1,6,4,0,38,5.428571428571429,1,0.0,8,6,4,1,7,6,2,4,0,19,19,1
9868,142632,cX5D1rnP35ppe9dQPHhDf3VIzo5UxdFJ,5Gyp41oLVo7Gg7vF4vpmggWP5MU70QO6,9,3,1,0,2,8,5,1,20,2.857142857142857,1,0.0,0,1,0,2,3,8,0,5,1,3,17,0
9869,142637,CgsguvEs0KUN3Abw9Qjh5ZZT0chwXUSw,5Gyp41oLVo7Gg7vF4vpmggWP5MU70QO6,17,31,16,15,7,3,8,1,81,11.571428571428571,4,0.0,6,16,11,7,25,3,4,8,1,40,41,1
9870,142639,6uHUgcd0luimAyfwarvpGHSZOL8ry9Vt,5Gyp41oLVo7Gg7vF4vpmggWP5MU70QO6,6,2,1,0,1,4,3,0,11,1.5714285714285714,1,0.0,0,1,0,1,2,4,0,3,0,2,9,1
9871,142642,ycYxVdTkB3SPaEMcSsJvYXF9LydWvOSZ,5Gyp41oLVo7Gg7vF4vpmggWP5MU70QO6,7,3,2,0,2,0,2,0,9,1.2857142857142858,1,0.0,0,2,0,2,3,0,0,2,0,4,5,1
9872,142643,jE5pZWKJJZZlEfXyHAiktBUQo0d4xaxK,5Gyp41oLVo7Gg7vF4vpmggWP5MU70QO6,6,3,2,0,2,0,1,0,8,1.1428571428571428,1,0.0,0,2,0,2,3,0,0,1,0,4,4,1
9873,142645,G7XmOVqtfJTMn7q51nsv0n7UbKc4e4CM,5Gyp41oLVo7Gg7vF4vpmggWP5MU70QO6,6,3,1,0,1,0,2,0,7,1.0,1,0.0,0,1,0,1,3,0,0,2,0,2,5,1
9874,142648,2we3WxltFBT1dd0FjP3YZ8iHf2xpHEei,5Gyp41oLVo7Gg7vF4vpmggWP5MU70QO6,9,7,3,2,3,5,1,0,21,3.0,1,0.0,2,3,1,3,5,5,1,1,0,9,12,1
9875,142650,AbUJGk67ueUV6YWXpG4Dr2koeNrU2Sk8,5Gyp41oLVo7Gg7vF4vpmggWP5MU70QO6,9,5,3,0,3,0,6,0,17,2.4285714285714284,1,0.0,0,3,0,3,5,0,0,6,0,6,11,0
9876,142654,mFyBIO6GmLHqTEssxzuSwYKXW2BbEyYv,5Gyp41oLVo7Gg7vF4vpmggWP5MU70QO6,24,58,31,11,14,11,17,2,144,20.571428571428573,3,0.0,14,31,8,14,44,11,3,17,2,67,77,1
9877,142661,hiOP3eN8v82uBo9ostiizEL8wqrrZAlw,5Gyp41oLVo7Gg7vF4vpmggWP5MU70QO6,10,12,6,4,2,0,9,0,33,4.714285714285714,4,0.0,1,6,3,2,11,0,1,9,0,12,21,0
9878,142665,aFLYSsMOJD7vuJCmYWrO6tPDVX9VcXzM,5Gyp41oLVo7Gg7vF4vpmggWP5MU70QO6,10,4,4,0,4,0,4,0,16,2.2857142857142856,1,0.0,0,4,0,4,4,0,0,4,0,8,8,1
9879,142671,WkP0QgVAglpv2YQKKTMZ7oETLJdQSz9a,5Gyp41oLVo7Gg7vF4vpmggWP5MU70QO6,11,10,6,0,3,4,6,1,30,4.285714285714286,1,0.0,1,6,0,3,9,4,0,6,1,10,20,1
9880,142675,JjRfXgajKvMZPr7I7oY0ZFbLcw7QrsDQ,5Gyp41oLVo7Gg7vF4vpmggWP5MU70QO6,10,9,2,0,4,0,6,0,21,3.0,3,0.0,0,2,0,4,9,0,0,6,0,6,15,1
9881,142678,B9w98beRRwEepVMm1hNpO2ICgom7vEqz,5Gyp41oLVo7Gg7vF4vpmggWP5MU70QO6,9,4,3,0,3,1,2,0,13,1.8571428571428572,1,0.0,0,3,0,3,4,1,0,2,0,6,7,1
9882,142680,6HbKV4M7xaeeDEow2yyukNC03fVTirBq,5Gyp41oLVo7Gg7vF4vpmggWP5MU70QO6,11,9,5,4,2,0,4,0,24,3.4285714285714284,3,0.0,1,5,2,2,8,0,2,4,0,10,14,0
9883,142683,zbYgISHkDeuR3m4mVajxkvqM3fJPLNns,5Gyp41oLVo7Gg7vF4vpmggWP5MU70QO6,5,1,1,0,1,0,2,0,5,0.7142857142857143,1,0.0,0,1,0,1,1,0,0,2,0,2,3,1
9884,142687,Y5EybULOrY5dAmMMQWE7bK5wg4bsR2Lr,5Gyp41oLVo7Gg7vF4vpmggWP5MU70QO6,5,9,2,0,1,0,1,0,13,1.8571428571428572,1,0.0,1,2,0,1,8,0,0,1,0,4,9,0
9885,142688,1YsWewIFm5PEDWv9Iorbz6WsCa2ShDei,5Gyp41oLVo7Gg7vF4vpmggWP5MU70QO6,8,11,2,1,5,0,1,0,20,2.857142857142857,1,0.0,4,2,1,5,7,0,0,1,0,12,8,1
9886,142690,4Tr4zS1WTYozCucBhtide31lwvTCWT44,5Gyp41oLVo7Gg7vF4vpmggWP5MU70QO6,10,5,4,0,4,0,1,0,14,2.0,1,0.0,0,4,0,4,5,0,0,1,0,8,6,1
9887,142696,pl0spcF4S6FVauXWiyBjvc2XHDeBRL8g,5Gyp41oLVo7Gg7vF4vpmggWP5MU70QO6,2,0,0,0,0,0,2,0,2,0.2857142857142857,1,0.0,0,0,0,0,0,0,0,2,0,0,2,1
9888,142698,CjuSkkkDMjiox2iJcbNK1MsuuNgkIqjP,5Gyp41oLVo7Gg7vF4vpmggWP5MU70QO6,9,4,2,0,3,1,4,0,14,2.0,1,0.0,1,2,0,3,3,1,0,4,0,6,8,1
9889,142708,FYdTGqTHtRATfo802agJiucYRW9Mfn1L,5Gyp41oLVo7Gg7vF4vpmggWP5MU70QO6,5,1,0,0,0,1,4,1,7,1.0,1,0.0,0,0,0,0,1,1,0,4,1,0,7,1
9890,142711,TA5wGtPfX5pEtgy8pd6XjVDtVvbBFXJS,5Gyp41oLVo7Gg7vF4vpmggWP5MU70QO6,3,1,0,0,0,0,2,0,3,0.42857142857142855,1,0.0,0,0,0,0,1,0,0,2,0,0,3,1
9891,142714,4X3QJBWqjjzt1tnJuinj3TQdGHwFyiAK,5Gyp41oLVo7Gg7vF4vpmggWP5MU70QO6,8,10,5,0,1,9,14,0,39,5.571428571428571,2,0.0,0,5,0,1,10,9,0,14,0,6,33,1
9892,142716,uXRfDeihF0hkAkJm7sgGsGBDRqSDq177,5Gyp41oLVo7Gg7vF4vpmggWP5MU70QO6,17,22,12,9,3,4,8,1,59,8.428571428571429,2,0.0,3,12,6,3,19,4,3,8,1,24,35,1
9893,142720,H5g9tdQ8zdQuC8mE8S1kStQ5QeJRaiem,5Gyp41oLVo7Gg7vF4vpmggWP5MU70QO6,6,3,2,0,2,0,1,0,8,1.1428571428571428,1,0.0,0,2,0,2,3,0,0,1,0,4,4,1
9894,142725,VxTZo8wWibkIng7J8YPkqWh1rsEKvqTC,5Gyp41oLVo7Gg7vF4vpmggWP5MU70QO6,5,0,0,0,0,1,4,0,5,0.7142857142857143,1,0.0,0,0,0,0,0,1,0,4,0,0,5,1
9895,142726,NMrufuUkT7urywi2vIs65HiLUq0GodvJ,5Gyp41oLVo7Gg7vF4vpmggWP5MU70QO6,4,2,1,0,1,0,1,0,5,0.7142857142857143,1,0.0,0,1,0,1,2,0,0,1,0,2,3,1
9896,142743,oy7vCCTKK5fna0ybbPQX7ynHsvxgRuDK,5Gyp41oLVo7Gg7vF4vpmggWP5MU70QO6,6,3,1,0,0,1,6,1,12,1.7142857142857142,1,0.0,0,1,0,0,3,1,0,6,1,1,11,1
9897,142756,Pai5xZZogwpbc7doQ2htBCn8nqi1CTjY,5Gyp41oLVo7Gg7vF4vpmggWP5MU70QO6,7,5,0,0,2,0,3,0,10,1.4285714285714286,2,0.0,0,0,0,2,5,0,0,3,0,2,8,1
9898,142761,R4qKMABYuzGzDkYeHszjB6pRZL9tl5ny,5Gyp41oLVo7Gg7vF4vpmggWP5MU70QO6,7,3,2,0,2,0,2,0,9,1.2857142857142858,1,0.0,0,2,0,2,3,0,0,2,0,4,5,1
9899,142775,rgfuJRvILCyoZ3ACpGqTeELGaXbZOX9A,5Gyp41oLVo7Gg7vF4vpmggWP5MU70QO6,8,6,2,0,1,1,5,1,16,2.2857142857142856,2,0.0,1,2,0,1,5,1,0,5,1,4,12,1
9900,142776,reBeUISe7rc1WY8sQ6udqDmHIOz0Z3w1,5Gyp41oLVo7Gg7vF4vpmggWP5MU70QO6,7,7,4,0,0,0,5,0,16,2.2857142857142856,2,0.0,0,4,0,0,7,0,0,5,0,4,12,1
9901,142777,jaeRBfNSkyTpFxAZieHe5vTAkzlHFDmm,5Gyp41oLVo7Gg7vF4vpmggWP5MU70QO6,8,13,1,3,1,0,1,0,19,2.7142857142857144,1,0.0,5,1,2,1,8,0,1,1,0,9,10,1
9902,142781,7rMi9CYErKLdcmN52YXqLfN4IUEFfzqp,5Gyp41oLVo7Gg7vF4vpmggWP5MU70QO6,31,87,52,18,17,4,19,0,197,28.142857142857142,6,0.0,11,52,13,17,76,4,5,19,0,93,104,1
9903,142789,YvOc6FqXZMoL0NWYKBDQjwnxonb9FCcf,5Gyp41oLVo7Gg7vF4vpmggWP5MU70QO6,13,9,4,7,3,0,10,0,33,4.714285714285714,1,0.0,4,4,6,3,5,0,1,10,0,17,16,1
9904,142796,UGYGSfRkJhOkgkdlCI6YSCshpNvwBF31,5Gyp41oLVo7Gg7vF4vpmggWP5MU70QO6,6,4,3,0,1,0,4,0,12,1.7142857142857142,2,0.0,0,3,0,1,4,0,0,4,0,4,8,1
9905,142797,rxcoIfkD9VVmXpA0UtXShDFNu2PSOtTk,5Gyp41oLVo7Gg7vF4vpmggWP5MU70QO6,8,13,8,0,0,0,2,0,23,3.2857142857142856,2,0.0,3,8,0,0,10,0,0,2,0,11,12,1
9906,142799,HhtKltqRVKGPT0pzckxFN7OMUH29mJzZ,5Gyp41oLVo7Gg7vF4vpmggWP5MU70QO6,30,50,30,7,11,30,22,2,152,21.714285714285715,7,0.0,8,30,6,11,42,30,1,22,2,55,97,1
9907,142810,3iJrlZJEv2h7DgWBpz6wZtSXPXEy6IAY,5Gyp41oLVo7Gg7vF4vpmggWP5MU70QO6,18,20,9,10,6,0,3,0,48,6.857142857142857,3,0.0,4,9,8,6,16,0,2,3,0,27,21,1
9908,142823,dfEblZOFiIiaFeZyXpOIUKoMmCK8J7HL,5Gyp41oLVo7Gg7vF4vpmggWP5MU70QO6,8,8,6,0,5,0,4,0,23,3.2857142857142856,2,0.0,0,6,0,5,8,0,0,4,0,11,12,1
9909,142825,bgNkqNGrx7FitOdXoRt9UTv855kAW6gY,5Gyp41oLVo7Gg7vF4vpmggWP5MU70QO6,6,16,8,0,1,0,3,0,28,4.0,2,0.0,5,8,0,1,11,0,0,3,0,14,14,1
9910,142843,EGp6xRzNCnsCPDRg0mfvtfy8t2jZt4I9,5Gyp41oLVo7Gg7vF4vpmggWP5MU70QO6,7,2,2,0,2,0,2,0,8,1.1428571428571428,1,0.0,0,2,0,2,2,0,0,2,0,4,4,1
9911,142846,IdijTNmoKxS8ApF0ePQZeGoS4kBBjX5q,5Gyp41oLVo7Gg7vF4vpmggWP5MU70QO6,5,2,0,0,1,0,4,0,7,1.0,2,0.0,0,0,0,1,2,0,0,4,0,1,6,1
9912,142852,yf1aB46OA5i79BZV0LoP2pzfryVAMP40,5Gyp41oLVo7Gg7vF4vpmggWP5MU70QO6,15,24,9,12,5,12,8,1,71,10.142857142857142,1,0.0,7,9,9,5,17,12,3,8,1,30,41,1
9913,142857,JZBebi62a9RwiiOIt21SU1RBcvnza8RC,5Gyp41oLVo7Gg7vF4vpmggWP5MU70QO6,10,8,2,0,6,10,6,1,33,4.714285714285714,1,0.0,5,2,0,6,3,10,0,6,1,13,20,1
9914,142862,qEcUTYcalHCp49zQzZTHlJUj8t0KbQ92,5Gyp41oLVo7Gg7vF4vpmggWP5MU70QO6,8,11,3,12,1,0,6,0,33,4.714285714285714,1,0.0,8,3,7,1,3,0,5,6,0,19,14,1
9915,142863,17x2siC1tkQccDH5KO5mYK5I39ctZkuT,5Gyp41oLVo7Gg7vF4vpmggWP5MU70QO6,21,37,19,25,6,24,16,5,132,18.857142857142858,3,0.0,9,19,22,6,28,24,3,16,5,56,76,1
9916,142869,2IPy33epg4zq9YB4p13d1uH5WhrVK1hq,5Gyp41oLVo7Gg7vF4vpmggWP5MU70QO6,7,3,1,0,1,0,10,0,15,2.142857142857143,1,0.0,0,1,0,1,3,0,0,10,0,2,13,1
9917,142877,ejkcEmPsQaezsRVIpePgfD352Pc6uBAG,5Gyp41oLVo7Gg7vF4vpmggWP5MU70QO6,5,6,4,0,3,0,1,0,14,2.0,1,0.0,0,4,0,3,6,0,0,1,0,7,7,1
9918,142889,Z35TrSi7rwWFfkDazbEG4KvEH4YsLfS1,5Gyp41oLVo7Gg7vF4vpmggWP5MU70QO6,8,5,0,0,0,1,8,1,15,2.142857142857143,2,0.0,0,0,0,0,5,1,0,8,1,0,15,1
9919,142891,QiYTai3Y8W2gCapn7xLJdAzRDbxFfQca,5Gyp41oLVo7Gg7vF4vpmggWP5MU70QO6,9,5,3,2,1,0,4,0,15,2.142857142857143,1,0.0,1,3,1,1,4,0,1,4,0,6,9,1
9920,142898,RvcFqQHE1iJoF2RYg2gswnnM7mWagdpD,5Gyp41oLVo7Gg7vF4vpmggWP5MU70QO6,6,2,1,0,0,0,5,1,9,1.2857142857142858,1,0.0,1,1,0,0,1,0,0,5,1,2,7,1
9921,142901,OCvsImL93NRBONEN4tEiveIXUcVgu9yf,5Gyp41oLVo7Gg7vF4vpmggWP5MU70QO6,10,13,7,0,3,1,3,0,27,3.857142857142857,1,0.0,3,7,0,3,10,1,0,3,0,13,14,1
9922,142907,C16JYq0aDivmltqQa9Vqq9AdrdmyaECj,5Gyp41oLVo7Gg7vF4vpmggWP5MU70QO6,17,25,19,0,6,0,6,0,56,8.0,4,0.0,1,19,0,6,24,0,0,6,0,26,30,1
9923,142910,qfT7qYjjtHpH8xzKPZCww7GR87XA6mUH,5Gyp41oLVo7Gg7vF4vpmggWP5MU70QO6,5,2,1,0,1,0,2,0,6,0.8571428571428571,1,0.0,0,1,0,1,2,0,0,2,0,2,4,1
9924,142911,o9LhepAr6TkNIwClYXTvyGmD8wbvv9UD,5Gyp41oLVo7Gg7vF4vpmggWP5MU70QO6,12,14,7,0,3,4,8,2,38,5.428571428571429,1,0.0,3,7,0,3,11,4,0,8,2,13,25,1
9925,142922,JBXB6u6rdJ6u5Tg7LFBEhBjKSXKrDwPA,5Gyp41oLVo7Gg7vF4vpmggWP5MU70QO6,16,19,8,0,5,0,9,0,41,5.857142857142857,1,0.0,3,8,0,5,16,0,0,9,0,16,25,1
9926,142925,1DRhd5bBJuCd8ewdbmKKPmk22SDsnmZW,5Gyp41oLVo7Gg7vF4vpmggWP5MU70QO6,7,4,1,0,2,0,1,0,8,1.1428571428571428,1,0.0,0,1,0,2,4,0,0,1,0,3,5,1
9927,142937,gDo9M8HDbXmLQPxqqLTsn9N4ZUEPKvcn,5Gyp41oLVo7Gg7vF4vpmggWP5MU70QO6,8,6,4,0,1,0,2,0,13,1.8571428571428572,1,0.0,0,4,0,1,6,0,0,2,0,5,8,1
9928,142939,dmhkL35doRyRiXlb3XuDnJlpO05GLvg1,5Gyp41oLVo7Gg7vF4vpmggWP5MU70QO6,10,11,5,0,2,16,5,1,40,5.714285714285714,2,0.0,0,5,0,2,11,16,0,5,1,7,33,1
9929,142946,LSVa2jpU1dF8RnC5rzovm0tv2cSNIe8I,5Gyp41oLVo7Gg7vF4vpmggWP5MU70QO6,19,37,16,12,13,6,8,0,92,13.142857142857142,6,0.0,12,16,8,13,25,6,4,8,0,49,43,1
9930,142947,fle9OCfJL8TB5Ku46DhwngiGCvONNuEB,5Gyp41oLVo7Gg7vF4vpmggWP5MU70QO6,9,4,3,0,2,3,8,1,21,3.0,1,0.0,0,3,0,2,4,3,0,8,1,5,16,0
9931,142953,zuXPyOSeqv1Z9F86jQYRYxtPwfD1AoB3,5Gyp41oLVo7Gg7vF4vpmggWP5MU70QO6,5,4,3,0,2,0,1,0,10,1.4285714285714286,1,0.0,0,3,0,2,4,0,0,1,0,5,5,1
9932,142954,wqZdpQJ56pEKlaEZk0l8Q59mHuC7Ccfq,5Gyp41oLVo7Gg7vF4vpmggWP5MU70QO6,5,2,1,0,1,0,2,0,6,0.8571428571428571,1,0.0,0,1,0,1,2,0,0,2,0,2,4,1
9933,142955,LDoffeIzXBaEA3EoYd9Gp4Kl36LUuUJD,5Gyp41oLVo7Gg7vF4vpmggWP5MU70QO6,10,10,4,0,5,34,4,0,57,8.142857142857142,2,0.0,4,4,0,5,6,34,0,4,0,13,44,1
9934,142957,jT3pQSQPEBO5JBmeZgy8wpm0tZwiqHoI,5Gyp41oLVo7Gg7vF4vpmggWP5MU70QO6,6,2,1,0,1,0,5,0,9,1.2857142857142858,1,0.0,0,1,0,1,2,0,0,5,0,2,7,1
9935,142958,nWULEtY8mVT47elDfeZ33BhWjPFG2zXc,5Gyp41oLVo7Gg7vF4vpmggWP5MU70QO6,3,2,1,0,1,0,1,0,5,0.7142857142857143,1,0.0,0,1,0,1,2,0,0,1,0,2,3,1
9936,142962,fqjLnH3OTCihOU2gsb0OSNI1dFNVFkLM,5Gyp41oLVo7Gg7vF4vpmggWP5MU70QO6,9,13,1,0,1,9,3,0,27,3.857142857142857,2,0.0,0,1,0,1,13,9,0,3,0,2,25,1
9937,142965,wT2PCRFj23I7HDSSujNYjrYVx91GnsP3,5Gyp41oLVo7Gg7vF4vpmggWP5MU70QO6,1,0,0,0,0,0,1,0,1,0.14285714285714285,1,0.0,0,0,0,0,0,0,0,1,0,0,1,1
9938,142980,RbZEMS9VWFPa6Bw1eRa7DiuQ7kaKXjbF,5Gyp41oLVo7Gg7vF4vpmggWP5MU70QO6,5,4,2,5,0,0,1,0,12,1.7142857142857142,1,0.0,1,2,3,0,3,0,2,1,0,6,6,1
9939,142982,6WpUAvOn0104PVGU1qRupfdkikcVBl8O,5Gyp41oLVo7Gg7vF4vpmggWP5MU70QO6,6,6,2,0,1,0,2,0,11,1.5714285714285714,2,0.0,0,2,0,1,6,0,0,2,0,3,8,1
9940,142990,qvudCQW0qHQG0Qx7qWFtGoa7VWdIdmMz,5Gyp41oLVo7Gg7vF4vpmggWP5MU70QO6,12,16,6,4,3,0,4,0,33,4.714285714285714,2,0.0,2,6,3,3,14,0,1,4,0,14,19,1
9941,142995,4iCRMipwhTH06x1GiLZhC3aMUrEBiM5f,5Gyp41oLVo7Gg7vF4vpmggWP5MU70QO6,37,83,43,17,22,16,8,4,193,27.571428571428573,4,0.0,22,43,10,22,61,16,7,8,4,97,96,1
9942,142996,UMhqMBvNkRDXsJUWPwy4GcSQoSlGBO8t,5Gyp41oLVo7Gg7vF4vpmggWP5MU70QO6,19,37,17,14,6,0,9,0,83,11.857142857142858,3,0.0,10,17,10,6,27,0,4,9,0,43,40,1
9943,143000,UdESPSKgOrFyrYiZnI6WrGuVOhvRCwfS,5Gyp41oLVo7Gg7vF4vpmggWP5MU70QO6,15,12,7,2,6,1,4,0,32,4.571428571428571,1,0.0,2,7,1,6,10,1,1,4,0,16,16,1
9944,143013,jNFKLQDyusbF96R2XSxlZgGNyApuMVRT,5Gyp41oLVo7Gg7vF4vpmggWP5MU70QO6,9,4,2,0,2,0,4,0,12,1.7142857142857142,1,0.0,0,2,0,2,4,0,0,4,0,4,8,1
9945,143021,RMXdjy8Gra28DdVIoJYm0uLHHHz1ev3p,5Gyp41oLVo7Gg7vF4vpmggWP5MU70QO6,14,22,16,0,11,2,7,1,59,8.428571428571429,3,0.0,2,16,0,11,20,2,0,7,1,29,30,1
9946,143022,cCyIUKuvSVcuaNngx6IBU0qC1J3zOYfy,5Gyp41oLVo7Gg7vF4vpmggWP5MU70QO6,8,12,7,0,4,0,4,0,27,3.857142857142857,2,0.0,1,7,0,4,11,0,0,4,0,12,15,1
9947,143034,K2b5w6dQdpSuPpCln533WlJldy6cgW3p,5Gyp41oLVo7Gg7vF4vpmggWP5MU70QO6,18,9,7,2,4,0,6,1,29,4.142857142857143,2,0.0,0,7,1,4,9,0,1,6,1,12,17,1
9948,143043,xNbGpoUN6nuEw7SD5AAvKgLFHj0EfbXf,5Gyp41oLVo7Gg7vF4vpmggWP5MU70QO6,14,21,12,0,8,0,4,0,45,6.428571428571429,2,0.0,1,12,0,8,20,0,0,4,0,21,24,1
9949,143045,RpCB5287BqgdwCZkJwlXMkvyUhQODW89,5Gyp41oLVo7Gg7vF4vpmggWP5MU70QO6,1,0,0,0,0,0,1,0,1,0.14285714285714285,1,0.0,0,0,0,0,0,0,0,1,0,0,1,1
9950,143049,Pvv8yLPqgWNPXuVDQBtF0VAALIaMvqpu,5Gyp41oLVo7Gg7vF4vpmggWP5MU70QO6,1,0,0,0,0,0,1,0,1,0.14285714285714285,1,0.0,0,0,0,0,0,0,0,1,0,0,1,1
9951,143065,ldSLMGcwpXJME4390nV36CrMtKAbV74z,5Gyp41oLVo7Gg7vF4vpmggWP5MU70QO6,1,0,0,0,0,0,1,0,1,0.14285714285714285,1,0.0,0,0,0,0,0,0,0,1,0,0,1,1
9952,143068,fvEk8isN63xa8Boq4eAejcJ4CNYAHM9j,5Gyp41oLVo7Gg7vF4vpmggWP5MU70QO6,5,2,1,0,1,0,4,0,8,1.1428571428571428,1,0.0,0,1,0,1,2,0,0,4,0,2,6,1
9953,143076,LFoNU4BRd2Hz4cBJcaK2whvFNx8dsRxE,5Gyp41oLVo7Gg7vF4vpmggWP5MU70QO6,1,0,0,0,0,0,1,0,1,0.14285714285714285,1,0.0,0,0,0,0,0,0,0,1,0,0,1,1
9954,143077,c9KANAprbDpnTKiTdlu4hCvhWcBhVmkA,5Gyp41oLVo7Gg7vF4vpmggWP5MU70QO6,11,26,15,0,4,4,9,0,58,8.285714285714286,3,0.0,3,15,0,4,23,4,0,9,0,22,36,0
9955,143084,VhtnI0jXlmYjp8tocIt6NwYAhqIJcpfm,5Gyp41oLVo7Gg7vF4vpmggWP5MU70QO6,15,23,8,3,5,0,7,0,46,6.571428571428571,3,0.0,4,8,2,5,19,0,1,7,0,19,27,1
9956,143085,VkJtOMLeRLckBlBrcmBivRVG5Gn9VcP1,5Gyp41oLVo7Gg7vF4vpmggWP5MU70QO6,1,0,0,0,0,0,1,0,1,0.14285714285714285,1,0.0,0,0,0,0,0,0,0,1,0,0,1,1
9957,143089,o9EVHnUUU8I3f9dlC8NAcnHlKvZOnRmy,5Gyp41oLVo7Gg7vF4vpmggWP5MU70QO6,14,20,12,10,7,0,3,0,52,7.428571428571429,2,0.0,5,12,7,7,15,0,3,3,0,31,21,1
9958,143092,E6eRsum7azY2VkSoeGLIacPWSM4TI95Q,5Gyp41oLVo7Gg7vF4vpmggWP5MU70QO6,19,26,13,14,5,0,10,0,68,9.714285714285714,3,0.0,6,13,9,5,20,0,5,10,0,33,35,1
9959,143093,sXoPoJ8exd0R4iNQITJ21nyLilxwh5tY,5Gyp41oLVo7Gg7vF4vpmggWP5MU70QO6,13,12,5,15,3,0,7,0,42,6.0,3,0.0,4,5,11,3,8,0,4,7,0,23,19,1
9960,143095,igJ0f51d8a6Y1pQ5uln2duT0dGwsH0ZQ,5Gyp41oLVo7Gg7vF4vpmggWP5MU70QO6,11,13,6,0,5,0,3,0,27,3.857142857142857,2,0.0,5,6,0,5,8,0,0,3,0,16,11,1
9961,143104,6ApSpkhY40OyK6YY681fVCFC3lRd37r1,5Gyp41oLVo7Gg7vF4vpmggWP5MU70QO6,8,9,6,0,3,0,3,0,21,3.0,1,0.0,0,6,0,3,9,0,0,3,0,9,12,1
9962,143108,oNuwXj50Ar10v48RRIHz7AkiO77jEx2Q,5Gyp41oLVo7Gg7vF4vpmggWP5MU70QO6,8,6,3,0,2,0,5,0,16,2.2857142857142856,2,0.0,0,3,0,2,6,0,0,5,0,5,11,1
9963,143112,QKh6yCjm7KCBJwTgcTdbJMWujg3bWjbd,5Gyp41oLVo7Gg7vF4vpmggWP5MU70QO6,9,6,3,0,3,0,2,0,14,2.0,1,0.0,2,3,0,3,4,0,0,2,0,8,6,1
9964,143113,8JzafbS8byU6S2UgAbCtwWuNx4gr3Uhl,5Gyp41oLVo7Gg7vF4vpmggWP5MU70QO6,1,0,0,0,0,0,1,0,1,0.14285714285714285,1,0.0,0,0,0,0,0,0,0,1,0,0,1,1
9965,143115,4XBp4M0LgK0cKGGg2pjRyl6rZazBJm6K,5Gyp41oLVo7Gg7vF4vpmggWP5MU70QO6,3,2,0,0,0,0,1,0,3,0.42857142857142855,1,0.0,0,0,0,0,2,0,0,1,0,0,3,1
9966,143144,LOcIjzEQxkpusXXGGonKeazzQqmnIwRx,5Gyp41oLVo7Gg7vF4vpmggWP5MU70QO6,10,5,3,2,2,0,3,0,15,2.142857142857143,1,0.0,1,3,1,2,4,0,1,3,0,7,8,1
9967,143146,myIIBocNFelldmuN47bMrRiORGKDSj7S,5Gyp41oLVo7Gg7vF4vpmggWP5MU70QO6,21,33,18,24,7,1,11,1,95,13.571428571428571,5,0.0,9,18,22,7,24,1,2,11,1,56,39,0
9968,143147,pWu9eZBUQIsnvUmhD5XkUj4DL7Bo8m7Z,5Gyp41oLVo7Gg7vF4vpmggWP5MU70QO6,4,3,1,0,0,0,2,0,6,0.8571428571428571,2,0.0,0,1,0,0,3,0,0,2,0,1,5,1
9969,143148,Bt0YrpvyveynQfxqkzppqbivsu9tYRaK,5Gyp41oLVo7Gg7vF4vpmggWP5MU70QO6,1,0,0,0,0,0,1,0,1,0.14285714285714285,1,0.0,0,0,0,0,0,0,0,1,0,0,1,1
9970,143151,1tWXAXvyz9HkJmV83xaQq3fwkt1CNz8N,5Gyp41oLVo7Gg7vF4vpmggWP5MU70QO6,10,22,6,0,4,4,1,0,37,5.285714285714286,1,0.0,1,6,0,4,21,4,0,1,0,11,26,1
9971,143153,Go5c9muEuGHgZsLwObwsEKIQQ7mUzKJN,5Gyp41oLVo7Gg7vF4vpmggWP5MU70QO6,6,1,1,0,1,0,6,0,9,1.2857142857142858,1,0.0,0,1,0,1,1,0,0,6,0,2,7,1
9972,143155,AOy0e5xukkmuYjWQEwT6UCwFma8jpz06,5Gyp41oLVo7Gg7vF4vpmggWP5MU70QO6,4,4,1,0,1,0,1,0,7,1.0,1,0.0,0,1,0,1,4,0,0,1,0,2,5,1
9973,143160,OquQs3UlUuQySKKaB7T4hGbXWUMNQkYa,5Gyp41oLVo7Gg7vF4vpmggWP5MU70QO6,8,10,5,0,2,0,3,0,20,2.857142857142857,2,0.0,3,5,0,2,7,0,0,3,0,10,10,0
9974,143161,d1arTSE7SxbfzMjhdxvulgWFF4lWB4zh,5Gyp41oLVo7Gg7vF4vpmggWP5MU70QO6,5,2,1,0,1,0,2,0,6,0.8571428571428571,1,0.0,0,1,0,1,2,0,0,2,0,2,4,1
9975,143175,a0MTJMuyUHaGfgkAuJzZhYf5qRqDKT0G,5Gyp41oLVo7Gg7vF4vpmggWP5MU70QO6,10,5,3,0,1,2,6,1,18,2.5714285714285716,1,0.0,0,3,0,1,5,2,0,6,1,4,14,1
9976,143178,1qt3gH5lpss0VnR5LgXp1AGPTrEn5n0R,5Gyp41oLVo7Gg7vF4vpmggWP5MU70QO6,9,13,5,0,3,0,2,0,23,3.2857142857142856,1,0.0,0,5,0,3,13,0,0,2,0,8,15,1
9977,143185,OJF5d8tnOHv6TW0MMB3m0hQhsywDQQAw,5Gyp41oLVo7Gg7vF4vpmggWP5MU70QO6,3,2,1,0,0,0,1,0,4,0.5714285714285714,1,0.0,0,1,0,0,2,0,0,1,0,1,3,1
9978,143187,n1lmRh67H7bFW6LHVqBupk2D8FZ8NDby,5Gyp41oLVo7Gg7vF4vpmggWP5MU70QO6,13,17,10,9,5,8,3,0,52,7.428571428571429,1,0.0,4,10,6,5,13,8,3,3,0,25,27,1
9979,143196,j5XgrOAxRxENrCOne236prVqUgGjIY7N,5Gyp41oLVo7Gg7vF4vpmggWP5MU70QO6,10,23,13,0,5,0,6,0,47,6.714285714285714,3,0.0,5,13,0,5,18,0,0,6,0,23,24,1
9980,143198,SZ5q3TqDiWq8s23sHXWpsG5po2IH5JPk,5Gyp41oLVo7Gg7vF4vpmggWP5MU70QO6,9,12,1,6,1,0,1,0,21,3.0,2,0.0,2,1,4,1,10,0,2,1,0,8,13,1
9981,143200,xlb5sskrBWH1A6GjruCDDrxPv98p7c4g,5Gyp41oLVo7Gg7vF4vpmggWP5MU70QO6,9,4,3,0,2,0,3,0,12,1.7142857142857142,1,0.0,0,3,0,2,4,0,0,3,0,5,7,0
9982,143205,OMd5hO2BS5MFrbmAdRsf68WrTB16V1vi,5Gyp41oLVo7Gg7vF4vpmggWP5MU70QO6,11,28,7,8,11,25,6,0,85,12.142857142857142,3,0.0,6,7,6,11,22,25,2,6,0,30,55,1
9983,143208,UJPnRke0V5GQ6ioxh0USuF2sqgnLIYfk,5Gyp41oLVo7Gg7vF4vpmggWP5MU70QO6,7,3,2,0,1,12,4,3,25,3.5714285714285716,1,0.0,0,2,0,1,3,12,0,4,3,3,22,0
9984,143212,ZOXeaAo1YvHw7QB0bAA6QJadRJvaQbNE,5Gyp41oLVo7Gg7vF4vpmggWP5MU70QO6,22,40,20,5,14,36,10,1,126,18.0,2,0.0,14,20,3,14,26,36,2,10,1,51,75,1
9985,143219,dmVv4oc5Gy8IXIoX1c6y61vCY7ZjC5c1,5Gyp41oLVo7Gg7vF4vpmggWP5MU70QO6,8,21,6,0,0,0,4,0,31,4.428571428571429,1,0.0,7,6,0,0,14,0,0,4,0,13,18,1
9986,143227,i3TBGmeO4fvkD7YqpnTbNlRmmzyLScBH,5Gyp41oLVo7Gg7vF4vpmggWP5MU70QO6,5,4,3,0,0,0,2,0,9,1.2857142857142858,2,0.0,0,3,0,0,4,0,0,2,0,3,6,1
9987,143231,ZUlbVA3ANro9S1ne8l0m6JXZaMNDct1G,5Gyp41oLVo7Gg7vF4vpmggWP5MU70QO6,17,18,11,2,5,5,7,1,49,7.0,3,0.0,3,11,1,5,15,5,1,7,1,20,29,1
9988,143236,gCqmMW12TEdkpCuR8NZs1i7CPMU8t0Lj,5Gyp41oLVo7Gg7vF4vpmggWP5MU70QO6,1,0,0,0,0,0,1,0,1,0.14285714285714285,1,0.0,0,0,0,0,0,0,0,1,0,0,1,1
9989,143239,D0SRTJhzsGGnKbIKtAcGeOVG46CDAXxq,5Gyp41oLVo7Gg7vF4vpmggWP5MU70QO6,8,3,2,0,1,0,5,2,13,1.8571428571428572,1,0.0,0,2,0,1,3,0,0,5,2,3,10,1
9990,143245,ZGcbANp59jh5HoKYEi3osFbDIegBjaDx,5Gyp41oLVo7Gg7vF4vpmggWP5MU70QO6,1,0,0,0,0,0,1,0,1,0.14285714285714285,1,0.0,0,0,0,0,0,0,0,1,0,0,1,1
9991,143248,e4oqJIZiVVSrj74oA9qv5DL6x1BTE28k,5Gyp41oLVo7Gg7vF4vpmggWP5MU70QO6,17,36,13,0,18,5,9,0,81,11.571428571428571,2,0.0,11,13,0,18,25,5,0,9,0,42,39,1
9992,143250,aRWSlbYUgPWKJQUbaVqnmrHqZwSoAaW3,5Gyp41oLVo7Gg7vF4vpmggWP5MU70QO6,6,3,2,0,2,0,1,0,8,1.1428571428571428,1,0.0,0,2,0,2,3,0,0,1,0,4,4,1
9993,143252,DrIz3kDhvmSkfvrmxLfMPzccvUj4vYMn,5Gyp41oLVo7Gg7vF4vpmggWP5MU70QO6,5,1,1,0,1,0,2,0,5,0.7142857142857143,1,0.0,0,1,0,1,1,0,0,2,0,2,3,1
9994,143257,lBGrhUMcqy7UVFdaYHtWW7GeWS6IrzXi,5Gyp41oLVo7Gg7vF4vpmggWP5MU70QO6,6,10,1,0,0,0,2,0,13,1.8571428571428572,2,0.0,0,1,0,0,10,0,0,2,0,1,12,1
9995,143258,vehysrBoBzTFEiAZ5xY4pv6kepx8vbNH,5Gyp41oLVo7Gg7vF4vpmggWP5MU70QO6,6,3,2,0,2,0,1,0,8,1.1428571428571428,1,0.0,0,2,0,2,3,0,0,1,0,4,4,1
9996,143261,PNuCKnyPWCRVxphTjJ1pIquyKu0dURK7,5Gyp41oLVo7Gg7vF4vpmggWP5MU70QO6,7,7,2,0,3,0,1,0,13,1.8571428571428572,1,0.0,1,2,0,3,6,0,0,1,0,6,7,0
9997,143276,V4maDPP7ymXiWBoKzbNL9NLM8SbZBx64,5Gyp41oLVo7Gg7vF4vpmggWP5MU70QO6,6,2,1,0,1,0,3,0,7,1.0,1,0.0,0,1,0,1,2,0,0,3,0,2,5,1
9998,143277,lAQI1HA75fqdSp0agD1kegPEJvNWyfBy,5Gyp41oLVo7Gg7vF4vpmggWP5MU70QO6,15,16,7,5,7,4,4,0,43,6.142857142857143,2,0.0,5,7,3,7,11,4,2,4,0,22,21,1
9999,143279,hw2WVGzfZRXYWAzq8ZfYfakHEtBKUnie,5Gyp41oLVo7Gg7vF4vpmggWP5MU70QO6,10,4,3,3,2,0,3,0,15,2.142857142857143,2,0.0,1,3,2,2,3,0,1,3,0,8,7,1
10000,143290,E2BWJMlGAXYs00Msi7x11My9Zmuq9iIc,5Gyp41oLVo7Gg7vF4vpmggWP5MU70QO6,5,3,2,0,1,1,2,0,9,1.2857142857142858,1,0.0,0,2,0,1,3,1,0,2,0,3,6,1
10001,143302,Yce7TA6zcxabzTyAHw2EdJ3TEisyjXyi,5Gyp41oLVo7Gg7vF4vpmggWP5MU70QO6,8,11,3,2,1,3,2,0,22,3.142857142857143,1,0.0,5,3,2,1,6,3,0,2,0,11,11,1
10002,143306,vqyeWA2we44qvUIUFbVF8qhKfl0zvOXp,5Gyp41oLVo7Gg7vF4vpmggWP5MU70QO6,20,32,8,12,9,11,8,0,80,11.428571428571429,4,0.0,5,8,8,9,27,11,4,8,0,30,50,1
10003,143309,PnTAr4JQ7W1gITYEASL2GPQdvilj2Kny,5Gyp41oLVo7Gg7vF4vpmggWP5MU70QO6,6,3,2,0,2,0,1,0,8,1.1428571428571428,1,0.0,0,2,0,2,3,0,0,1,0,4,4,1
10004,143311,eKldxRzWRWCchzpFwuIYI37wgxRG6ly7,5Gyp41oLVo7Gg7vF4vpmggWP5MU70QO6,7,2,1,0,1,5,6,1,16,2.2857142857142856,1,0.0,0,1,0,1,2,5,0,6,1,2,14,1
10005,143319,NiiDqxBAdTsDc9DPcwgtqbrrDhEOlyZf,5Gyp41oLVo7Gg7vF4vpmggWP5MU70QO6,19,52,21,16,7,66,13,2,177,25.285714285714285,4,0.0,13,21,11,7,39,66,5,13,2,52,125,1
10006,143325,GXqFtrHuoRowCJYfCGHoX2k0m5Okzhop,5Gyp41oLVo7Gg7vF4vpmggWP5MU70QO6,14,9,0,12,3,7,5,0,36,5.142857142857143,1,0.0,3,0,7,3,6,7,5,5,0,13,23,1
10007,143326,d9pckuRFsv50kgCdQHKJsVIFdRPwkgpJ,5Gyp41oLVo7Gg7vF4vpmggWP5MU70QO6,7,5,3,0,2,0,2,0,12,1.7142857142857142,2,0.0,0,3,0,2,5,0,0,2,0,5,7,1
10008,143334,fRC3oUa2KFV7qXiPwvtscwTM49QCFBch,5Gyp41oLVo7Gg7vF4vpmggWP5MU70QO6,14,12,2,15,4,7,6,0,46,6.571428571428571,1,0.0,5,2,10,4,7,7,5,6,0,21,25,1
10009,143336,HfK03bfo5oHEIPN5TtTteaLYvLuA5TvQ,5Gyp41oLVo7Gg7vF4vpmggWP5MU70QO6,7,3,2,0,2,0,2,0,9,1.2857142857142858,1,0.0,0,2,0,2,3,0,0,2,0,4,5,1
10010,143342,thNUY2LiLdfoa2GF2Lwhr6spnxSoHgtr,5Gyp41oLVo7Gg7vF4vpmggWP5MU70QO6,9,5,2,0,2,7,6,0,22,3.142857142857143,2,0.0,0,2,0,2,5,7,0,6,0,4,18,1
10011,143349,yk7dNPuy2QkmAKDFHBIIPQEIBenZLmlw,5Gyp41oLVo7Gg7vF4vpmggWP5MU70QO6,7,7,2,0,4,0,1,0,14,2.0,1,0.0,2,2,0,4,5,0,0,1,0,8,6,1
10012,143351,T0S9RcfRRq60YsulXc3BYDvg0TOnLWiP,5Gyp41oLVo7Gg7vF4vpmggWP5MU70QO6,12,11,1,4,4,0,5,0,25,3.5714285714285716,3,0.0,4,1,2,4,7,0,2,5,0,11,14,1
10013,143354,mBlZxi6MP72QNzNmrNKi5CEb2ro3f1Wq,5Gyp41oLVo7Gg7vF4vpmggWP5MU70QO6,10,5,3,0,2,12,4,1,27,3.857142857142857,1,0.0,1,3,0,2,4,12,0,4,1,6,21,1
10014,143357,ES5t80qPSBsLdNwO5l4yvxva1043enzC,5Gyp41oLVo7Gg7vF4vpmggWP5MU70QO6,9,13,6,0,3,0,3,0,25,3.5714285714285716,3,0.0,2,6,0,3,11,0,0,3,0,11,14,1
10015,143359,skejDfGuPGYaPthvGkth4r5DzX8PSKgP,5Gyp41oLVo7Gg7vF4vpmggWP5MU70QO6,12,8,6,0,4,0,2,0,20,2.857142857142857,2,0.0,0,6,0,4,8,0,0,2,0,10,10,1
10016,143361,bAqGAqxg5V5Ftv9yeWvf8clZs7uLWIIu,5Gyp41oLVo7Gg7vF4vpmggWP5MU70QO6,12,16,7,8,3,0,5,0,39,5.571428571428571,1,0.0,3,7,6,3,13,0,2,5,0,19,20,1
10017,143363,gV52CTZaoNfCOT1aopCcdjXcqPjdhB8p,5Gyp41oLVo7Gg7vF4vpmggWP5MU70QO6,25,35,18,17,10,1,5,0,86,12.285714285714286,3,0.0,8,18,11,10,27,1,6,5,0,47,39,1
10018,143381,hcfKSKKQtScLfh5Yckcu4qVee0w7aEQG,5Gyp41oLVo7Gg7vF4vpmggWP5MU70QO6,6,4,2,0,1,0,4,0,11,1.5714285714285714,2,0.0,0,2,0,1,4,0,0,4,0,3,8,1
10019,143382,hjTlTldX3nv2rdUD7FZwX9ixWL4HYfi0,5Gyp41oLVo7Gg7vF4vpmggWP5MU70QO6,1,0,0,0,0,0,1,0,1,0.14285714285714285,1,0.0,0,0,0,0,0,0,0,1,0,0,1,1
10020,143394,xrw7VHX9gmfzucjRVukSBMEK0dnlpfLA,5Gyp41oLVo7Gg7vF4vpmggWP5MU70QO6,7,4,3,0,2,0,1,0,10,1.4285714285714286,1,0.0,0,3,0,2,4,0,0,1,0,5,5,1
10021,143408,02eB8ecCHjqNKo6qHUUGR29f8TPEGh0h,5Gyp41oLVo7Gg7vF4vpmggWP5MU70QO6,4,2,1,0,1,0,1,0,5,0.7142857142857143,1,0.0,0,1,0,1,2,0,0,1,0,2,3,1
10022,143411,CK1y4VjcDqbHCyc8j3ZyMmye3Kr0k5ek,5Gyp41oLVo7Gg7vF4vpmggWP5MU70QO6,14,13,5,13,3,1,12,1,48,6.857142857142857,2,0.0,6,5,9,3,7,1,4,12,1,23,25,1
10023,143417,7Y5C8uyNuEClb8hOu715XyJadaHTCp61,5Gyp41oLVo7Gg7vF4vpmggWP5MU70QO6,1,0,0,0,0,0,2,0,2,0.2857142857142857,1,0.0,0,0,0,0,0,0,0,2,0,0,2,1
10024,143419,Ht9x3o743lad1plxfsf7HdjIfMKPMZn4,5Gyp41oLVo7Gg7vF4vpmggWP5MU70QO6,5,2,1,0,1,0,2,0,6,0.8571428571428571,1,0.0,0,1,0,1,2,0,0,2,0,2,4,1
10025,143420,kPKbtFeSZycXMdPSVXWifyTfYCsLYpsm,5Gyp41oLVo7Gg7vF4vpmggWP5MU70QO6,6,6,3,0,1,0,1,0,11,1.5714285714285714,1,0.0,0,3,0,1,6,0,0,1,0,4,7,1
10026,143423,W3EB1elPrDjFWV4QIzuswTukmjxtHb6Z,5Gyp41oLVo7Gg7vF4vpmggWP5MU70QO6,7,5,0,0,2,0,4,0,11,1.5714285714285714,2,0.0,0,0,0,2,5,0,0,4,0,2,9,1
10027,143431,PVIjAE0m0OeJAYOHc5gIjzktRijtXdS4,5Gyp41oLVo7Gg7vF4vpmggWP5MU70QO6,14,14,9,2,7,13,3,0,48,6.857142857142857,2,0.0,1,9,2,7,13,13,0,3,0,19,29,1
10028,143436,Rp2fhqTorRTBr1g8D33XPBmW7cDKMNsw,5Gyp41oLVo7Gg7vF4vpmggWP5MU70QO6,10,5,4,0,3,0,2,0,14,2.0,1,0.0,0,4,0,3,5,0,0,2,0,7,7,1
10029,143442,TL1aA8ITe7VP42GX52yE5M5UsjXNCOS3,5Gyp41oLVo7Gg7vF4vpmggWP5MU70QO6,1,0,0,0,0,0,1,0,1,0.14285714285714285,1,0.0,0,0,0,0,0,0,0,1,0,0,1,1
10030,143444,rzXoVvb6RM0hS48T1GDjFso4hKBDuhsd,5Gyp41oLVo7Gg7vF4vpmggWP5MU70QO6,7,3,2,0,2,0,3,0,10,1.4285714285714286,2,0.0,0,2,0,2,3,0,0,3,0,4,6,0
10031,143445,tkWTBuD8nrYklSlgsF9aKVPineGUm2wd,5Gyp41oLVo7Gg7vF4vpmggWP5MU70QO6,8,21,1,0,0,4,5,0,31,4.428571428571429,2,0.0,3,1,0,0,18,4,0,5,0,4,27,1
10032,143459,1wBARDHHvsWKQHj7bq7lK3F0H1NiNW7P,5Gyp41oLVo7Gg7vF4vpmggWP5MU70QO6,20,56,32,10,3,31,12,1,145,20.714285714285715,4,0.0,15,32,8,3,41,31,2,12,1,58,87,0
10033,143461,HpI5z92WE9TCj3JyfZi0b0yrE9hT84vs,5Gyp41oLVo7Gg7vF4vpmggWP5MU70QO6,3,2,1,0,1,0,1,0,5,0.7142857142857143,1,0.0,0,1,0,1,2,0,0,1,0,2,3,0
10034,143464,EIwrlyeGDjeWjUXh7JHlTyUT60Atu46k,5Gyp41oLVo7Gg7vF4vpmggWP5MU70QO6,9,3,2,0,2,0,5,1,13,1.8571428571428572,2,0.0,0,2,0,2,3,0,0,5,1,4,9,1
10035,143465,Ym06EDwHzBxFYaLLU6Bmy2owSb22Fa89,5Gyp41oLVo7Gg7vF4vpmggWP5MU70QO6,11,5,3,4,1,2,8,1,24,3.4285714285714284,1,0.0,1,3,2,1,4,2,2,8,1,7,17,1
10036,143468,FCVHfcDbYsYWzYxezM7NdJuRbNG7Stcf,5Gyp41oLVo7Gg7vF4vpmggWP5MU70QO6,9,9,2,0,1,0,5,0,17,2.4285714285714284,2,0.0,0,2,0,1,9,0,0,5,0,3,14,1
10037,143470,aMqu8eCEf86pHiQHjiXQU7HNwgjJ7Ef9,5Gyp41oLVo7Gg7vF4vpmggWP5MU70QO6,7,10,3,2,2,0,1,0,18,2.5714285714285716,1,0.0,6,3,2,2,4,0,0,1,0,13,5,1
10038,143471,vSDrQ1d9geDui9ep7HEAuKTGkHAGrSj9,5Gyp41oLVo7Gg7vF4vpmggWP5MU70QO6,1,0,0,0,0,0,1,0,1,0.14285714285714285,1,0.0,0,0,0,0,0,0,0,1,0,0,1,1
10039,143472,B9Y7e8bNhkzxmAC9KQ9khaR6Z5USyAMX,5Gyp41oLVo7Gg7vF4vpmggWP5MU70QO6,17,20,9,14,4,10,11,1,69,9.857142857142858,3,0.0,8,9,9,4,12,10,5,11,1,30,39,0
10040,143477,xcA8OXOfvqanvgUzFy9rw3fowOqTxLUh,5Gyp41oLVo7Gg7vF4vpmggWP5MU70QO6,1,0,0,0,0,0,2,0,2,0.2857142857142857,1,0.0,0,0,0,0,0,0,0,2,0,0,2,1
10041,143488,SC4Tg58IhuJ0FTbgAqt8uHgpsrGP7oZS,5Gyp41oLVo7Gg7vF4vpmggWP5MU70QO6,5,1,1,0,1,0,2,0,5,0.7142857142857143,1,0.0,0,1,0,1,1,0,0,2,0,2,3,1
10042,143497,58zOxfIYcP2qNqBDKTQKJbiBMUfZrt1H,5Gyp41oLVo7Gg7vF4vpmggWP5MU70QO6,5,2,2,0,1,0,2,0,7,1.0,1,0.0,0,2,0,1,2,0,0,2,0,3,4,1
10043,143502,NG8XCq6OkKK4wXwAiK6pXXmZHFULWlRj,5Gyp41oLVo7Gg7vF4vpmggWP5MU70QO6,9,11,5,0,4,0,2,0,22,3.142857142857143,2,0.0,3,5,0,4,8,0,0,2,0,12,10,0
10044,143503,aSyCUcrUz5zbUWUCs7M3fNxeiJQvjetP,5Gyp41oLVo7Gg7vF4vpmggWP5MU70QO6,5,1,1,0,1,0,2,0,5,0.7142857142857143,1,0.0,0,1,0,1,1,0,0,2,0,2,3,1
10045,143516,H5zUL9xfz1fEoOcbR4FmFtG01oFL0kN2,5Gyp41oLVo7Gg7vF4vpmggWP5MU70QO6,7,6,3,0,3,0,3,0,15,2.142857142857143,1,0.0,0,3,0,3,6,0,0,3,0,6,9,1
10046,143520,XVDb9H5Pu5RcveZQUtB2uYNi9gcWY9Ky,5Gyp41oLVo7Gg7vF4vpmggWP5MU70QO6,12,15,6,0,4,0,2,0,27,3.857142857142857,2,0.0,2,6,0,4,13,0,0,2,0,12,15,1
10047,143526,o6ifuqP5xId6uZ3IOv5wNZtyqLX9zcSt,5Gyp41oLVo7Gg7vF4vpmggWP5MU70QO6,8,13,7,0,3,0,4,0,27,3.857142857142857,4,0.0,0,7,0,3,13,0,0,4,0,10,17,1
10048,143535,eoe8MCP3PcQfeT4TaH2o2CzTUaHJ13Dz,5Gyp41oLVo7Gg7vF4vpmggWP5MU70QO6,6,2,1,0,1,1,4,1,10,1.4285714285714286,1,0.0,0,1,0,1,2,1,0,4,1,2,8,1
10049,143538,n9Gury1tEYEuvNBPCLDIs6gucbc6RB21,5Gyp41oLVo7Gg7vF4vpmggWP5MU70QO6,11,8,3,0,2,8,10,2,33,4.714285714285714,3,0.0,0,3,0,2,8,8,0,10,2,5,28,1
10050,143539,J7s2RwINzhWkMnB419eeqE7UEMRUnC6K,5Gyp41oLVo7Gg7vF4vpmggWP5MU70QO6,10,7,4,2,2,1,4,0,20,2.857142857142857,1,0.0,1,4,1,2,6,1,1,4,0,8,12,1
10051,143543,KrwFmeOk1mDr3eJOjicE7v40zcLjCFgW,5Gyp41oLVo7Gg7vF4vpmggWP5MU70QO6,5,5,2,0,0,0,2,0,9,1.2857142857142858,2,0.0,0,2,0,0,5,0,0,2,0,2,7,1
10052,143544,Kpn2SZmmiazR6DCkcb8B8TXM52qr9chW,5Gyp41oLVo7Gg7vF4vpmggWP5MU70QO6,4,2,0,0,0,0,2,0,4,0.5714285714285714,2,0.0,0,0,0,0,2,0,0,2,0,0,4,1
10053,143547,O90JYkj1gGlHgM5UA1XQxOTlw7sPJoVW,5Gyp41oLVo7Gg7vF4vpmggWP5MU70QO6,1,0,0,0,0,0,2,0,2,0.2857142857142857,1,0.0,0,0,0,0,0,0,0,2,0,0,2,1
10054,143549,xw2vNsMYolKmmnXlGh5JB53RVkTtvaQu,5Gyp41oLVo7Gg7vF4vpmggWP5MU70QO6,14,19,7,2,4,7,9,1,49,7.0,2,0.0,7,7,1,4,12,7,1,9,1,19,30,1
10055,143557,vLcgnxkCcq9VvWpGGz0OyGsPIrIRA9U8,5Gyp41oLVo7Gg7vF4vpmggWP5MU70QO6,10,14,4,5,5,0,2,0,30,4.285714285714286,1,0.0,8,4,3,5,6,0,2,2,0,20,10,1
10056,143586,o2z1lYhmt3dNuWADVCZXyE0sw3eHFzWq,G8EPVSXsOYB5YQWZGiz1aVq5Pgr2GrQu,12,3,2,6,1,1,6,1,20,2.857142857142857,1,0.0,0,2,5,1,3,1,1,6,1,8,12,1
10057,143589,z7uFh58nBoces7c1gc4iOr2l4NXGSjok,SpATywNh6bZuzm8s1ceuBUnMUAeoAHHw,19,25,11,27,1,0,12,0,76,10.857142857142858,2,0.0,7,11,27,1,18,0,0,12,0,46,30,0
10058,143599,43nq30xhRsgmZVAWkH8Zjb7IyZDGRDeY,A3fsA9Zfv1X2fVEQhTw51lKENdNrEqT3,6,4,1,0,0,0,3,0,8,1.1428571428571428,1,0.0,0,1,0,0,4,0,0,3,0,1,7,1
10059,143601,tXegIvrCsh9OUalSxRPl6DBhe0HWN5J1,bWdj2GDclj5ofokWjzoa5jAwMkxCykd6,4,2,0,0,0,0,4,0,6,0.8571428571428571,1,0.0,0,0,0,0,2,0,0,4,0,0,6,1
10060,143612,MKvKDEIiF4MpIyn9vn0Yw7gT3feDOAo3,bWdj2GDclj5ofokWjzoa5jAwMkxCykd6,3,2,0,0,0,0,1,0,3,0.42857142857142855,1,0.0,0,0,0,0,2,0,0,1,0,0,3,1
10061,143618,SAdK4BrTbltHilVBy10zBoad8iM8mXa4,G8EPVSXsOYB5YQWZGiz1aVq5Pgr2GrQu,12,19,10,0,10,12,9,0,60,8.571428571428571,1,0.0,2,10,0,10,17,12,0,9,0,22,38,0
10062,143632,BFi14w12zqsNleSplrknYhvmJy8GL2FY,bWdj2GDclj5ofokWjzoa5jAwMkxCykd6,18,27,8,44,5,0,5,0,89,12.714285714285714,2,0.0,9,8,37,5,18,0,7,5,0,59,30,1
10063,143636,HwdB7Xtsh4qUznoQGIINfFO0z6SlgPWN,G8EPVSXsOYB5YQWZGiz1aVq5Pgr2GrQu,7,3,2,0,1,0,4,0,10,1.4285714285714286,1,0.0,0,2,0,1,3,0,0,4,0,3,7,1
10064,143646,BQAHxDKbPTX2OmvOEbIJrtNWABd3lWzF,G8EPVSXsOYB5YQWZGiz1aVq5Pgr2GrQu,84,107,30,203,18,9,22,2,391,55.857142857142854,4,0.0,58,30,152,18,49,9,51,22,2,258,133,1
10065,143658,qCIGCxbEF5IZjc2KbYsE1TkH5yxiGth5,SpATywNh6bZuzm8s1ceuBUnMUAeoAHHw,17,32,2,12,1,1,13,0,61,8.714285714285714,6,0.0,8,2,11,1,24,1,1,13,0,22,39,1
10066,143662,rZhamd6VgzDuUbGwNlJUwteIExfrDmL0,SpATywNh6bZuzm8s1ceuBUnMUAeoAHHw,27,35,23,12,15,0,4,0,89,12.714285714285714,2,0.0,8,23,12,15,27,0,0,4,0,58,31,1
10067,143663,DtdInjZr4k2oFve3KkbkHNxJxR1ugIKn,SpATywNh6bZuzm8s1ceuBUnMUAeoAHHw,9,5,1,0,1,2,8,2,19,2.7142857142857144,2,0.0,1,1,0,1,4,2,0,8,2,3,16,1
10068,143674,7lzEjeizq2WryXPCFV63iiJ0sRC0XsD5,A3fsA9Zfv1X2fVEQhTw51lKENdNrEqT3,3,2,0,0,0,0,1,0,3,0.42857142857142855,1,0.0,0,0,0,0,2,0,0,1,0,0,3,1
10069,143678,P1PW7aZzx8NF90gRnrYjkf5ZxxKRlBng,SpATywNh6bZuzm8s1ceuBUnMUAeoAHHw,30,97,53,37,12,78,58,14,349,49.857142857142854,5,0.0,13,53,30,12,84,78,7,58,14,108,241,1
10070,143685,s2CLgeYgKwvHdG0n6HyjEsmd9rHYgz53,RXDvfPUBYFlVdlueBFbLW0mhhAyGEqpt,45,42,17,109,9,10,9,2,198,28.285714285714285,3,0.0,11,17,102,9,31,10,7,9,2,139,59,1
10071,143686,xhoMHYDn0DYj6NEexX867ukahPmWhSwf,bWdj2GDclj5ofokWjzoa5jAwMkxCykd6,25,23,14,0,12,0,7,0,56,8.0,3,0.0,5,14,0,12,18,0,0,7,0,31,25,1
10072,143701,BCr2GOpOyeEKOuzlRV7PJCL1CEnRyr6Q,G8EPVSXsOYB5YQWZGiz1aVq5Pgr2GrQu,19,18,12,0,9,0,8,1,48,6.857142857142857,3,0.0,3,12,0,9,15,0,0,8,1,24,24,1
10073,143729,YITGGXKhxzNHdElox232lzcaZdJ61YFn,G8EPVSXsOYB5YQWZGiz1aVq5Pgr2GrQu,9,10,2,0,2,0,5,0,19,2.7142857142857144,3,0.0,0,2,0,2,10,0,0,5,0,4,15,1
10074,143753,BFi14w12zqsNleSplrknYhvmJy8GL2FY,SpATywNh6bZuzm8s1ceuBUnMUAeoAHHw,6,10,3,0,1,0,2,0,16,2.2857142857142856,2,0.0,4,3,0,1,6,0,0,2,0,8,8,1
10075,143757,CNd98TtnFYCKW8sIKXbo0EVDlFn0r29F,SpATywNh6bZuzm8s1ceuBUnMUAeoAHHw,14,14,7,12,3,1,5,0,42,6.0,2,0.0,2,7,10,3,12,1,2,5,0,22,20,1
10076,143759,qjm8uLcDpLtNxtPMuyI6LdPbp6n70fuZ,bWdj2GDclj5ofokWjzoa5jAwMkxCykd6,6,2,1,0,0,0,4,1,8,1.1428571428571428,1,0.0,0,1,0,0,2,0,0,4,1,1,7,1
10077,143765,UI53aostODbFE1SZneA6yZKpOYnaewLS,G8EPVSXsOYB5YQWZGiz1aVq5Pgr2GrQu,19,8,7,20,6,0,2,0,43,6.142857142857143,1,0.0,0,7,15,6,8,0,5,2,0,28,15,1
10078,143775,kJR7SORW78mX9yl9TvMAdIrYcwnnZz4r,RXDvfPUBYFlVdlueBFbLW0mhhAyGEqpt,2,0,0,0,0,0,2,0,2,0.2857142857142857,1,0.0,0,0,0,0,0,0,0,2,0,0,2,1
10079,143785,OStdVLf6yEEZ6snmnFowdmcaKWpdnJbL,RXDvfPUBYFlVdlueBFbLW0mhhAyGEqpt,1,0,0,0,0,0,1,0,1,0.14285714285714285,1,0.0,0,0,0,0,0,0,0,1,0,0,1,1
10080,143812,ee58foeX64HQVEJT3urOlMI7BjSHbs8j,SpATywNh6bZuzm8s1ceuBUnMUAeoAHHw,15,20,1,12,0,0,14,3,50,7.142857142857143,4,0.0,5,1,11,0,15,0,1,14,3,17,33,1
10081,143813,GJGZOa9ckBlFcfojmDXHYkGGywyzKOaN,SpATywNh6bZuzm8s1ceuBUnMUAeoAHHw,29,49,2,36,2,71,32,6,198,28.285714285714285,8,0.0,15,2,33,2,34,71,3,32,6,52,146,1
10082,143822,kfS0nefl4PODD2Wbg3xDtahejAoyK8Co,RXDvfPUBYFlVdlueBFbLW0mhhAyGEqpt,108,116,79,209,35,125,17,1,582,83.14285714285714,9,0.0,21,79,180,35,95,125,29,17,1,315,267,0
10083,143829,wBxOvXavxcvDHQtsCbkdt1VRzmB8Qh9E,A3fsA9Zfv1X2fVEQhTw51lKENdNrEqT3,1,0,0,0,0,0,1,0,1,0.14285714285714285,1,0.0,0,0,0,0,0,0,0,1,0,0,1,1
10084,143836,GmLQtlg8yrQT4o49Mau9FkoR2KxlaFCK,A3fsA9Zfv1X2fVEQhTw51lKENdNrEqT3,3,0,0,0,0,1,5,0,6,0.8571428571428571,1,0.0,0,0,0,0,0,1,0,5,0,0,6,1
10085,143845,JlEwtKnXvqCWlVkvWLsPOkSZfN8DgLlO,SpATywNh6bZuzm8s1ceuBUnMUAeoAHHw,8,9,3,0,1,0,3,0,16,2.2857142857142856,1,0.0,1,3,0,1,8,0,0,3,0,5,11,1
10086,143846,i0sekElajxS5N9A9gI4ciPHJzCFHyEzA,SpATywNh6bZuzm8s1ceuBUnMUAeoAHHw,7,4,2,0,2,0,1,0,9,1.2857142857142858,1,0.0,0,2,0,2,4,0,0,1,0,4,5,1
10087,143852,6pc1PztS8sMKmk9TBeVVlDzbAlFBojkU,bWdj2GDclj5ofokWjzoa5jAwMkxCykd6,4,2,1,0,1,0,1,0,5,0.7142857142857143,1,0.0,0,1,0,1,2,0,0,1,0,2,3,1
10088,143871,i0Fe8GkgETgJLYZf4oG1MMDT0SsDr0Jw,bWdj2GDclj5ofokWjzoa5jAwMkxCykd6,8,8,4,0,2,0,3,0,17,2.4285714285714284,3,0.0,0,4,0,2,8,0,0,3,0,6,11,1
10089,143878,OMrkn9SYYoJHeW009nGi3tN8klhPSmaY,G8EPVSXsOYB5YQWZGiz1aVq5Pgr2GrQu,1,0,0,0,0,0,1,0,1,0.14285714285714285,1,0.0,0,0,0,0,0,0,0,1,0,0,1,1
10090,143885,ix15aF6FOEF1waZCSZt01VrPOuPGJ3yM,A3fsA9Zfv1X2fVEQhTw51lKENdNrEqT3,17,21,1,10,1,1,2,0,36,5.142857142857143,2,0.0,0,1,10,1,21,1,0,2,0,12,24,1
10091,143903,Vd6Fw7jRvBeu91l91UPCADQJMohO1ulC,SpATywNh6bZuzm8s1ceuBUnMUAeoAHHw,19,27,3,16,3,5,10,0,64,9.142857142857142,8,0.0,5,3,13,3,22,5,3,10,0,24,40,0
10092,143914,qDW8D89X9oTRJFDDcQZTLb3PUIxnDi04,A3fsA9Zfv1X2fVEQhTw51lKENdNrEqT3,7,4,1,0,1,0,2,0,8,1.1428571428571428,1,0.0,0,1,0,1,4,0,0,2,0,2,6,1
10093,143916,YGuMlMRO0oSJvGD54x9bLYiGJQjDsQL5,G8EPVSXsOYB5YQWZGiz1aVq5Pgr2GrQu,7,8,1,6,0,3,3,0,21,3.0,1,0.0,6,1,3,0,2,3,3,3,0,10,11,1
10094,143919,0Wa2kEuzurHwd29qlJEDljKGNBFtcml7,G8EPVSXsOYB5YQWZGiz1aVq5Pgr2GrQu,6,1,1,0,1,0,3,0,6,0.8571428571428571,1,0.0,0,1,0,1,1,0,0,3,0,2,4,1
10095,143922,kjGwgryJuZFnPYPKqBQ3NNskwkNfGn3d,A3fsA9Zfv1X2fVEQhTw51lKENdNrEqT3,1,0,0,0,0,0,2,0,2,0.2857142857142857,1,0.0,0,0,0,0,0,0,0,2,0,0,2,1
10096,143926,kjGwgryJuZFnPYPKqBQ3NNskwkNfGn3d,bWdj2GDclj5ofokWjzoa5jAwMkxCykd6,7,2,0,0,0,7,6,1,16,2.2857142857142856,1,0.0,0,0,0,0,2,7,0,6,1,0,16,1
10097,143942,kS57PN5w4M8SePVOR15O2soQi4RHoCPq,SpATywNh6bZuzm8s1ceuBUnMUAeoAHHw,40,49,21,31,12,0,8,1,122,17.428571428571427,6,0.0,7,21,30,12,42,0,1,8,1,70,52,0
10098,143954,8jktIbkTyfsrxSTzXB9djfwFIqhVk9sD,G8EPVSXsOYB5YQWZGiz1aVq5Pgr2GrQu,11,8,1,0,1,0,6,0,16,2.2857142857142856,2,0.0,0,1,0,1,8,0,0,6,0,2,14,1
10099,143962,xqtF7kz0ECRMGC9cksHZcAo5S9h7Xs8O,A3fsA9Zfv1X2fVEQhTw51lKENdNrEqT3,3,3,2,0,0,0,1,0,6,0.8571428571428571,2,0.0,0,2,0,0,3,0,0,1,0,2,4,1
10100,143978,Bj8ATra8VoYTzA097NzbEns3tHpy9inW,SpATywNh6bZuzm8s1ceuBUnMUAeoAHHw,3,1,0,0,0,0,4,0,5,0.7142857142857143,2,0.0,0,0,0,0,1,0,0,4,0,0,5,1
10101,143985,VYyLsKD1rNE6IEMOVHtWy3gAcazZXSjf,SpATywNh6bZuzm8s1ceuBUnMUAeoAHHw,10,8,6,0,0,1,7,1,23,3.2857142857142856,1,0.0,0,6,0,0,8,1,0,7,1,6,17,1
10102,144002,ldTDPaSBa3R7vzg6xAgzmxomfcP7FtgG,G8EPVSXsOYB5YQWZGiz1aVq5Pgr2GrQu,7,3,0,0,0,0,4,1,8,1.1428571428571428,1,0.0,1,0,0,0,2,0,0,4,1,1,7,1
10103,144004,U62bUOUAMvRVibRWhVYvsfcC0FytLRv5,A3fsA9Zfv1X2fVEQhTw51lKENdNrEqT3,12,7,5,0,5,0,2,0,19,2.7142857142857144,2,0.0,0,5,0,5,7,0,0,2,0,10,9,1
10104,144031,LAQONTh6B8YO6fNJXryzQnYCV0hkbp2b,SpATywNh6bZuzm8s1ceuBUnMUAeoAHHw,15,21,12,8,4,0,7,0,52,7.428571428571429,3,0.0,5,12,7,4,16,0,1,7,0,28,24,1
10105,144074,JHhY30IKFzw4LWcyrHuTEglWNqRkqdDU,A3fsA9Zfv1X2fVEQhTw51lKENdNrEqT3,1,0,0,0,0,0,5,0,5,0.7142857142857143,1,0.0,0,0,0,0,0,0,0,5,0,0,5,1
10106,144077,0gS5Q732yxgOQo1BReYmVwLNG0PEmJtw,bWdj2GDclj5ofokWjzoa5jAwMkxCykd6,11,37,13,12,3,7,8,2,82,11.714285714285714,4,0.0,2,13,11,3,35,7,1,8,2,29,53,1
10107,144080,M8cV3FHZsXmaSmJz43zOWXbhj6ecftQ6,bWdj2GDclj5ofokWjzoa5jAwMkxCykd6,9,7,1,0,1,1,9,2,21,3.0,2,0.0,0,1,0,1,7,1,0,9,2,2,19,1
10108,144083,jVbyR2K2eRZglkuIyxRotkq1vJB87WuF,A3fsA9Zfv1X2fVEQhTw51lKENdNrEqT3,15,19,15,0,11,0,4,0,49,7.0,3,0.0,0,15,0,11,19,0,0,4,0,26,23,0
10109,144085,jVbyR2K2eRZglkuIyxRotkq1vJB87WuF,bWdj2GDclj5ofokWjzoa5jAwMkxCykd6,4,3,2,0,2,0,2,0,9,1.2857142857142858,2,0.0,0,2,0,2,3,0,0,2,0,4,5,1
10110,144106,Kky2aVSeER09Ccbe6jHNmsRuAd2julij,A3fsA9Zfv1X2fVEQhTw51lKENdNrEqT3,4,2,1,0,1,0,1,0,5,0.7142857142857143,1,0.0,0,1,0,1,2,0,0,1,0,2,3,1
10111,144110,ZkodedaetKv5naAeRDAkOlSxAXe0IboP,A3fsA9Zfv1X2fVEQhTw51lKENdNrEqT3,9,5,4,0,2,2,5,0,18,2.5714285714285716,1,0.0,0,4,0,2,5,2,0,5,0,6,12,1
10112,144123,VbTtM6XJ2ULINXtlzPV5CdmpUQ96Z4m1,A3fsA9Zfv1X2fVEQhTw51lKENdNrEqT3,2,0,0,0,0,0,2,0,2,0.2857142857142857,1,0.0,0,0,0,0,0,0,0,2,0,0,2,1
10113,144125,9T6sJuPiEkwFHn4VyREnKyR6Ni1hFol4,A3fsA9Zfv1X2fVEQhTw51lKENdNrEqT3,136,70,54,344,36,0,16,0,520,74.28571428571429,5,0.0,1,54,284,36,69,0,60,16,0,375,145,0
10114,144128,XFHjgUTOXGdMfDJPVsJ9fIgVszICPgyz,SpATywNh6bZuzm8s1ceuBUnMUAeoAHHw,4,2,0,0,0,0,2,0,4,0.5714285714285714,1,0.0,0,0,0,0,2,0,0,2,0,0,4,1
10115,144149,Q0aJXENLM8Ba7eSfqdpvheSc04S1CuaH,SpATywNh6bZuzm8s1ceuBUnMUAeoAHHw,2,0,0,0,0,0,2,0,2,0.2857142857142857,1,0.0,0,0,0,0,0,0,0,2,0,0,2,1
10116,144160,rukMFkuKsi65w6w0x0BTdkn9Ums9NFFL,RXDvfPUBYFlVdlueBFbLW0mhhAyGEqpt,8,3,2,0,1,1,6,1,14,2.0,2,0.0,0,2,0,1,3,1,0,6,1,3,11,1
10117,144164,OD1pqN8En0iNd52vQpaf4DwGLH3W4dof,SpATywNh6bZuzm8s1ceuBUnMUAeoAHHw,5,2,1,0,1,0,3,0,7,1.0,2,0.0,0,1,0,1,2,0,0,3,0,2,5,1
10118,144179,L1IQ56wH1SqkL7PACuNGk2Nkhk5s11JQ,SpATywNh6bZuzm8s1ceuBUnMUAeoAHHw,7,3,2,0,2,0,2,0,9,1.2857142857142858,1,0.0,0,2,0,2,3,0,0,2,0,4,5,1
10119,144183,ZG0u2uQ1GPj4pTtPSRFTX9ZynYPgcWTk,G8EPVSXsOYB5YQWZGiz1aVq5Pgr2GrQu,14,26,3,22,2,0,3,0,56,8.0,3,0.0,12,3,15,2,14,0,7,3,0,32,24,1
10120,144192,soXc1elBesZE0RSRAIRToGxlZRocKEhG,G8EPVSXsOYB5YQWZGiz1aVq5Pgr2GrQu,18,12,7,22,2,1,8,1,53,7.571428571428571,2,0.0,0,7,17,2,12,1,5,8,1,26,27,1
10121,144193,vSPx0Rg8IfOWpaATb7kkPj0mZPaLkdwk,RXDvfPUBYFlVdlueBFbLW0mhhAyGEqpt,3,2,0,0,0,0,1,0,3,0.42857142857142855,1,0.0,0,0,0,0,2,0,0,1,0,0,3,1
10122,144197,8eAVRzls7MGQwc3WaPP7ONmygmpXQE3K,A3fsA9Zfv1X2fVEQhTw51lKENdNrEqT3,7,5,3,0,2,0,1,0,11,1.5714285714285714,1,0.0,0,3,0,2,5,0,0,1,0,5,6,1
10123,144202,CLjs31mL2a4HrNzVlnTt15ZnHVg4guKy,bWdj2GDclj5ofokWjzoa5jAwMkxCykd6,5,3,1,0,1,0,3,0,8,1.1428571428571428,2,0.0,1,1,0,1,2,0,0,3,0,3,5,1
10124,144207,q8Ghyemwk98Z0FJ5i93VufZPwN70TN9G,G8EPVSXsOYB5YQWZGiz1aVq5Pgr2GrQu,2,0,0,0,0,0,2,0,2,0.2857142857142857,1,0.0,0,0,0,0,0,0,0,2,0,0,2,1
10125,144221,KkSinTdG2PbGrJIRATMZos8HES46UawO,bWdj2GDclj5ofokWjzoa5jAwMkxCykd6,9,43,10,0,8,0,6,0,67,9.571428571428571,3,0.0,13,10,0,8,30,0,0,6,0,31,36,0
10126,144226,KkSinTdG2PbGrJIRATMZos8HES46UawO,A3fsA9Zfv1X2fVEQhTw51lKENdNrEqT3,26,46,21,0,16,2,6,1,92,13.142857142857142,3,0.0,0,21,0,16,46,2,0,6,1,37,55,0
10127,144228,tLK4qfNEt0O7kdBEQmDtMwddSX278qz9,SpATywNh6bZuzm8s1ceuBUnMUAeoAHHw,2,0,0,0,0,0,2,0,2,0.2857142857142857,1,0.0,0,0,0,0,0,0,0,2,0,0,2,1
10128,144239,YCrhaujUJb2ysdJEAlnTFggfP634EwtZ,A3fsA9Zfv1X2fVEQhTw51lKENdNrEqT3,1,0,0,0,0,0,1,0,1,0.14285714285714285,1,0.0,0,0,0,0,0,0,0,1,0,0,1,1
10129,144242,asiNuyAOWs6SCiRYMsJjoOdnVeDfmCWA,A3fsA9Zfv1X2fVEQhTw51lKENdNrEqT3,7,3,0,0,0,1,8,0,12,1.7142857142857142,1,0.0,0,0,0,0,3,1,0,8,0,0,12,1
10130,144264,1La5rp9ZSz9cfpqCRJiC01Rwvuq5VVrf,A3fsA9Zfv1X2fVEQhTw51lKENdNrEqT3,13,7,4,6,3,0,4,0,24,3.4285714285714284,1,0.0,2,4,5,3,5,0,1,4,0,14,10,0
10131,144273,myIIBocNFelldmuN47bMrRiORGKDSj7S,A3fsA9Zfv1X2fVEQhTw51lKENdNrEqT3,8,4,3,0,3,0,1,0,11,1.5714285714285714,1,0.0,0,3,0,3,4,0,0,1,0,6,5,1
10132,144279,QGuKTIBC2KLaYpPdOnB4nXCWgxMM1Dog,A3fsA9Zfv1X2fVEQhTw51lKENdNrEqT3,8,4,3,0,3,0,1,0,11,1.5714285714285714,1,0.0,0,3,0,3,4,0,0,1,0,6,5,0
10133,144307,xzsDRI5lJyx0VDWOgYiu4gtqXBQyCAlZ,SpATywNh6bZuzm8s1ceuBUnMUAeoAHHw,5,2,1,0,1,0,2,0,6,0.8571428571428571,1,0.0,0,1,0,1,2,0,0,2,0,2,4,1
10134,144321,l9yVkoh4OzNZS3boMvfvu1qkbaccG6pv,SpATywNh6bZuzm8s1ceuBUnMUAeoAHHw,29,83,42,14,14,21,22,4,200,28.571428571428573,8,0.0,26,42,11,14,57,21,3,22,4,93,107,0
10135,144328,1z8xVGdONRHgttCsFcaiTYfHNmdRXPsG,SpATywNh6bZuzm8s1ceuBUnMUAeoAHHw,8,8,3,0,2,0,2,0,15,2.142857142857143,1,0.0,2,3,0,2,6,0,0,2,0,7,8,1
10136,144352,15iBXbgbmcpqKkeTya1vwlvLo9VSZF3Q,G8EPVSXsOYB5YQWZGiz1aVq5Pgr2GrQu,14,7,6,34,4,0,3,0,54,7.714285714285714,1,0.0,1,6,29,4,6,0,5,3,0,40,14,1
10137,144367,j6kVkVGKYZT7ozL2NE5rOIexD3a1ewYn,bWdj2GDclj5ofokWjzoa5jAwMkxCykd6,8,6,2,18,3,0,1,0,30,4.285714285714286,1,0.0,3,2,16,3,3,0,2,1,0,24,6,1
10138,144376,rTLMEQB78zn1g6bt6KRypanGZ8QWPbQv,bWdj2GDclj5ofokWjzoa5jAwMkxCykd6,1,0,0,0,0,0,1,0,1,0.14285714285714285,1,0.0,0,0,0,0,0,0,0,1,0,0,1,1
10139,144389,BeS19JPMXzXPGfXk6YRJuHRmyxH0T7Wj,A3fsA9Zfv1X2fVEQhTw51lKENdNrEqT3,2,0,0,0,0,0,4,0,4,0.5714285714285714,1,0.0,0,0,0,0,0,0,0,4,0,0,4,1
10140,144393,15iBXbgbmcpqKkeTya1vwlvLo9VSZF3Q,SpATywNh6bZuzm8s1ceuBUnMUAeoAHHw,2,0,0,0,0,0,2,0,2,0.2857142857142857,1,0.0,0,0,0,0,0,0,0,2,0,0,2,1
10141,144406,Y4L4Q01m86olYens1XXjwQSIKQK0VXY8,SpATywNh6bZuzm8s1ceuBUnMUAeoAHHw,11,6,5,4,3,0,1,0,19,2.7142857142857144,1,0.0,0,5,3,3,6,0,1,1,0,11,8,1
10142,144421,IH3Fpf227mcEx04r510MqQHERjzGveWM,A3fsA9Zfv1X2fVEQhTw51lKENdNrEqT3,60,56,46,72,26,1,14,0,215,30.714285714285715,6,0.0,1,46,57,26,55,1,15,14,0,130,85,1
10143,144422,6ElmeAobgOVWMQKbfyTe96fhVbG33C2X,G8EPVSXsOYB5YQWZGiz1aVq5Pgr2GrQu,1,0,0,0,0,0,1,0,1,0.14285714285714285,1,0.0,0,0,0,0,0,0,0,1,0,0,1,1
10144,144429,tVItbLut2hv4GIKzxM0DVZ7s3PzDPaT6,RXDvfPUBYFlVdlueBFbLW0mhhAyGEqpt,1,0,0,0,0,0,1,0,1,0.14285714285714285,1,0.0,0,0,0,0,0,0,0,1,0,0,1,1
10145,144439,7WYyQ5o657nnaDs90V9cVaz7JKBLQO6T,bWdj2GDclj5ofokWjzoa5jAwMkxCykd6,12,10,4,34,4,0,6,0,58,8.285714285714286,1,0.0,4,4,33,4,6,0,1,6,0,45,13,1
10146,144443,OocLfrCOBb0PIIRDKMfTM554g3aeKj99,A3fsA9Zfv1X2fVEQhTw51lKENdNrEqT3,9,4,3,0,3,0,2,0,12,1.7142857142857142,1,0.0,0,3,0,3,4,0,0,2,0,6,6,1
10147,144455,uzKo5XybDLGWG8pNxiIda7r0TfSQ9SeA,A3fsA9Zfv1X2fVEQhTw51lKENdNrEqT3,10,7,6,0,6,0,1,0,20,2.857142857142857,1,0.0,0,6,0,6,7,0,0,1,0,12,8,1
10148,144460,QhamLDlsBIMrNG9NsQtpJBjMOuVLF7Tg,SpATywNh6bZuzm8s1ceuBUnMUAeoAHHw,1,0,0,0,0,0,1,0,1,0.14285714285714285,1,0.0,0,0,0,0,0,0,0,1,0,0,1,1
10149,144462,98Rmjqd0huhIhiHJIK65vNiEBdUVwDLb,bWdj2GDclj5ofokWjzoa5jAwMkxCykd6,1,0,0,0,0,0,1,0,1,0.14285714285714285,1,0.0,0,0,0,0,0,0,0,1,0,0,1,1
10150,144505,XYAJcmpULCxF9eHnylLtZOUd3WBca1G2,SpATywNh6bZuzm8s1ceuBUnMUAeoAHHw,6,4,1,0,1,0,4,0,10,1.4285714285714286,1,0.0,0,1,0,1,4,0,0,4,0,2,8,1
10151,144510,M8d3qfut8VxaqPRwVms9OlOmOpQg63xG,SpATywNh6bZuzm8s1ceuBUnMUAeoAHHw,18,56,11,18,4,29,21,4,143,20.428571428571427,2,0.0,23,11,15,4,33,29,3,21,4,53,90,1
10152,144511,XqxXHlwlYxd9RSTeUV9pBamG1DPgHOIg,G8EPVSXsOYB5YQWZGiz1aVq5Pgr2GrQu,7,9,3,4,2,0,2,0,20,2.857142857142857,1,0.0,4,3,3,2,5,0,1,2,0,12,8,1
10153,144515,g3liImBcMScJKznyarQ0IVXqD3a9da64,bWdj2GDclj5ofokWjzoa5jAwMkxCykd6,2,0,0,0,0,0,2,0,2,0.2857142857142857,1,0.0,0,0,0,0,0,0,0,2,0,0,2,1
10154,144523,a47rhYVhWUpsdxtGQACB0YgDJVPXyOje,G8EPVSXsOYB5YQWZGiz1aVq5Pgr2GrQu,15,10,0,18,0,1,5,1,35,5.0,1,0.0,6,0,14,0,4,1,4,5,1,20,15,1
10155,144538,E030rU1LpxP75gCwLYOV4Fo0HxMZiV04,bWdj2GDclj5ofokWjzoa5jAwMkxCykd6,4,2,1,0,1,0,1,0,5,0.7142857142857143,1,0.0,0,1,0,1,2,0,0,1,0,2,3,1
10156,144543,3myCXWasasCDpepMqlfZ17VF0Gt1zPNm,SpATywNh6bZuzm8s1ceuBUnMUAeoAHHw,9,31,5,0,4,0,9,0,49,7.0,2,0.0,0,5,0,4,31,0,0,9,0,9,40,1
10157,144550,dRD1DS5DuggVygcG59W7832HdVYwtgOn,SpATywNh6bZuzm8s1ceuBUnMUAeoAHHw,11,12,3,0,3,1,8,1,28,4.0,3,0.0,0,3,0,3,12,1,0,8,1,6,22,0
10158,144554,a98Mt6r9LLCkAEPo2R3JVMN20OhIPoaG,G8EPVSXsOYB5YQWZGiz1aVq5Pgr2GrQu,12,9,8,0,8,1,13,3,42,6.0,1,0.0,0,8,0,8,9,1,0,13,3,16,26,1
10159,144565,aGxe7bEAMBiGMI7BWz3muh2QIgH75sEQ,SpATywNh6bZuzm8s1ceuBUnMUAeoAHHw,7,9,4,0,3,1,5,1,23,3.2857142857142856,2,0.0,0,4,0,3,9,1,0,5,1,7,16,1
10160,144576,K938KGiMd2B4Ec49syEZjpINF1qucFfC,RXDvfPUBYFlVdlueBFbLW0mhhAyGEqpt,8,6,5,0,3,0,1,0,15,2.142857142857143,1,0.0,0,5,0,3,6,0,0,1,0,8,7,1
10161,144588,TfgVRC9skFsGu3qq14caEQmfjmrp7rot,A3fsA9Zfv1X2fVEQhTw51lKENdNrEqT3,7,15,4,2,0,47,11,0,79,11.285714285714286,5,0.0,2,4,2,0,13,47,0,11,0,8,71,1
10162,144595,ILvCdOvVnKq9RshqMB5c6cdDGIsepuiz,SpATywNh6bZuzm8s1ceuBUnMUAeoAHHw,22,41,13,16,9,1,6,0,86,12.285714285714286,4,0.0,10,13,14,9,31,1,2,6,0,46,40,0
10163,144597,8sZcaktUJCX4PaAufyDgY0i3vpLY8cZl,SpATywNh6bZuzm8s1ceuBUnMUAeoAHHw,21,58,25,26,10,11,16,0,146,20.857142857142858,8,0.0,13,25,23,10,45,11,3,16,0,71,75,1
10164,144603,FKroAYBvJIjpEDPtuLwEtwENqpzITIVV,G8EPVSXsOYB5YQWZGiz1aVq5Pgr2GrQu,2,0,0,0,0,0,2,0,2,0.2857142857142857,1,0.0,0,0,0,0,0,0,0,2,0,0,2,1
10165,144617,pU8vRE1UHTj9vg59DuOCQhz7JoOflgLu,A3fsA9Zfv1X2fVEQhTw51lKENdNrEqT3,7,3,2,0,2,0,2,0,9,1.2857142857142858,1,0.0,0,2,0,2,3,0,0,2,0,4,5,1
10166,144618,MXpZg6Y3WvwOURUS1VvgXTxhk1pXKVY7,A3fsA9Zfv1X2fVEQhTw51lKENdNrEqT3,1,0,0,0,0,0,1,0,1,0.14285714285714285,1,0.0,0,0,0,0,0,0,0,1,0,0,1,1
10167,144629,BP5bWGw3QHuTeDApT0DMqwZyLZFJNObH,bWdj2GDclj5ofokWjzoa5jAwMkxCykd6,2,0,0,0,0,0,4,0,4,0.5714285714285714,2,0.0,0,0,0,0,0,0,0,4,0,0,4,1
10168,144631,HOzFChSOtA5eaxaGdVcuMk1vnx6fpMBO,A3fsA9Zfv1X2fVEQhTw51lKENdNrEqT3,8,6,5,0,5,0,1,0,17,2.4285714285714284,1,0.0,0,5,0,5,6,0,0,1,0,10,7,1
10169,144636,JUXaUT76xGfe9CQCOTjnER9kYb6QPZYj,SpATywNh6bZuzm8s1ceuBUnMUAeoAHHw,1,0,0,0,0,0,1,0,1,0.14285714285714285,1,0.0,0,0,0,0,0,0,0,1,0,0,1,1
10170,144640,BP5bWGw3QHuTeDApT0DMqwZyLZFJNObH,G8EPVSXsOYB5YQWZGiz1aVq5Pgr2GrQu,1,0,0,0,0,0,1,0,1,0.14285714285714285,1,0.0,0,0,0,0,0,0,0,1,0,0,1,1
10171,144641,BP5bWGw3QHuTeDApT0DMqwZyLZFJNObH,RXDvfPUBYFlVdlueBFbLW0mhhAyGEqpt,1,0,0,0,0,0,1,0,1,0.14285714285714285,1,0.0,0,0,0,0,0,0,0,1,0,0,1,1
10172,144643,BP5bWGw3QHuTeDApT0DMqwZyLZFJNObH,A3fsA9Zfv1X2fVEQhTw51lKENdNrEqT3,1,0,0,0,0,0,1,0,1,0.14285714285714285,1,0.0,0,0,0,0,0,0,0,1,0,0,1,0
10173,144649,uKGXhzbiDEpxCHjVlf9dmkGcQbxLosVe,A3fsA9Zfv1X2fVEQhTw51lKENdNrEqT3,71,35,12,182,5,0,8,0,242,34.57142857142857,3,0.0,18,12,182,5,17,0,0,8,0,217,25,1
10174,144672,0CSUGuJXm53wz281T7wy30wWcjmP6Jhd,A3fsA9Zfv1X2fVEQhTw51lKENdNrEqT3,1,0,0,0,0,0,1,0,1,0.14285714285714285,1,0.0,0,0,0,0,0,0,0,1,0,0,1,1
10175,144675,R6EtBVYzIOtYw5JSZPuQBl0alOVcbr6I,A3fsA9Zfv1X2fVEQhTw51lKENdNrEqT3,12,7,4,0,2,0,10,1,24,3.4285714285714284,3,0.0,0,4,0,2,7,0,0,10,1,6,18,1
10176,144681,ZbpLZuhcPXDt8MCBlzIEU31Qmn57Ldle,SpATywNh6bZuzm8s1ceuBUnMUAeoAHHw,5,12,6,0,1,0,8,0,27,3.857142857142857,6,0.0,0,6,0,1,12,0,0,8,0,7,20,0
10177,144684,3URMlJ8WFfbFx3SvBMPqUCA5oJqCky66,SpATywNh6bZuzm8s1ceuBUnMUAeoAHHw,1,0,0,0,0,0,1,0,1,0.14285714285714285,1,0.0,0,0,0,0,0,0,0,1,0,0,1,1
10178,144685,3URMlJ8WFfbFx3SvBMPqUCA5oJqCky66,A3fsA9Zfv1X2fVEQhTw51lKENdNrEqT3,1,0,0,0,0,0,1,0,1,0.14285714285714285,1,0.0,0,0,0,0,0,0,0,1,0,0,1,1
10179,144715,xQxCv7HVGUZGKsbGAuM07smPdylb1xSw,SpATywNh6bZuzm8s1ceuBUnMUAeoAHHw,42,46,18,36,7,4,20,4,135,19.285714285714285,6,0.0,10,18,34,7,36,4,2,20,4,69,66,1
10180,144717,dSEPqlVIJhcDJWr692RG1EpaZWCLqDyG,SpATywNh6bZuzm8s1ceuBUnMUAeoAHHw,18,23,15,17,8,0,10,1,74,10.571428571428571,2,0.0,3,15,14,8,20,0,3,10,1,40,34,1
10181,144718,4ZrtrSJyUYRfKbXFhTQGaeeh25vDmius,A3fsA9Zfv1X2fVEQhTw51lKENdNrEqT3,1,0,0,0,0,0,1,0,1,0.14285714285714285,1,0.0,0,0,0,0,0,0,0,1,0,0,1,1
10182,144719,xQxCv7HVGUZGKsbGAuM07smPdylb1xSw,A3fsA9Zfv1X2fVEQhTw51lKENdNrEqT3,95,45,19,254,12,3,16,1,350,50.0,6,0.0,7,19,231,12,38,3,23,16,1,269,81,1
10183,144725,AIfINm6P1sC5sVX3hdv80PZXLkhHXqk1,G8EPVSXsOYB5YQWZGiz1aVq5Pgr2GrQu,12,23,8,14,6,1,6,0,58,8.285714285714286,1,0.0,12,8,11,6,11,1,3,6,0,37,21,1
10184,144738,WQgX9jQZlUNhL3E2Z5eSuSFzKxNFacOF,SpATywNh6bZuzm8s1ceuBUnMUAeoAHHw,7,3,1,0,2,0,2,0,8,1.1428571428571428,1,0.0,0,1,0,2,3,0,0,2,0,3,5,1
10185,144767,D4wnvxE0dpHZJOcudMfhDCLWhQhwv6kG,RXDvfPUBYFlVdlueBFbLW0mhhAyGEqpt,5,2,1,0,1,0,3,0,7,1.0,1,0.0,0,1,0,1,2,0,0,3,0,2,5,1
10186,144783,tLtF2xuv7ODjuOISevnoALqvBz99SIrS,A3fsA9Zfv1X2fVEQhTw51lKENdNrEqT3,11,14,0,0,0,0,3,0,17,2.4285714285714284,2,0.0,0,0,0,0,14,0,0,3,0,0,17,1
10187,144786,pOHHE099KbMGj1W8GOyTSnGwPkWGlTwN,SpATywNh6bZuzm8s1ceuBUnMUAeoAHHw,6,3,2,0,2,0,1,0,8,1.1428571428571428,1,0.0,0,2,0,2,3,0,0,1,0,4,4,1
10188,144794,NSeMeg6h5JDvAoSbt1mktNuQe2nQivm2,SpATywNh6bZuzm8s1ceuBUnMUAeoAHHw,7,7,4,0,3,0,2,0,16,2.2857142857142856,3,0.0,0,4,0,3,7,0,0,2,0,7,9,1
10189,144796,kVjEgLBjlwxZOZHT9ChhdKAcv24WA2AK,A3fsA9Zfv1X2fVEQhTw51lKENdNrEqT3,5,4,0,0,0,0,3,0,7,1.0,1,0.0,0,0,0,0,4,0,0,3,0,0,7,1
10190,144799,mJTYU2VNehzj4vso65R9VtV3DFyktCio,A3fsA9Zfv1X2fVEQhTw51lKENdNrEqT3,1,0,0,0,0,0,1,0,1,0.14285714285714285,1,0.0,0,0,0,0,0,0,0,1,0,0,1,1
10191,144806,7vmy4dx8h1nmyk40XB1bVEo0ZK716pcj,SpATywNh6bZuzm8s1ceuBUnMUAeoAHHw,26,75,17,20,10,7,18,0,147,21.0,9,0.0,17,17,20,10,58,7,0,18,0,64,83,0
10192,144811,EORWbUeiO6FyoVtc0SbozxGi0vBVCOhI,RXDvfPUBYFlVdlueBFbLW0mhhAyGEqpt,7,6,0,0,0,1,9,0,16,2.2857142857142856,1,0.0,0,0,0,0,6,1,0,9,0,0,16,0
10193,144815,YB7yB7CNt6VhEWaKJG02XZ1X013EpWWP,SpATywNh6bZuzm8s1ceuBUnMUAeoAHHw,10,6,3,6,2,0,2,0,19,2.7142857142857144,1,0.0,0,3,6,2,6,0,0,2,0,11,8,1
10194,144837,w1HLpf01ff60tSyrkRwOPpdSlz3uqa1C,G8EPVSXsOYB5YQWZGiz1aVq5Pgr2GrQu,8,29,8,2,4,0,11,0,54,7.714285714285714,1,0.0,16,8,2,4,13,0,0,11,0,30,24,1
10195,144840,8EW2D448XGSlxAI534l0xtNnCA9hxB1o,SpATywNh6bZuzm8s1ceuBUnMUAeoAHHw,18,36,21,17,6,21,18,2,121,17.285714285714285,3,0.0,9,21,15,6,27,21,2,18,2,51,70,0
10196,144848,lWrAH12K4dJ1TRkFPwboUyykF2mRtmZq,SpATywNh6bZuzm8s1ceuBUnMUAeoAHHw,13,24,0,23,0,13,6,1,67,9.571428571428571,1,0.0,9,0,18,0,15,13,5,6,1,27,40,0
10197,144849,3Szk0pKijWd9ul5APNqiXkIk1r9cxADp,SpATywNh6bZuzm8s1ceuBUnMUAeoAHHw,14,21,2,5,1,3,13,5,50,7.142857142857143,3,0.0,3,2,4,1,18,3,1,13,5,10,40,1
10198,144857,nN9pe51IpLVxUmywITIZON7RGbeNZPas,SpATywNh6bZuzm8s1ceuBUnMUAeoAHHw,1,0,0,0,0,0,1,0,1,0.14285714285714285,1,0.0,0,0,0,0,0,0,0,1,0,0,1,1
10199,144869,wdtTKNG0uA9GskMOgg4nh6i8cQYwrWBl,A3fsA9Zfv1X2fVEQhTw51lKENdNrEqT3,2,0,0,0,0,0,2,0,2,0.2857142857142857,1,0.0,0,0,0,0,0,0,0,2,0,0,2,1
10200,144871,1R1zO9aMB7Mx1Lw84JzsChVEV5JpwmZv,A3fsA9Zfv1X2fVEQhTw51lKENdNrEqT3,12,13,3,0,2,0,7,0,25,3.5714285714285716,3,0.0,0,3,0,2,13,0,0,7,0,5,20,1
10201,144880,DPiNWGgyN27xfAyZbYcImdtWAWiA8G6T,A3fsA9Zfv1X2fVEQhTw51lKENdNrEqT3,2,0,0,0,0,0,6,0,6,0.8571428571428571,1,0.0,0,0,0,0,0,0,0,6,0,0,6,1
10202,144888,Fa0j89udkjEUrIyHxCII6V32n0NpiqGO,SpATywNh6bZuzm8s1ceuBUnMUAeoAHHw,4,5,0,0,0,0,2,0,7,1.0,1,0.0,1,0,0,0,4,0,0,2,0,1,6,1
10203,144889,y9hyyqGNd76OPDqzcsRztJJMWbz6UZny,bWdj2GDclj5ofokWjzoa5jAwMkxCykd6,5,2,1,0,1,0,2,0,6,0.8571428571428571,1,0.0,0,1,0,1,2,0,0,2,0,2,4,1
10204,144892,TBXYAxwexaNd47Tj9eT3p3QhXiwNSKj3,A3fsA9Zfv1X2fVEQhTw51lKENdNrEqT3,5,2,1,0,1,0,2,0,6,0.8571428571428571,1,0.0,0,1,0,1,2,0,0,2,0,2,4,1
10205,144900,k0mvvZulPoyJiICbYxKkU42hG2G5I80n,G8EPVSXsOYB5YQWZGiz1aVq5Pgr2GrQu,15,5,5,0,4,5,8,1,28,4.0,1,0.0,0,5,0,4,5,5,0,8,1,9,19,0
10206,144902,xbjVL5LPvdMl78h4grzGu4EO36e7wFtJ,G8EPVSXsOYB5YQWZGiz1aVq5Pgr2GrQu,17,24,14,14,9,0,4,0,65,9.285714285714286,1,0.0,7,14,13,9,17,0,1,4,0,43,22,1
10207,144906,ltWU63DD5GSM3zr2uNJoqVqAhziwXNdd,A3fsA9Zfv1X2fVEQhTw51lKENdNrEqT3,1,0,0,0,0,0,1,0,1,0.14285714285714285,1,0.0,0,0,0,0,0,0,0,1,0,0,1,1
10208,144910,3QwYnxvK4cR8IsGQGOLRPbhjjuJL7iw4,bWdj2GDclj5ofokWjzoa5jAwMkxCykd6,1,0,0,0,0,0,1,0,1,0.14285714285714285,1,0.0,0,0,0,0,0,0,0,1,0,0,1,1
10209,144913,xbjVL5LPvdMl78h4grzGu4EO36e7wFtJ,SpATywNh6bZuzm8s1ceuBUnMUAeoAHHw,16,14,5,18,2,5,6,1,51,7.285714285714286,1,0.0,7,5,15,2,7,5,3,6,1,29,22,1
10210,144917,qIeFceRzEPXi4DRrMYWrvBiuDgAZSOfu,SpATywNh6bZuzm8s1ceuBUnMUAeoAHHw,6,4,3,0,2,0,2,0,11,1.5714285714285714,1,0.0,0,3,0,2,4,0,0,2,0,5,6,1
10211,144929,j32U9Y949ZW1nXMwG0aPWZXCmluBzel9,A3fsA9Zfv1X2fVEQhTw51lKENdNrEqT3,2,0,0,0,0,0,2,0,2,0.2857142857142857,1,0.0,0,0,0,0,0,0,0,2,0,0,2,1
10212,144953,FDUH5NLrpwAq9aLqLXeux2jUy8LXyyH1,SpATywNh6bZuzm8s1ceuBUnMUAeoAHHw,4,2,0,0,0,0,2,0,4,0.5714285714285714,1,0.0,0,0,0,0,2,0,0,2,0,0,4,0
10213,144955,eE1Ts31Y4vQL30WuFQSepkqre5sjHOf7,A3fsA9Zfv1X2fVEQhTw51lKENdNrEqT3,1,0,0,0,0,0,1,0,1,0.14285714285714285,1,0.0,0,0,0,0,0,0,0,1,0,0,1,1
10214,144957,spFI1Ow5BGpTh0oHb0EunsXhby1WBBGm,A3fsA9Zfv1X2fVEQhTw51lKENdNrEqT3,2,0,0,0,0,0,2,0,2,0.2857142857142857,1,0.0,0,0,0,0,0,0,0,2,0,0,2,1
10215,144963,BohRHH2vBIgnEZGZjM3WnHwJbVFmITRG,A3fsA9Zfv1X2fVEQhTw51lKENdNrEqT3,1,0,0,0,0,0,10,0,10,1.4285714285714286,3,0.0,0,0,0,0,0,0,0,10,0,0,10,1
10216,144970,9fBHqnUYCnvcFTWqd4TwpElPXxWTxMR8,G8EPVSXsOYB5YQWZGiz1aVq5Pgr2GrQu,7,4,1,0,1,0,3,0,9,1.2857142857142858,2,0.0,0,1,0,1,4,0,0,3,0,2,7,1
10217,144985,UdRvlfQEjfzv2meiEECQoQ6VdSnYEWcK,RXDvfPUBYFlVdlueBFbLW0mhhAyGEqpt,17,21,12,30,10,6,6,0,85,12.142857142857142,3,0.0,6,12,22,10,15,6,8,6,0,50,35,1
10218,145015,MOcMwRKo0dtFqZ5xWBgRzquuZGKtQyf4,A3fsA9Zfv1X2fVEQhTw51lKENdNrEqT3,6,3,2,0,2,0,1,0,8,1.1428571428571428,1,0.0,0,2,0,2,3,0,0,1,0,4,4,1
10219,145021,qwhxcjW9iIMBAQoGSWDtst34AFkcFQoV,bWdj2GDclj5ofokWjzoa5jAwMkxCykd6,9,13,6,0,2,1,7,0,29,4.142857142857143,4,0.0,0,6,0,2,13,1,0,7,0,8,21,0
10220,145032,9KLyc4q5evm7m8P2TqAkjsYxwe72QOQ1,bWdj2GDclj5ofokWjzoa5jAwMkxCykd6,7,6,2,0,3,0,2,0,13,1.8571428571428572,1,0.0,2,2,0,3,4,0,0,2,0,7,6,1
10221,145045,fAwXW6DQAyNHjMN17jlyBSVcZRO4da21,bWdj2GDclj5ofokWjzoa5jAwMkxCykd6,3,2,0,0,0,0,1,0,3,0.42857142857142855,1,0.0,0,0,0,0,2,0,0,1,0,0,3,1
10222,145049,OoYnFZVZGncVBxTvo4CMvSktXlZzaVm6,SpATywNh6bZuzm8s1ceuBUnMUAeoAHHw,1,0,0,0,0,0,1,0,1,0.14285714285714285,1,0.0,0,0,0,0,0,0,0,1,0,0,1,1
10223,145054,aRdmmgSzM3Ga3svQ0ZT0DvTgw1R0bnD6,SpATywNh6bZuzm8s1ceuBUnMUAeoAHHw,22,30,2,27,0,9,13,0,81,11.571428571428571,5,0.0,6,2,24,0,24,9,3,13,0,32,49,0
10224,145066,YOvd9uht0tZm889aIFQH8jd68xtH7inE,A3fsA9Zfv1X2fVEQhTw51lKENdNrEqT3,42,40,18,62,7,0,15,0,142,20.285714285714285,5,0.0,3,18,55,7,37,0,7,15,0,83,59,0
10225,145068,sytW49I21SJ70ElOkXGU5SHeeHl1E3fL,SpATywNh6bZuzm8s1ceuBUnMUAeoAHHw,5,4,2,0,1,0,2,0,9,1.2857142857142858,2,0.0,0,2,0,1,4,0,0,2,0,3,6,1
10226,145074,zKArdfpgac7e9qM8jxPrRvIXOkmrDk9Z,SpATywNh6bZuzm8s1ceuBUnMUAeoAHHw,6,2,1,0,1,0,3,0,7,1.0,1,0.0,0,1,0,1,2,0,0,3,0,2,5,1
10227,145075,aVjhXoDZEpZewbee7kboIyQDdDGbqzp9,G8EPVSXsOYB5YQWZGiz1aVq5Pgr2GrQu,2,0,0,0,0,0,2,0,2,0.2857142857142857,1,0.0,0,0,0,0,0,0,0,2,0,0,2,1
10228,145091,ung1DnQyYgd0tfz7mAKTwJrrm5UPHWt1,SpATywNh6bZuzm8s1ceuBUnMUAeoAHHw,1,0,0,0,0,0,3,0,3,0.42857142857142855,2,0.0,0,0,0,0,0,0,0,3,0,0,3,1
10229,145095,tXsXr7pk3kL9xbg1D57dnKxY4YjIc1Gu,SpATywNh6bZuzm8s1ceuBUnMUAeoAHHw,1,0,0,0,0,0,1,0,1,0.14285714285714285,1,0.0,0,0,0,0,0,0,0,1,0,0,1,1
10230,145097,oQl0xDZ6pRPXU9L7MUpc2rUtjHufKB7J,RXDvfPUBYFlVdlueBFbLW0mhhAyGEqpt,4,3,2,0,0,0,1,0,6,0.8571428571428571,1,0.0,0,2,0,0,3,0,0,1,0,2,4,1
10231,145103,DSKmSALREyqQ6TTRJZ71cZdSUivRfs4F,A3fsA9Zfv1X2fVEQhTw51lKENdNrEqT3,8,6,3,0,2,0,3,0,14,2.0,1,0.0,0,3,0,2,6,0,0,3,0,5,9,1
10232,145104,GIGWJmYKqXl2NDr50MFNWHRPBdEAyP24,SpATywNh6bZuzm8s1ceuBUnMUAeoAHHw,6,2,1,0,1,0,7,1,12,1.7142857142857142,2,0.0,0,1,0,1,2,0,0,7,1,2,10,1
10233,145105,RjP92xCHXSUOtRBYjOBBQtIX0x4y84M8,SpATywNh6bZuzm8s1ceuBUnMUAeoAHHw,5,2,1,0,1,0,3,0,7,1.0,1,0.0,0,1,0,1,2,0,0,3,0,2,5,1
10234,145131,y7ML2j3yhLTXFlpVgDfbFQ7iV1QJE8KN,A3fsA9Zfv1X2fVEQhTw51lKENdNrEqT3,8,4,0,0,0,0,8,1,13,1.8571428571428572,2,0.0,0,0,0,0,4,0,0,8,1,0,13,1
10235,145132,VtMJYS2BOcqNwb9vhCBVs8m6rwGm1W7t,A3fsA9Zfv1X2fVEQhTw51lKENdNrEqT3,9,4,3,0,3,0,2,0,12,1.7142857142857142,1,0.0,0,3,0,3,4,0,0,2,0,6,6,1
10236,145133,gcAX0pXem59fO2vK8c72MGTEEeEu58YB,SpATywNh6bZuzm8s1ceuBUnMUAeoAHHw,9,8,4,0,2,0,10,1,25,3.5714285714285716,5,0.0,0,4,0,2,8,0,0,10,1,6,19,1
10237,145138,RiLBe5rsNsQ05e1l2H5DyOu2jxJ20lju,SpATywNh6bZuzm8s1ceuBUnMUAeoAHHw,5,6,0,0,0,0,2,0,8,1.1428571428571428,1,0.0,0,0,0,0,6,0,0,2,0,0,8,1
10238,145141,sytW49I21SJ70ElOkXGU5SHeeHl1E3fL,G8EPVSXsOYB5YQWZGiz1aVq5Pgr2GrQu,1,0,0,0,0,0,1,0,1,0.14285714285714285,1,0.0,0,0,0,0,0,0,0,1,0,0,1,1
10239,145177,2HllbOBswZcfya5rDzlXYMHVB93oWjxb,SpATywNh6bZuzm8s1ceuBUnMUAeoAHHw,31,104,38,22,7,21,19,0,211,30.142857142857142,8,0.0,15,38,19,7,89,21,3,19,0,79,132,1
10240,145209,VDfyMtI3GxFkSIKeQUI9WFdkBVMRRXiz,SpATywNh6bZuzm8s1ceuBUnMUAeoAHHw,5,3,0,0,0,0,4,0,7,1.0,1,0.0,0,0,0,0,3,0,0,4,0,0,7,1
10241,145213,paYCysIECekGmZR2IMHuvcxiMIpmnCQ8,SpATywNh6bZuzm8s1ceuBUnMUAeoAHHw,7,5,0,0,0,1,2,0,8,1.1428571428571428,1,0.0,0,0,0,0,5,1,0,2,0,0,8,1
10242,145218,gBdCgqP4ofpM7Vyy2N6nMT9XqzCjM1Oh,SpATywNh6bZuzm8s1ceuBUnMUAeoAHHw,7,3,2,0,2,0,2,0,9,1.2857142857142858,1,0.0,0,2,0,2,3,0,0,2,0,4,5,1
10243,145221,twJpEV6sOcVGisdKOs7bOfiwkX5tFRQS,SpATywNh6bZuzm8s1ceuBUnMUAeoAHHw,10,12,1,0,1,3,6,1,24,3.4285714285714284,1,0.0,0,1,0,1,12,3,0,6,1,2,22,1
10244,145265,OpGwtUbMGweipJr0vMybah9tM3IHgiea,bWdj2GDclj5ofokWjzoa5jAwMkxCykd6,12,24,2,60,4,0,3,0,93,13.285714285714286,3,0.0,11,2,57,4,13,0,3,3,0,74,19,1
10245,145278,TxcS8XkQULHRvLzAPNlWKiWhaRYPoBRt,G8EPVSXsOYB5YQWZGiz1aVq5Pgr2GrQu,6,2,1,0,1,0,4,0,8,1.1428571428571428,1,0.0,0,1,0,1,2,0,0,4,0,2,6,1
10246,145288,qJfYTCfAKzghj5i0hFgmRNbo2RAMR1vj,A3fsA9Zfv1X2fVEQhTw51lKENdNrEqT3,1,0,0,0,0,0,1,0,1,0.14285714285714285,1,0.0,0,0,0,0,0,0,0,1,0,0,1,1
10247,145291,hnuoUj2kTW5DzBnYNuL5k21Q4R9tMedy,G8EPVSXsOYB5YQWZGiz1aVq5Pgr2GrQu,1,0,0,0,0,0,1,0,1,0.14285714285714285,1,0.0,0,0,0,0,0,0,0,1,0,0,1,1
10248,145292,rwtLVsXV0McQpa98tIZ3wTZOVSCGNjDc,A3fsA9Zfv1X2fVEQhTw51lKENdNrEqT3,2,0,0,0,0,0,2,0,2,0.2857142857142857,1,0.0,0,0,0,0,0,0,0,2,0,0,2,1
10249,145295,vBbCzoxWi1xTyTmmDeTUsTbUY4qjPd8y,G8EPVSXsOYB5YQWZGiz1aVq5Pgr2GrQu,21,26,8,36,7,7,5,1,90,12.857142857142858,2,0.0,16,8,26,7,10,7,10,5,1,57,33,1
10250,145299,Msbm8ecHOfoRqpOAXpgLpOJMSb42Fh1S,bWdj2GDclj5ofokWjzoa5jAwMkxCykd6,1,0,0,0,0,0,2,0,2,0.2857142857142857,2,0.0,0,0,0,0,0,0,0,2,0,0,2,1
10251,145317,xXaLTSrOfjZMoecs1p8kChNEzFzZxcjE,bWdj2GDclj5ofokWjzoa5jAwMkxCykd6,2,0,0,0,0,0,2,0,2,0.2857142857142857,1,0.0,0,0,0,0,0,0,0,2,0,0,2,1
10252,145341,Cgu1GLWn7izWpBdNFknarDBOnLjP2HFo,SpATywNh6bZuzm8s1ceuBUnMUAeoAHHw,1,0,0,0,0,0,1,0,1,0.14285714285714285,1,0.0,0,0,0,0,0,0,0,1,0,0,1,1
10253,145345,RjNr7pqr5wdbMZIOQUnJioAJdhoV1M2t,A3fsA9Zfv1X2fVEQhTw51lKENdNrEqT3,2,0,0,0,0,0,2,0,2,0.2857142857142857,1,0.0,0,0,0,0,0,0,0,2,0,0,2,1
10254,145356,yODUqFZFhl66c3de8GWk0KnGzndelUJ3,SpATywNh6bZuzm8s1ceuBUnMUAeoAHHw,5,4,0,0,0,0,2,0,6,0.8571428571428571,1,0.0,0,0,0,0,4,0,0,2,0,0,6,1
10255,145357,vBbCzoxWi1xTyTmmDeTUsTbUY4qjPd8y,bWdj2GDclj5ofokWjzoa5jAwMkxCykd6,12,11,5,18,4,0,5,0,43,6.142857142857143,2,0.0,3,5,18,4,8,0,0,5,0,30,13,1
10256,145372,N7bFFbLK2teqNFII1ql8vn5jRsylN8ml,A3fsA9Zfv1X2fVEQhTw51lKENdNrEqT3,2,0,0,0,0,0,3,0,3,0.42857142857142855,1,0.0,0,0,0,0,0,0,0,3,0,0,3,1
10257,145379,7DPRFpgqZz2tLX453UgkvNfatiWrVLIi,bWdj2GDclj5ofokWjzoa5jAwMkxCykd6,1,0,0,0,0,0,1,0,1,0.14285714285714285,1,0.0,0,0,0,0,0,0,0,1,0,0,1,1
10258,145406,DaYS7gf8DVgCD84ya5YqgMFFiGYw1ps2,SpATywNh6bZuzm8s1ceuBUnMUAeoAHHw,5,2,1,0,1,0,2,0,6,0.8571428571428571,1,0.0,0,1,0,1,2,0,0,2,0,2,4,1
10259,145432,KMY78k4PWHNGUKa8SpxqTI7uzFKhJIDC,bWdj2GDclj5ofokWjzoa5jAwMkxCykd6,1,0,0,0,0,0,1,0,1,0.14285714285714285,1,0.0,0,0,0,0,0,0,0,1,0,0,1,1
10260,145434,r0Dep3QHNNWSPLkR08tICGVj5Fu7r77t,A3fsA9Zfv1X2fVEQhTw51lKENdNrEqT3,4,2,0,0,0,0,3,0,5,0.7142857142857143,2,0.0,0,0,0,0,2,0,0,3,0,0,5,1
10261,145436,uO6I869Gu09HIUH9g2koYFrRZOQcNS34,SpATywNh6bZuzm8s1ceuBUnMUAeoAHHw,1,0,0,0,0,0,1,0,1,0.14285714285714285,1,0.0,0,0,0,0,0,0,0,1,0,0,1,1
10262,145438,sETZmDR5b3CheYe2K5IvWb1lrRsZmOT8,A3fsA9Zfv1X2fVEQhTw51lKENdNrEqT3,4,2,1,0,1,0,2,0,6,0.8571428571428571,1,0.0,0,1,0,1,2,0,0,2,0,2,4,1
10263,145443,YjyR7WtUqlaMl5G5DWaaUx9XfYg7ssrK,G8EPVSXsOYB5YQWZGiz1aVq5Pgr2GrQu,1,0,0,0,0,0,1,0,1,0.14285714285714285,1,0.0,0,0,0,0,0,0,0,1,0,0,1,1
10264,145450,YAsCREgt5tIqJEvOtaek3jtgsLn87nEr,SpATywNh6bZuzm8s1ceuBUnMUAeoAHHw,4,2,0,0,0,2,2,0,6,0.8571428571428571,1,0.0,0,0,0,0,2,2,0,2,0,0,6,1
10265,145454,kjrJbHri2dhD9BduhqLwj0qNbqxkh9F5,G8EPVSXsOYB5YQWZGiz1aVq5Pgr2GrQu,3,3,0,0,0,0,1,0,4,0.5714285714285714,1,0.0,0,0,0,0,3,0,0,1,0,0,4,1
10266,145465,IvdoAzckjyWWCkzCy6V0BjWvOwMyZEwg,A3fsA9Zfv1X2fVEQhTw51lKENdNrEqT3,35,27,17,84,1,1,17,1,148,21.142857142857142,6,0.0,3,17,74,1,24,1,10,17,1,95,53,1
10267,145469,cRlXLJdkIX4KH74JKLBjP86zQb3lppxR,bWdj2GDclj5ofokWjzoa5jAwMkxCykd6,5,2,1,0,1,0,2,0,6,0.8571428571428571,1,0.0,0,1,0,1,2,0,0,2,0,2,4,1
10268,145472,vUg72yuNvNQBasGeqPwQue3GKgSAK3Os,bWdj2GDclj5ofokWjzoa5jAwMkxCykd6,7,3,2,0,2,0,2,0,9,1.2857142857142858,2,0.0,0,2,0,2,3,0,0,2,0,4,5,1
10269,145526,SxwYiL0K8imHewBqHVzk62D1lCszL0BN,SpATywNh6bZuzm8s1ceuBUnMUAeoAHHw,1,0,0,0,0,0,1,0,1,0.14285714285714285,1,0.0,0,0,0,0,0,0,0,1,0,0,1,1
10270,145527,lmlSe7ne5kLVEzM7wObkzo8bsMDoN8xr,SpATywNh6bZuzm8s1ceuBUnMUAeoAHHw,10,5,4,0,3,0,3,0,15,2.142857142857143,1,0.0,0,4,0,3,5,0,0,3,0,7,8,1
10271,145556,W7jA7ye7B2WHwijEGRwBOnLy8XlzJD6d,7GRhBDsirIGkRZBtSMEzNTyDr2JQm4xx,9,13,6,3,6,0,3,0,31,4.428571428571429,2,0.0,5,6,3,6,8,0,0,3,0,20,11,1
10272,145568,mJIoPjqDTjzZMwCDHGuOl5HDFi5poBoo,5X6FeZozNMgE2VRi3MJYjkkFK8SETtu2,1,0,0,0,0,0,1,0,1,0.14285714285714285,1,0.0,0,0,0,0,0,0,0,1,0,0,1,1
10273,145573,azsfvKoTKLQ8ipwpPOtqZMAvWCpOjcns,7GRhBDsirIGkRZBtSMEzNTyDr2JQm4xx,11,4,3,0,3,0,5,0,15,2.142857142857143,2,0.0,0,3,0,3,4,0,0,5,0,6,9,1
10274,145591,zUUxzMGQmBZk6tO8vnbhkaGffbYWZvas,7GRhBDsirIGkRZBtSMEzNTyDr2JQm4xx,1,0,0,0,0,0,1,0,1,0.14285714285714285,1,0.0,0,0,0,0,0,0,0,1,0,0,1,1
10275,145734,hzecatREssedFdFCykKMURt84PE7MA6q,7GRhBDsirIGkRZBtSMEzNTyDr2JQm4xx,1,0,0,0,0,0,1,0,1,0.14285714285714285,1,0.0,0,0,0,0,0,0,0,1,0,0,1,1
10276,145735,F4Ymj8M8QZRxfZ568RAeHEvyAX7UEtl3,5X6FeZozNMgE2VRi3MJYjkkFK8SETtu2,2,0,0,0,0,0,2,0,2,0.2857142857142857,1,0.0,0,0,0,0,0,0,0,2,0,0,2,1
10277,145746,qWYBo2adrtMVzANonhELRQVrWKW8T9T5,7GRhBDsirIGkRZBtSMEzNTyDr2JQm4xx,1,0,0,0,0,0,1,0,1,0.14285714285714285,1,0.0,0,0,0,0,0,0,0,1,0,0,1,1
10278,145767,PUvUSLbNhJCmhl8hY6hN43xWGmaNTEJm,7GRhBDsirIGkRZBtSMEzNTyDr2JQm4xx,3,2,1,0,0,0,1,0,4,0.5714285714285714,1,0.0,0,1,0,0,2,0,0,1,0,1,3,1
10279,145806,oIeIfwhQt9r1G6uZ62W7p7DLvDQ1KzcN,7GRhBDsirIGkRZBtSMEzNTyDr2JQm4xx,1,0,0,0,0,0,1,0,1,0.14285714285714285,1,0.0,0,0,0,0,0,0,0,1,0,0,1,1
10280,145807,RzKvPu4qwYnkKioYxIJem5I7hV4q5Zey,5X6FeZozNMgE2VRi3MJYjkkFK8SETtu2,2,0,0,0,0,0,14,0,14,2.0,2,0.0,0,0,0,0,0,0,0,14,0,0,14,0
10281,145824,iOFL9rLCMe8MjMlK3933AhOhA0dxbzTJ,7GRhBDsirIGkRZBtSMEzNTyDr2JQm4xx,2,0,0,0,0,0,2,0,2,0.2857142857142857,1,0.0,0,0,0,0,0,0,0,2,0,0,2,1
10282,145865,YYoTz5aT6oXhrDferhw1rplLYmNDgFub,7GRhBDsirIGkRZBtSMEzNTyDr2JQm4xx,40,91,2,0,15,0,2,0,110,15.714285714285714,2,0.0,60,2,0,15,31,0,0,2,0,77,33,0
10283,145878,vkI2g6NMz3qUYtvneHWPmtBdkC0OUJ1I,7GRhBDsirIGkRZBtSMEzNTyDr2JQm4xx,10,6,3,0,1,1,10,1,22,3.142857142857143,2,0.0,0,3,0,1,6,1,0,10,1,4,18,1
10284,145912,iKD9MJsvnX9ciKcvGfAz7YdFPBkrBH2I,5X6FeZozNMgE2VRi3MJYjkkFK8SETtu2,2,0,0,0,0,0,2,0,2,0.2857142857142857,1,0.0,0,0,0,0,0,0,0,2,0,0,2,1
10285,145953,TUdJl2punKYQuyj7cqcfXJ5p7FVAGa9A,7GRhBDsirIGkRZBtSMEzNTyDr2JQm4xx,12,30,13,0,4,1,3,0,51,7.285714285714286,2,0.0,8,13,0,4,22,1,0,3,0,25,26,1
10286,145989,ULvgH0dn9cMQ7RqvqnSWbMcAlKJJQ0Fk,7GRhBDsirIGkRZBtSMEzNTyDr2JQm4xx,2,0,0,0,0,0,2,0,2,0.2857142857142857,1,0.0,0,0,0,0,0,0,0,2,0,0,2,1
10287,146030,p0fw4v0FzqDHoIprXWv2PhAw9MEKisrS,3VkHkmOtom3jM2wCu94xgzzu1d6Dn7or,1,0,0,0,0,0,4,0,4,0.5714285714285714,1,0.0,0,0,0,0,0,0,0,4,0,0,4,0
10288,146088,5ZgKWEa42e4WFZ5q7dgOWe1eNOZx4GwM,3VkHkmOtom3jM2wCu94xgzzu1d6Dn7or,9,12,3,5,4,7,4,0,35,5.0,1,0.0,6,3,4,4,6,7,1,4,0,17,18,1
10289,146125,Bh1XqfOWD3l2FtZEwegqKxGpifXXNdJN,3VkHkmOtom3jM2wCu94xgzzu1d6Dn7or,9,16,7,0,5,4,4,0,36,5.142857142857143,1,0.0,4,7,0,5,12,4,0,4,0,16,20,1
10290,146129,9XyEVNM3WuxNMMtydG2KuKONQHNstdig,3VkHkmOtom3jM2wCu94xgzzu1d6Dn7or,6,2,1,0,1,0,4,1,9,1.2857142857142858,1,0.0,0,1,0,1,2,0,0,4,1,2,7,1
10291,146141,hF9wzZzzUNXUdemSIRccNUzFWcmYBmRA,3VkHkmOtom3jM2wCu94xgzzu1d6Dn7or,3,0,0,0,0,2,4,0,6,0.8571428571428571,2,0.0,0,0,0,0,0,2,0,4,0,0,6,1
10292,146150,hbRrVB0PrdEtXH8GGGBFfB3k36ebB3OX,3VkHkmOtom3jM2wCu94xgzzu1d6Dn7or,1,0,0,0,0,0,3,0,3,0.42857142857142855,1,0.0,0,0,0,0,0,0,0,3,0,0,3,1
10293,146153,BR3KNjegUloMzoYx4NUKOSSnRcwXdL8Z,3VkHkmOtom3jM2wCu94xgzzu1d6Dn7or,7,7,1,0,1,0,5,0,14,2.0,2,0.0,0,1,0,1,7,0,0,5,0,2,12,1
10294,146157,hMI82z3xwyibLI6HSTNSkdJkW2EbD9X5,3VkHkmOtom3jM2wCu94xgzzu1d6Dn7or,1,0,0,0,0,0,1,0,1,0.14285714285714285,1,0.0,0,0,0,0,0,0,0,1,0,0,1,1
10295,146204,Rm7NiSTRcB7r1obJzmNitfCOx35D0HWg,3VkHkmOtom3jM2wCu94xgzzu1d6Dn7or,5,2,1,0,1,0,2,0,6,0.8571428571428571,1,0.0,0,1,0,1,2,0,0,2,0,2,4,1
10296,146265,HAAd4i2Dbdg5zfCsIa6cyt0n4dIwRrHT,3VkHkmOtom3jM2wCu94xgzzu1d6Dn7or,1,0,0,0,0,0,1,0,1,0.14285714285714285,1,0.0,0,0,0,0,0,0,0,1,0,0,1,1
10297,146270,41XQah6d0f9hcRZOlQ9rAlVZvkLRx2th,3VkHkmOtom3jM2wCu94xgzzu1d6Dn7or,5,2,1,0,1,0,2,0,6,0.8571428571428571,1,0.0,0,1,0,1,2,0,0,2,0,2,4,1
10298,146286,BfyHpsFcf5SdJtDDEokJ2DaJODuDhRyN,3VkHkmOtom3jM2wCu94xgzzu1d6Dn7or,1,0,0,0,0,0,1,0,1,0.14285714285714285,1,0.0,0,0,0,0,0,0,0,1,0,0,1,0
10299,146381,B617XtuzfaazOCyEoxmlGt9BoJzuhRfF,3VkHkmOtom3jM2wCu94xgzzu1d6Dn7or,1,0,0,0,0,0,1,0,1,0.14285714285714285,1,0.0,0,0,0,0,0,0,0,1,0,0,1,1
10300,146386,6gBl9jZf9smJOKDJTr2au2myiSPXFYdj,3VkHkmOtom3jM2wCu94xgzzu1d6Dn7or,2,0,0,0,0,0,2,0,2,0.2857142857142857,1,0.0,0,0,0,0,0,0,0,2,0,0,2,1
10301,146406,srAtmjq13mrVXP6Fz4IrGLiyqwc9XE9D,3VkHkmOtom3jM2wCu94xgzzu1d6Dn7or,6,4,1,0,1,0,4,0,10,1.4285714285714286,1,0.0,2,1,0,1,2,0,0,4,0,4,6,1
10302,146416,TeUT01LyHIjK17Pt45AAodeVSkOVbecw,3VkHkmOtom3jM2wCu94xgzzu1d6Dn7or,2,0,0,0,0,0,3,0,3,0.42857142857142855,1,0.0,0,0,0,0,0,0,0,3,0,0,3,1
10303,146427,SxwYiL0K8imHewBqHVzk62D1lCszL0BN,3VkHkmOtom3jM2wCu94xgzzu1d6Dn7or,1,0,0,0,0,0,1,0,1,0.14285714285714285,1,0.0,0,0,0,0,0,0,0,1,0,0,1,1
10304,146429,7LQi4DdHoXorygBnRTdfQ002aWsmdA67,3VkHkmOtom3jM2wCu94xgzzu1d6Dn7or,66,156,41,73,36,1,26,0,333,47.57142857142857,10,0.0,58,41,71,36,98,1,2,26,0,206,127,0
10305,146461,3n6ajKAkQu8rgtUnNpdWOfMF8VSNsMVs,3VkHkmOtom3jM2wCu94xgzzu1d6Dn7or,4,0,0,0,0,9,3,0,12,1.7142857142857142,1,0.0,0,0,0,0,0,9,0,3,0,0,12,1
10306,146487,fTcFH58Cw752lPnCGf5x6q5eEon6zuX3,3VkHkmOtom3jM2wCu94xgzzu1d6Dn7or,4,4,1,0,0,0,1,0,6,0.8571428571428571,1,0.0,0,1,0,0,4,0,0,1,0,1,5,1
10307,146488,5Zai53b50WVBE5hKH1c6pfutFqTxzA73,3VkHkmOtom3jM2wCu94xgzzu1d6Dn7or,1,0,0,0,0,0,1,0,1,0.14285714285714285,1,0.0,0,0,0,0,0,0,0,1,0,0,1,1
10308,146501,RzFBvVoh5etyCpMS4xSy7pBkQzhnynt8,3VkHkmOtom3jM2wCu94xgzzu1d6Dn7or,8,4,2,0,1,0,7,0,14,2.0,2,0.0,0,2,0,1,4,0,0,7,0,3,11,1
10309,146537,5gHshx7kYLGiQqmHsTdONQBFgnspojH8,3VkHkmOtom3jM2wCu94xgzzu1d6Dn7or,1,0,0,0,0,0,2,0,2,0.2857142857142857,1,0.0,0,0,0,0,0,0,0,2,0,0,2,1
10310,146545,7oYfkKRqp5qH8msQgLOvvi2uWytP3BFJ,3VkHkmOtom3jM2wCu94xgzzu1d6Dn7or,1,0,0,0,0,0,2,0,2,0.2857142857142857,1,0.0,0,0,0,0,0,0,0,2,0,0,2,1
10311,146567,JnJRaNJGpEv1jND4E80Q1qrNA6h3u4XV,3VkHkmOtom3jM2wCu94xgzzu1d6Dn7or,5,3,1,0,1,0,2,0,7,1.0,1,0.0,0,1,0,1,3,0,0,2,0,2,5,1
10312,146589,cmPAv0G01upQaGYeDqwQ4S5qXOhzhpzv,7GRhBDsirIGkRZBtSMEzNTyDr2JQm4xx,58,88,17,54,23,9,8,0,199,28.428571428571427,3,0.0,63,17,27,23,25,9,27,8,0,130,69,1
10313,146605,9EKebTddhclJL55PjLiGQo9OLE0PGHsa,7GRhBDsirIGkRZBtSMEzNTyDr2JQm4xx,5,2,1,0,1,0,2,0,6,0.8571428571428571,1,0.0,0,1,0,1,2,0,0,2,0,2,4,1
10314,146626,6hX10Wu1E2KDRE7mYGP1VPoNRkdF7lrL,7GRhBDsirIGkRZBtSMEzNTyDr2JQm4xx,2,0,0,0,0,0,2,0,2,0.2857142857142857,1,0.0,0,0,0,0,0,0,0,2,0,0,2,1
10315,146630,OQs5DQZggGhucPRMJFFD3iwpCiRr1PsA,7GRhBDsirIGkRZBtSMEzNTyDr2JQm4xx,26,20,10,10,13,0,3,0,56,8.0,1,0.0,9,10,6,13,11,0,4,3,0,38,18,0
10316,146640,pTRc6CAadu6zTjX2qZFrcMkdMB0bHDuN,7GRhBDsirIGkRZBtSMEzNTyDr2JQm4xx,13,9,6,0,6,0,6,0,27,3.857142857142857,1,0.0,0,6,0,6,9,0,0,6,0,12,15,1
10317,146641,EgpDPflS4BhonvUv2cHFmcaZA6HKkGFU,7GRhBDsirIGkRZBtSMEzNTyDr2JQm4xx,1,0,0,0,0,0,1,0,1,0.14285714285714285,1,0.0,0,0,0,0,0,0,0,1,0,0,1,1
10318,146643,SdTaXBG7REox88XfdMpaUAB4YsjrXpUf,7GRhBDsirIGkRZBtSMEzNTyDr2JQm4xx,2,0,0,0,0,0,2,0,2,0.2857142857142857,1,0.0,0,0,0,0,0,0,0,2,0,0,2,1
10319,146646,h8QJMBO6w1y7T0vbgdE5PdsJTbaRhwO4,7GRhBDsirIGkRZBtSMEzNTyDr2JQm4xx,10,3,2,0,1,1,6,1,14,2.0,1,0.0,0,2,0,1,3,1,0,6,1,3,11,1
10320,146810,oOXpwQYARdFIxXrQ6sYVF4DXSqd0OmBs,3VkHkmOtom3jM2wCu94xgzzu1d6Dn7or,5,5,2,0,1,0,2,0,10,1.4285714285714286,2,0.0,0,2,0,1,5,0,0,2,0,3,7,1
10321,146816,PTKB8bd5qh2006KGct9uCgjhYN03wvoy,3VkHkmOtom3jM2wCu94xgzzu1d6Dn7or,9,37,17,3,10,3,16,0,86,12.285714285714286,6,0.0,9,17,3,10,28,3,0,16,0,39,47,1
10322,146818,yGll7cBEK4l513wg08W8WjrXiINZSUwd,3VkHkmOtom3jM2wCu94xgzzu1d6Dn7or,4,2,1,0,1,0,1,0,5,0.7142857142857143,1,0.0,0,1,0,1,2,0,0,1,0,2,3,1
10323,146820,IsadHJOwNaj1oDSfODX6YQ3zhU5rGmsp,3VkHkmOtom3jM2wCu94xgzzu1d6Dn7or,4,3,0,0,0,0,2,0,5,0.7142857142857143,1,0.0,0,0,0,0,3,0,0,2,0,0,5,1
10324,146831,Ztd12M7Z9bcBRNRSsNmIlBULfPhqrHyq,3VkHkmOtom3jM2wCu94xgzzu1d6Dn7or,17,38,5,13,16,0,4,0,76,10.857142857142858,1,0.0,26,5,10,16,12,0,3,4,0,57,19,1
10325,146840,Pdvh6UTK9FXuCE4WVrV5Y121aJBdVbkt,3VkHkmOtom3jM2wCu94xgzzu1d6Dn7or,5,9,5,0,2,0,5,0,21,3.0,2,0.0,0,5,0,2,9,0,0,5,0,7,14,1
10326,146842,tvlPmqHL9PXqDvjLJ02gNq4VLJb5A42f,3VkHkmOtom3jM2wCu94xgzzu1d6Dn7or,9,28,2,6,7,0,5,0,48,6.857142857142857,1,0.0,21,2,5,7,7,0,1,5,0,35,13,1
10327,146843,EUUfQTv6vUzkuoskuW3kW6Hpb2j0Ef88,3VkHkmOtom3jM2wCu94xgzzu1d6Dn7or,49,42,1,84,17,0,6,0,150,21.428571428571427,1,0.0,21,1,70,17,21,0,14,6,0,109,41,1
10328,146845,bmHkulbXG0BjFpKMImZMFiP0baUfbcTM,3VkHkmOtom3jM2wCu94xgzzu1d6Dn7or,14,40,6,6,7,8,5,0,72,10.285714285714286,2,0.0,18,6,6,7,22,8,0,5,0,37,35,0
10329,146848,3fP0Xga7TS7Jsjk4DeQ5kqvq5cbz44YC,3VkHkmOtom3jM2wCu94xgzzu1d6Dn7or,10,23,5,11,9,0,1,0,49,7.0,1,0.0,17,5,9,9,6,0,2,1,0,40,9,1
10330,146853,CNqk6cg6jWF1610X55efjYNNGXI0iRJg,3VkHkmOtom3jM2wCu94xgzzu1d6Dn7or,1,0,0,0,0,0,2,0,2,0.2857142857142857,2,0.0,0,0,0,0,0,0,0,2,0,0,2,1
10331,146862,GXaWQVeuF1AxK2nB4DS6IZdQ6sDVS1nk,3VkHkmOtom3jM2wCu94xgzzu1d6Dn7or,1,0,0,0,0,0,1,0,1,0.14285714285714285,1,0.0,0,0,0,0,0,0,0,1,0,0,1,1
10332,146863,tBFPasxeVyKNeSOXIs2AXEH5l7WLcUsl,3VkHkmOtom3jM2wCu94xgzzu1d6Dn7or,1,0,0,0,0,0,1,0,1,0.14285714285714285,1,0.0,0,0,0,0,0,0,0,1,0,0,1,1
10333,146864,oW9L7CxP0sDxYCxol70CUfkBpdozjWLb,3VkHkmOtom3jM2wCu94xgzzu1d6Dn7or,15,16,6,0,6,2,6,0,36,5.142857142857143,2,0.0,3,6,0,6,13,2,0,6,0,15,21,0
10334,146876,whXUFOJ70VhYM5aEzjMsCGcx2sy2vjyH,3VkHkmOtom3jM2wCu94xgzzu1d6Dn7or,2,0,0,0,0,0,2,0,2,0.2857142857142857,1,0.0,0,0,0,0,0,0,0,2,0,0,2,1
10335,146883,1JGeoCLOy0Ohd1AVNEEwdkSiGm93i5PR,3VkHkmOtom3jM2wCu94xgzzu1d6Dn7or,4,2,1,0,0,0,2,0,5,0.7142857142857143,1,0.0,0,1,0,0,2,0,0,2,0,1,4,1
10336,146887,jcXoYFaI9QPcliotiwIgOLeObkrSUvNn,3VkHkmOtom3jM2wCu94xgzzu1d6Dn7or,5,2,1,0,1,0,2,0,6,0.8571428571428571,1,0.0,0,1,0,1,2,0,0,2,0,2,4,1
10337,146898,EjT6fX5T9wBIN8gJ6jd6KRGiSiN1cqcA,3VkHkmOtom3jM2wCu94xgzzu1d6Dn7or,7,5,3,0,2,0,3,0,13,1.8571428571428572,2,0.0,0,3,0,2,5,0,0,3,0,5,8,1
10338,146936,c5MkJ205AcjWsm07YpOktUEc4lrC6DvN,RXDvfPUBYFlVdlueBFbLW0mhhAyGEqpt,1,0,0,0,0,0,1,0,1,0.14285714285714285,1,0.0,0,0,0,0,0,0,0,1,0,0,1,1
10339,146953,TkwNaNrSLynIgxaNvilfhFA70R9L2fY3,RXDvfPUBYFlVdlueBFbLW0mhhAyGEqpt,28,36,4,21,2,0,13,0,76,10.857142857142858,5,0.0,3,4,19,2,33,0,2,13,0,28,48,0
10340,147072,8yNyyy8aPKd19nuqwaynaLkU67KuROpn,G8EPVSXsOYB5YQWZGiz1aVq5Pgr2GrQu,9,7,3,0,3,0,3,0,16,2.2857142857142856,2,0.0,0,3,0,3,7,0,0,3,0,6,10,1
10341,147073,aFc1dZRXyhduGfLgWKifgShSyZKIHAn2,G8EPVSXsOYB5YQWZGiz1aVq5Pgr2GrQu,1,0,0,0,0,0,1,0,1,0.14285714285714285,1,0.0,0,0,0,0,0,0,0,1,0,0,1,1
10342,147106,114X1vLT3OTzchhxfRGg24FTsgrs6Boi,G8EPVSXsOYB5YQWZGiz1aVq5Pgr2GrQu,1,0,0,0,0,0,1,0,1,0.14285714285714285,1,0.0,0,0,0,0,0,0,0,1,0,0,1,1
10343,147113,sL5jw3pLWZoRI7avI17oM60mfF67Acgz,RXDvfPUBYFlVdlueBFbLW0mhhAyGEqpt,1,0,0,0,0,0,3,0,3,0.42857142857142855,3,0.0,0,0,0,0,0,0,0,3,0,0,3,0
10344,147134,FmbW6BMW2tvli3L6T9qC97SAIzFg6ww1,G8EPVSXsOYB5YQWZGiz1aVq5Pgr2GrQu,1,0,0,0,0,0,1,0,1,0.14285714285714285,1,0.0,0,0,0,0,0,0,0,1,0,0,1,1
10345,147182,Z8r3kWGF2ZuWSy5TZGg00SEG4qfRh2Ag,RXDvfPUBYFlVdlueBFbLW0mhhAyGEqpt,1,0,0,0,0,0,1,0,1,0.14285714285714285,1,0.0,0,0,0,0,0,0,0,1,0,0,1,1
10346,147195,CabsQjb2Sd2I3ynTdtsErAG67rLex08f,RXDvfPUBYFlVdlueBFbLW0mhhAyGEqpt,1,0,0,0,0,0,1,0,1,0.14285714285714285,1,0.0,0,0,0,0,0,0,0,1,0,0,1,1
10347,147226,G6cW0d2bzLHgB0vreFbhNx3GSiMBKbtv,RXDvfPUBYFlVdlueBFbLW0mhhAyGEqpt,1,0,0,0,0,0,1,0,1,0.14285714285714285,1,0.0,0,0,0,0,0,0,0,1,0,0,1,1
10348,147256,mKHQM9iW9olu6z2WamdxK7ySH3UwX3JX,G8EPVSXsOYB5YQWZGiz1aVq5Pgr2GrQu,1,0,0,0,0,0,1,0,1,0.14285714285714285,1,0.0,0,0,0,0,0,0,0,1,0,0,1,1
10349,147302,yYdEa9txfr33mPdKZaxK9a9x3sCFYrvO,RXDvfPUBYFlVdlueBFbLW0mhhAyGEqpt,1,0,0,0,0,0,1,0,1,0.14285714285714285,1,0.0,0,0,0,0,0,0,0,1,0,0,1,1
10350,147396,fr3LtKJIFGCsR1nz5ebBpapeX9CBJz4r,RXDvfPUBYFlVdlueBFbLW0mhhAyGEqpt,1,0,0,0,0,0,1,0,1,0.14285714285714285,1,0.0,0,0,0,0,0,0,0,1,0,0,1,1
10351,147400,W0jA3kW6UFNLExCUVwSYpHHYwJL1vqo8,G8EPVSXsOYB5YQWZGiz1aVq5Pgr2GrQu,1,0,0,0,0,0,1,0,1,0.14285714285714285,1,0.0,0,0,0,0,0,0,0,1,0,0,1,1
10352,147402,hlub8IQ6xr3M5qQPn6YnEFWROpuhMcwL,RXDvfPUBYFlVdlueBFbLW0mhhAyGEqpt,1,0,0,0,0,0,1,0,1,0.14285714285714285,1,0.0,0,0,0,0,0,0,0,1,0,0,1,1
10353,147419,T7YlTqIDVTZFYEYihxD1Zij5IkDsmVZP,RXDvfPUBYFlVdlueBFbLW0mhhAyGEqpt,1,0,0,0,0,0,1,0,1,0.14285714285714285,1,0.0,0,0,0,0,0,0,0,1,0,0,1,1
10354,147428,qyJkLuZ2kSoWLr9To4rUoAUCy3t2DtqK,RXDvfPUBYFlVdlueBFbLW0mhhAyGEqpt,22,23,1,23,2,1,6,1,57,8.142857142857142,2,0.0,4,1,23,2,19,1,0,6,1,30,27,1
10355,147484,ly5oRv8hiewZ1JUIP5AGbwWRi69QKnfA,G8EPVSXsOYB5YQWZGiz1aVq5Pgr2GrQu,1,0,0,0,0,0,1,0,1,0.14285714285714285,1,0.0,0,0,0,0,0,0,0,1,0,0,1,1
10356,147496,fJRilHVpgCFPzgCMD6Xh8rgK6259Z6TQ,RXDvfPUBYFlVdlueBFbLW0mhhAyGEqpt,1,0,0,0,0,0,1,0,1,0.14285714285714285,1,0.0,0,0,0,0,0,0,0,1,0,0,1,1
10357,147511,GXuacM1G2BzxiXouSVLnDv1V97NGwCCe,G8EPVSXsOYB5YQWZGiz1aVq5Pgr2GrQu,1,0,0,0,0,0,1,0,1,0.14285714285714285,1,0.0,0,0,0,0,0,0,0,1,0,0,1,1
10358,147512,WnXohtCVTjGmg2VYZ7QMusUaSQiMqg1z,G8EPVSXsOYB5YQWZGiz1aVq5Pgr2GrQu,1,0,0,0,0,0,1,0,1,0.14285714285714285,1,0.0,0,0,0,0,0,0,0,1,0,0,1,1
10359,147519,nYcDj7802ShzcCKfMPZblsaYoLQlLfFa,RXDvfPUBYFlVdlueBFbLW0mhhAyGEqpt,1,0,0,0,0,0,2,0,2,0.2857142857142857,1,0.0,0,0,0,0,0,0,0,2,0,0,2,1
10360,147558,FgDDMWCPhLKDQm2tOcaDRFOiW3MmNhxn,RXDvfPUBYFlVdlueBFbLW0mhhAyGEqpt,1,0,0,0,0,0,1,0,1,0.14285714285714285,1,0.0,0,0,0,0,0,0,0,1,0,0,1,1
10361,147627,qtx0N6lbHC7rLYVDABZMZjBHS66niL8J,RXDvfPUBYFlVdlueBFbLW0mhhAyGEqpt,1,0,0,0,0,0,1,0,1,0.14285714285714285,1,0.0,0,0,0,0,0,0,0,1,0,0,1,1
10362,147631,V1B34PKYcESnicIbQVUA4gpuU2uOqNWz,G8EPVSXsOYB5YQWZGiz1aVq5Pgr2GrQu,1,0,0,0,0,0,1,0,1,0.14285714285714285,1,0.0,0,0,0,0,0,0,0,1,0,0,1,1
10363,147661,8Eqf4bSicFmRziRU1kFgF89C5yGB8WDX,RXDvfPUBYFlVdlueBFbLW0mhhAyGEqpt,1,0,0,0,0,0,2,0,2,0.2857142857142857,2,0.0,0,0,0,0,0,0,0,2,0,0,2,1
10364,147668,RXybWoyBfxb1StD4gTX3cQ7Ir2hHF7eD,G8EPVSXsOYB5YQWZGiz1aVq5Pgr2GrQu,1,0,0,0,0,0,1,0,1,0.14285714285714285,1,0.0,0,0,0,0,0,0,0,1,0,0,1,1
10365,147692,97s9Gq3v1SpdnbcXTUeP0PbnntkfF2Gl,G8EPVSXsOYB5YQWZGiz1aVq5Pgr2GrQu,1,0,0,0,0,0,1,0,1,0.14285714285714285,1,0.0,0,0,0,0,0,0,0,1,0,0,1,1
10366,147731,y25cTP8mHUkaHLXFWhaRvqNBGzTMte3f,RXDvfPUBYFlVdlueBFbLW0mhhAyGEqpt,1,0,0,0,0,0,1,0,1,0.14285714285714285,1,0.0,0,0,0,0,0,0,0,1,0,0,1,1
10367,147756,kjYtN2fLOM5h2d7NgR39VaAB4M2wF6SJ,fbPkOYLVPtPgIt0MxizjfFJov3JbHyAi,3,0,0,0,0,0,4,0,4,0.5714285714285714,1,0.0,0,0,0,0,0,0,0,4,0,0,4,0
10368,147757,PR1Ko3tMvIqClzd4kShPXdxxynmXc5v2,fbPkOYLVPtPgIt0MxizjfFJov3JbHyAi,3,2,0,0,0,0,1,0,3,0.42857142857142855,1,0.0,0,0,0,0,2,0,0,1,0,0,3,1
10369,147760,Ie773JkkSDQvIHXsBZsmS2dO9aRzKpSr,fbPkOYLVPtPgIt0MxizjfFJov3JbHyAi,5,2,1,0,1,0,2,0,6,0.8571428571428571,1,0.0,0,1,0,1,2,0,0,2,0,2,4,0
10370,147765,FTc6jHk7ojdVaEQtsGdTEiSOrQxUe2mX,fbPkOYLVPtPgIt0MxizjfFJov3JbHyAi,5,2,1,0,1,0,2,0,6,0.8571428571428571,1,0.0,0,1,0,1,2,0,0,2,0,2,4,1
10371,147766,V7i4XepTGJkVDBndf2aQyywvfMxZi1VZ,fbPkOYLVPtPgIt0MxizjfFJov3JbHyAi,5,3,1,0,1,0,3,0,8,1.1428571428571428,1,0.0,0,1,0,1,3,0,0,3,0,2,6,1
10372,147767,pfujrhh6IFsgpvQm0YrnHZDUVmO3MMCt,fbPkOYLVPtPgIt0MxizjfFJov3JbHyAi,2,0,0,0,0,0,3,0,3,0.42857142857142855,1,0.0,0,0,0,0,0,0,0,3,0,0,3,1
10373,147777,ADt4SeNSXIM0T3FNDJeQ4CFmAhPZqDNW,fbPkOYLVPtPgIt0MxizjfFJov3JbHyAi,7,3,2,0,2,0,2,0,9,1.2857142857142858,1,0.0,0,2,0,2,3,0,0,2,0,4,5,1
10374,147779,BucCzwL2XP7gPTz7VVXQ2NN15VleWmxc,fbPkOYLVPtPgIt0MxizjfFJov3JbHyAi,7,3,2,0,2,0,2,0,9,1.2857142857142858,1,0.0,0,2,0,2,3,0,0,2,0,4,5,1
10375,147788,v80xARhw6o0qWoZhV3Z6c6dVXIF7GAis,fbPkOYLVPtPgIt0MxizjfFJov3JbHyAi,8,5,2,0,2,2,5,0,16,2.2857142857142856,1,0.0,0,2,0,2,5,2,0,5,0,4,12,1
10376,147792,rT1OrFQC18rdvYkTGYqwRgC7eDvihHsc,fbPkOYLVPtPgIt0MxizjfFJov3JbHyAi,1,0,0,0,0,2,0,0,2,0.2857142857142857,1,0.0,0,0,0,0,0,2,0,0,0,0,2,1
10377,147805,tftk2lpy46oUtFBoiUqZftLC1w52aVR4,5Gyp41oLVo7Gg7vF4vpmggWP5MU70QO6,4,2,0,0,0,0,3,0,5,0.7142857142857143,1,0.0,0,0,0,0,2,0,0,3,0,0,5,1
10378,147811,gXLitrmdBVXj6hOavgwX5Kv8nSH9hE13,5Gyp41oLVo7Gg7vF4vpmggWP5MU70QO6,2,0,0,0,0,0,2,0,2,0.2857142857142857,1,0.0,0,0,0,0,0,0,0,2,0,0,2,1
10379,147818,b2ohpFiEgZaZsBBPqUMnfjpywCAbNR88,5Gyp41oLVo7Gg7vF4vpmggWP5MU70QO6,1,0,0,0,0,0,1,0,1,0.14285714285714285,1,0.0,0,0,0,0,0,0,0,1,0,0,1,1
10380,147860,drueXeBWixFThYW148nki4eFPlnN0ceQ,5Gyp41oLVo7Gg7vF4vpmggWP5MU70QO6,4,2,1,0,0,0,2,0,5,0.7142857142857143,1,0.0,0,1,0,0,2,0,0,2,0,1,4,1
10381,147865,ZLrFhujCu1GYe9vslCLEfOmIFjQWSDsp,5Gyp41oLVo7Gg7vF4vpmggWP5MU70QO6,1,0,0,0,0,0,1,0,1,0.14285714285714285,1,0.0,0,0,0,0,0,0,0,1,0,0,1,1
10382,147894,rSiN1kTw2xbRsjF9BN3yUneRjJkZ8YKM,5Gyp41oLVo7Gg7vF4vpmggWP5MU70QO6,7,6,0,0,0,0,10,0,16,2.2857142857142856,3,0.0,0,0,0,0,6,0,0,10,0,0,16,1
10383,147902,dy6Zpf6SHivuEMzVbXysN6HLT1APxBtg,5Gyp41oLVo7Gg7vF4vpmggWP5MU70QO6,5,3,2,0,0,0,2,0,7,1.0,1,0.0,0,2,0,0,3,0,0,2,0,2,5,1
10384,147941,koVX8tCHV978kRzpSr9Kw3f0QZ9cjrGR,5Gyp41oLVo7Gg7vF4vpmggWP5MU70QO6,5,2,1,0,1,0,2,0,6,0.8571428571428571,1,0.0,0,1,0,1,2,0,0,2,0,2,4,1
10385,148007,vuVnTFCBfdzSvUffWnstx1XETLzOHwWp,5Gyp41oLVo7Gg7vF4vpmggWP5MU70QO6,1,0,0,0,0,0,2,0,2,0.2857142857142857,2,0.0,0,0,0,0,0,0,0,2,0,0,2,1
10386,148009,zCJfWd31cSL3nAYNdLVd2wJYEQhn4S1i,5Gyp41oLVo7Gg7vF4vpmggWP5MU70QO6,1,0,0,0,0,0,1,0,1,0.14285714285714285,1,0.0,0,0,0,0,0,0,0,1,0,0,1,1
10387,148010,szo3dxoUVFtnyPC8dDQr5oYgurANL0jM,5Gyp41oLVo7Gg7vF4vpmggWP5MU70QO6,1,0,0,0,0,0,1,0,1,0.14285714285714285,1,0.0,0,0,0,0,0,0,0,1,0,0,1,1
10388,148043,wpSpDcXHsdXkRVpbtm1hXwCRQFLPOV7G,5Gyp41oLVo7Gg7vF4vpmggWP5MU70QO6,5,2,1,0,1,0,2,0,6,0.8571428571428571,1,0.0,0,1,0,1,2,0,0,2,0,2,4,1
10389,148063,SB6c72YMu2I6UoxRlKmbFhpADSxoKwQc,5Gyp41oLVo7Gg7vF4vpmggWP5MU70QO6,14,28,12,14,13,5,8,0,80,11.428571428571429,3,0.0,12,12,9,13,16,5,5,8,0,46,34,1
10390,148083,kjrJbHri2dhD9BduhqLwj0qNbqxkh9F5,5Gyp41oLVo7Gg7vF4vpmggWP5MU70QO6,11,7,6,0,4,0,1,0,18,2.5714285714285716,1,0.0,0,6,0,4,7,0,0,1,0,10,8,1
10391,148191,h3GEL33ZjWW6TpuAxgoUiVq42WJkrtPw,5Gyp41oLVo7Gg7vF4vpmggWP5MU70QO6,17,16,10,4,4,16,8,1,59,8.428571428571429,1,0.0,5,10,2,4,11,16,2,8,1,21,38,1
10392,148202,o8kHR47syKKEbYoWQpVJ0TZ0kXlfuaxo,5Gyp41oLVo7Gg7vF4vpmggWP5MU70QO6,1,0,0,0,0,0,1,0,1,0.14285714285714285,1,0.0,0,0,0,0,0,0,0,1,0,0,1,1
10393,148208,Zp2S71jHE6ylpy0KCBMNtqgAseq1yfR6,5Gyp41oLVo7Gg7vF4vpmggWP5MU70QO6,5,2,1,0,1,0,2,0,6,0.8571428571428571,1,0.0,0,1,0,1,2,0,0,2,0,2,4,1
10394,148248,uVnx7FjvELGOuvTyZhK3CuRgHkmAxzaa,5Gyp41oLVo7Gg7vF4vpmggWP5MU70QO6,1,0,0,0,0,0,1,0,1,0.14285714285714285,1,0.0,0,0,0,0,0,0,0,1,0,0,1,1
10395,148286,YFMufLtcQ6iEP2bQyAB5uI0HLfSzIDX1,5Gyp41oLVo7Gg7vF4vpmggWP5MU70QO6,1,0,0,0,0,0,1,0,1,0.14285714285714285,1,0.0,0,0,0,0,0,0,0,1,0,0,1,1
10396,148296,rum49bxsKrsKz5qfYVoNEGa5FabtWndb,7GRhBDsirIGkRZBtSMEzNTyDr2JQm4xx,1,0,0,0,0,0,1,0,1,0.14285714285714285,1,0.0,0,0,0,0,0,0,0,1,0,0,1,1
10397,148297,mSs5bB1Rxg3xYWjWjJY9pVTt7WAiMgyu,7GRhBDsirIGkRZBtSMEzNTyDr2JQm4xx,7,3,2,0,2,0,5,0,12,1.7142857142857142,3,0.0,0,2,0,2,3,0,0,5,0,4,8,0
10398,148300,FKqGzWb3VsmU7jpYPJbCVaVAzRrOMrbY,7GRhBDsirIGkRZBtSMEzNTyDr2JQm4xx,13,14,3,6,4,25,8,0,60,8.571428571428571,1,0.0,8,3,5,4,6,25,1,8,0,20,40,0
10399,148306,YITKlH8EFDS1BDDcEfdQ73rlI4f37n9A,7GRhBDsirIGkRZBtSMEzNTyDr2JQm4xx,7,5,2,4,2,2,2,0,17,2.4285714285714284,1,0.0,1,2,4,2,4,2,0,2,0,9,8,1
10400,148308,AgkxRkUEeKaWJWeFdUfFP1oidzDmX3wN,7GRhBDsirIGkRZBtSMEzNTyDr2JQm4xx,8,6,4,0,2,0,4,0,16,2.2857142857142856,2,0.0,1,4,0,2,5,0,0,4,0,7,9,1
10401,148309,MlTxi8RHVkOkUJvdeW5QueC8rHHUb8J8,7GRhBDsirIGkRZBtSMEzNTyDr2JQm4xx,2,0,0,0,0,0,2,0,2,0.2857142857142857,1,0.0,0,0,0,0,0,0,0,2,0,0,2,1
10402,148312,pDoh1uqWcgliQMNyRKRo96mBVZnNp096,7GRhBDsirIGkRZBtSMEzNTyDr2JQm4xx,2,0,0,0,0,0,2,0,2,0.2857142857142857,1,0.0,0,0,0,0,0,0,0,2,0,0,2,1
10403,148321,J55iMOtceEGJhbZdzVk7bzHO712hM6pj,7GRhBDsirIGkRZBtSMEzNTyDr2JQm4xx,8,7,4,0,3,1,4,0,19,2.7142857142857144,1,0.0,1,4,0,3,6,1,0,4,0,8,11,0
10404,148323,iTyaCKpU2BXn5y8oYGLNdArTQsPetqh8,7GRhBDsirIGkRZBtSMEzNTyDr2JQm4xx,2,0,0,0,0,0,3,0,3,0.42857142857142855,1,0.0,0,0,0,0,0,0,0,3,0,0,3,1
10405,148324,97rBQQfPK19vUmiWQp62BQGqA2mCgBut,7GRhBDsirIGkRZBtSMEzNTyDr2JQm4xx,5,2,1,0,1,2,5,0,11,1.5714285714285714,1,0.0,0,1,0,1,2,2,0,5,0,2,9,1
10406,148333,5ofq7JCTsrFWBDElbifdevFR6SqxchRB,7GRhBDsirIGkRZBtSMEzNTyDr2JQm4xx,1,0,0,0,0,0,1,0,1,0.14285714285714285,1,0.0,0,0,0,0,0,0,0,1,0,0,1,1
10407,148349,9ygD0mCVCT1xftgjX9ZtkVBAEBAxmXMV,fbPkOYLVPtPgIt0MxizjfFJov3JbHyAi,4,3,2,0,2,0,1,0,8,1.1428571428571428,1,0.0,0,2,0,2,3,0,0,1,0,4,4,1
10408,148350,c9Dj079MYKUiWTTvAk5TtHXcSaCd3TDw,fbPkOYLVPtPgIt0MxizjfFJov3JbHyAi,5,3,2,0,0,0,8,0,13,1.8571428571428572,1,0.0,0,2,0,0,3,0,0,8,0,2,11,1
10409,148353,kxG2Ez4bVR5aERCBG6xs61rr9emGwqKo,fbPkOYLVPtPgIt0MxizjfFJov3JbHyAi,6,3,2,0,2,0,4,0,11,1.5714285714285714,3,0.0,0,2,0,2,3,0,0,4,0,4,7,1
10410,148358,bgLrRcnTjnOSlAj1yyvNbcR2GZlKU2gU,fbPkOYLVPtPgIt0MxizjfFJov3JbHyAi,25,30,13,12,10,15,2,0,82,11.714285714285714,1,0.0,12,13,10,10,18,15,2,2,0,45,37,1
10411,148366,fi4TXeoZ9lfPojTLqkoAXZWQgcUwi3WY,fbPkOYLVPtPgIt0MxizjfFJov3JbHyAi,9,5,5,0,5,4,7,1,27,3.857142857142857,2,0.0,0,5,0,5,5,4,0,7,1,10,17,1
10412,148367,CUHsvexAAfaCEMKsM3644JTxXL5DgSss,fbPkOYLVPtPgIt0MxizjfFJov3JbHyAi,5,3,2,0,2,0,2,0,9,1.2857142857142858,1,0.0,0,2,0,2,3,0,0,2,0,4,5,1
10413,148368,0oCNqxLZfnQykzt9jEtrYeCAvyN5aMiK,fbPkOYLVPtPgIt0MxizjfFJov3JbHyAi,2,0,0,0,0,0,5,0,5,0.7142857142857143,1,0.0,0,0,0,0,0,0,0,5,0,0,5,1
10414,148371,ULdF32fTmMpV957Ngz6P80D0kuxYFb2A,fbPkOYLVPtPgIt0MxizjfFJov3JbHyAi,1,0,0,0,0,0,1,0,1,0.14285714285714285,1,0.0,0,0,0,0,0,0,0,1,0,0,1,1
10415,148375,9LHCfUuBRybCFmCd7bbV3yZ92Mp8tv7j,fbPkOYLVPtPgIt0MxizjfFJov3JbHyAi,1,0,0,0,0,0,1,0,1,0.14285714285714285,1,0.0,0,0,0,0,0,0,0,1,0,0,1,1
10416,148378,KalDXAC9uFbnu9AKEx3pGk1aVT7IBvd6,fbPkOYLVPtPgIt0MxizjfFJov3JbHyAi,2,0,0,0,0,0,3,0,3,0.42857142857142855,1,0.0,0,0,0,0,0,0,0,3,0,0,3,1
10417,148379,MKj9RE36KMaNQttYmK1FP436E01YmNeZ,fbPkOYLVPtPgIt0MxizjfFJov3JbHyAi,2,0,0,0,0,0,2,0,2,0.2857142857142857,1,0.0,0,0,0,0,0,0,0,2,0,0,2,1
10418,148381,WYlT48XIScuGFSR7mYrH3M5CfjOCOMTP,fbPkOYLVPtPgIt0MxizjfFJov3JbHyAi,13,12,1,0,1,0,3,0,17,2.4285714285714284,1,0.0,0,1,0,1,12,0,0,3,0,2,15,1
10419,148382,qJEf5DGSDkSxZ1JIhipEbBFRbrhnAj1a,fbPkOYLVPtPgIt0MxizjfFJov3JbHyAi,6,8,2,0,1,0,2,0,13,1.8571428571428572,1,0.0,0,2,0,1,8,0,0,2,0,3,10,1
10420,148383,9TLjVfAVQirUv9D0iCSnjtMLWmZOKr0C,fbPkOYLVPtPgIt0MxizjfFJov3JbHyAi,7,3,2,0,2,0,4,0,11,1.5714285714285714,1,0.0,0,2,0,2,3,0,0,4,0,4,7,1
10421,148384,EQVGtOGC6NrveIndUoSckLgaBol5CW91,fbPkOYLVPtPgIt0MxizjfFJov3JbHyAi,1,0,0,0,0,0,1,0,1,0.14285714285714285,1,0.0,0,0,0,0,0,0,0,1,0,0,1,1
10422,148385,ciDinbfum1guAgZtUPEyI6UQ7y3ahoVh,fbPkOYLVPtPgIt0MxizjfFJov3JbHyAi,6,3,2,0,2,0,1,0,8,1.1428571428571428,1,0.0,0,2,0,2,3,0,0,1,0,4,4,1
10423,148388,idmrxuEoIjSYuzZhdG66vR2sh6aBS2ui,fbPkOYLVPtPgIt0MxizjfFJov3JbHyAi,2,0,0,0,0,0,2,0,2,0.2857142857142857,1,0.0,0,0,0,0,0,0,0,2,0,0,2,1
10424,148441,C5JjdaA2TpnbGFuMIjvBUyS5u6COBRuh,A3fsA9Zfv1X2fVEQhTw51lKENdNrEqT3,47,35,20,180,7,0,5,0,247,35.285714285714285,3,0.0,3,20,178,7,32,0,2,5,0,208,39,1
10425,148462,NFcWSxRIoQJ6uyBNNayVcsmUYxNvF0Hr,SpATywNh6bZuzm8s1ceuBUnMUAeoAHHw,6,4,0,0,0,0,5,0,9,1.2857142857142858,1,0.0,1,0,0,0,3,0,0,5,0,1,8,1
10426,148465,aISyThuiw10fsCPPUtqVz2ccwIDIESls,G8EPVSXsOYB5YQWZGiz1aVq5Pgr2GrQu,98,187,114,256,0,97,42,6,702,100.28571428571429,11,0.0,20,114,221,0,167,97,35,42,6,355,347,0
10427,148503,9CQfIvDiQz4gDArSnTXOgxNKUwJW75pD,SpATywNh6bZuzm8s1ceuBUnMUAeoAHHw,46,73,46,51,20,2,37,3,232,33.142857142857146,8,0.0,9,46,43,20,64,2,8,37,3,118,114,0
10428,148509,EJqwtsSz6hilFtXpX5lfE4At9whH7WUw,SpATywNh6bZuzm8s1ceuBUnMUAeoAHHw,3,1,0,0,0,0,3,0,4,0.5714285714285714,1,0.0,0,0,0,0,1,0,0,3,0,0,4,1
10429,148577,1TDqryriD1i68B6PFn9vcGOnlC4cHux8,A3fsA9Zfv1X2fVEQhTw51lKENdNrEqT3,13,14,7,0,7,0,2,0,30,4.285714285714286,1,0.0,0,7,0,7,14,0,0,2,0,14,16,1
10430,148586,oYErMzphr0xt2i2tKTG42QELMDaumLkL,RXDvfPUBYFlVdlueBFbLW0mhhAyGEqpt,4,2,1,0,1,0,1,0,5,0.7142857142857143,1,0.0,0,1,0,1,2,0,0,1,0,2,3,1
10431,148596,FC3H56QIjzwzfAuLhWGinlpASokqCo9M,SpATywNh6bZuzm8s1ceuBUnMUAeoAHHw,17,35,19,13,0,9,14,1,91,13.0,4,0.0,6,19,11,0,29,9,2,14,1,36,55,0
10432,148598,sg4VVv9cgk6nt80dZvUKhL5H7RMgLm0l,SpATywNh6bZuzm8s1ceuBUnMUAeoAHHw,20,34,3,40,1,0,12,0,90,12.857142857142858,4,0.0,12,3,37,1,22,0,3,12,0,53,37,1
10433,148611,oGTSG0bYZEKmqMQUI2QOgfbr6I1mZJJh,SpATywNh6bZuzm8s1ceuBUnMUAeoAHHw,28,77,7,18,3,0,44,1,150,21.428571428571427,7,0.0,7,7,15,3,70,0,3,44,1,32,118,1
10434,148612,ZdOBK87GOMIn8wzMbSvbPLgG549sCOY6,A3fsA9Zfv1X2fVEQhTw51lKENdNrEqT3,6,3,2,0,2,0,1,0,8,1.1428571428571428,1,0.0,0,2,0,2,3,0,0,1,0,4,4,1
10435,148622,6RpP1knSR8iDNosichQ4lSzSXyvfFkNH,SpATywNh6bZuzm8s1ceuBUnMUAeoAHHw,9,6,4,0,3,3,11,3,30,4.285714285714286,1,0.0,0,4,0,3,6,3,0,11,3,7,23,1
10436,148625,230jUwlujvGZtNIXTT6Gi5AZGgeYapcT,SpATywNh6bZuzm8s1ceuBUnMUAeoAHHw,8,4,3,0,3,0,9,0,19,2.7142857142857144,1,0.0,0,3,0,3,4,0,0,9,0,6,13,1
10437,148627,eK6us9hOnBMXSFhvwgioyiPARpsZ94KW,A3fsA9Zfv1X2fVEQhTw51lKENdNrEqT3,2,0,0,0,0,0,3,0,3,0.42857142857142855,1,0.0,0,0,0,0,0,0,0,3,0,0,3,1
10438,148650,9zA3LVN93nZSiZIUpOhwqziA6RcnSGOv,SpATywNh6bZuzm8s1ceuBUnMUAeoAHHw,14,20,3,6,1,0,1,0,31,4.428571428571429,1,0.0,0,3,5,1,20,0,1,1,0,9,22,1
10439,148654,sTxEoxueQ2iNvcjPH8BgpVT2Uz1KyXvb,A3fsA9Zfv1X2fVEQhTw51lKENdNrEqT3,12,17,12,0,4,8,10,0,51,7.285714285714286,3,0.0,1,12,0,4,16,8,0,10,0,17,34,1
10440,148666,cAYlx5bxU4cY2ACDTf2EB19Cf6nnrW4p,A3fsA9Zfv1X2fVEQhTw51lKENdNrEqT3,2,0,0,0,0,0,2,0,2,0.2857142857142857,1,0.0,0,0,0,0,0,0,0,2,0,0,2,1
10441,148668,qaT3OJRfY4kTUsuWIZdgTvNFyRsoPB48,A3fsA9Zfv1X2fVEQhTw51lKENdNrEqT3,16,19,2,20,1,0,9,0,51,7.285714285714286,2,0.0,0,2,15,1,19,0,5,9,0,18,33,1
10442,148708,QffrhmaCXbaB9XOhV3NLOmPuRvGWA3G5,SpATywNh6bZuzm8s1ceuBUnMUAeoAHHw,17,9,5,9,3,0,7,1,34,4.857142857142857,2,0.0,2,5,9,3,7,0,0,7,1,19,15,1
10443,148724,4YDp1nxKf6ZgyVxOrG2MY3nyG30jIlTN,SpATywNh6bZuzm8s1ceuBUnMUAeoAHHw,21,35,13,10,7,0,12,0,77,11.0,5,0.0,3,13,9,7,32,0,1,12,0,32,45,1
10444,148741,lcf8IA11Zd7V2ZBaDLUO5BNWLkJI60Zh,A3fsA9Zfv1X2fVEQhTw51lKENdNrEqT3,6,5,1,0,1,0,2,0,9,1.2857142857142858,2,0.0,0,1,0,1,5,0,0,2,0,2,7,1
10445,148773,f2RxaLdYf2Tr0XIXAiBwlA7VXVA1XDPz,SpATywNh6bZuzm8s1ceuBUnMUAeoAHHw,17,43,17,20,6,4,14,1,105,15.0,2,0.0,17,17,16,6,26,4,4,14,1,56,49,1
10446,148776,6EaK0gHFiSwbLJpDVBHv9ZNNoyIiEert,SpATywNh6bZuzm8s1ceuBUnMUAeoAHHw,23,49,13,27,0,0,7,0,96,13.714285714285714,4,0.0,27,13,27,0,22,0,0,7,0,67,29,0
10447,148777,SWaMMFaEgBIwWimOSjcPRySyg7Gfrl6L,G8EPVSXsOYB5YQWZGiz1aVq5Pgr2GrQu,31,50,20,90,4,3,13,0,180,25.714285714285715,3,0.0,11,20,72,4,39,3,18,13,0,107,73,1
10448,148790,aJHRT3LiLupkaY9OS8kHMvtwJmIsdmDj,5X6FeZozNMgE2VRi3MJYjkkFK8SETtu2,3,2,0,0,0,0,2,0,4,0.5714285714285714,1,0.0,0,0,0,0,2,0,0,2,0,0,4,1
10449,148793,2brfbtCm4kcVm5Xvz8Jw1eZfaRPhXxis,SpATywNh6bZuzm8s1ceuBUnMUAeoAHHw,5,2,1,0,1,0,3,1,8,1.1428571428571428,1,0.0,0,1,0,1,2,0,0,3,1,2,6,1
10450,148819,kuZwBvEdgeUtKZ495C2FptBbxEtLtmVH,5X6FeZozNMgE2VRi3MJYjkkFK8SETtu2,5,7,3,0,2,0,2,0,14,2.0,2,0.0,0,3,0,2,7,0,0,2,0,5,9,1
10451,148884,PjNJu1yveIzqM45IGKszKj86ZWx1BoKb,bWdj2GDclj5ofokWjzoa5jAwMkxCykd6,1,0,0,0,0,0,1,0,1,0.14285714285714285,1,0.0,0,0,0,0,0,0,0,1,0,0,1,1
10452,148911,xeWj4YSbf5BxF3thVawoQgzwU89sTfAT,G8EPVSXsOYB5YQWZGiz1aVq5Pgr2GrQu,22,19,14,0,9,3,16,1,62,8.857142857142858,2,0.0,0,14,0,9,19,3,0,16,1,23,39,1
10453,148934,HWbSEkrpOgvIJQ3i154EhtbcbMi0AO6e,SpATywNh6bZuzm8s1ceuBUnMUAeoAHHw,5,5,2,0,1,0,1,0,9,1.2857142857142858,1,0.0,0,2,0,1,5,0,0,1,0,3,6,1
10454,148942,ZCud3HVbJtHY8VV7DwTxNTWANdhPzMYh,bWdj2GDclj5ofokWjzoa5jAwMkxCykd6,1,0,0,0,0,0,1,0,1,0.14285714285714285,1,0.0,0,0,0,0,0,0,0,1,0,0,1,1
10455,148992,4OV0W0nOUO05rXo3pxbmiSLc9O458KIT,SpATywNh6bZuzm8s1ceuBUnMUAeoAHHw,16,15,0,41,0,0,11,0,67,9.571428571428571,3,0.0,9,0,38,0,6,0,3,11,0,47,20,0
10456,149002,6rY5gqjppQzPtOIlGOty1LtzqGK2wvGe,SpATywNh6bZuzm8s1ceuBUnMUAeoAHHw,6,4,1,0,1,0,2,0,8,1.1428571428571428,1,0.0,0,1,0,1,4,0,0,2,0,2,6,0
10457,149008,FpSzDAj37qdvKX5nxNGIEeNIprGz0pzn,SpATywNh6bZuzm8s1ceuBUnMUAeoAHHw,5,2,0,0,1,0,3,0,6,0.8571428571428571,1,0.0,0,0,0,1,2,0,0,3,0,1,5,1
10458,149014,5UJZmEar1AX3gQXOzkh3MnQcYdErI17M,bWdj2GDclj5ofokWjzoa5jAwMkxCykd6,6,9,5,0,2,7,4,0,27,3.857142857142857,2,0.0,0,5,0,2,9,7,0,4,0,7,20,0
10459,149053,5cDuzRb0PcKkxzhRmOgPuiz1InwgLalt,5X6FeZozNMgE2VRi3MJYjkkFK8SETtu2,11,17,5,0,7,1,3,0,33,4.714285714285714,1,0.0,10,5,0,7,7,1,0,3,0,22,11,1
10460,149056,79sLgxKWhPrtGazd9PH6J4Tn1LGZboVt,SpATywNh6bZuzm8s1ceuBUnMUAeoAHHw,5,2,1,0,1,0,2,1,7,1.0,1,0.0,0,1,0,1,2,0,0,2,1,2,5,1
10461,149128,5ehf4EFN8WhDbvmb2WvfZwpaBD0cj1oj,SpATywNh6bZuzm8s1ceuBUnMUAeoAHHw,17,23,4,0,4,38,10,0,79,11.285714285714286,4,0.0,0,4,0,4,23,38,0,10,0,8,71,0
10462,149135,HDeZBhNQKtgQRWJ96cSCNvruJhAhiBb4,SpATywNh6bZuzm8s1ceuBUnMUAeoAHHw,2,0,0,0,0,0,3,0,3,0.42857142857142855,2,0.0,0,0,0,0,0,0,0,3,0,0,3,1
10463,149142,mWpCn0bY1MeiAVq9pPQtOc8MGk8PY2NJ,5X6FeZozNMgE2VRi3MJYjkkFK8SETtu2,27,76,11,46,18,0,4,0,155,22.142857142857142,2,0.0,34,11,37,18,42,0,9,4,0,100,55,1
10464,149162,NCvc3nvyx1PEfaFio0HFzoICqxsY9Kiv,SpATywNh6bZuzm8s1ceuBUnMUAeoAHHw,5,3,2,0,0,0,2,0,7,1.0,1,0.0,0,2,0,0,3,0,0,2,0,2,5,1
10465,149175,fxLa2btVt7GxkzfoIMOfvQ33z85P1T4A,A3fsA9Zfv1X2fVEQhTw51lKENdNrEqT3,1,0,0,0,0,0,1,0,1,0.14285714285714285,1,0.0,0,0,0,0,0,0,0,1,0,0,1,1
10466,149193,CttUHIFDXoWTFOldpxfPnv8kQdVn6WXf,G8EPVSXsOYB5YQWZGiz1aVq5Pgr2GrQu,2,0,0,0,0,0,2,0,2,0.2857142857142857,1,0.0,0,0,0,0,0,0,0,2,0,0,2,1
10467,149206,eph9VIYbQuJfMrz8nF876Qp2UCrBhVsi,SpATywNh6bZuzm8s1ceuBUnMUAeoAHHw,7,3,2,0,2,0,2,0,9,1.2857142857142858,1,0.0,0,2,0,2,3,0,0,2,0,4,5,1
10468,149253,xEGf9qcbsdcPFG6LbnSrabaHc27cQrPO,G8EPVSXsOYB5YQWZGiz1aVq5Pgr2GrQu,1,0,0,0,0,0,1,0,1,0.14285714285714285,1,0.0,0,0,0,0,0,0,0,1,0,0,1,1
10469,149321,FCLM3qdcpb60NUQFViwykzSTHS7GhoKF,bWdj2GDclj5ofokWjzoa5jAwMkxCykd6,1,0,0,0,0,0,1,0,1,0.14285714285714285,1,0.0,0,0,0,0,0,0,0,1,0,0,1,1
10470,149331,Sl8HkyBvr8NGjHxzN5bFwFxLwJOTbHKV,bWdj2GDclj5ofokWjzoa5jAwMkxCykd6,1,0,0,0,0,0,1,0,1,0.14285714285714285,1,0.0,0,0,0,0,0,0,0,1,0,0,1,1
10471,149345,GxZBUh8Rj9So22P1De1wjazGUEkYIxNL,SpATywNh6bZuzm8s1ceuBUnMUAeoAHHw,1,0,0,0,0,0,1,0,1,0.14285714285714285,1,0.0,0,0,0,0,0,0,0,1,0,0,1,1
10472,149364,C5JjdaA2TpnbGFuMIjvBUyS5u6COBRuh,5X6FeZozNMgE2VRi3MJYjkkFK8SETtu2,4,2,1,0,1,0,1,0,5,0.7142857142857143,1,0.0,0,1,0,1,2,0,0,1,0,2,3,1
10473,149400,ne1lWju9UTXOBd1dA2M5rJRVVshMCIYz,A3fsA9Zfv1X2fVEQhTw51lKENdNrEqT3,2,0,0,0,0,0,2,0,2,0.2857142857142857,1,0.0,0,0,0,0,0,0,0,2,0,0,2,1
10474,149401,bLwwrXuBpPds35XzYeL0YGMC0uDavcsO,G8EPVSXsOYB5YQWZGiz1aVq5Pgr2GrQu,21,27,4,42,3,1,10,0,87,12.428571428571429,1,0.0,12,4,36,3,15,1,6,10,0,55,32,1
10475,149417,Pdvh6UTK9FXuCE4WVrV5Y121aJBdVbkt,bWdj2GDclj5ofokWjzoa5jAwMkxCykd6,5,2,1,0,1,0,2,0,6,0.8571428571428571,1,0.0,0,1,0,1,2,0,0,2,0,2,4,1
10476,149420,vVmrtbXOR8LaWp48hajdNZIlFCL7http,SpATywNh6bZuzm8s1ceuBUnMUAeoAHHw,8,10,7,0,5,0,4,0,26,3.7142857142857144,3,0.0,0,7,0,5,10,0,0,4,0,12,14,1
10477,149421,RAAQLpPenoCljHENtpqjvSXS8Gfv0T1E,A3fsA9Zfv1X2fVEQhTw51lKENdNrEqT3,14,6,4,0,3,1,6,1,21,3.0,2,0.0,0,4,0,3,6,1,0,6,1,7,14,1
10478,149438,HhHFHVl0FdyFAQQ7F70xD2HQyGMqv85Q,5X6FeZozNMgE2VRi3MJYjkkFK8SETtu2,1,0,0,0,0,0,1,0,1,0.14285714285714285,1,0.0,0,0,0,0,0,0,0,1,0,0,1,1
10479,149440,HhHFHVl0FdyFAQQ7F70xD2HQyGMqv85Q,A3fsA9Zfv1X2fVEQhTw51lKENdNrEqT3,21,33,8,0,5,0,6,0,52,7.428571428571429,4,0.0,0,8,0,5,33,0,0,6,0,13,39,1
10480,149450,MxG2Ev7XiiMWM1pXw5Ve1ZD2Aymhanp7,bWdj2GDclj5ofokWjzoa5jAwMkxCykd6,1,0,0,0,0,0,1,0,1,0.14285714285714285,1,0.0,0,0,0,0,0,0,0,1,0,0,1,1
10481,149455,QCIxkwrtd7EyHnigeiQpqn6l0kVuCgK4,bWdj2GDclj5ofokWjzoa5jAwMkxCykd6,7,3,2,0,2,0,2,0,9,1.2857142857142858,1,0.0,0,2,0,2,3,0,0,2,0,4,5,1
10482,149462,o69BaNn8nNwkn0WRwXTNaYgGrUvOyxv9,SpATywNh6bZuzm8s1ceuBUnMUAeoAHHw,20,19,1,5,1,27,8,0,61,8.714285714285714,3,0.0,1,1,5,1,18,27,0,8,0,8,53,0
10483,149468,xlweOOPqtNKKu7s1PmxHGdYFecoJy0tW,bWdj2GDclj5ofokWjzoa5jAwMkxCykd6,1,0,0,0,0,0,1,0,1,0.14285714285714285,1,0.0,0,0,0,0,0,0,0,1,0,0,1,1
10484,149489,u8XDmL2Jcc1UmsAKR6F96ZEMjyKd0OHk,5X6FeZozNMgE2VRi3MJYjkkFK8SETtu2,5,2,1,0,1,0,2,0,6,0.8571428571428571,1,0.0,0,1,0,1,2,0,0,2,0,2,4,1
10485,149502,FBX5RhepBD18ojig0DuZagEpl7jrwSAk,bWdj2GDclj5ofokWjzoa5jAwMkxCykd6,10,14,7,36,4,0,4,0,65,9.285714285714286,2,0.0,3,7,36,4,11,0,0,4,0,50,15,1
10486,149505,TgcCH3erWiZRHJcY2HABDtNaJwPoDafv,SpATywNh6bZuzm8s1ceuBUnMUAeoAHHw,25,31,4,25,3,0,15,0,78,11.142857142857142,5,0.0,14,4,22,3,17,0,3,15,0,43,35,1
10487,149560,2uhnOLzQkP0M6l7V6JeJRSNzF5FWIx9G,5X6FeZozNMgE2VRi3MJYjkkFK8SETtu2,5,2,1,0,1,0,2,0,6,0.8571428571428571,1,0.0,0,1,0,1,2,0,0,2,0,2,4,1
10488,149569,KR5RKdabOCnxR33wIN39OavKAg4R47ZU,A3fsA9Zfv1X2fVEQhTw51lKENdNrEqT3,9,4,1,0,1,1,6,0,13,1.8571428571428572,1,0.0,0,1,0,1,4,1,0,6,0,2,11,1
10489,149570,8958pt2z4OHwTl32JK0k9CAPziEN4Bzu,SpATywNh6bZuzm8s1ceuBUnMUAeoAHHw,6,5,1,0,0,11,6,0,23,3.2857142857142856,3,0.0,0,1,0,0,5,11,0,6,0,1,22,1
10490,149573,0aomsNaDMmIRvMUNvKVIFXzFDfLWKysB,A3fsA9Zfv1X2fVEQhTw51lKENdNrEqT3,2,0,0,0,0,0,2,0,2,0.2857142857142857,1,0.0,0,0,0,0,0,0,0,2,0,0,2,1
10491,149575,MDp7DOIvKcLxQwYa7iYETsW6UM7XLKe9,SpATywNh6bZuzm8s1ceuBUnMUAeoAHHw,4,5,2,0,0,0,2,0,9,1.2857142857142858,2,0.0,0,2,0,0,5,0,0,2,0,2,7,1
10492,149586,SdSbeWd4oEnIQjEokLws1yqSOv3sXqaR,A3fsA9Zfv1X2fVEQhTw51lKENdNrEqT3,2,0,0,0,0,0,2,0,2,0.2857142857142857,1,0.0,0,0,0,0,0,0,0,2,0,0,2,1
10493,149588,SdSbeWd4oEnIQjEokLws1yqSOv3sXqaR,bWdj2GDclj5ofokWjzoa5jAwMkxCykd6,1,0,0,0,0,0,1,0,1,0.14285714285714285,1,0.0,0,0,0,0,0,0,0,1,0,0,1,1
10494,149617,8aV4yRTVM0HzdlWjuQKHgiNXm0RErk1U,bWdj2GDclj5ofokWjzoa5jAwMkxCykd6,6,5,0,0,0,0,6,0,11,1.5714285714285714,2,0.0,0,0,0,0,5,0,0,6,0,0,11,0
10495,149633,tmwYxPndf0bBoBktnRObtCNzTZcFIFQq,SpATywNh6bZuzm8s1ceuBUnMUAeoAHHw,12,17,1,2,1,0,5,0,26,3.7142857142857144,3,0.0,6,1,2,1,11,0,0,5,0,10,16,1
10496,149655,BvI5CiGNtYcKpjVG9fTMezMQs6vWmHfH,bWdj2GDclj5ofokWjzoa5jAwMkxCykd6,10,11,7,4,4,3,5,0,34,4.857142857142857,2,0.0,0,7,2,4,11,3,2,5,0,13,21,1
10497,149659,PMp3RxnsqELMI5BiCmteZ8iF2l5wlW7H,5X6FeZozNMgE2VRi3MJYjkkFK8SETtu2,1,0,0,0,0,0,2,0,2,0.2857142857142857,1,0.0,0,0,0,0,0,0,0,2,0,0,2,1
10498,149682,cQ0KD7lyMK06WYdfiZiDvkcnrB91X6dF,RXDvfPUBYFlVdlueBFbLW0mhhAyGEqpt,42,41,4,100,4,0,6,0,155,22.142857142857142,5,0.0,10,4,94,4,31,0,6,6,0,112,43,0
10499,149692,7AAdXAGWvappN7B38jOB9fzxLSuIXADG,RXDvfPUBYFlVdlueBFbLW0mhhAyGEqpt,8,6,2,0,2,0,4,0,14,2.0,2,0.0,0,2,0,2,6,0,0,4,0,4,10,0
10500,149702,oSiyWt4iiuWU3OGDrEk1CkOoayHN39wy,SpATywNh6bZuzm8s1ceuBUnMUAeoAHHw,5,2,1,0,1,0,2,0,6,0.8571428571428571,1,0.0,0,1,0,1,2,0,0,2,0,2,4,0
10501,149712,ovOrxCTVGxQyC9labPGJ3gKHEzv9s9aZ,SpATywNh6bZuzm8s1ceuBUnMUAeoAHHw,5,3,2,0,1,0,1,0,7,1.0,1,0.0,0,2,0,1,3,0,0,1,0,3,4,1
10502,149724,p5nLTT7lxlGHa4qmyYsgcjTpAWKheo2V,A3fsA9Zfv1X2fVEQhTw51lKENdNrEqT3,17,8,6,0,5,0,21,2,42,6.0,2,0.0,0,6,0,5,8,0,0,21,2,11,31,1
10503,149734,364UhjscaMOKYjf1pPgmVT64NkpJR1Jx,A3fsA9Zfv1X2fVEQhTw51lKENdNrEqT3,1,0,0,0,0,0,1,0,1,0.14285714285714285,1,0.0,0,0,0,0,0,0,0,1,0,0,1,1
10504,149794,DpqUZKEZpIFvZzvEXk8oaJMRAbEfypNN,bWdj2GDclj5ofokWjzoa5jAwMkxCykd6,10,3,3,0,3,0,3,0,12,1.7142857142857142,1,0.0,0,3,0,3,3,0,0,3,0,6,6,1
10505,149795,YI86C9tMYiPNH60fwrrOqDqOHSDWv9QR,G8EPVSXsOYB5YQWZGiz1aVq5Pgr2GrQu,5,3,2,0,2,0,2,0,9,1.2857142857142858,1,0.0,0,2,0,2,3,0,0,2,0,4,5,1
10506,149814,OUOJlObKrXM0JmEUq0o8KzZHzr8jy9dn,A3fsA9Zfv1X2fVEQhTw51lKENdNrEqT3,8,4,3,0,3,0,1,0,11,1.5714285714285714,1,0.0,0,3,0,3,4,0,0,1,0,6,5,0
10507,149816,U8u2oofRYkvAFc5S0d9MPpENNm076FZl,G8EPVSXsOYB5YQWZGiz1aVq5Pgr2GrQu,20,22,2,28,2,4,12,1,71,10.142857142857142,2,0.0,2,2,24,2,20,4,4,12,1,30,41,0
10508,149853,EGrooJVAAIUP6U4I2p0rt4nL3Y713JTJ,bWdj2GDclj5ofokWjzoa5jAwMkxCykd6,12,26,16,0,8,0,12,0,62,8.857142857142858,3,0.0,1,16,0,8,25,0,0,12,0,25,37,1
10509,149861,s1avI0XWB1DlJJFaBkTxVlC3TXo4qwtF,A3fsA9Zfv1X2fVEQhTw51lKENdNrEqT3,2,0,0,0,0,0,2,0,2,0.2857142857142857,1,0.0,0,0,0,0,0,0,0,2,0,0,2,1
10510,149865,EWPkFJXEPcxVpISSGikSu1idwGgv3lJY,SpATywNh6bZuzm8s1ceuBUnMUAeoAHHw,8,5,3,0,2,0,3,0,13,1.8571428571428572,1,0.0,0,3,0,2,5,0,0,3,0,5,8,1
10511,149869,DV9cmKY91lk8lKsMUmLIMP1KsHFcyZMK,bWdj2GDclj5ofokWjzoa5jAwMkxCykd6,20,16,10,94,0,0,3,0,123,17.571428571428573,2,0.0,0,10,87,0,16,0,7,3,0,97,26,1
10512,149871,LuPgMCIdX2ugHzDAngaEsA394qOat0id,5X6FeZozNMgE2VRi3MJYjkkFK8SETtu2,1,0,0,0,0,0,1,0,1,0.14285714285714285,1,0.0,0,0,0,0,0,0,0,1,0,0,1,1
10513,149877,SANLEmv2xqr9UbPUpTzbFGNJfLVXFrzf,SpATywNh6bZuzm8s1ceuBUnMUAeoAHHw,18,30,2,21,1,38,11,1,104,14.857142857142858,2,0.0,7,2,17,1,23,38,4,11,1,27,77,1
10514,149899,jcaD7HmCCQ4mKgrQNeo4NKmPRmKgoAZW,SpATywNh6bZuzm8s1ceuBUnMUAeoAHHw,2,0,0,0,0,0,2,0,2,0.2857142857142857,1,0.0,0,0,0,0,0,0,0,2,0,0,2,1
10515,149903,tNeYs5eBpBxsyX2sdRFHqDEmvM7JeehL,SpATywNh6bZuzm8s1ceuBUnMUAeoAHHw,6,3,1,0,1,0,4,0,9,1.2857142857142858,1,0.0,0,1,0,1,3,0,0,4,0,2,7,1
10516,149917,ChzNldCJWcjFbNJPk0sdV5CvUzj1IPeI,SpATywNh6bZuzm8s1ceuBUnMUAeoAHHw,2,0,0,0,0,0,2,0,2,0.2857142857142857,1,0.0,0,0,0,0,0,0,0,2,0,0,2,1
10517,149924,ICTHiMLsDNdLMg40eEErPhb0R1VUkY0B,SpATywNh6bZuzm8s1ceuBUnMUAeoAHHw,5,3,0,0,0,0,2,0,5,0.7142857142857143,1,0.0,0,0,0,0,3,0,0,2,0,0,5,1
10518,149925,3qTPc1fFRwuwUUC7TOpySJ2JiqYsj3j7,G8EPVSXsOYB5YQWZGiz1aVq5Pgr2GrQu,1,0,0,0,0,0,1,0,1,0.14285714285714285,1,0.0,0,0,0,0,0,0,0,1,0,0,1,1
10519,149939,Of6sdrvyVlVDF5GVtRDGN0xmyyFixkhD,SpATywNh6bZuzm8s1ceuBUnMUAeoAHHw,1,0,0,0,0,0,1,0,1,0.14285714285714285,1,0.0,0,0,0,0,0,0,0,1,0,0,1,1
10520,149950,byUmCtzRLWWrWRajFZnozMEalaeEKWAr,RXDvfPUBYFlVdlueBFbLW0mhhAyGEqpt,28,24,14,28,11,0,3,0,80,11.428571428571429,3,0.0,5,14,26,11,19,0,2,3,0,56,24,1
10521,149971,6gWNl8crhOxwgA0Ij5LzJgWFSYDFCzaS,SpATywNh6bZuzm8s1ceuBUnMUAeoAHHw,1,0,0,0,0,0,1,0,1,0.14285714285714285,1,0.0,0,0,0,0,0,0,0,1,0,0,1,1
10522,150014,iyF9qVPSlqT1UqIz618IudxC9zNsOV1h,A3fsA9Zfv1X2fVEQhTw51lKENdNrEqT3,1,0,0,0,0,0,1,0,1,0.14285714285714285,1,0.0,0,0,0,0,0,0,0,1,0,0,1,1
10523,150018,2XDpaAo3slMsrFQXFgtVX89IlqkzpX74,RXDvfPUBYFlVdlueBFbLW0mhhAyGEqpt,10,9,5,0,1,0,8,0,23,3.2857142857142856,2,0.0,0,5,0,1,9,0,0,8,0,6,17,1
10524,150044,OxJaeWpi7GqNZC9vZnlS2EIr7v2Sn1Az,RXDvfPUBYFlVdlueBFbLW0mhhAyGEqpt,1,0,0,0,0,0,1,0,1,0.14285714285714285,1,0.0,0,0,0,0,0,0,0,1,0,0,1,1
10525,150064,kFq2dX2idryINNQb9BQiBNQL0jaWL2j5,bWdj2GDclj5ofokWjzoa5jAwMkxCykd6,17,12,6,4,3,4,12,3,44,6.285714285714286,2,0.0,0,6,2,3,12,4,2,12,3,11,33,1
10526,150075,FWX9YkLyj47mhurdCZuuv2217ViDfzCr,A3fsA9Zfv1X2fVEQhTw51lKENdNrEqT3,2,0,0,0,0,0,2,0,2,0.2857142857142857,1,0.0,0,0,0,0,0,0,0,2,0,0,2,1
10527,150086,foZomfeiH5mdSFjeB6umSt6lwP9hfSDR,5X6FeZozNMgE2VRi3MJYjkkFK8SETtu2,2,0,0,0,0,0,4,0,4,0.5714285714285714,1,0.0,0,0,0,0,0,0,0,4,0,0,4,1
10528,150124,2ux7ss84pdjL26Mv3ZxbKmm47IXkqPAr,5Gyp41oLVo7Gg7vF4vpmggWP5MU70QO6,14,13,9,0,5,1,9,0,37,5.285714285714286,2,0.0,0,9,0,5,13,1,0,9,0,14,23,1
10529,150130,3UKnBgGmIdlU5zyDHb4w8rwI2yh5Hedu,5Gyp41oLVo7Gg7vF4vpmggWP5MU70QO6,1,0,0,0,0,0,1,0,1,0.14285714285714285,1,0.0,0,0,0,0,0,0,0,1,0,0,1,1
10530,150132,EAiClpyKaZse8fkxBRKv0DqS6nuRtZM9,5Gyp41oLVo7Gg7vF4vpmggWP5MU70QO6,27,44,20,2,14,0,19,0,99,14.142857142857142,1,0.0,12,20,1,14,32,0,1,19,0,47,52,1
10531,150140,69cOGwnqxePe9nAy9ETeoKKFcDvh4Fa2,5Gyp41oLVo7Gg7vF4vpmggWP5MU70QO6,1,0,0,0,0,0,1,0,1,0.14285714285714285,1,0.0,0,0,0,0,0,0,0,1,0,0,1,1
10532,150144,cW0B2vcjXS3ZZohkLuGOhkvF4B1TOcDs,5Gyp41oLVo7Gg7vF4vpmggWP5MU70QO6,7,2,1,0,2,25,8,1,39,5.571428571428571,4,0.0,0,1,0,2,2,25,0,8,1,3,36,1
10533,150147,E0Vc68zQyaBo1QGFDy3X2ztIvkjoKV3F,5Gyp41oLVo7Gg7vF4vpmggWP5MU70QO6,9,6,3,0,2,0,3,0,14,2.0,2,0.0,0,3,0,2,6,0,0,3,0,5,9,1
10534,150169,XWkUssXjFp3Qa0LKKWs5ZQhrpUTfMUOj,5Gyp41oLVo7Gg7vF4vpmggWP5MU70QO6,10,10,7,0,4,8,5,9,43,6.142857142857143,2,0.0,0,7,0,4,10,8,0,5,9,11,32,1
10535,150213,XcX7jntb9BOOUDGcODQiEKhoCORQSkKD,5Gyp41oLVo7Gg7vF4vpmggWP5MU70QO6,17,52,21,6,16,1,8,0,104,14.857142857142858,4,0.0,21,21,3,16,31,1,3,8,0,61,43,1
10536,150215,ZfFcPMi7CiWRckoSdTX421RgHPXLS5Fb,5Gyp41oLVo7Gg7vF4vpmggWP5MU70QO6,1,0,0,0,0,0,1,0,1,0.14285714285714285,1,0.0,0,0,0,0,0,0,0,1,0,0,1,1
10537,150225,5ku4QlS4ornNEZ2wdEoOkcf6KpaMZWez,5Gyp41oLVo7Gg7vF4vpmggWP5MU70QO6,5,2,1,0,1,0,2,0,6,0.8571428571428571,1,0.0,0,1,0,1,2,0,0,2,0,2,4,1
10538,150226,Vdzgbzphso2p85XrvyY36mZ2isT1PG4Q,5Gyp41oLVo7Gg7vF4vpmggWP5MU70QO6,1,0,0,0,0,0,1,0,1,0.14285714285714285,1,0.0,0,0,0,0,0,0,0,1,0,0,1,1
10539,150250,8loJZqV93UIB0LVEOgs0qIcfMBhyuVR4,5Gyp41oLVo7Gg7vF4vpmggWP5MU70QO6,3,0,0,0,0,6,2,0,8,1.1428571428571428,1,0.0,0,0,0,0,0,6,0,2,0,0,8,1
10540,150272,o61d02uP0OX8m0Pmj3Zu4on4UaOcYPIz,5Gyp41oLVo7Gg7vF4vpmggWP5MU70QO6,1,0,0,0,0,0,1,0,1,0.14285714285714285,1,0.0,0,0,0,0,0,0,0,1,0,0,1,1
10541,150292,2MvssppOXCyTsvOeL8Qha0XCY7xMr0VC,5Gyp41oLVo7Gg7vF4vpmggWP5MU70QO6,2,0,0,0,0,0,3,0,3,0.42857142857142855,1,0.0,0,0,0,0,0,0,0,3,0,0,3,1
10542,150318,Vnhhp2QbBiDiUTTHmXkksXuO8NCNMbjj,5Gyp41oLVo7Gg7vF4vpmggWP5MU70QO6,5,2,1,0,1,0,5,0,9,1.2857142857142858,2,0.0,0,1,0,1,2,0,0,5,0,2,7,1
10543,150328,cb7jNXqn7p6ZQ1oC4AT2clOPnv4dnr7A,5Gyp41oLVo7Gg7vF4vpmggWP5MU70QO6,1,0,0,0,0,0,1,0,1,0.14285714285714285,1,0.0,0,0,0,0,0,0,0,1,0,0,1,1
10544,150337,Zv5VeaMMbvjl8jJyhTVQ5nqNe4EbI3B0,5Gyp41oLVo7Gg7vF4vpmggWP5MU70QO6,4,0,0,0,0,0,4,1,5,0.7142857142857143,1,0.0,0,0,0,0,0,0,0,4,1,0,5,1
10545,150382,KkQ1P7pL98UFcX9bdxynk5hysiFETC0o,5Gyp41oLVo7Gg7vF4vpmggWP5MU70QO6,4,2,1,0,1,0,1,0,5,0.7142857142857143,1,0.0,0,1,0,1,2,0,0,1,0,2,3,1
10546,150383,lOEkFX2UjUz4RbKsCpQMNvAzZosP46Gx,5Gyp41oLVo7Gg7vF4vpmggWP5MU70QO6,4,2,0,0,0,0,3,0,5,0.7142857142857143,1,0.0,0,0,0,0,2,0,0,3,0,0,5,1
10547,150400,UaxJs1OVUxTunPQEqx3l4sqSKHUOSLXn,5Gyp41oLVo7Gg7vF4vpmggWP5MU70QO6,8,4,2,0,2,0,7,0,15,2.142857142857143,1,0.0,0,2,0,2,4,0,0,7,0,4,11,1
10548,150402,pDBDEaT1TkEAKx8A6rNzLrIDq6wvQxYq,5Gyp41oLVo7Gg7vF4vpmggWP5MU70QO6,25,27,18,0,7,9,9,0,70,10.0,4,0.0,2,18,0,7,25,9,0,9,0,27,43,1
10549,150413,FZEwaAUaiR6zemazrUHMMvDLCgHez3sb,5Gyp41oLVo7Gg7vF4vpmggWP5MU70QO6,1,0,0,0,0,0,2,0,2,0.2857142857142857,1,0.0,0,0,0,0,0,0,0,2,0,0,2,1
10550,150440,VILh645pfC7rghlyAmcYjXVWOqx9Ai6K,5Gyp41oLVo7Gg7vF4vpmggWP5MU70QO6,7,5,1,0,1,0,4,2,13,1.8571428571428572,4,0.0,0,1,0,1,5,0,0,4,2,2,11,1
10551,150444,FbUhEVU22eqpMzOoW1CIL4Y83nQcE2jK,5Gyp41oLVo7Gg7vF4vpmggWP5MU70QO6,6,7,2,0,1,0,2,0,12,1.7142857142857142,1,0.0,0,2,0,1,7,0,0,2,0,3,9,1
10552,150456,9bFD092MsvByWNxuJr10AnyxOuH020vI,5Gyp41oLVo7Gg7vF4vpmggWP5MU70QO6,25,26,11,56,2,1,7,1,104,14.857142857142858,2,0.0,7,11,44,2,19,1,12,7,1,64,40,1
10553,150457,giExKGHF0kvbnC4pJk3m0ErzorpAfn7y,5Gyp41oLVo7Gg7vF4vpmggWP5MU70QO6,22,37,18,12,5,2,12,8,94,13.428571428571429,3,0.0,14,18,6,5,23,2,6,12,8,43,51,1
10554,150461,CCNnpKzXeVHLfdNfS5ZIopm7zGj7TDdv,5Gyp41oLVo7Gg7vF4vpmggWP5MU70QO6,4,0,0,0,0,1,3,0,4,0.5714285714285714,1,0.0,0,0,0,0,0,1,0,3,0,0,4,1
10555,150500,5u2loU6SQHykZPE3DNYj8Ct9ALl8JuZN,5Gyp41oLVo7Gg7vF4vpmggWP5MU70QO6,6,2,1,0,1,0,4,1,9,1.2857142857142858,1,0.0,0,1,0,1,2,0,0,4,1,2,7,1
10556,150542,EQVGtOGC6NrveIndUoSckLgaBol5CW91,5Gyp41oLVo7Gg7vF4vpmggWP5MU70QO6,9,6,3,8,1,0,3,0,21,3.0,2,0.0,1,3,4,1,5,0,4,3,0,9,12,1
10557,150548,KU1Z77ni8AHRrRVsLFsNy9nUsxm1KBTF,5Gyp41oLVo7Gg7vF4vpmggWP5MU70QO6,5,2,1,0,1,0,2,0,6,0.8571428571428571,1,0.0,0,1,0,1,2,0,0,2,0,2,4,1
10558,150549,aAIVa75qVPzpOmZJw2HIa9VdDBLKFDiz,5Gyp41oLVo7Gg7vF4vpmggWP5MU70QO6,7,2,1,0,1,1,6,1,12,1.7142857142857142,2,0.0,0,1,0,1,2,1,0,6,1,2,10,1
10559,150588,Cyo1WobzoL4cOEv0dsCDxj6wLjJg2fCH,5Gyp41oLVo7Gg7vF4vpmggWP5MU70QO6,6,4,3,0,3,0,1,0,11,1.5714285714285714,1,0.0,0,3,0,3,4,0,0,1,0,6,5,1
10560,150609,N6gXZQzrkHr8bw4E0tsXv9b0W0XoVjeP,5Gyp41oLVo7Gg7vF4vpmggWP5MU70QO6,8,4,2,0,2,0,5,1,14,2.0,1,0.0,0,2,0,2,4,0,0,5,1,4,10,1
10561,150630,flCmHJf2qnOpqWD4LHvZSxE5EZr1mMwI,5Gyp41oLVo7Gg7vF4vpmggWP5MU70QO6,1,0,0,0,0,0,1,0,1,0.14285714285714285,1,0.0,0,0,0,0,0,0,0,1,0,0,1,1
10562,150699,UB3T1xdX46WHuJ9IUpYPsABhZbypMXdd,5Gyp41oLVo7Gg7vF4vpmggWP5MU70QO6,2,0,0,0,0,0,2,0,2,0.2857142857142857,1,0.0,0,0,0,0,0,0,0,2,0,0,2,1
10563,150716,hEw8FL1KT7bCC88Jn3Nko4dT9ob6cai1,5Gyp41oLVo7Gg7vF4vpmggWP5MU70QO6,9,7,1,0,1,0,5,0,14,2.0,2,0.0,0,1,0,1,7,0,0,5,0,2,12,0
10564,150719,cTB4X2bRT1xHu8we0D7DvB0Dk0LEvzWM,5Gyp41oLVo7Gg7vF4vpmggWP5MU70QO6,5,2,1,0,1,0,2,0,6,0.8571428571428571,1,0.0,0,1,0,1,2,0,0,2,0,2,4,1
10565,150741,E2Oyq6ihCiT5QQe2BJC2C3SHeqeC0PTM,5Gyp41oLVo7Gg7vF4vpmggWP5MU70QO6,4,0,0,0,0,0,4,0,4,0.5714285714285714,1,0.0,0,0,0,0,0,0,0,4,0,0,4,1
10566,150766,LbvWqiv4pS7aRXIXyFn0o9xR8kGvWO8j,5Gyp41oLVo7Gg7vF4vpmggWP5MU70QO6,7,3,2,0,2,0,2,0,9,1.2857142857142858,1,0.0,0,2,0,2,3,0,0,2,0,4,5,0
10567,150772,2p7BWGCBsWr2G3F8TRtrYfQBak778298,5Gyp41oLVo7Gg7vF4vpmggWP5MU70QO6,1,0,0,0,0,0,1,0,1,0.14285714285714285,1,0.0,0,0,0,0,0,0,0,1,0,0,1,1
10568,150797,xcTs8E0JdUV5Fa3zmLqi0jCmZBwpcQNb,5Gyp41oLVo7Gg7vF4vpmggWP5MU70QO6,1,0,0,0,0,0,1,0,1,0.14285714285714285,1,0.0,0,0,0,0,0,0,0,1,0,0,1,1
10569,150798,6Fzv6BHa892WsSiThSmgkOpA8ZIRBlsi,5Gyp41oLVo7Gg7vF4vpmggWP5MU70QO6,1,0,0,0,0,0,1,0,1,0.14285714285714285,1,0.0,0,0,0,0,0,0,0,1,0,0,1,1
10570,150810,rimZAbDroN4JHLy1FnUyyHIXythkaSlF,5Gyp41oLVo7Gg7vF4vpmggWP5MU70QO6,1,0,0,0,0,0,1,0,1,0.14285714285714285,1,0.0,0,0,0,0,0,0,0,1,0,0,1,1
10571,150820,aWpML43pNRTlN0bl6CyYnFSUHuMwTloH,5Gyp41oLVo7Gg7vF4vpmggWP5MU70QO6,8,5,2,0,2,0,4,0,13,1.8571428571428572,2,0.0,0,2,0,2,5,0,0,4,0,4,9,1
10572,150824,TvbOZN90Rb22qxeutrBmoxAH9AkWYGE0,5Gyp41oLVo7Gg7vF4vpmggWP5MU70QO6,8,3,1,0,1,1,5,1,12,1.7142857142857142,1,0.0,0,1,0,1,3,1,0,5,1,2,10,1
10573,150883,TDlQaHz2Iiso6vxYQwqnZwIeJCgOzjvG,5Gyp41oLVo7Gg7vF4vpmggWP5MU70QO6,8,7,2,10,0,0,2,0,21,3.0,1,0.0,3,2,5,0,4,0,5,2,0,10,11,1
10574,150920,iWEmpult7cdvgdjFW97TkROBvpRLqQNG,5Gyp41oLVo7Gg7vF4vpmggWP5MU70QO6,10,5,4,0,2,4,7,0,22,3.142857142857143,2,0.0,0,4,0,2,5,4,0,7,0,6,16,1
10575,150924,z0iuBBXe6NAwnTD1TjbGOHoZJjubB4QY,5Gyp41oLVo7Gg7vF4vpmggWP5MU70QO6,7,6,4,0,1,0,3,0,14,2.0,1,0.0,0,4,0,1,6,0,0,3,0,5,9,1
10576,150929,VtEfFHwCwR0CG3OZFyRUkRQlzB85HLcu,5Gyp41oLVo7Gg7vF4vpmggWP5MU70QO6,12,8,5,2,3,0,4,0,22,3.142857142857143,1,0.0,1,5,1,3,7,0,1,4,0,10,12,1
10577,150946,uakEazVAgtWyDmSE47vyFHnNC6Qf3U0X,5Gyp41oLVo7Gg7vF4vpmggWP5MU70QO6,2,0,0,0,0,0,2,0,2,0.2857142857142857,1,0.0,0,0,0,0,0,0,0,2,0,0,2,1
10578,150962,2opiscyEIUMZmPKePynNJqybmsfM3G0C,5Gyp41oLVo7Gg7vF4vpmggWP5MU70QO6,1,0,0,0,0,0,1,0,1,0.14285714285714285,1,0.0,0,0,0,0,0,0,0,1,0,0,1,1
10579,150977,xLGTIbdl9NaTSL16miIAzql2qWGFIhiP,5Gyp41oLVo7Gg7vF4vpmggWP5MU70QO6,7,4,3,0,2,0,3,0,12,1.7142857142857142,2,0.0,0,3,0,2,4,0,0,3,0,5,7,1
10580,150990,qgASLWQyU9k2ZqOsvlCG3fRTd4MLx6um,5Gyp41oLVo7Gg7vF4vpmggWP5MU70QO6,5,2,1,0,1,0,2,0,6,0.8571428571428571,1,0.0,0,1,0,1,2,0,0,2,0,2,4,1
10581,150991,zt8D4cN45BQ8WOokF7iya4FQJ1n05JY2,5Gyp41oLVo7Gg7vF4vpmggWP5MU70QO6,1,0,0,0,0,0,2,0,2,0.2857142857142857,1,0.0,0,0,0,0,0,0,0,2,0,0,2,0
10582,151002,MBVAkaXCYILTL9RsvJRxHQ8HQtjIMFqR,5Gyp41oLVo7Gg7vF4vpmggWP5MU70QO6,12,9,4,0,3,2,4,3,25,3.5714285714285716,1,0.0,3,4,0,3,6,2,0,4,3,10,15,1
10583,151032,Cgo3i5wPjnPlIDXy5ZtlFAfb9EGIh6Ho,5Gyp41oLVo7Gg7vF4vpmggWP5MU70QO6,10,19,7,4,2,0,7,0,39,5.571428571428571,2,0.0,2,7,2,2,17,0,2,7,0,13,26,1
10584,151104,Cahe3svEUsAtvhU4j36EhbbwAZFF7PRw,5Gyp41oLVo7Gg7vF4vpmggWP5MU70QO6,1,0,0,0,0,0,1,0,1,0.14285714285714285,1,0.0,0,0,0,0,0,0,0,1,0,0,1,1
10585,151116,IRKD6QQqE5UsB7CGCGf1VbjHjgbIZ5ik,5Gyp41oLVo7Gg7vF4vpmggWP5MU70QO6,12,9,8,0,4,0,1,0,22,3.142857142857143,1,0.0,0,8,0,4,9,0,0,1,0,12,10,1
10586,151117,OGSx3QXbJb2YyeaMiQfX8Io7pXUD2AtB,5Gyp41oLVo7Gg7vF4vpmggWP5MU70QO6,3,0,0,0,0,0,2,1,3,0.42857142857142855,1,0.0,0,0,0,0,0,0,0,2,1,0,3,1
10587,151123,PRurM3JVE5CgyeeLqPfYEy4me00WTdzZ,5Gyp41oLVo7Gg7vF4vpmggWP5MU70QO6,2,0,0,0,0,0,5,0,5,0.7142857142857143,1,0.0,0,0,0,0,0,0,0,5,0,0,5,1
10588,151157,ppIjeIXeEOowZa4er1vFyLGyuckaeG1L,5Gyp41oLVo7Gg7vF4vpmggWP5MU70QO6,1,0,0,0,0,0,2,0,2,0.2857142857142857,1,0.0,0,0,0,0,0,0,0,2,0,0,2,1
10589,151211,ZMqcGNZ6hflvNiblPBWALOYjNJzfGsw9,5Gyp41oLVo7Gg7vF4vpmggWP5MU70QO6,10,6,4,0,3,0,6,1,20,2.857142857142857,1,0.0,0,4,0,3,6,0,0,6,1,7,13,1
10590,151219,OCvBDvGVZRaHWTizVfivm6XtBJbQUiAu,5Gyp41oLVo7Gg7vF4vpmggWP5MU70QO6,12,14,7,7,4,0,7,0,39,5.571428571428571,3,0.0,2,7,4,4,12,0,3,7,0,17,22,1
10591,151259,zYGWXWLcT41N9I9BOKqVpDhJ5WG0y41g,5Gyp41oLVo7Gg7vF4vpmggWP5MU70QO6,20,13,12,0,10,1,3,1,40,5.714285714285714,1,0.0,0,12,0,10,13,1,0,3,1,22,18,1
10592,151301,nyRjmMZBGrtgSgXab1LYEUfPApgIXNxT,5Gyp41oLVo7Gg7vF4vpmggWP5MU70QO6,8,9,5,0,1,0,4,1,20,2.857142857142857,1,0.0,1,5,0,1,8,0,0,4,1,7,13,1
10593,151313,ztPOXhNtl56G3t97cXRwCL5RI1J4OFD7,5Gyp41oLVo7Gg7vF4vpmggWP5MU70QO6,1,0,0,0,0,0,2,0,2,0.2857142857142857,1,0.0,0,0,0,0,0,0,0,2,0,0,2,1
10594,151329,CQQcy0Bo0ukva0QKFtZhYCLjSZESjyrA,5Gyp41oLVo7Gg7vF4vpmggWP5MU70QO6,7,3,2,0,2,0,2,0,9,1.2857142857142858,1,0.0,0,2,0,2,3,0,0,2,0,4,5,1
10595,151335,GmmVywER1JF6omawNroxy8entDJKS1q8,5Gyp41oLVo7Gg7vF4vpmggWP5MU70QO6,10,8,5,0,2,2,4,1,22,3.142857142857143,1,0.0,2,5,0,2,6,2,0,4,1,9,13,1
10596,151370,m3riDkeaP3qLddM2Qy9128A1o8BoTU63,5Gyp41oLVo7Gg7vF4vpmggWP5MU70QO6,8,4,3,0,2,0,2,0,11,1.5714285714285714,1,0.0,0,3,0,2,4,0,0,2,0,5,6,1
10597,151381,pCJ601RaucAyYeKAjB6Wx4CXJkI6lR1v,5Gyp41oLVo7Gg7vF4vpmggWP5MU70QO6,1,0,0,0,0,0,1,0,1,0.14285714285714285,1,0.0,0,0,0,0,0,0,0,1,0,0,1,1
10598,151395,vriOkwsWVqJfzxJ8W7a8LLBlyXQZ3fG0,5Gyp41oLVo7Gg7vF4vpmggWP5MU70QO6,11,4,3,0,2,1,8,1,19,2.7142857142857144,1,0.0,0,3,0,2,4,1,0,8,1,5,14,1
10599,151444,XqxXHlwlYxd9RSTeUV9pBamG1DPgHOIg,5Gyp41oLVo7Gg7vF4vpmggWP5MU70QO6,1,0,0,0,0,0,1,0,1,0.14285714285714285,1,0.0,0,0,0,0,0,0,0,1,0,0,1,1
10600,151452,i2zvUf1J8DQ4RkSXNyPilWOV1qg13nU6,5Gyp41oLVo7Gg7vF4vpmggWP5MU70QO6,8,2,1,0,1,2,6,1,13,1.8571428571428572,1,0.0,0,1,0,1,2,2,0,6,1,2,11,1
10601,151474,e1obZM1bAHvfZHkoYcbAKIAxfJj6crMT,5Gyp41oLVo7Gg7vF4vpmggWP5MU70QO6,6,2,1,0,1,0,5,0,9,1.2857142857142858,1,0.0,0,1,0,1,2,0,0,5,0,2,7,1
10602,151497,skJn7dtfSekFrPHRHs9swZ9AtSUKi36u,5Gyp41oLVo7Gg7vF4vpmggWP5MU70QO6,1,0,0,0,0,0,1,0,1,0.14285714285714285,1,0.0,0,0,0,0,0,0,0,1,0,0,1,1
10603,151512,pyjnq4Vgp0Ue1K5a6sybK0KOMHIfkFg2,5Gyp41oLVo7Gg7vF4vpmggWP5MU70QO6,7,3,2,0,2,0,2,0,9,1.2857142857142858,2,0.0,0,2,0,2,3,0,0,2,0,4,5,1
10604,151555,qQRLEcAlg6T9U8qnTd9lkM0YuBTWzAFC,5Gyp41oLVo7Gg7vF4vpmggWP5MU70QO6,7,6,5,0,0,0,2,0,13,1.8571428571428572,1,0.0,0,5,0,0,6,0,0,2,0,5,8,1
10605,151561,8TlP9GD3t3ZkBfQqFdUNcmi2jEbrR8GT,5Gyp41oLVo7Gg7vF4vpmggWP5MU70QO6,10,7,5,0,4,0,6,0,22,3.142857142857143,2,0.0,0,5,0,4,7,0,0,6,0,9,13,1
10606,151574,gMepcFQRTN7lgKSmtSrn4XIeT7QqyXcl,5Gyp41oLVo7Gg7vF4vpmggWP5MU70QO6,10,7,3,0,2,3,7,0,22,3.142857142857143,2,0.0,3,3,0,2,4,3,0,7,0,8,14,1
10607,151603,vfamyv38RKSLNIrvpxjE1CUmutx8EQhb,5Gyp41oLVo7Gg7vF4vpmggWP5MU70QO6,7,3,2,0,2,0,2,0,9,1.2857142857142858,1,0.0,0,2,0,2,3,0,0,2,0,4,5,1
10608,151614,QeowjJjTtxojAhNbnbzRAgIFHoftB0wb,5Gyp41oLVo7Gg7vF4vpmggWP5MU70QO6,27,34,1,0,27,0,2,0,64,9.142857142857142,1,0.0,16,1,0,27,18,0,0,2,0,44,20,1
10609,151624,zIHhHIwIbH6mJbe3ZAvW2ovaPewaq0E0,5Gyp41oLVo7Gg7vF4vpmggWP5MU70QO6,37,82,35,0,20,2,10,1,150,21.428571428571427,3,0.0,15,35,0,20,67,2,0,10,1,70,80,1
10610,151645,BGqQxatBbJGg1InFei2J6ukObltYiaee,5Gyp41oLVo7Gg7vF4vpmggWP5MU70QO6,1,0,0,0,0,0,1,0,1,0.14285714285714285,1,0.0,0,0,0,0,0,0,0,1,0,0,1,1
10611,151650,0jwIHraHXkLHayCuy1koBhJBBpRul7ls,5Gyp41oLVo7Gg7vF4vpmggWP5MU70QO6,8,12,3,0,3,0,3,0,21,3.0,2,0.0,0,3,0,3,12,0,0,3,0,6,15,1
10612,151673,5GSOIk40DiaxFLDGO9CmF3s4EHBoQKBL,5Gyp41oLVo7Gg7vF4vpmggWP5MU70QO6,7,4,2,0,2,0,2,0,10,1.4285714285714286,1,0.0,0,2,0,2,4,0,0,2,0,4,6,1
10613,151677,AE2tdbLbxS64wcOz5nwhZPxxpeFVRBm8,5Gyp41oLVo7Gg7vF4vpmggWP5MU70QO6,6,3,2,0,2,0,2,0,9,1.2857142857142858,2,0.0,0,2,0,2,3,0,0,2,0,4,5,1
10614,151702,XVusSBM1iN4EPU3OTN6DbNp5XkkHOSNw,5Gyp41oLVo7Gg7vF4vpmggWP5MU70QO6,8,6,2,6,1,0,4,0,19,2.7142857142857144,1,0.0,3,2,3,1,3,0,3,4,0,9,10,1
10615,151705,7SuBh5oLILOH91rGG7eNhiJeOIevyQ8x,5Gyp41oLVo7Gg7vF4vpmggWP5MU70QO6,8,8,4,0,2,0,5,0,19,2.7142857142857144,1,0.0,0,4,0,2,8,0,0,5,0,6,13,1
10616,151737,Gcq3zQq7nrW11GPHgteepGdAD3QWdcjQ,5Gyp41oLVo7Gg7vF4vpmggWP5MU70QO6,6,3,2,0,2,0,2,0,9,1.2857142857142858,1,0.0,0,2,0,2,3,0,0,2,0,4,5,1
10617,151741,txSjWYX3TEWx5QLOiaADcbFdCZMHt7yE,5Gyp41oLVo7Gg7vF4vpmggWP5MU70QO6,9,5,3,0,2,0,4,0,14,2.0,1,0.0,0,3,0,2,5,0,0,4,0,5,9,1
10618,151745,BJXfeE05oCoqfG6dfkL7NvI6ach99v6o,5Gyp41oLVo7Gg7vF4vpmggWP5MU70QO6,11,16,8,0,8,0,7,0,39,5.571428571428571,3,0.0,4,8,0,8,12,0,0,7,0,20,19,1
10619,151770,dFw00KiVLqF6ijTvDd8ZTWBC93HPidxG,5Gyp41oLVo7Gg7vF4vpmggWP5MU70QO6,11,8,6,0,2,0,4,0,20,2.857142857142857,1,0.0,0,6,0,2,8,0,0,4,0,8,12,1
10620,151786,0nqj6iIWmYxLKHezCs5xwlB8hzJ9Rg2d,5Gyp41oLVo7Gg7vF4vpmggWP5MU70QO6,3,6,2,0,0,0,1,0,9,1.2857142857142858,2,0.0,0,2,0,0,6,0,0,1,0,2,7,1
10621,151799,GSkYUOcl4XzYMWSWhE6gXRGQ9kqPeXsi,5Gyp41oLVo7Gg7vF4vpmggWP5MU70QO6,7,5,3,0,3,0,3,0,14,2.0,2,0.0,0,3,0,3,5,0,0,3,0,6,8,1
10622,151802,XDivE5MTW4h2lu5IAUqNO8tyEE7Yd12k,5Gyp41oLVo7Gg7vF4vpmggWP5MU70QO6,1,0,0,0,0,0,1,0,1,0.14285714285714285,1,0.0,0,0,0,0,0,0,0,1,0,0,1,1
10623,151839,WS3JHNCirmqyl3FCjFTJGtt7sm7sHXD1,5Gyp41oLVo7Gg7vF4vpmggWP5MU70QO6,1,0,0,0,0,0,1,0,1,0.14285714285714285,1,0.0,0,0,0,0,0,0,0,1,0,0,1,1
10624,151848,c59bqAm33HlD1IRUizkYpbuOmhSlZKxz,5Gyp41oLVo7Gg7vF4vpmggWP5MU70QO6,18,29,14,20,6,0,3,0,72,10.285714285714286,3,0.0,10,14,12,6,19,0,8,3,0,42,30,0
10625,151851,oWiCn9WB0Vf7GiIarokSY3ZAcyaFBYwe,5Gyp41oLVo7Gg7vF4vpmggWP5MU70QO6,8,7,2,0,3,0,2,0,14,2.0,1,0.0,1,2,0,3,6,0,0,2,0,6,8,1
10626,151909,A6Hs6FgdHHIEd93aaJeyuHd0DKLVp4TC,5Gyp41oLVo7Gg7vF4vpmggWP5MU70QO6,1,0,0,0,0,0,1,0,1,0.14285714285714285,1,0.0,0,0,0,0,0,0,0,1,0,0,1,1
10627,151918,oTRd7t0ldKB6LIoIZRzWKZS6aziZbQCm,5Gyp41oLVo7Gg7vF4vpmggWP5MU70QO6,5,1,1,0,0,0,3,0,5,0.7142857142857143,1,0.0,0,1,0,0,1,0,0,3,0,1,4,1
10628,151933,aiiEmLNQSiolhZl1TXNarodE8iRQ1uLE,5Gyp41oLVo7Gg7vF4vpmggWP5MU70QO6,9,18,6,8,6,1,2,0,41,5.857142857142857,2,0.0,4,6,5,6,14,1,3,2,0,21,20,1
10629,151936,mdbXSl3hCFCVMuDJ0iaG5R41jsALVGcQ,5Gyp41oLVo7Gg7vF4vpmggWP5MU70QO6,1,0,0,0,0,0,1,0,1,0.14285714285714285,1,0.0,0,0,0,0,0,0,0,1,0,0,1,1
10630,151938,vfxTkrGlbFfxC6BbsVcu0C1Uj2f3Pj72,5Gyp41oLVo7Gg7vF4vpmggWP5MU70QO6,9,9,4,0,5,0,7,0,25,3.5714285714285716,1,0.0,2,4,0,5,7,0,0,7,0,11,14,1
10631,151940,znxZnyXtm1pjamqHGbXAqp2Ed6fvtKuD,5Gyp41oLVo7Gg7vF4vpmggWP5MU70QO6,1,0,0,0,0,0,1,0,1,0.14285714285714285,1,0.0,0,0,0,0,0,0,0,1,0,0,1,1
10632,151966,9jMHJUpmGoib0Ra2B7XTqz1ENGVtyEfI,5Gyp41oLVo7Gg7vF4vpmggWP5MU70QO6,7,9,4,0,1,0,1,0,15,2.142857142857143,1,0.0,4,4,0,1,5,0,0,1,0,9,6,1
10633,152027,uHRQj2YwOI5LAsC864CB2Tbx3zimAMyg,5Gyp41oLVo7Gg7vF4vpmggWP5MU70QO6,8,24,9,0,0,10,2,0,45,6.428571428571429,1,0.0,8,9,0,0,16,10,0,2,0,17,28,1
10634,152058,hpKSHIi4bRo1DEIvbfvzcRke2iP1vwgF,5Gyp41oLVo7Gg7vF4vpmggWP5MU70QO6,6,1,1,0,1,0,3,0,6,0.8571428571428571,1,0.0,0,1,0,1,1,0,0,3,0,2,4,1
10635,152070,IYltlIa655Ul4wh63KcHA7YpTNQSMVLE,5Gyp41oLVo7Gg7vF4vpmggWP5MU70QO6,10,20,8,0,7,0,4,0,39,5.571428571428571,1,0.0,9,8,0,7,11,0,0,4,0,24,15,1
10636,152076,F3kU8xdNifwVhzzpDIJtdulyqML1znNn,5Gyp41oLVo7Gg7vF4vpmggWP5MU70QO6,8,6,3,0,2,0,3,0,14,2.0,1,0.0,0,3,0,2,6,0,0,3,0,5,9,1
10637,152114,6Bz2zeEUATpI58ZQRDX1hHy6J89t4dQK,5Gyp41oLVo7Gg7vF4vpmggWP5MU70QO6,6,3,1,0,2,0,1,0,7,1.0,1,0.0,0,1,0,2,3,0,0,1,0,3,4,1
10638,152133,xZnb7uXmxIWQ7sisovgxwTXG7X7Be4Tl,5Gyp41oLVo7Gg7vF4vpmggWP5MU70QO6,1,0,0,0,0,0,1,0,1,0.14285714285714285,1,0.0,0,0,0,0,0,0,0,1,0,0,1,1
10639,152134,Nc3ZZeizgzMQ7ljgRcfUdDiH0EOAXMpI,5Gyp41oLVo7Gg7vF4vpmggWP5MU70QO6,11,5,3,7,2,0,3,0,20,2.857142857142857,1,0.0,1,3,5,2,4,0,2,3,0,11,9,1
10640,152155,HbR6yZSevBZ4UKfkvdM9rmYn4kVz8brA,5Gyp41oLVo7Gg7vF4vpmggWP5MU70QO6,6,7,4,0,0,0,5,0,16,2.2857142857142856,1,0.0,0,4,0,0,7,0,0,5,0,4,12,1
10641,152163,syOsxSZOACgbnBxkt1yNu9uBPLJQFluD,5Gyp41oLVo7Gg7vF4vpmggWP5MU70QO6,1,0,0,0,0,0,1,0,1,0.14285714285714285,1,0.0,0,0,0,0,0,0,0,1,0,0,1,1
10642,152169,Er5duxYmvCidXsitQ5JrRU2NhqugWM9n,5Gyp41oLVo7Gg7vF4vpmggWP5MU70QO6,6,6,3,0,0,0,2,0,11,1.5714285714285714,1,0.0,1,3,0,0,5,0,0,2,0,4,7,1
10643,152247,1a9ONolNdHfPzIvOLc3Ed7iRRpnKvMt7,5Gyp41oLVo7Gg7vF4vpmggWP5MU70QO6,10,5,4,0,3,0,5,2,19,2.7142857142857144,1,0.0,1,4,0,3,4,0,0,5,2,8,11,1
10644,152253,NQaRkMwNJWFXhN2DoUJm3UnH8xIwYVaH,5Gyp41oLVo7Gg7vF4vpmggWP5MU70QO6,8,10,2,0,3,0,3,0,18,2.5714285714285716,1,0.0,3,2,0,3,7,0,0,3,0,8,10,1
10645,152258,guhTAC2wGHeGVbnCgc8qjrM4m2j0yBgB,5Gyp41oLVo7Gg7vF4vpmggWP5MU70QO6,2,0,0,0,0,0,2,0,2,0.2857142857142857,1,0.0,0,0,0,0,0,0,0,2,0,0,2,1
10646,152261,5ZHcPycX71kTiy1OkbQ8m2LgrpLSnwdX,5Gyp41oLVo7Gg7vF4vpmggWP5MU70QO6,5,2,1,0,1,0,2,0,6,0.8571428571428571,1,0.0,0,1,0,1,2,0,0,2,0,2,4,1
10647,152270,OryrsMazzodnSHJ9vOTAfmrHnnogyu54,5Gyp41oLVo7Gg7vF4vpmggWP5MU70QO6,1,0,0,0,0,0,1,0,1,0.14285714285714285,1,0.0,0,0,0,0,0,0,0,1,0,0,1,1
10648,152290,La9OQauy1UvIOhhQdOQTkNOwvHK4jV3P,5Gyp41oLVo7Gg7vF4vpmggWP5MU70QO6,6,1,0,0,1,0,5,0,7,1.0,1,0.0,0,0,0,1,1,0,0,5,0,1,6,1
10649,152318,CwJlacazjIgIAUmauxBsaXoD9dcHccYO,5Gyp41oLVo7Gg7vF4vpmggWP5MU70QO6,14,19,7,24,4,2,10,0,66,9.428571428571429,1,0.0,10,7,14,4,9,2,10,10,0,35,31,1
10650,152323,9Vi5veC33YSf2pxAVQxxr05mLKSB17N2,5Gyp41oLVo7Gg7vF4vpmggWP5MU70QO6,10,12,6,4,6,0,2,0,30,4.285714285714286,1,0.0,5,6,2,6,7,0,2,2,0,19,11,1
10651,152346,DJbioQ5SfDLmvjZBFcvRe6hHQMvGv4XM,5Gyp41oLVo7Gg7vF4vpmggWP5MU70QO6,19,14,7,25,2,0,5,0,53,7.571428571428571,2,0.0,4,7,21,2,10,0,4,5,0,34,19,1
10652,152373,uQ8RFZZxkrASTM8MRJxF8TGJLfCzH2Qo,5Gyp41oLVo7Gg7vF4vpmggWP5MU70QO6,13,11,6,24,1,0,2,0,44,6.285714285714286,1,0.0,3,6,17,1,8,0,7,2,0,27,17,0
10653,152382,z6mKqvs4i5mBYDccEiyPrpSR9giHEwNf,5Gyp41oLVo7Gg7vF4vpmggWP5MU70QO6,1,0,0,0,0,0,1,0,1,0.14285714285714285,1,0.0,0,0,0,0,0,0,0,1,0,0,1,1
10654,152394,nKyehpqCzFKe7AQ0H2jeEWUcUDLPIpGO,5Gyp41oLVo7Gg7vF4vpmggWP5MU70QO6,7,4,3,0,3,0,2,0,12,1.7142857142857142,1,0.0,0,3,0,3,4,0,0,2,0,6,6,1
10655,152400,ODT1AC3wa6ys7gxuLnHmS8BkFzaQrA9t,5Gyp41oLVo7Gg7vF4vpmggWP5MU70QO6,7,4,2,0,1,0,3,0,10,1.4285714285714286,1,0.0,0,2,0,1,4,0,0,3,0,3,7,1
10656,152406,nmzQqvd0h7JcyHIrVLdmRJ7QIayUcwIs,5Gyp41oLVo7Gg7vF4vpmggWP5MU70QO6,10,4,3,0,3,0,3,0,13,1.8571428571428572,1,0.0,1,3,0,3,3,0,0,3,0,7,6,1
10657,152424,uW1QxDE1Emo9PgDLqa7HDYgVFWbLLrwd,5Gyp41oLVo7Gg7vF4vpmggWP5MU70QO6,4,2,1,0,1,0,2,0,6,0.8571428571428571,1,0.0,0,1,0,1,2,0,0,2,0,2,4,1
10658,152426,SdxEuBLh8sNfmF8jUHIs4F2rJk51GkSG,5Gyp41oLVo7Gg7vF4vpmggWP5MU70QO6,5,2,1,0,1,0,3,0,7,1.0,1,0.0,0,1,0,1,2,0,0,3,0,2,5,1
10659,152442,fRUiNuT9vqr8LocDhCAsx8sUOBNWvuDu,5Gyp41oLVo7Gg7vF4vpmggWP5MU70QO6,10,5,4,3,2,0,3,0,17,2.4285714285714284,1,0.0,1,4,2,2,4,0,1,3,0,9,8,1
10660,152450,98Xmwep7rMoNdRjjxMw7R5Q1iLZQOljL,5Gyp41oLVo7Gg7vF4vpmggWP5MU70QO6,10,9,5,0,5,0,4,0,23,3.2857142857142856,1,0.0,0,5,0,5,9,0,0,4,0,10,13,1
10661,152462,q5Mh1DiRxqFPerzFhySJn3OvdiZ2Qdjc,5Gyp41oLVo7Gg7vF4vpmggWP5MU70QO6,10,3,2,0,2,3,7,1,18,2.5714285714285716,2,0.0,0,2,0,2,3,3,0,7,1,4,14,1
10662,152465,8ngiQOsuSsE6kh3Xd6QPTnftoLXvq8kg,5Gyp41oLVo7Gg7vF4vpmggWP5MU70QO6,5,2,0,0,0,1,4,0,7,1.0,1,0.0,0,0,0,0,2,1,0,4,0,0,7,1
10663,152474,sNuvw1spatTiOI6DpTHKFQgkJLxj3SJB,5Gyp41oLVo7Gg7vF4vpmggWP5MU70QO6,8,6,4,0,3,5,3,0,21,3.0,1,0.0,0,4,0,3,6,5,0,3,0,7,14,1
10664,152483,HfDg6ZshQIIsqHP26E57zcevXCtObxuT,5Gyp41oLVo7Gg7vF4vpmggWP5MU70QO6,17,16,8,8,6,0,3,0,41,5.857142857142857,2,0.0,5,8,7,6,11,0,1,3,0,26,15,1
10665,152505,jDRAci5S9OVs0Bpi7WzecuNlYqhyG3Bh,5Gyp41oLVo7Gg7vF4vpmggWP5MU70QO6,4,2,1,0,1,1,1,0,6,0.8571428571428571,1,0.0,0,1,0,1,2,1,0,1,0,2,4,1
10666,152507,ikK35mgDGK5ja784wwliOZjgmMMhehV6,5Gyp41oLVo7Gg7vF4vpmggWP5MU70QO6,4,2,1,0,0,0,4,0,7,1.0,1,0.0,0,1,0,0,2,0,0,4,0,1,6,1
10667,152512,4aRIMbnJ1MTzkvhZECvseAcRbjetlYDH,5Gyp41oLVo7Gg7vF4vpmggWP5MU70QO6,14,20,10,0,6,4,18,2,60,8.571428571428571,1,0.0,4,10,0,6,16,4,0,18,2,20,40,1
10668,152533,TTAUaNpDZti7U0Kjn6qpJlzxCyZQx90l,5Gyp41oLVo7Gg7vF4vpmggWP5MU70QO6,1,0,0,0,0,0,1,0,1,0.14285714285714285,1,0.0,0,0,0,0,0,0,0,1,0,0,1,1
10669,152543,2EottGYE4ATYAfZTb7e9UBk04hnSGKC0,5Gyp41oLVo7Gg7vF4vpmggWP5MU70QO6,6,5,3,0,1,0,3,0,12,1.7142857142857142,1,0.0,0,3,0,1,5,0,0,3,0,4,8,1
10670,152561,rl0RdWbqEf676uDYZiC3mM5uJRCHF96R,5Gyp41oLVo7Gg7vF4vpmggWP5MU70QO6,4,5,4,0,4,0,2,0,15,2.142857142857143,4,0.0,0,4,0,4,5,0,0,2,0,8,7,0
10671,152574,INDzJmJAfnF9QC3J8iKsduqg5ZM7irgR,5Gyp41oLVo7Gg7vF4vpmggWP5MU70QO6,7,4,1,0,2,0,2,0,9,1.2857142857142858,1,0.0,0,1,0,2,4,0,0,2,0,3,6,1
10672,152620,a0DcOGLeLwsJrHdEijar1MaQPhCwfyFX,5Gyp41oLVo7Gg7vF4vpmggWP5MU70QO6,1,0,0,0,0,0,1,0,1,0.14285714285714285,1,0.0,0,0,0,0,0,0,0,1,0,0,1,1
10673,152627,bnW1DbN8HNsOfIMBlKslbLJxB4iy78sI,5Gyp41oLVo7Gg7vF4vpmggWP5MU70QO6,6,3,2,0,2,0,1,0,8,1.1428571428571428,1,0.0,0,2,0,2,3,0,0,1,0,4,4,1
10674,152634,cX7YBuX9CV7Gubtjtl9QcNLmo4OXvb3w,5Gyp41oLVo7Gg7vF4vpmggWP5MU70QO6,7,8,4,0,2,0,6,0,20,2.857142857142857,3,0.0,0,4,0,2,8,0,0,6,0,6,14,1
10675,152666,wVIlQjqMwCv7ElIiAFUCVThdNvZtGDDY,5Gyp41oLVo7Gg7vF4vpmggWP5MU70QO6,4,2,1,0,1,0,1,0,5,0.7142857142857143,1,0.0,0,1,0,1,2,0,0,1,0,2,3,1
10676,152679,yieHWJtKxAlre6lcLGlFmy8nVvAvYHNq,5Gyp41oLVo7Gg7vF4vpmggWP5MU70QO6,7,8,4,0,0,0,4,0,16,2.2857142857142856,1,0.0,1,4,0,0,7,0,0,4,0,5,11,1
10677,152690,GIcv0cCXnFkrCBMZ2gyZyitp5Csvo5Ak,5Gyp41oLVo7Gg7vF4vpmggWP5MU70QO6,9,4,2,0,1,2,7,1,17,2.4285714285714284,1,0.0,0,2,0,1,4,2,0,7,1,3,14,1
10678,152741,x29OOChdmJGXK62DnUpwKbwJurqULmnD,5Gyp41oLVo7Gg7vF4vpmggWP5MU70QO6,4,2,1,0,1,0,2,0,6,0.8571428571428571,1,0.0,0,1,0,1,2,0,0,2,0,2,4,1
10679,152747,LgJ5ZhF5tQkktd8PpEfF1ErKOOnQRsGH,5Gyp41oLVo7Gg7vF4vpmggWP5MU70QO6,7,3,2,0,2,0,2,0,9,1.2857142857142858,1,0.0,0,2,0,2,3,0,0,2,0,4,5,1
10680,152766,ooIWsP0fEF17mEtGXwAlb2bCuQl5BzHu,5Gyp41oLVo7Gg7vF4vpmggWP5MU70QO6,6,2,2,0,0,0,3,0,7,1.0,1,0.0,0,2,0,0,2,0,0,3,0,2,5,1
10681,152797,eHvQ2U78p4YZsMgDMMDOOzYAdsqzih5K,5Gyp41oLVo7Gg7vF4vpmggWP5MU70QO6,5,5,2,0,2,0,1,0,10,1.4285714285714286,1,0.0,2,2,0,2,3,0,0,1,0,6,4,1
10682,152839,myUAFxvFHyWAiYmHYoqBgQ9oSGcqfz50,5Gyp41oLVo7Gg7vF4vpmggWP5MU70QO6,1,0,0,0,0,0,1,0,1,0.14285714285714285,1,0.0,0,0,0,0,0,0,0,1,0,0,1,1
10683,152852,8eAVRzls7MGQwc3WaPP7ONmygmpXQE3K,7GRhBDsirIGkRZBtSMEzNTyDr2JQm4xx,29,32,12,33,9,1,2,0,89,12.714285714285714,1,0.0,18,12,30,9,14,1,3,2,0,69,20,1
10684,152880,8Hm415bdFcwpFDq3GCBcLB32eZ08pGv6,5X6FeZozNMgE2VRi3MJYjkkFK8SETtu2,8,3,2,0,2,0,3,0,10,1.4285714285714286,1,0.0,0,2,0,2,3,0,0,3,0,4,6,1
10685,152889,4BpRE14XuCFERPNFltqE4ojcMHw6pKyT,7GRhBDsirIGkRZBtSMEzNTyDr2JQm4xx,6,2,1,0,1,0,3,0,7,1.0,1,0.0,0,1,0,1,2,0,0,3,0,2,5,1
10686,152895,U28zDecdJpM6GHGKP6A5ulmz5rhbfnrO,5X6FeZozNMgE2VRi3MJYjkkFK8SETtu2,8,8,4,0,0,0,2,0,14,2.0,1,0.0,0,4,0,0,8,0,0,2,0,4,10,1
10687,152905,vJkzpyJ0SKHdsZjXqrrJXheB0apoeMZe,5X6FeZozNMgE2VRi3MJYjkkFK8SETtu2,5,2,1,0,1,0,2,0,6,0.8571428571428571,1,0.0,0,1,0,1,2,0,0,2,0,2,4,1
10688,152924,1UDHQI8imw8nweB1TYtOC79yWWeAk6dI,7GRhBDsirIGkRZBtSMEzNTyDr2JQm4xx,1,0,0,0,0,0,1,0,1,0.14285714285714285,1,0.0,0,0,0,0,0,0,0,1,0,0,1,1
10689,152928,pDrKPdaXWYW4w4iXEP1j5gnJPxx2TpIU,5X6FeZozNMgE2VRi3MJYjkkFK8SETtu2,1,0,0,0,0,0,1,0,1,0.14285714285714285,1,0.0,0,0,0,0,0,0,0,1,0,0,1,1
10690,152947,8CRgXCsGfpR9dPh02oBh23kfAkqyw4RQ,5X6FeZozNMgE2VRi3MJYjkkFK8SETtu2,2,0,0,0,0,0,2,0,2,0.2857142857142857,1,0.0,0,0,0,0,0,0,0,2,0,0,2,1
10691,152950,2bFnB4uI8l4fyqIbUzJ6PgGAsqDupazk,7GRhBDsirIGkRZBtSMEzNTyDr2JQm4xx,5,2,0,0,0,2,4,0,8,1.1428571428571428,1,0.0,0,0,0,0,2,2,0,4,0,0,8,1
10692,153021,dcAfcDe1XQG4OPzTBHUeq4qqwRgLRIBM,7GRhBDsirIGkRZBtSMEzNTyDr2JQm4xx,33,36,18,42,20,3,3,0,122,17.428571428571427,1,0.0,16,18,40,20,20,3,2,3,0,94,28,1
10693,153028,Z5LlhMEzK5ZFl6PY51s2Mt2xA8hbOdg8,5X6FeZozNMgE2VRi3MJYjkkFK8SETtu2,10,35,3,3,3,0,8,0,52,7.428571428571429,4,0.0,3,3,3,3,32,0,0,8,0,12,40,1
10694,153032,SunVurSWT2ON8oDyf5iEIbV6p9uzItF1,5X6FeZozNMgE2VRi3MJYjkkFK8SETtu2,4,2,0,0,0,0,3,0,5,0.7142857142857143,1,0.0,0,0,0,0,2,0,0,3,0,0,5,1
10695,153052,UfBZxbp3dHdvs4dmjpPF1a599SiVHfq9,7GRhBDsirIGkRZBtSMEzNTyDr2JQm4xx,13,14,7,0,4,0,3,0,28,4.0,1,0.0,0,7,0,4,14,0,0,3,0,11,17,1
10696,153059,A2QvZbkv82OL2jQwgDFpwg2Cui3PLWb0,5X6FeZozNMgE2VRi3MJYjkkFK8SETtu2,8,12,2,0,5,0,3,0,22,3.142857142857143,1,0.0,6,2,0,5,6,0,0,3,0,13,9,0
10697,153070,nNeSwHjoP91mmln5SrcL87TOEBs15zTk,7GRhBDsirIGkRZBtSMEzNTyDr2JQm4xx,2,0,0,0,0,0,2,0,2,0.2857142857142857,1,0.0,0,0,0,0,0,0,0,2,0,0,2,1
10698,153072,IOcEoixO9HVhIQeLNHKaS3iQynrmSTmV,7GRhBDsirIGkRZBtSMEzNTyDr2JQm4xx,40,148,34,63,6,37,29,3,320,45.714285714285715,4,0.0,87,34,49,6,61,37,14,29,3,176,144,0
10699,153082,pc8Cijkar16XHq3iOS71C2O61xVOM7hS,7GRhBDsirIGkRZBtSMEzNTyDr2JQm4xx,1,0,0,0,0,0,1,0,1,0.14285714285714285,1,0.0,0,0,0,0,0,0,0,1,0,0,1,1
10700,153100,b1z9qcijCspwmiMthrB1U99sapgpXD16,5X6FeZozNMgE2VRi3MJYjkkFK8SETtu2,9,8,2,0,4,0,2,0,16,2.2857142857142856,1,0.0,3,2,0,4,5,0,0,2,0,9,7,1
10701,153106,4dWOmHqqlMb2FlRY2mDnSBR6FrPBKxXO,7GRhBDsirIGkRZBtSMEzNTyDr2JQm4xx,2,0,0,0,0,0,5,0,5,0.7142857142857143,1,0.0,0,0,0,0,0,0,0,5,0,0,5,1
10702,153121,8I7HeVQkY0Ghn3WH0qZuBP62XiNRUFqR,5X6FeZozNMgE2VRi3MJYjkkFK8SETtu2,2,0,0,0,0,0,2,0,2,0.2857142857142857,1,0.0,0,0,0,0,0,0,0,2,0,0,2,1
10703,153143,lrzhiR0lqwM9mMtMpTIKNjxovQJrC4EF,5X6FeZozNMgE2VRi3MJYjkkFK8SETtu2,1,0,0,0,0,0,2,0,2,0.2857142857142857,1,0.0,0,0,0,0,0,0,0,2,0,0,2,1
10704,153151,Q3gIXSI0FAVHTJlJRiNvbhHhP7SCfem4,5X6FeZozNMgE2VRi3MJYjkkFK8SETtu2,5,2,1,0,1,0,2,0,6,0.8571428571428571,1,0.0,0,1,0,1,2,0,0,2,0,2,4,1
10705,153160,wFvodFqghxL7iISMFbYXkYNq6P6eK5gH,5X6FeZozNMgE2VRi3MJYjkkFK8SETtu2,1,0,0,0,0,0,2,0,2,0.2857142857142857,2,0.0,0,0,0,0,0,0,0,2,0,0,2,1
10706,153176,u87aVD0sE7LnY3BaUJepoCjM2Nidt8Dg,5X6FeZozNMgE2VRi3MJYjkkFK8SETtu2,1,0,0,0,0,0,1,0,1,0.14285714285714285,1,0.0,0,0,0,0,0,0,0,1,0,0,1,1
10707,153205,pvxjw4szSuluDWQ3DWPes9Mzs1MCvxjI,SpATywNh6bZuzm8s1ceuBUnMUAeoAHHw,44,51,30,48,14,19,33,6,201,28.714285714285715,7,0.0,11,30,41,14,40,19,7,33,6,96,105,1
10708,153209,5ZHw0M7FTk5cO1fK8KsZKsofS7GANtcz,SpATywNh6bZuzm8s1ceuBUnMUAeoAHHw,14,22,2,10,0,17,7,1,59,8.428571428571429,1,0.0,5,2,9,0,17,17,1,7,1,16,43,1
10709,153222,qGeBgOr7St26ZmQVIT5NibjBEisNw9ln,SpATywNh6bZuzm8s1ceuBUnMUAeoAHHw,23,34,21,11,5,2,11,1,85,12.142857142857142,5,0.0,2,21,10,5,32,2,1,11,1,38,47,1
10710,153223,4iqKNHeZS5JSEDCOEGY9iVAlANRyx0Hy,bWdj2GDclj5ofokWjzoa5jAwMkxCykd6,1,0,0,0,0,0,1,0,1,0.14285714285714285,1,0.0,0,0,0,0,0,0,0,1,0,0,1,1
10711,153230,9pfskqYp4pvR53OXPIHxfdcjDCQolJRR,SpATywNh6bZuzm8s1ceuBUnMUAeoAHHw,35,27,16,19,9,4,13,0,88,12.571428571428571,3,0.0,4,16,17,9,23,4,2,13,0,46,42,1
10712,153240,HKDSRzc7MQzCfJsk49D6xFQK4oFHHvy7,G8EPVSXsOYB5YQWZGiz1aVq5Pgr2GrQu,11,7,1,6,2,0,7,0,23,3.2857142857142856,2,0.0,5,1,3,2,2,0,3,7,0,11,12,1
10713,153250,b9mxLoVADmerKv5HkkvTTWu7wHJ0K2g8,RXDvfPUBYFlVdlueBFbLW0mhhAyGEqpt,5,3,1,0,1,0,1,0,6,0.8571428571428571,1,0.0,0,1,0,1,3,0,0,1,0,2,4,1
10714,153254,CxT0CHLq6J1c8Jut4aoI3ctVaIuJrmZd,SpATywNh6bZuzm8s1ceuBUnMUAeoAHHw,6,2,1,0,1,0,4,0,8,1.1428571428571428,1,0.0,0,1,0,1,2,0,0,4,0,2,6,1
10715,153304,AxjnggPTKyT2aYQCBpgnjenDZZbNsOpc,SpATywNh6bZuzm8s1ceuBUnMUAeoAHHw,15,13,2,4,0,0,2,0,21,3.0,2,0.0,0,2,4,0,13,0,0,2,0,6,15,0
10716,153320,17nF9FTjTWCsbOCjXVTb0OZUIQSKIDV1,SpATywNh6bZuzm8s1ceuBUnMUAeoAHHw,5,3,1,0,1,0,1,0,6,0.8571428571428571,1,0.0,0,1,0,1,3,0,0,1,0,2,4,1
10717,153335,OgqpjGMMInWS9PhYsy4mlMX0fhVM7tcA,SpATywNh6bZuzm8s1ceuBUnMUAeoAHHw,27,51,24,30,17,4,3,0,129,18.428571428571427,3,0.0,14,24,27,17,37,4,3,3,0,82,47,1
10718,153344,zFxBEkWmbKmgcm9gb8oYLXK8dhxOMTgG,bWdj2GDclj5ofokWjzoa5jAwMkxCykd6,4,2,1,0,1,0,1,0,5,0.7142857142857143,1,0.0,0,1,0,1,2,0,0,1,0,2,3,1
10719,153359,OsZOOHLTzswhvwcqovfIZ4d3mMdzbQV4,bWdj2GDclj5ofokWjzoa5jAwMkxCykd6,4,2,0,0,0,0,2,0,4,0.5714285714285714,1,0.0,0,0,0,0,2,0,0,2,0,0,4,1
10720,153377,pShr7F4fdPHy76vFAX1gnyjDQNfbMT7w,SpATywNh6bZuzm8s1ceuBUnMUAeoAHHw,10,8,5,0,3,1,10,1,28,4.0,2,0.0,0,5,0,3,8,1,0,10,1,8,20,1
10721,153381,mgLL2TOXKEK8di2v3UUyM4FMUqEuj4kl,bWdj2GDclj5ofokWjzoa5jAwMkxCykd6,1,0,0,0,0,0,1,0,1,0.14285714285714285,1,0.0,0,0,0,0,0,0,0,1,0,0,1,1
10722,153388,afQkAxUvdLu532EqkP2BO2E822Re7HYk,A3fsA9Zfv1X2fVEQhTw51lKENdNrEqT3,1,0,0,0,0,0,1,0,1,0.14285714285714285,1,0.0,0,0,0,0,0,0,0,1,0,0,1,1
10723,153389,afQkAxUvdLu532EqkP2BO2E822Re7HYk,bWdj2GDclj5ofokWjzoa5jAwMkxCykd6,1,0,0,0,0,0,1,0,1,0.14285714285714285,1,0.0,0,0,0,0,0,0,0,1,0,0,1,1
10724,153404,ZoDpWjHIWpxSzHmkG8xPsIIgTQq9K5uN,SpATywNh6bZuzm8s1ceuBUnMUAeoAHHw,15,20,7,15,1,2,6,1,52,7.428571428571429,3,0.0,9,7,14,1,11,2,1,6,1,31,21,1
10725,153443,ngup3fucB3JZQIAGeEk4g3OEqzwFokS0,A3fsA9Zfv1X2fVEQhTw51lKENdNrEqT3,15,7,6,0,6,3,6,0,28,4.0,1,0.0,0,6,0,6,7,3,0,6,0,12,16,1
10726,153457,cYe4n4c9KPDfBEWjGIRj6ImLxtmj3FnE,SpATywNh6bZuzm8s1ceuBUnMUAeoAHHw,24,35,17,4,8,1,10,2,77,11.0,4,0.0,0,17,4,8,35,1,0,10,2,29,48,0
10727,153527,7abxlkdMiNWAIk78NzVnHWo2fZI6eMvl,G8EPVSXsOYB5YQWZGiz1aVq5Pgr2GrQu,1,0,0,0,0,0,1,0,1,0.14285714285714285,1,0.0,0,0,0,0,0,0,0,1,0,0,1,1
10728,153528,Xbyo7HUsTZeFyBz3S4UH7TOjaOcOatNR,G8EPVSXsOYB5YQWZGiz1aVq5Pgr2GrQu,14,9,4,10,2,1,7,0,33,4.714285714285714,1,0.0,3,4,7,2,6,1,3,7,0,16,17,1
10729,153554,5ESBYT4YXwThMhRWcyNvUGRmyEr1sxDg,A3fsA9Zfv1X2fVEQhTw51lKENdNrEqT3,8,9,4,0,2,0,2,0,17,2.4285714285714284,2,0.0,0,4,0,2,9,0,0,2,0,6,11,0
10730,153591,wnrnl9khoFP1InwfVTZawT3pFxBvI7k9,SpATywNh6bZuzm8s1ceuBUnMUAeoAHHw,16,15,2,10,3,0,4,0,34,4.857142857142857,1,0.0,4,2,8,3,11,0,2,4,0,17,17,1
10731,153593,UBlBWZ3qSNiPpjfNB2f0HBLc8JT09fQp,bWdj2GDclj5ofokWjzoa5jAwMkxCykd6,1,0,0,0,0,0,1,0,1,0.14285714285714285,1,0.0,0,0,0,0,0,0,0,1,0,0,1,1
10732,153600,f1mXA42Iut2h3an7dNcb6e25YzQPcYho,SpATywNh6bZuzm8s1ceuBUnMUAeoAHHw,28,47,20,27,11,0,6,0,111,15.857142857142858,3,0.0,10,20,25,11,37,0,2,6,0,66,45,1
10733,153603,bGlyGIDBiTQ9cORO6s00PigGAgG0feOe,bWdj2GDclj5ofokWjzoa5jAwMkxCykd6,12,14,0,48,2,6,3,1,74,10.571428571428571,1,0.0,6,0,47,2,8,6,1,3,1,55,19,1
10734,153638,npggYhQDuWIBT1CD0vElHVM5v5VjjGlP,SpATywNh6bZuzm8s1ceuBUnMUAeoAHHw,12,9,5,0,4,0,3,0,21,3.0,2,0.0,0,5,0,4,9,0,0,3,0,9,12,1
10735,153642,y0PkAopIdLmRFrkWC9eBHvWT77KfVWMh,SpATywNh6bZuzm8s1ceuBUnMUAeoAHHw,13,24,11,0,7,0,3,0,45,6.428571428571429,2,0.0,0,11,0,7,24,0,0,3,0,18,27,1
10736,153643,1pusTPLSLF5m0UuZqZkNpGlAq8VrQ1KA,G8EPVSXsOYB5YQWZGiz1aVq5Pgr2GrQu,1,0,0,0,0,0,1,0,1,0.14285714285714285,1,0.0,0,0,0,0,0,0,0,1,0,0,1,1
10737,153651,4arExpTK1wIuXqxD9mjuWbelMebzEsNU,SpATywNh6bZuzm8s1ceuBUnMUAeoAHHw,5,2,1,0,1,0,2,0,6,0.8571428571428571,1,0.0,0,1,0,1,2,0,0,2,0,2,4,1
10738,153665,2mwblOfAIlWCnOpKEy9s0V1Ag6iOs76e,SpATywNh6bZuzm8s1ceuBUnMUAeoAHHw,1,0,0,0,0,0,1,0,1,0.14285714285714285,1,0.0,0,0,0,0,0,0,0,1,0,0,1,1
10739,153668,0ORnjZDNtR58wRPjDahIQtI1SSJa0QxJ,SpATywNh6bZuzm8s1ceuBUnMUAeoAHHw,14,13,7,15,5,0,4,0,44,6.285714285714286,1,0.0,5,7,14,5,8,0,1,4,0,31,13,1
10740,153684,htua1xywlnpsMMY7EJSOsurL86GI912X,A3fsA9Zfv1X2fVEQhTw51lKENdNrEqT3,28,8,4,96,1,0,7,0,116,16.571428571428573,1,0.0,2,4,80,1,6,0,16,7,0,87,29,1
10741,153697,JVadOLmYm00UY6RpVFCz6oCIzPWjF9Xb,bWdj2GDclj5ofokWjzoa5jAwMkxCykd6,4,4,1,0,2,0,1,0,8,1.1428571428571428,1,0.0,2,1,0,2,2,0,0,1,0,5,3,1
10742,153698,imNhKIaFauvST7J9xfEWryq9BWP5AbNf,SpATywNh6bZuzm8s1ceuBUnMUAeoAHHw,1,0,0,0,0,0,1,0,1,0.14285714285714285,1,0.0,0,0,0,0,0,0,0,1,0,0,1,1
10743,153705,imNhKIaFauvST7J9xfEWryq9BWP5AbNf,RXDvfPUBYFlVdlueBFbLW0mhhAyGEqpt,1,0,0,0,0,0,1,0,1,0.14285714285714285,1,0.0,0,0,0,0,0,0,0,1,0,0,1,1
10744,153708,cX96KcLUG7eWbqHO7enIWngg59YqtKEY,SpATywNh6bZuzm8s1ceuBUnMUAeoAHHw,13,32,14,14,1,4,10,2,77,11.0,4,0.0,13,14,13,1,19,4,1,10,2,41,36,1
10745,153744,ttb5iuebPMlcVHZPAjxVbJ8njCe9OqDr,SpATywNh6bZuzm8s1ceuBUnMUAeoAHHw,15,17,3,18,3,0,7,0,48,6.857142857142857,3,0.0,2,3,15,3,15,0,3,7,0,23,25,1
10746,153745,lBUrinPM7S9o6yK6K8JSMwJaVRnBcZFO,bWdj2GDclj5ofokWjzoa5jAwMkxCykd6,4,2,0,0,0,0,3,0,5,0.7142857142857143,1,0.0,0,0,0,0,2,0,0,3,0,0,5,1
10747,153761,VEn1n8siGoYMgQvsRJOH6Mt6C0Cu6W64,SpATywNh6bZuzm8s1ceuBUnMUAeoAHHw,28,23,17,24,11,0,3,0,78,11.142857142857142,3,0.0,4,17,23,11,19,0,1,3,0,55,23,1
10748,153775,NDTWRDiLyYPUSKAzpsOEnrkggSOfO91T,SpATywNh6bZuzm8s1ceuBUnMUAeoAHHw,28,64,37,36,17,0,7,0,161,23.0,4,0.0,17,37,32,17,47,0,4,7,0,103,58,1
10749,153790,IA8IlgrjDUbf5IQm26Ve5t8QQHZhw82k,SpATywNh6bZuzm8s1ceuBUnMUAeoAHHw,1,0,0,0,0,0,1,0,1,0.14285714285714285,1,0.0,0,0,0,0,0,0,0,1,0,0,1,1
10750,153802,JrfTo5GNjMn6EHzlMiG1fSQLURYPPGKs,bWdj2GDclj5ofokWjzoa5jAwMkxCykd6,2,0,0,0,0,0,4,0,4,0.5714285714285714,1,0.0,0,0,0,0,0,0,0,4,0,0,4,1
10751,153806,VhpXVmuePjSLeMVIlElMMladDGd0odWC,bWdj2GDclj5ofokWjzoa5jAwMkxCykd6,17,17,6,24,0,3,4,0,54,7.714285714285714,1,0.0,6,6,23,0,11,3,1,4,0,35,19,0
10752,153810,pGNIRV05CYiaTTY4zIoziuGcEcxqXgio,A3fsA9Zfv1X2fVEQhTw51lKENdNrEqT3,5,1,0,0,0,0,3,2,6,0.8571428571428571,1,0.0,0,0,0,0,1,0,0,3,2,0,6,1
10753,153815,ocmyq6MXRULfgpYdGM8QGfWnP2Queprt,RXDvfPUBYFlVdlueBFbLW0mhhAyGEqpt,1,0,0,0,0,0,1,0,1,0.14285714285714285,1,0.0,0,0,0,0,0,0,0,1,0,0,1,1
10754,153857,BsO4gYCEUXQGKYLyHXV4q0f2CE6gKQPc,bWdj2GDclj5ofokWjzoa5jAwMkxCykd6,2,0,0,0,0,0,2,0,2,0.2857142857142857,1,0.0,0,0,0,0,0,0,0,2,0,0,2,1
10755,153860,ZNBGAlJve4TYJ3FcDlTLBdyuklADldDZ,A3fsA9Zfv1X2fVEQhTw51lKENdNrEqT3,6,5,3,0,1,0,2,0,11,1.5714285714285714,2,0.0,0,3,0,1,5,0,0,2,0,4,7,1
10756,153882,WY9Kk93NuRsoZvVUYcqVREh3xtBHbvAb,SpATywNh6bZuzm8s1ceuBUnMUAeoAHHw,1,0,0,0,0,0,2,0,2,0.2857142857142857,1,0.0,0,0,0,0,0,0,0,2,0,0,2,1
10757,153883,5hosZ8hQASGCVLdW9XYMecTXS9o9Kexh,G8EPVSXsOYB5YQWZGiz1aVq5Pgr2GrQu,7,3,2,0,2,0,2,0,9,1.2857142857142858,1,0.0,0,2,0,2,3,0,0,2,0,4,5,1
10758,153898,q9ayVwEoKiDDsIKc3IAHGSTn37C2BcId,SpATywNh6bZuzm8s1ceuBUnMUAeoAHHw,1,0,0,0,0,0,4,0,4,0.5714285714285714,1,0.0,0,0,0,0,0,0,0,4,0,0,4,1
10759,153916,fg9xG7J3hLazBdFakHteLNxtYgOMtOn7,SpATywNh6bZuzm8s1ceuBUnMUAeoAHHw,5,5,1,0,1,0,3,0,10,1.4285714285714286,1,0.0,2,1,0,1,3,0,0,3,0,4,6,1
10760,153925,LH8Ugxvjxhypkt5v1imhfncDCGMVYvOX,SpATywNh6bZuzm8s1ceuBUnMUAeoAHHw,7,46,3,0,1,1,15,0,66,9.428571428571429,1,0.0,0,3,0,1,46,1,0,15,0,4,62,1
10761,153930,a7HqL5rVaBWdmJJ0LA7o4pdEGfF0vFCf,SpATywNh6bZuzm8s1ceuBUnMUAeoAHHw,24,18,11,29,6,0,3,0,67,9.571428571428571,1,0.0,6,11,28,6,12,0,1,3,0,51,16,1
10762,153939,ECkqmAuIkv3ncN9wNJby8oOn15qTd9kR,bWdj2GDclj5ofokWjzoa5jAwMkxCykd6,2,0,0,0,0,0,3,0,3,0.42857142857142855,3,0.0,0,0,0,0,0,0,0,3,0,0,3,1
10763,153960,lHqG7UT3evpRhAVEeXMKWozC3OBfRB6b,bWdj2GDclj5ofokWjzoa5jAwMkxCykd6,4,1,1,0,0,0,2,0,4,0.5714285714285714,1,0.0,0,1,0,0,1,0,0,2,0,1,3,1
10764,153970,rK6GKHeyjKWUALwDzkIRQ6keCnDOngXi,SpATywNh6bZuzm8s1ceuBUnMUAeoAHHw,9,10,3,8,0,0,6,0,27,3.857142857142857,3,0.0,6,3,8,0,4,0,0,6,0,17,10,1
10765,153980,RuTxY8DaJW8mZYxEAeQrQJD3l4wbq41Q,A3fsA9Zfv1X2fVEQhTw51lKENdNrEqT3,9,5,1,0,1,0,5,0,12,1.7142857142857142,1,0.0,0,1,0,1,5,0,0,5,0,2,10,1
10766,153981,PWSenA2xTFV9h2dRBUmJc6Dd5CU49Bfk,SpATywNh6bZuzm8s1ceuBUnMUAeoAHHw,8,3,3,0,2,0,6,0,14,2.0,3,0.0,0,3,0,2,3,0,0,6,0,5,9,1
10767,153987,tWEnJYIhXMJ03Foo959mubaAJUHZPTw0,bWdj2GDclj5ofokWjzoa5jAwMkxCykd6,1,0,0,0,0,0,1,0,1,0.14285714285714285,1,0.0,0,0,0,0,0,0,0,1,0,0,1,1
10768,153994,y0CnonzJAddQ4oYr5LBSP0Y6KP3RgPGg,bWdj2GDclj5ofokWjzoa5jAwMkxCykd6,3,2,1,0,0,0,1,0,4,0.5714285714285714,1,0.0,0,1,0,0,2,0,0,1,0,1,3,1
10769,154004,Cf7GCeUZzG7WjvUIyGfwv9hfcwXPVq5G,SpATywNh6bZuzm8s1ceuBUnMUAeoAHHw,35,78,5,46,1,20,21,0,171,24.428571428571427,13,0.0,12,5,41,1,66,20,5,21,0,59,112,0
10770,154030,ijmzTkXDQO41J49xgIf8BYjGtAGyN9zu,SpATywNh6bZuzm8s1ceuBUnMUAeoAHHw,1,0,0,0,0,0,1,0,1,0.14285714285714285,1,0.0,0,0,0,0,0,0,0,1,0,0,1,1
10771,154035,DHCzWncH94ErnybHPppeaE2nTRJmmMhY,SpATywNh6bZuzm8s1ceuBUnMUAeoAHHw,35,99,40,41,14,45,19,6,264,37.714285714285715,3,0.0,45,40,33,14,54,45,8,19,6,132,132,1
10772,154042,2K1Z8MHkxSfa3IoXQMOOkvPRYry0VFvS,A3fsA9Zfv1X2fVEQhTw51lKENdNrEqT3,6,3,2,0,2,0,1,0,8,1.1428571428571428,1,0.0,0,2,0,2,3,0,0,1,0,4,4,1
10773,154089,HiNePj7VyLNET123cNCa7VjP10PYv5CS,SpATywNh6bZuzm8s1ceuBUnMUAeoAHHw,9,9,4,0,2,0,2,0,17,2.4285714285714284,1,0.0,4,4,0,2,5,0,0,2,0,10,7,1
10774,154117,BdPEjrNeRWORvoAvmySSATaD7FpfgjJ7,bWdj2GDclj5ofokWjzoa5jAwMkxCykd6,1,0,0,0,0,0,1,0,1,0.14285714285714285,1,0.0,0,0,0,0,0,0,0,1,0,0,1,1
10775,154119,BdPEjrNeRWORvoAvmySSATaD7FpfgjJ7,A3fsA9Zfv1X2fVEQhTw51lKENdNrEqT3,4,0,0,0,0,0,3,1,4,0.5714285714285714,1,0.0,0,0,0,0,0,0,0,3,1,0,4,1
10776,154123,vljlAhHGhHZt2ciFpy2bQxMoEL2SUwdk,SpATywNh6bZuzm8s1ceuBUnMUAeoAHHw,7,4,1,0,1,0,2,0,8,1.1428571428571428,1,0.0,0,1,0,1,4,0,0,2,0,2,6,1
10777,154133,zUPpTYisLLzFG12BVDvWrty0j8q1G6Si,SpATywNh6bZuzm8s1ceuBUnMUAeoAHHw,32,52,4,29,5,7,17,1,115,16.428571428571427,10,0.0,17,4,27,5,35,7,2,17,1,53,62,0
10778,154181,BXV7sGq2IrRSqCFuLKgoxpKYDPSPpUSj,A3fsA9Zfv1X2fVEQhTw51lKENdNrEqT3,2,0,0,0,0,0,2,0,2,0.2857142857142857,2,0.0,0,0,0,0,0,0,0,2,0,0,2,1
10779,154194,fZpfLVVUEp7GXISLcNFyxWveiOP0dldp,G8EPVSXsOYB5YQWZGiz1aVq5Pgr2GrQu,10,10,0,0,1,0,2,0,13,1.8571428571428572,1,0.0,0,0,0,1,10,0,0,2,0,1,12,0
10780,154208,SnMvZAwuUspzGESZwgJ4IDkT9epWcLq2,RXDvfPUBYFlVdlueBFbLW0mhhAyGEqpt,13,13,10,0,6,0,2,0,31,4.428571428571429,1,0.0,2,10,0,6,11,0,0,2,0,18,13,1
10781,154222,Csfk45aTs4wr0LJ69dzlrUlkEXjL89zd,bWdj2GDclj5ofokWjzoa5jAwMkxCykd6,23,11,6,50,2,5,7,1,82,11.714285714285714,3,0.0,3,6,45,2,8,5,5,7,1,56,26,0
10782,154230,H3O4gyMG4JZCCta11ycRXQMoTwg05Wu8,SpATywNh6bZuzm8s1ceuBUnMUAeoAHHw,4,1,0,0,0,0,4,0,5,0.7142857142857143,1,0.0,0,0,0,0,1,0,0,4,0,0,5,1
10783,154248,vMZukU2eTrxJbVM8jQ4bYVexnS3K2zdf,bWdj2GDclj5ofokWjzoa5jAwMkxCykd6,3,0,0,0,0,0,4,0,4,0.5714285714285714,1,0.0,0,0,0,0,0,0,0,4,0,0,4,1
10784,154272,CyBDBZRil6YI8WC6HxaXnpzYqE6gLNfL,A3fsA9Zfv1X2fVEQhTw51lKENdNrEqT3,1,0,0,0,0,0,1,0,1,0.14285714285714285,1,0.0,0,0,0,0,0,0,0,1,0,0,1,1
10785,154299,AcDeEJDUje4XRTI7mcV6fGOSh4iQh87e,5X6FeZozNMgE2VRi3MJYjkkFK8SETtu2,1,0,0,0,0,0,1,0,1,0.14285714285714285,1,0.0,0,0,0,0,0,0,0,1,0,0,1,1
10786,154302,6MMO6p1gWBmDJN4eS7QrAi6Zg4mTPljX,SpATywNh6bZuzm8s1ceuBUnMUAeoAHHw,8,10,2,0,1,0,4,0,17,2.4285714285714284,2,0.0,0,2,0,1,10,0,0,4,0,3,14,1
10787,154303,UsP8UHahXGHaChNTAHL4dZh6OmvP94L7,7GRhBDsirIGkRZBtSMEzNTyDr2JQm4xx,15,12,6,0,5,13,9,1,46,6.571428571428571,2,0.0,0,6,0,5,12,13,0,9,1,11,35,1
10788,154304,daNjsyZDfgvLE6mYr7BU5mjTXLNsBDii,SpATywNh6bZuzm8s1ceuBUnMUAeoAHHw,6,2,0,0,0,0,4,1,7,1.0,1,0.0,0,0,0,0,2,0,0,4,1,0,7,1
10789,154306,IXrLVJjodB615NE3nTgPKqPt8WaHKw26,5X6FeZozNMgE2VRi3MJYjkkFK8SETtu2,5,4,0,0,0,0,9,0,13,1.8571428571428572,3,0.0,0,0,0,0,4,0,0,9,0,0,13,1
10790,154309,iQAaSG6rDuzt2Sv1j0V2ZpmflXGImJaM,SpATywNh6bZuzm8s1ceuBUnMUAeoAHHw,28,20,17,0,14,0,2,0,53,7.571428571428571,1,0.0,0,17,0,14,20,0,0,2,0,31,22,1
10791,154316,j5n34dhJSAsFAv6KAw4rsAZTfhL07lCD,5X6FeZozNMgE2VRi3MJYjkkFK8SETtu2,2,0,0,0,0,0,3,0,3,0.42857142857142855,2,0.0,0,0,0,0,0,0,0,3,0,0,3,0
10792,154318,27pUZlupG1aVjIY0f9PLE1OvbJSBVMXw,SpATywNh6bZuzm8s1ceuBUnMUAeoAHHw,32,32,19,33,10,2,7,1,104,14.857142857142858,2,0.0,8,19,27,10,24,2,6,7,1,64,40,1
10793,154321,HoO8LKjjUMgJCeJcpwq1z7Z3nTHrSV55,5X6FeZozNMgE2VRi3MJYjkkFK8SETtu2,9,13,5,0,3,7,1,0,29,4.142857142857143,1,0.0,6,5,0,3,7,7,0,1,0,14,15,1
10794,154330,j5n34dhJSAsFAv6KAw4rsAZTfhL07lCD,A3fsA9Zfv1X2fVEQhTw51lKENdNrEqT3,1,0,0,0,0,0,1,0,1,0.14285714285714285,1,0.0,0,0,0,0,0,0,0,1,0,0,1,1
10795,154332,KQmd6JxNlcb9gfHTSXRQcfdSrHHAzfcG,5X6FeZozNMgE2VRi3MJYjkkFK8SETtu2,8,4,0,1,0,0,5,0,10,1.4285714285714286,1,0.0,1,0,1,0,3,0,0,5,0,2,8,1
10796,154336,6wr6dBOxcvGA1j07rybem8uoLQOkR2xX,SpATywNh6bZuzm8s1ceuBUnMUAeoAHHw,1,0,0,0,0,0,1,0,1,0.14285714285714285,1,0.0,0,0,0,0,0,0,0,1,0,0,1,1
10797,154341,zHI8MHuExufwDJ1uuBe75QQrzwho6OSZ,RXDvfPUBYFlVdlueBFbLW0mhhAyGEqpt,101,289,54,230,59,58,63,3,756,108.0,3,0.0,145,54,201,59,144,58,29,63,3,459,297,0
10798,154348,a6vqrMhHKzyWidqZtHap3qGcKb3WEBch,A3fsA9Zfv1X2fVEQhTw51lKENdNrEqT3,4,2,1,0,1,0,1,0,5,0.7142857142857143,1,0.0,0,1,0,1,2,0,0,1,0,2,3,1
10799,154377,0bzBCQH8D9DXq9uXmykneuVKZUsPAEIB,bWdj2GDclj5ofokWjzoa5jAwMkxCykd6,1,0,0,0,0,0,1,0,1,0.14285714285714285,1,0.0,0,0,0,0,0,0,0,1,0,0,1,1
10800,154386,XqlPY37hESY7wIIxbmRJf5T3alfyV4dl,RXDvfPUBYFlVdlueBFbLW0mhhAyGEqpt,1,0,0,0,0,0,1,0,1,0.14285714285714285,1,0.0,0,0,0,0,0,0,0,1,0,0,1,1
10801,154396,YJvyDY5DP7OYrdCjfLmpzctDWZWOOZ8F,SpATywNh6bZuzm8s1ceuBUnMUAeoAHHw,11,7,2,0,2,1,6,1,19,2.7142857142857144,2,0.0,0,2,0,2,7,1,0,6,1,4,15,1
10802,154397,3Aa3Am7eXOQ9i46JqJGoqVdbq443j86Q,5X6FeZozNMgE2VRi3MJYjkkFK8SETtu2,1,0,0,0,0,0,1,0,1,0.14285714285714285,1,0.0,0,0,0,0,0,0,0,1,0,0,1,1
10803,154415,sL5jw3pLWZoRI7avI17oM60mfF67Acgz,bWdj2GDclj5ofokWjzoa5jAwMkxCykd6,1,0,0,0,0,0,2,0,2,0.2857142857142857,2,0.0,0,0,0,0,0,0,0,2,0,0,2,0
10804,154436,VgwfEqq4zzESU4PqjsdqDnf6ZuDvfVVs,A3fsA9Zfv1X2fVEQhTw51lKENdNrEqT3,8,3,1,0,0,2,6,1,13,1.8571428571428572,2,0.0,0,1,0,0,3,2,0,6,1,1,12,1
10805,154452,ct3ZFc3dYzkZrA1pmvZdNHcuNKAGoE3e,G8EPVSXsOYB5YQWZGiz1aVq5Pgr2GrQu,1,0,0,0,0,0,1,0,1,0.14285714285714285,1,0.0,0,0,0,0,0,0,0,1,0,0,1,1
10806,154462,bhPYgMCLOyyitUb5vkMkP521Cgx8SoP8,bWdj2GDclj5ofokWjzoa5jAwMkxCykd6,12,9,6,6,3,0,6,0,30,4.285714285714286,1,0.0,0,6,3,3,9,0,3,6,0,12,18,1
10807,154465,iXy1VLqWL70M2DzueTojY5DBMUTLnXaY,G8EPVSXsOYB5YQWZGiz1aVq5Pgr2GrQu,38,6,0,112,0,0,2,0,120,17.142857142857142,1,0.0,0,0,91,0,6,0,21,2,0,91,29,1
10808,154492,eC4StSuQwImpW962lXYQQlRlP4Dxmsjm,SpATywNh6bZuzm8s1ceuBUnMUAeoAHHw,11,17,8,23,2,1,4,0,55,7.857142857142857,2,0.0,7,8,18,2,10,1,5,4,0,35,20,1
10809,154519,iAp4ykRY58SNvScBd1duZ1zo4LobCruL,RXDvfPUBYFlVdlueBFbLW0mhhAyGEqpt,10,14,5,0,2,0,2,0,23,3.2857142857142856,1,0.0,3,5,0,2,11,0,0,2,0,10,13,1
10810,154532,y4jCbRq0ZMCabQVeAWisCVju9AF82joj,bWdj2GDclj5ofokWjzoa5jAwMkxCykd6,5,2,1,0,1,0,3,1,8,1.1428571428571428,2,0.0,0,1,0,1,2,0,0,3,1,2,6,1
10811,154545,fSmbrw0Ju6sDIYVnX3wBreBY5XT3qxJ6,RXDvfPUBYFlVdlueBFbLW0mhhAyGEqpt,8,5,3,0,2,0,5,0,15,2.142857142857143,1,0.0,0,3,0,2,5,0,0,5,0,5,10,1
10812,154555,hUoOQP103jtoSjE8huNXPy5FlXS050j3,7GRhBDsirIGkRZBtSMEzNTyDr2JQm4xx,4,2,1,0,0,0,2,0,5,0.7142857142857143,1,0.0,0,1,0,0,2,0,0,2,0,1,4,1
10813,154570,EXZ81qqSldwR1xdBEwBZ7wmgbTHF86sl,A3fsA9Zfv1X2fVEQhTw51lKENdNrEqT3,77,67,53,186,37,11,13,1,368,52.57142857142857,4,0.0,2,53,149,37,65,11,37,13,1,241,127,0
10814,154572,IZjvzkwq6mW6mk7nIYbEArtjalxzWdW9,SpATywNh6bZuzm8s1ceuBUnMUAeoAHHw,16,16,8,15,5,0,2,0,46,6.571428571428571,2,0.0,5,8,15,5,11,0,0,2,0,33,13,1
10815,154617,Z9nbZek76s4RBuA56w1WtME3e9ClZkaP,7GRhBDsirIGkRZBtSMEzNTyDr2JQm4xx,4,2,0,0,0,0,2,0,4,0.5714285714285714,1,0.0,0,0,0,0,2,0,0,2,0,0,4,1
10816,154630,PE4KBwh4ltl7dienGR8pJbew7yjFv3Vz,RXDvfPUBYFlVdlueBFbLW0mhhAyGEqpt,76,114,56,108,32,28,26,1,365,52.142857142857146,3,0.0,39,56,100,32,75,28,8,26,1,227,138,0
10817,154647,efygWYkxxUMOGInRZT4qEeuzMRlIpQq6,A3fsA9Zfv1X2fVEQhTw51lKENdNrEqT3,1,0,0,0,0,0,1,0,1,0.14285714285714285,1,0.0,0,0,0,0,0,0,0,1,0,0,1,1
10818,154652,0nScgbbn10u6m6AtEv5NZACOHoXfwiE1,bWdj2GDclj5ofokWjzoa5jAwMkxCykd6,4,2,1,0,0,0,2,0,5,0.7142857142857143,1,0.0,0,1,0,0,2,0,0,2,0,1,4,1
10819,154661,efygWYkxxUMOGInRZT4qEeuzMRlIpQq6,bWdj2GDclj5ofokWjzoa5jAwMkxCykd6,1,0,0,0,0,0,1,0,1,0.14285714285714285,1,0.0,0,0,0,0,0,0,0,1,0,0,1,1
10820,154662,5U79KRZxDDBIetuxjK0KXphUhzbxTzjr,SpATywNh6bZuzm8s1ceuBUnMUAeoAHHw,10,12,7,0,4,0,5,0,28,4.0,3,0.0,0,7,0,4,12,0,0,5,0,11,17,0
10821,154671,mjAv9AclbtbUXFdXjAFHT42UNJBkK7UO,5X6FeZozNMgE2VRi3MJYjkkFK8SETtu2,8,6,1,0,1,0,3,0,11,1.5714285714285714,1,0.0,0,1,0,1,6,0,0,3,0,2,9,1
10822,154687,MHJvZPnhmnZTjSPJQtFU0MT0vplye5Bv,SpATywNh6bZuzm8s1ceuBUnMUAeoAHHw,5,2,1,0,1,0,2,0,6,0.8571428571428571,1,0.0,0,1,0,1,2,0,0,2,0,2,4,0
10823,154691,ZnPDiA6jmqQOIbODvVYNoIgZSaO1dso9,7GRhBDsirIGkRZBtSMEzNTyDr2JQm4xx,5,2,1,0,1,0,2,0,6,0.8571428571428571,1,0.0,0,1,0,1,2,0,0,2,0,2,4,1
10824,154722,wEtddkCnDW67OGRvoryp7gzDvLpg5XYx,7GRhBDsirIGkRZBtSMEzNTyDr2JQm4xx,2,0,0,0,0,0,2,0,2,0.2857142857142857,1,0.0,0,0,0,0,0,0,0,2,0,0,2,1
10825,154730,QTkjMZ2x2XpQJLg858rH1nCjMIxPq1Ot,bWdj2GDclj5ofokWjzoa5jAwMkxCykd6,1,0,0,0,0,0,1,0,1,0.14285714285714285,1,0.0,0,0,0,0,0,0,0,1,0,0,1,1
10826,154754,2YvoGUTGx2dwzFxr98daOcUVN093Uexo,SpATywNh6bZuzm8s1ceuBUnMUAeoAHHw,6,9,0,0,0,0,3,0,12,1.7142857142857142,1,0.0,0,0,0,0,9,0,0,3,0,0,12,0
10827,154784,Hz0LP3au6HFJJqiLBqYxNiliqJ4HLt82,7GRhBDsirIGkRZBtSMEzNTyDr2JQm4xx,2,0,0,0,0,0,2,0,2,0.2857142857142857,1,0.0,0,0,0,0,0,0,0,2,0,0,2,1
10828,154787,bWTCgLlWI05nNVcVRoVSZYxP5KtyHgRM,SpATywNh6bZuzm8s1ceuBUnMUAeoAHHw,1,0,0,0,0,0,1,0,1,0.14285714285714285,1,0.0,0,0,0,0,0,0,0,1,0,0,1,0
10829,154795,X7yAkPsl5rqRM0rJWJ1Nk7IUSPBbdZXP,7GRhBDsirIGkRZBtSMEzNTyDr2JQm4xx,2,0,0,0,0,0,3,0,3,0.42857142857142855,2,0.0,0,0,0,0,0,0,0,3,0,0,3,1
10830,154800,9bv4TssyKs6woXSaEFvigyhEyIkdO1mQ,G8EPVSXsOYB5YQWZGiz1aVq5Pgr2GrQu,6,3,2,0,2,0,1,0,8,1.1428571428571428,1,0.0,0,2,0,2,3,0,0,1,0,4,4,1
10831,154816,z99UWQHarVUXDSOuqNWR7PLwRKDFIaa2,SpATywNh6bZuzm8s1ceuBUnMUAeoAHHw,4,3,1,0,1,0,1,0,6,0.8571428571428571,1,0.0,1,1,0,1,2,0,0,1,0,3,3,1
10832,154819,9bv4TssyKs6woXSaEFvigyhEyIkdO1mQ,SpATywNh6bZuzm8s1ceuBUnMUAeoAHHw,19,16,8,21,3,0,3,0,51,7.285714285714286,2,0.0,6,8,20,3,10,0,1,3,0,37,14,1
10833,154847,OtGZHAMUloRDuFpftk1FK3bKwFDUoVzm,bWdj2GDclj5ofokWjzoa5jAwMkxCykd6,5,2,1,0,1,0,2,0,6,0.8571428571428571,1,0.0,0,1,0,1,2,0,0,2,0,2,4,1
10834,154867,GnGb3MjVBgYFavJRehOmmU05ktvVgJLM,SpATywNh6bZuzm8s1ceuBUnMUAeoAHHw,34,60,12,26,6,2,21,0,127,18.142857142857142,9,0.0,14,12,26,6,46,2,0,21,0,58,69,0
10835,154879,eLVxEJXOj5JCDBaPnfFyMxorDIkKR9kF,7GRhBDsirIGkRZBtSMEzNTyDr2JQm4xx,5,4,0,0,0,0,2,0,6,0.8571428571428571,1,0.0,0,0,0,0,4,0,0,2,0,0,6,1
10836,154882,qZCURwy8JtTyuwzOv8VNGZdlPKRFUQ4x,bWdj2GDclj5ofokWjzoa5jAwMkxCykd6,1,0,0,0,0,0,1,0,1,0.14285714285714285,1,0.0,0,0,0,0,0,0,0,1,0,0,1,1
10837,154884,yIu3KUc7c2P1kltKfHrQV3zLqR8js3Nt,SpATywNh6bZuzm8s1ceuBUnMUAeoAHHw,17,9,7,5,6,0,2,0,29,4.142857142857143,1,0.0,1,7,4,6,8,0,1,2,0,18,11,1
10838,154885,TVSg46EJil4CAr2XoeKrOl5oJKlyMQop,SpATywNh6bZuzm8s1ceuBUnMUAeoAHHw,4,3,1,0,0,0,2,0,6,0.8571428571428571,1,0.0,0,1,0,0,3,0,0,2,0,1,5,0
10839,154888,bJlGVPYw5PozLrZ7sFyc3ZbkRaMzwvR4,5X6FeZozNMgE2VRi3MJYjkkFK8SETtu2,4,2,1,0,1,0,1,0,5,0.7142857142857143,1,0.0,0,1,0,1,2,0,0,1,0,2,3,1
10840,154890,ESVgLjevBgVMt5NWT7qc1LwRqq23pUi3,SpATywNh6bZuzm8s1ceuBUnMUAeoAHHw,13,15,7,13,4,1,1,0,41,5.857142857142857,1,0.0,4,7,10,4,11,1,3,1,0,25,16,0
10841,154900,MQZ83qOJRka3gcNvl5FCRvHenmiUnsd9,7GRhBDsirIGkRZBtSMEzNTyDr2JQm4xx,7,5,0,0,0,4,4,0,13,1.8571428571428572,1,0.0,1,0,0,0,4,4,0,4,0,1,12,1
10842,154932,edXPiPlXsxZWAwb1eG9vvJRlK1XmINAg,SpATywNh6bZuzm8s1ceuBUnMUAeoAHHw,1,0,0,0,0,0,1,0,1,0.14285714285714285,1,0.0,0,0,0,0,0,0,0,1,0,0,1,0
10843,154958,uCkUGoRSr1o0e7C3DgvaHjtZmuIVbEoc,7GRhBDsirIGkRZBtSMEzNTyDr2JQm4xx,16,19,4,16,7,0,4,0,50,7.142857142857143,1,0.0,14,4,14,7,5,0,2,4,0,39,11,1
10844,154964,11vXtWJnN3H2cgEcJiLRnuxFRJzAe10n,bWdj2GDclj5ofokWjzoa5jAwMkxCykd6,1,0,0,0,0,0,1,0,1,0.14285714285714285,1,0.0,0,0,0,0,0,0,0,1,0,0,1,1
10845,154969,zWDepCfjbS7ISrpw6SZrVfUm7fvpWJYm,RXDvfPUBYFlVdlueBFbLW0mhhAyGEqpt,99,80,46,144,40,0,5,0,315,45.0,3,0.0,27,46,137,40,53,0,7,5,0,250,65,1
10846,154971,T6EWQ7jVP89JlHzj41KN1gEtGYevpSQM,7GRhBDsirIGkRZBtSMEzNTyDr2JQm4xx,22,29,16,5,10,1,3,0,64,9.142857142857142,2,0.0,10,16,5,10,19,1,0,3,0,41,23,1
10847,154975,bmN2HbDrwDSmJ0Xp4dCDimKA67pr9rbv,A3fsA9Zfv1X2fVEQhTw51lKENdNrEqT3,4,2,0,0,0,0,2,0,4,0.5714285714285714,1,0.0,0,0,0,0,2,0,0,2,0,0,4,1
10848,155012,m7LPs49nHZUcvz2esAX8UbdKFZVSnWet,RXDvfPUBYFlVdlueBFbLW0mhhAyGEqpt,17,16,10,16,5,0,4,0,51,7.285714285714286,1,0.0,3,10,16,5,13,0,0,4,0,34,17,1
10849,155040,7BLSB26pFgDMSTV4x8nY66FLFZIw20Ig,SpATywNh6bZuzm8s1ceuBUnMUAeoAHHw,4,3,0,0,0,0,2,1,6,0.8571428571428571,1,0.0,1,0,0,0,2,0,0,2,1,1,5,1
10850,155041,oUmqIjzIqM0YLgZAwAfxKw9lIlJHSuxC,SpATywNh6bZuzm8s1ceuBUnMUAeoAHHw,42,49,21,43,12,0,13,0,138,19.714285714285715,2,0.0,26,21,36,12,23,0,7,13,0,95,43,0
10851,155056,hNPdZRGhrBNCKKHi19Tc0KVO04Qmubqr,SpATywNh6bZuzm8s1ceuBUnMUAeoAHHw,1,0,0,0,0,0,1,0,1,0.14285714285714285,1,0.0,0,0,0,0,0,0,0,1,0,0,1,1
10852,155059,0UQZhuiUnymjN9gGHDhi5njksg7urq3M,SpATywNh6bZuzm8s1ceuBUnMUAeoAHHw,7,6,2,0,2,0,3,0,13,1.8571428571428572,1,0.0,0,2,0,2,6,0,0,3,0,4,9,0
10853,155060,f6wHmVbM5ovn7AGXHgdzXq3eHvksX9VF,A3fsA9Zfv1X2fVEQhTw51lKENdNrEqT3,4,3,1,0,0,0,2,0,6,0.8571428571428571,1,0.0,0,1,0,0,3,0,0,2,0,1,5,1
10854,155065,aVCTqFxxjGJavhP7uYzlBoPGeSpDrJ0J,SpATywNh6bZuzm8s1ceuBUnMUAeoAHHw,5,4,1,0,1,0,1,0,7,1.0,1,0.0,0,1,0,1,4,0,0,1,0,2,5,0
10855,155070,UGYGSfRkJhOkgkdlCI6YSCshpNvwBF31,A3fsA9Zfv1X2fVEQhTw51lKENdNrEqT3,6,4,2,0,1,0,5,0,12,1.7142857142857142,1,0.0,0,2,0,1,4,0,0,5,0,3,9,1
10856,155080,bUAApLDRSsYoejMOs9wtzojFHzl0leoA,5X6FeZozNMgE2VRi3MJYjkkFK8SETtu2,8,20,10,0,7,0,3,0,40,5.714285714285714,5,0.0,1,10,0,7,19,0,0,3,0,18,22,1
10857,155081,erkNYBqLpKRElyeL8GeAgO43CMazg6Rt,7GRhBDsirIGkRZBtSMEzNTyDr2JQm4xx,4,0,0,0,0,0,4,0,4,0.5714285714285714,1,0.0,0,0,0,0,0,0,0,4,0,0,4,1
10858,155087,UGYGSfRkJhOkgkdlCI6YSCshpNvwBF31,bWdj2GDclj5ofokWjzoa5jAwMkxCykd6,3,0,0,0,0,0,4,0,4,0.5714285714285714,1,0.0,0,0,0,0,0,0,0,4,0,0,4,0
10859,155092,3dD9gQSxLGK862CIf14a7AwmUeS49yRD,SpATywNh6bZuzm8s1ceuBUnMUAeoAHHw,4,2,1,0,1,0,1,0,5,0.7142857142857143,1,0.0,0,1,0,1,2,0,0,1,0,2,3,0
10860,155111,31aB1n1dsQQ1ksrWlX8ZehnLm4yKoPC4,SpATywNh6bZuzm8s1ceuBUnMUAeoAHHw,1,0,0,0,0,0,1,0,1,0.14285714285714285,1,0.0,0,0,0,0,0,0,0,1,0,0,1,0
10861,155155,LLekC5mtNTZwDXx4lqyHuAGXC1yYmPsa,SpATywNh6bZuzm8s1ceuBUnMUAeoAHHw,5,5,4,0,4,0,2,0,15,2.142857142857143,1,0.0,0,4,0,4,5,0,0,2,0,8,7,0
10862,155156,HdnrV7nditsFLVLpxc0QNpu4amVe8QVg,SpATywNh6bZuzm8s1ceuBUnMUAeoAHHw,1,0,0,0,0,0,3,0,3,0.42857142857142855,1,0.0,0,0,0,0,0,0,0,3,0,0,3,1
10863,155169,Eb5RWg3UkgZrmyRIPeFGfGNJ7vkOrNwq,SpATywNh6bZuzm8s1ceuBUnMUAeoAHHw,1,0,0,0,0,0,1,0,1,0.14285714285714285,1,0.0,0,0,0,0,0,0,0,1,0,0,1,1
10864,155194,NAJvTJBbpzTm4Ejnn68Kzje83d040jMj,5X6FeZozNMgE2VRi3MJYjkkFK8SETtu2,1,0,0,0,0,0,1,0,1,0.14285714285714285,1,0.0,0,0,0,0,0,0,0,1,0,0,1,1
10865,155201,Yg9hgHRSCdpITsjHOmkyqEwp1aNMC9ra,7GRhBDsirIGkRZBtSMEzNTyDr2JQm4xx,4,2,0,0,0,0,4,0,6,0.8571428571428571,2,0.0,0,0,0,0,2,0,0,4,0,0,6,1
10866,155217,7FfBjqz6byqYChvceuS9Jc7NHYR6f9E3,SpATywNh6bZuzm8s1ceuBUnMUAeoAHHw,1,0,0,0,0,0,1,0,1,0.14285714285714285,1,0.0,0,0,0,0,0,0,0,1,0,0,1,1
10867,155228,QZIRHdwFgibI2SBehTrmLAZxED1F4JL7,SpATywNh6bZuzm8s1ceuBUnMUAeoAHHw,7,10,4,0,1,0,3,0,18,2.5714285714285716,3,0.0,0,4,0,1,10,0,0,3,0,5,13,0
10868,155249,6T4qq3cdISFF5pyvVKMrcmEINY6BysCY,7GRhBDsirIGkRZBtSMEzNTyDr2JQm4xx,1,0,0,0,0,0,1,0,1,0.14285714285714285,1,0.0,0,0,0,0,0,0,0,1,0,0,1,1
10869,155257,Mc1x8qc2ag2ssiz0qfYSRk8wfa0Gy5Kt,G8EPVSXsOYB5YQWZGiz1aVq5Pgr2GrQu,7,7,2,0,2,0,2,0,13,1.8571428571428572,1,0.0,0,2,0,2,7,0,0,2,0,4,9,1
10870,155259,DIn0cKF2NBuMvNyPjBbvqUIlAOozCZHa,SpATywNh6bZuzm8s1ceuBUnMUAeoAHHw,14,12,5,14,3,0,3,0,37,5.285714285714286,1,0.0,6,5,12,3,6,0,2,3,0,26,11,0
10871,155260,RYxlkEfybScjuURHdWSAT0EfdWxxzl53,G8EPVSXsOYB5YQWZGiz1aVq5Pgr2GrQu,13,13,5,8,3,0,3,0,32,4.571428571428571,2,0.0,6,5,5,3,7,0,3,3,0,19,13,1
10872,155270,xcsswfe3yez02HFG13qFCOZgHBl5zUGi,SpATywNh6bZuzm8s1ceuBUnMUAeoAHHw,20,22,12,37,6,3,4,2,86,12.285714285714286,2,0.0,7,12,31,6,15,3,6,4,2,56,30,0
10873,155276,GDK8eMRsCP5HvmKIuj8lRzbGyRDkL72s,G8EPVSXsOYB5YQWZGiz1aVq5Pgr2GrQu,54,26,16,205,8,0,11,0,266,38.0,1,0.0,10,16,174,8,16,0,31,11,0,208,58,0
10874,155278,vrdtE3c9uMTgSnAvUaVDDSMPyuNMNjJw,A3fsA9Zfv1X2fVEQhTw51lKENdNrEqT3,22,30,2,0,1,1,13,1,48,6.857142857142857,2,0.0,1,2,0,1,29,1,0,13,1,4,44,0
10875,155281,gam6NJWaaIRnsXzS5REeM5SpdSEqwYEM,G8EPVSXsOYB5YQWZGiz1aVq5Pgr2GrQu,2,0,0,0,0,0,2,0,2,0.2857142857142857,1,0.0,0,0,0,0,0,0,0,2,0,0,2,1
10876,155289,OPl7KyHzFf9FR7H5bJaIZJAJnuKijjNP,A3fsA9Zfv1X2fVEQhTw51lKENdNrEqT3,1,0,0,0,0,0,2,0,2,0.2857142857142857,1,0.0,0,0,0,0,0,0,0,2,0,0,2,1
10877,155294,AM0Pq0VaajXHw12VriykE7JoeiBR3Zq9,SpATywNh6bZuzm8s1ceuBUnMUAeoAHHw,1,0,0,0,0,0,1,0,1,0.14285714285714285,1,0.0,0,0,0,0,0,0,0,1,0,0,1,1
10878,155303,BPLTF2By1jayxHugVACT0ruRLIH96sul,SpATywNh6bZuzm8s1ceuBUnMUAeoAHHw,12,7,4,17,2,0,2,0,32,4.571428571428571,1,0.0,2,4,15,2,5,0,2,2,0,23,9,1
10879,155310,Mc1x8qc2ag2ssiz0qfYSRk8wfa0Gy5Kt,SpATywNh6bZuzm8s1ceuBUnMUAeoAHHw,2,0,0,0,0,0,2,0,2,0.2857142857142857,1,0.0,0,0,0,0,0,0,0,2,0,0,2,1
10880,155323,0B7Lg7kBiHggKw9Wk7X0Ew4GVuXGGcvN,A3fsA9Zfv1X2fVEQhTw51lKENdNrEqT3,7,10,3,0,1,0,5,0,19,2.7142857142857144,1,0.0,0,3,0,1,10,0,0,5,0,4,15,1
10881,155367,LSvU72CFq1TrHd9SCZOiKQ0qcV2oa2Ok,SpATywNh6bZuzm8s1ceuBUnMUAeoAHHw,4,8,0,0,0,0,5,0,13,1.8571428571428572,4,0.0,0,0,0,0,8,0,0,5,0,0,13,1
10882,155384,eXLK6r8B7rhNuShaQfaa1NTqPuVY4VIk,SpATywNh6bZuzm8s1ceuBUnMUAeoAHHw,1,0,0,0,0,0,1,0,1,0.14285714285714285,1,0.0,0,0,0,0,0,0,0,1,0,0,1,1
10883,155391,mV4YsIiA8Oc8PxZhA2HzdmyhI1ZXRUSS,SpATywNh6bZuzm8s1ceuBUnMUAeoAHHw,16,28,12,10,5,0,8,0,63,9.0,2,0.0,6,12,10,5,22,0,0,8,0,33,30,1
10884,155412,DTCznfsIfPRlvOLeQgZUHf8RkJdb61WR,5X6FeZozNMgE2VRi3MJYjkkFK8SETtu2,16,32,6,14,9,0,4,0,65,9.285714285714286,2,0.0,16,6,13,9,16,0,1,4,0,44,21,0
10885,155432,LkEFlCqQYkjvIKgJmv3NaW67JKbg7cls,bWdj2GDclj5ofokWjzoa5jAwMkxCykd6,9,11,2,14,1,0,15,1,44,6.285714285714286,2,0.0,2,2,13,1,9,0,1,15,1,18,26,1
10886,155453,lmCPiW6l0WNp9Ttn0lhwFDs7FfVubtvY,bWdj2GDclj5ofokWjzoa5jAwMkxCykd6,5,8,0,0,0,0,2,0,10,1.4285714285714286,2,0.0,0,0,0,0,8,0,0,2,0,0,10,1
10887,155459,cuPQwSytidcCUilblyO4K9ALDT0iH8XK,SpATywNh6bZuzm8s1ceuBUnMUAeoAHHw,9,42,7,0,6,0,9,0,64,9.142857142857142,4,0.0,2,7,0,6,40,0,0,9,0,15,49,0
10888,155473,vIGrumQhxED6ggjqRtDJTWjYD26BFXvf,SpATywNh6bZuzm8s1ceuBUnMUAeoAHHw,4,2,1,0,1,0,1,0,5,0.7142857142857143,1,0.0,0,1,0,1,2,0,0,1,0,2,3,1
10889,155477,6QvLuupNiStrzgd1XTxuVafPKhPqbm1k,SpATywNh6bZuzm8s1ceuBUnMUAeoAHHw,1,0,0,0,0,0,3,0,3,0.42857142857142855,2,0.0,0,0,0,0,0,0,0,3,0,0,3,1
10890,155505,anKy5XeCNcJg717tYlt4WP7NvJptZoH3,SpATywNh6bZuzm8s1ceuBUnMUAeoAHHw,6,3,2,0,1,0,2,0,8,1.1428571428571428,1,0.0,0,2,0,1,3,0,0,2,0,3,5,1
10891,155507,SgOZJSP28EVOKcdy4QUHKj5FTNBlaKTy,bWdj2GDclj5ofokWjzoa5jAwMkxCykd6,4,3,2,0,0,0,1,0,6,0.8571428571428571,1,0.0,0,2,0,0,3,0,0,1,0,2,4,1
10892,155515,RWIpGfxvEVJcZlPnYrpOXKnv6jNCgDMr,G8EPVSXsOYB5YQWZGiz1aVq5Pgr2GrQu,5,2,1,0,1,0,2,0,6,0.8571428571428571,1,0.0,0,1,0,1,2,0,0,2,0,2,4,1
10893,155519,LPuI0zsA5TBOFE9XpHozb9j9tJuwGxCb,RXDvfPUBYFlVdlueBFbLW0mhhAyGEqpt,9,8,5,0,1,0,5,0,19,2.7142857142857144,2,0.0,0,5,0,1,8,0,0,5,0,6,13,0
10894,155553,bpGV6fnSXAO5YTgsxVkdmYC0rSgonD8Y,SpATywNh6bZuzm8s1ceuBUnMUAeoAHHw,7,11,2,0,2,0,2,0,17,2.4285714285714284,2,0.0,0,2,0,2,11,0,0,2,0,4,13,1
10895,155560,I0VfBqvM8JyWCrBNLkrKH3hPvb4CxoQx,SpATywNh6bZuzm8s1ceuBUnMUAeoAHHw,23,30,1,26,1,1,5,0,64,9.142857142857142,2,0.0,7,1,24,1,23,1,2,5,0,33,31,1
10896,155575,LigXW35gPDwdC5qVp0UrC4fmHQ8ox9Rk,bWdj2GDclj5ofokWjzoa5jAwMkxCykd6,7,6,3,0,2,0,1,0,12,1.7142857142857142,1,0.0,0,3,0,2,6,0,0,1,0,5,7,1
10897,155580,RRM0TElcCY25pdcWRkMGxwCn30ehvK5c,SpATywNh6bZuzm8s1ceuBUnMUAeoAHHw,26,37,18,22,6,0,6,0,89,12.714285714285714,4,0.0,15,18,18,6,22,0,4,6,0,57,32,0
10898,155610,UK0wMwBzvN90sgDmKYl9zi5a5BuEJyvZ,RXDvfPUBYFlVdlueBFbLW0mhhAyGEqpt,54,54,31,67,21,22,11,2,208,29.714285714285715,4,0.0,15,31,63,21,39,22,4,11,2,130,78,1
10899,155611,dd7Jtt1fMMutX1RG7iWTpWNKUpGu8Lqf,A3fsA9Zfv1X2fVEQhTw51lKENdNrEqT3,35,50,29,62,0,3,24,1,169,24.142857142857142,3,0.0,6,29,49,0,44,3,13,24,1,84,85,1
10900,155637,qjvq1sHqAcfKswM6blXTqWOneUd9IwNB,SpATywNh6bZuzm8s1ceuBUnMUAeoAHHw,5,2,1,0,1,0,2,0,6,0.8571428571428571,1,0.0,0,1,0,1,2,0,0,2,0,2,4,1
10901,155650,qsqwu8COYqhvRbnpZxaxzFgLRXRrEQUY,SpATywNh6bZuzm8s1ceuBUnMUAeoAHHw,5,3,2,0,1,0,1,0,7,1.0,1,0.0,0,2,0,1,3,0,0,1,0,3,4,1
10902,155663,idXxMKeWJz1JyNZp33R8B6DMVoKa5csf,5X6FeZozNMgE2VRi3MJYjkkFK8SETtu2,13,15,3,20,5,0,3,0,46,6.571428571428571,3,0.0,8,3,16,5,7,0,4,3,0,32,14,1
10903,155705,CFhLEVkKrtcBJJ6gRh8HSuSfw1jMfUb7,SpATywNh6bZuzm8s1ceuBUnMUAeoAHHw,2,0,0,0,0,0,2,0,2,0.2857142857142857,1,0.0,0,0,0,0,0,0,0,2,0,0,2,1
10904,155719,US9otMg797RbX2BsleYBFadMSrBjJXZF,SpATywNh6bZuzm8s1ceuBUnMUAeoAHHw,2,0,0,0,0,0,2,0,2,0.2857142857142857,1,0.0,0,0,0,0,0,0,0,2,0,0,2,1
10905,155741,1fhx237jT4Kg2Hfne9D1cZg9DXyWHZEN,bWdj2GDclj5ofokWjzoa5jAwMkxCykd6,6,5,3,0,2,0,5,0,15,2.142857142857143,2,0.0,0,3,0,2,5,0,0,5,0,5,10,0
10906,155745,bcDgsH6ZU4RUVLG7I2fsAvcl6B7ySYCd,RXDvfPUBYFlVdlueBFbLW0mhhAyGEqpt,5,5,0,0,0,0,3,0,8,1.1428571428571428,3,0.0,0,0,0,0,5,0,0,3,0,0,8,1
10907,155782,I19aG6zmdTntoy0T8VxEogbN4WVEZZNa,G8EPVSXsOYB5YQWZGiz1aVq5Pgr2GrQu,11,9,1,10,1,0,3,0,24,3.4285714285714284,2,0.0,3,1,7,1,6,0,3,3,0,12,12,1
10908,155787,IkURdjJHTtVaMfzGLDY0ow22hHa6VKoA,G8EPVSXsOYB5YQWZGiz1aVq5Pgr2GrQu,1,0,0,0,0,0,1,0,1,0.14285714285714285,1,0.0,0,0,0,0,0,0,0,1,0,0,1,1
10909,155816,088SASUPOVYUGhoEly8vlrkGvRBJoNwp,SpATywNh6bZuzm8s1ceuBUnMUAeoAHHw,5,2,1,0,1,0,3,0,7,1.0,1,0.0,0,1,0,1,2,0,0,3,0,2,5,1
10910,155821,jaQSY9BdnD0HM1u5vJYwNWQnUzzZzI8e,SpATywNh6bZuzm8s1ceuBUnMUAeoAHHw,1,0,0,0,0,0,1,0,1,0.14285714285714285,1,0.0,0,0,0,0,0,0,0,1,0,0,1,1
10911,155826,VFaDw1WYcOtIcsxfLW3x5fsJ2JkUIOUZ,G8EPVSXsOYB5YQWZGiz1aVq5Pgr2GrQu,62,90,35,132,24,11,28,1,321,45.857142857142854,7,0.0,25,35,112,24,65,11,20,28,1,196,125,0
10912,155845,kAH6V7JzDoLq5AdXMqvLO78igpFvmPcb,SpATywNh6bZuzm8s1ceuBUnMUAeoAHHw,4,4,1,0,0,0,3,0,8,1.1428571428571428,2,0.0,0,1,0,0,4,0,0,3,0,1,7,1
10913,155885,4G4cusC28dHeOh2Typ91i1q3Okbvvqth,bWdj2GDclj5ofokWjzoa5jAwMkxCykd6,7,6,2,4,2,0,3,0,17,2.4285714285714284,2,0.0,2,2,3,2,4,0,1,3,0,9,8,1
10914,155915,tJ3sl9o76r3EHByeMBO5S5Oajse8uEcy,SpATywNh6bZuzm8s1ceuBUnMUAeoAHHw,25,27,3,32,3,0,8,0,73,10.428571428571429,3,0.0,4,3,29,3,23,0,3,8,0,39,34,0
10915,155927,5zF3LAGlpXwVChANKN0umOaI1kNrk73h,SpATywNh6bZuzm8s1ceuBUnMUAeoAHHw,1,0,0,0,0,0,1,0,1,0.14285714285714285,1,0.0,0,0,0,0,0,0,0,1,0,0,1,1
10916,155964,nVB1o73xluQXZjoI2dUYHGxbCDG8qiCL,RXDvfPUBYFlVdlueBFbLW0mhhAyGEqpt,1,0,0,0,0,0,3,0,3,0.42857142857142855,3,0.0,0,0,0,0,0,0,0,3,0,0,3,0
10917,155976,7xpmz6LF4dl35fFKZgRU70OZyF8UO4PL,SpATywNh6bZuzm8s1ceuBUnMUAeoAHHw,7,5,2,0,2,0,2,0,11,1.5714285714285714,1,0.0,0,2,0,2,5,0,0,2,0,4,7,0
10918,155978,8Q914g366DdD8SM59Cwv8CGJVdCfYrAr,SpATywNh6bZuzm8s1ceuBUnMUAeoAHHw,20,15,12,4,8,0,2,0,41,5.857142857142857,2,0.0,0,12,3,8,15,0,1,2,0,23,18,1
10919,156011,V6bmtFqzrgy6dG2nlcL1Nh8X9EOeOyrE,SpATywNh6bZuzm8s1ceuBUnMUAeoAHHw,5,3,1,0,1,0,1,0,6,0.8571428571428571,1,0.0,0,1,0,1,3,0,0,1,0,2,4,1
10920,156049,LIH6u87VTR1542727Uc42mhP2iK5GaFP,5X6FeZozNMgE2VRi3MJYjkkFK8SETtu2,1,0,0,0,0,0,1,0,1,0.14285714285714285,1,0.0,0,0,0,0,0,0,0,1,0,0,1,1
10921,156064,xSvCHzbSKemMKYEdGEAC5YZv1OdVf9nN,bWdj2GDclj5ofokWjzoa5jAwMkxCykd6,3,0,0,0,0,0,3,0,3,0.42857142857142855,1,0.0,0,0,0,0,0,0,0,3,0,0,3,1
10922,156067,3JnJF2wvxZ8RWlVFjIL8g8mywZiR6k1T,G8EPVSXsOYB5YQWZGiz1aVq5Pgr2GrQu,18,23,16,26,9,0,4,1,79,11.285714285714286,1,0.0,5,16,22,9,18,0,4,4,1,52,27,1
10923,156077,nx1z63DgmeEAxW8gQgEbpcNs34kbRne4,5X6FeZozNMgE2VRi3MJYjkkFK8SETtu2,15,19,3,18,8,3,12,1,64,9.142857142857142,2,0.0,15,3,15,8,4,3,3,12,1,41,23,1
10924,156123,iMSX1uHcSxcasOlc9agP5kI5TmyEQeiD,G8EPVSXsOYB5YQWZGiz1aVq5Pgr2GrQu,1,0,0,0,0,0,1,0,1,0.14285714285714285,1,0.0,0,0,0,0,0,0,0,1,0,0,1,1
10925,156130,i6hU5SR8XgkqdPxlmxtV7dYt9PZfaBTn,SpATywNh6bZuzm8s1ceuBUnMUAeoAHHw,5,2,1,0,1,0,2,0,6,0.8571428571428571,1,0.0,0,1,0,1,2,0,0,2,0,2,4,1
10926,156133,i6hU5SR8XgkqdPxlmxtV7dYt9PZfaBTn,bWdj2GDclj5ofokWjzoa5jAwMkxCykd6,6,8,3,0,2,0,2,0,15,2.142857142857143,1,0.0,3,3,0,2,5,0,0,2,0,8,7,1
10927,156141,i6hU5SR8XgkqdPxlmxtV7dYt9PZfaBTn,RXDvfPUBYFlVdlueBFbLW0mhhAyGEqpt,10,9,3,0,2,0,4,0,18,2.5714285714285716,1,0.0,0,3,0,2,9,0,0,4,0,5,13,1
10928,156174,xWDzyWVfwaNblicJcu1jEcVTvovEMjsP,SpATywNh6bZuzm8s1ceuBUnMUAeoAHHw,14,46,0,21,0,6,7,1,81,11.571428571428571,1,0.0,31,0,18,0,15,6,3,7,1,49,32,1
10929,156203,TJJeYBVqqJqVT0UpmMwKMknr7rLf2JfH,G8EPVSXsOYB5YQWZGiz1aVq5Pgr2GrQu,1,0,0,0,0,0,1,0,1,0.14285714285714285,1,0.0,0,0,0,0,0,0,0,1,0,0,1,1
10930,156210,QJa7950JZ1G1IXjh9PFTLBwHz50g7cPs,RXDvfPUBYFlVdlueBFbLW0mhhAyGEqpt,6,3,1,0,1,0,2,0,7,1.0,1,0.0,0,1,0,1,3,0,0,2,0,2,5,1
10931,156215,craou3bPovoGYp07wkpPUHi7pTV19nnS,SpATywNh6bZuzm8s1ceuBUnMUAeoAHHw,1,0,0,0,0,0,1,0,1,0.14285714285714285,1,0.0,0,0,0,0,0,0,0,1,0,0,1,1
10932,156218,lOpYzxjzA9vRip7edGAzRT31tzjhDFRT,SpATywNh6bZuzm8s1ceuBUnMUAeoAHHw,14,15,1,20,0,1,7,1,45,6.428571428571429,1,0.0,2,1,17,0,13,1,3,7,1,20,25,1
10933,156229,H7bZ54NuzkB5Nw5q0ZI1nld9qDoHNngL,5X6FeZozNMgE2VRi3MJYjkkFK8SETtu2,2,0,0,0,0,0,2,0,2,0.2857142857142857,2,0.0,0,0,0,0,0,0,0,2,0,0,2,0
10934,156249,NOCI3alBOLdcP6U9772QoJvMxwy9UAN6,SpATywNh6bZuzm8s1ceuBUnMUAeoAHHw,7,12,5,0,1,0,3,0,21,3.0,2,0.0,3,5,0,1,9,0,0,3,0,9,12,1
10935,156274,0sjXk2kwvvV16YH049lNSti4Pj1sg16S,bWdj2GDclj5ofokWjzoa5jAwMkxCykd6,8,9,4,12,0,1,5,0,31,4.428571428571429,1,0.0,3,4,11,0,6,1,1,5,0,18,13,1
10936,156295,BMNiq5EV6A8TNZJcxF7Tx1slpqQ99u0q,SpATywNh6bZuzm8s1ceuBUnMUAeoAHHw,1,0,0,0,0,0,1,0,1,0.14285714285714285,1,0.0,0,0,0,0,0,0,0,1,0,0,1,1
10937,156308,ifnHK7elzUrx6FoT7eceCrEZMhAwQ98l,A3fsA9Zfv1X2fVEQhTw51lKENdNrEqT3,28,17,14,18,11,0,8,0,68,9.714285714285714,2,0.0,0,14,16,11,17,0,2,8,0,41,27,1
10938,156323,WN48iLnvvEk85bn1Ax5lHk0fUlDw6OCg,SpATywNh6bZuzm8s1ceuBUnMUAeoAHHw,13,15,0,12,0,2,8,1,38,5.428571428571429,2,0.0,0,0,10,0,15,2,2,8,1,10,28,1
10939,156325,OpLX96TX0mzsRYhDl2C02nVgjI6j9XrW,RXDvfPUBYFlVdlueBFbLW0mhhAyGEqpt,1,0,0,0,0,0,1,0,1,0.14285714285714285,1,0.0,0,0,0,0,0,0,0,1,0,0,1,1
10940,156435,45E6hpwDMHp9Q3Pt1xT8q04bbowKk87g,bWdj2GDclj5ofokWjzoa5jAwMkxCykd6,72,96,48,124,38,6,34,2,348,49.714285714285715,8,0.0,32,48,120,38,64,6,4,34,2,238,110,1
10941,156506,WsrGHMpJC5JoJNy1qcc46gvaDlt9pDn6,SpATywNh6bZuzm8s1ceuBUnMUAeoAHHw,9,4,3,0,3,0,2,0,12,1.7142857142857142,1,0.0,0,3,0,3,4,0,0,2,0,6,6,1
10942,156510,Atic9bcAYez6iPYGWH9qjmSkP3PGX2jq,bWdj2GDclj5ofokWjzoa5jAwMkxCykd6,3,3,1,0,0,0,2,0,6,0.8571428571428571,1,0.0,0,1,0,0,3,0,0,2,0,1,5,1
10943,156518,Atic9bcAYez6iPYGWH9qjmSkP3PGX2jq,RXDvfPUBYFlVdlueBFbLW0mhhAyGEqpt,32,63,29,39,16,11,16,1,175,25.0,3,0.0,8,29,33,16,55,11,6,16,1,86,89,1
10944,156529,JS5kXpYeMxOghDu5iWEChapuWqXPxCs4,RXDvfPUBYFlVdlueBFbLW0mhhAyGEqpt,2,0,0,0,0,0,2,0,2,0.2857142857142857,1,0.0,0,0,0,0,0,0,0,2,0,0,2,1
10945,156543,HoNj5dKRTM00OCznK2rkvjainbjOBy0O,bWdj2GDclj5ofokWjzoa5jAwMkxCykd6,11,5,3,0,2,1,10,1,22,3.142857142857143,1,0.0,0,3,0,2,5,1,0,10,1,5,17,1
10946,156560,wiTUeXradyIJk2N3XHfmkjuyGIQHziQH,SpATywNh6bZuzm8s1ceuBUnMUAeoAHHw,13,12,7,11,2,0,3,0,35,5.0,2,0.0,0,7,10,2,12,0,1,3,0,19,16,0
10947,156562,Un3EzEE4Sz8i5Z84q9e50URbIAEkkVSB,A3fsA9Zfv1X2fVEQhTw51lKENdNrEqT3,5,2,1,0,1,0,7,0,11,1.5714285714285714,4,0.0,0,1,0,1,2,0,0,7,0,2,9,1
10948,156569,OLSxCkluLildKVrVnzRIsj47tt9tVHj9,A3fsA9Zfv1X2fVEQhTw51lKENdNrEqT3,2,0,0,0,0,0,4,0,4,0.5714285714285714,2,0.0,0,0,0,0,0,0,0,4,0,0,4,1
10949,156579,TqZSbKLYcFD5gfQ0wHk9V7SVlkqO9WOv,A3fsA9Zfv1X2fVEQhTw51lKENdNrEqT3,2,0,0,0,0,0,3,0,3,0.42857142857142855,1,0.0,0,0,0,0,0,0,0,3,0,0,3,1
10950,156612,QqE2Xjwy9gUzOvFdkDqAwAaNZLBZkxvd,5X6FeZozNMgE2VRi3MJYjkkFK8SETtu2,3,0,0,0,0,0,7,0,7,1.0,4,0.0,0,0,0,0,0,0,0,7,0,0,7,1
10951,156615,1l4J4YNslNweqVYZ9PIiphpLsWKaZHE7,SpATywNh6bZuzm8s1ceuBUnMUAeoAHHw,14,21,9,14,3,4,3,0,54,7.714285714285714,1,0.0,9,9,11,3,12,4,3,3,0,32,22,0
10952,156656,7IdpyRf57AcKqRM0ayoEIjOEGtDFURim,SpATywNh6bZuzm8s1ceuBUnMUAeoAHHw,17,46,24,4,7,0,12,0,93,13.285714285714286,4,0.0,0,24,3,7,46,0,1,12,0,34,59,0
10953,156682,dgVkbE4MU9DJV1tctk0wRyOO49V94n6e,SpATywNh6bZuzm8s1ceuBUnMUAeoAHHw,7,15,0,0,0,0,6,0,21,3.0,3,0.0,0,0,0,0,15,0,0,6,0,0,21,1
10954,156689,t59SBB5EkGAnAVQuchgekkDDOWF5xR9g,bWdj2GDclj5ofokWjzoa5jAwMkxCykd6,4,1,0,0,0,0,3,0,4,0.5714285714285714,1,0.0,0,0,0,0,1,0,0,3,0,0,4,1
10955,156713,OIIVm7SlB1MihSMHP9mqOAQU5V2HwVOP,A3fsA9Zfv1X2fVEQhTw51lKENdNrEqT3,2,0,0,0,0,0,2,0,2,0.2857142857142857,1,0.0,0,0,0,0,0,0,0,2,0,0,2,1
10956,156717,X535Iu5jdKv0ppLqkwhIGZajlbhLXvmn,bWdj2GDclj5ofokWjzoa5jAwMkxCykd6,8,4,2,0,2,0,11,0,19,2.7142857142857144,2,0.0,0,2,0,2,4,0,0,11,0,4,15,1
10957,156761,gK3XDdBxJJXAYJgDo42Lu6DpWYFShLP7,SpATywNh6bZuzm8s1ceuBUnMUAeoAHHw,5,13,0,0,0,0,1,0,14,2.0,1,0.0,4,0,0,0,9,0,0,1,0,4,10,1
10958,156794,O8fsI8cLbZAXSgU5jDWyt6O1zSRxLyqW,SpATywNh6bZuzm8s1ceuBUnMUAeoAHHw,4,0,0,0,0,1,3,4,8,1.1428571428571428,1,0.0,0,0,0,0,0,1,0,3,4,0,8,1
10959,156801,HoH1joiBpbDlKqg5IXGbrLHAYskumoZ0,A3fsA9Zfv1X2fVEQhTw51lKENdNrEqT3,8,5,2,0,1,0,5,0,13,1.8571428571428572,2,0.0,0,2,0,1,5,0,0,5,0,3,10,1
10960,156805,GtIbKUKASYfKNPKGxbljpDBTth0Im6QW,A3fsA9Zfv1X2fVEQhTw51lKENdNrEqT3,2,0,0,0,0,0,2,0,2,0.2857142857142857,1,0.0,0,0,0,0,0,0,0,2,0,0,2,1
10961,156814,NUS8SY2k3f0DNpfQK2nVGgf0JlJGgonT,5X6FeZozNMgE2VRi3MJYjkkFK8SETtu2,1,0,0,0,0,0,1,0,1,0.14285714285714285,1,0.0,0,0,0,0,0,0,0,1,0,0,1,1
10962,156828,WRiHtWJX61VUGyAGQFSHJ3czdrgqxeQW,SpATywNh6bZuzm8s1ceuBUnMUAeoAHHw,1,0,0,0,0,0,1,0,1,0.14285714285714285,1,0.0,0,0,0,0,0,0,0,1,0,0,1,1
10963,156857,6Wl1wEYRYla7mkHoSYrGvmHM4YNCaD3n,3VkHkmOtom3jM2wCu94xgzzu1d6Dn7or,24,97,44,18,15,32,50,1,257,36.714285714285715,5,0.0,22,44,15,15,75,32,3,50,1,96,161,1
10964,156881,Nnfk32V9AUiBIlPGAKpXXGDwSTEb28r2,3VkHkmOtom3jM2wCu94xgzzu1d6Dn7or,1,0,0,0,0,0,2,0,2,0.2857142857142857,1,0.0,0,0,0,0,0,0,0,2,0,0,2,1
10965,156984,qI2TFhwq18nYOTCvta1laF36Rf50g4U5,3VkHkmOtom3jM2wCu94xgzzu1d6Dn7or,2,0,0,0,0,0,3,0,3,0.42857142857142855,1,0.0,0,0,0,0,0,0,0,3,0,0,3,1
10966,157010,WHFo5hRS2YZ5idgDwEWwHai4y5ZGv29k,3VkHkmOtom3jM2wCu94xgzzu1d6Dn7or,7,2,1,0,1,7,5,1,17,2.4285714285714284,1,0.0,0,1,0,1,2,7,0,5,1,2,15,1
10967,157019,9InyUG1HqccZWi5HVBzl2o4TV1KsASqo,3VkHkmOtom3jM2wCu94xgzzu1d6Dn7or,3,3,0,0,0,0,4,0,7,1.0,1,0.0,0,0,0,0,3,0,0,4,0,0,7,1
10968,157059,XMxNRap7k9Wk3QHHZRAATbBEOBshaiXR,3VkHkmOtom3jM2wCu94xgzzu1d6Dn7or,2,0,0,0,0,0,2,0,2,0.2857142857142857,1,0.0,0,0,0,0,0,0,0,2,0,0,2,1
10969,157061,Xf7hdurXZL8gf3FBiEK1cLryOJhCr0Cv,3VkHkmOtom3jM2wCu94xgzzu1d6Dn7or,11,17,5,5,5,10,13,1,56,8.0,3,0.0,10,5,4,5,7,10,1,13,1,24,32,0
10970,157062,63lqYGGtr9LJWJAQWQ0ApJu43pQGE26W,3VkHkmOtom3jM2wCu94xgzzu1d6Dn7or,9,3,2,0,2,0,5,1,13,1.8571428571428572,1,0.0,0,2,0,2,3,0,0,5,1,4,9,1
10971,157104,HhG2dCKpkSCA1aCq3JeL6EdAqYEZXpAC,3VkHkmOtom3jM2wCu94xgzzu1d6Dn7or,1,0,0,0,0,0,1,0,1,0.14285714285714285,1,0.0,0,0,0,0,0,0,0,1,0,0,1,1
10972,157141,wv5T3V7CEVt74uCfZX0bShz9AhS2hmJh,3VkHkmOtom3jM2wCu94xgzzu1d6Dn7or,1,0,0,0,0,0,3,0,3,0.42857142857142855,2,0.0,0,0,0,0,0,0,0,3,0,0,3,1
10973,157144,Q9vRNhatkLDJJU3tGkLQZvY6VPiyvyvp,3VkHkmOtom3jM2wCu94xgzzu1d6Dn7or,5,2,1,0,1,0,2,0,6,0.8571428571428571,1,0.0,0,1,0,1,2,0,0,2,0,2,4,1
10974,157189,uo7YhZ0OnoXU4DzC6rBENt0NolKURdsm,7GRhBDsirIGkRZBtSMEzNTyDr2JQm4xx,10,10,6,0,2,0,5,0,23,3.2857142857142856,1,0.0,1,6,0,2,9,0,0,5,0,9,14,1
10975,157198,C9PYulDhlCOnLsyEzeELLLcPxqCNkZMm,7GRhBDsirIGkRZBtSMEzNTyDr2JQm4xx,4,2,0,0,0,0,6,0,8,1.1428571428571428,1,0.0,0,0,0,0,2,0,0,6,0,0,8,1
10976,157202,GXOvdzrIyLHGb3WpOAU0L7zoSw672i7L,7GRhBDsirIGkRZBtSMEzNTyDr2JQm4xx,2,0,0,0,0,0,2,0,2,0.2857142857142857,1,0.0,0,0,0,0,0,0,0,2,0,0,2,1
10977,157234,YsQh8U8uW7iK5N2UDcWrxeNI3UNG6b7j,7GRhBDsirIGkRZBtSMEzNTyDr2JQm4xx,1,0,0,0,0,0,2,0,2,0.2857142857142857,1,0.0,0,0,0,0,0,0,0,2,0,0,2,1
10978,157249,6JlRZxC3M5GDCXBPRgqIBCezswNuact8,5X6FeZozNMgE2VRi3MJYjkkFK8SETtu2,2,0,0,0,0,0,2,0,2,0.2857142857142857,1,0.0,0,0,0,0,0,0,0,2,0,0,2,1
10979,157259,hED50EZVrg4iRW4iqOekbQhqnICw3N8M,7GRhBDsirIGkRZBtSMEzNTyDr2JQm4xx,5,3,2,0,2,0,2,0,9,1.2857142857142858,1,0.0,0,2,0,2,3,0,0,2,0,4,5,1
10980,157270,G6cW0d2bzLHgB0vreFbhNx3GSiMBKbtv,5X6FeZozNMgE2VRi3MJYjkkFK8SETtu2,5,5,2,0,1,0,2,0,10,1.4285714285714286,1,0.0,0,2,0,1,5,0,0,2,0,3,7,1
10981,157286,2GvFS2RdNGmAeuBW2TvolO9O5aFFmxNB,7GRhBDsirIGkRZBtSMEzNTyDr2JQm4xx,1,0,0,0,0,0,1,0,1,0.14285714285714285,1,0.0,0,0,0,0,0,0,0,1,0,0,1,1
10982,157321,Zv5J5vZd6sts8D8tkpz93CdtunC9xapP,5X6FeZozNMgE2VRi3MJYjkkFK8SETtu2,1,0,0,0,0,0,1,0,1,0.14285714285714285,1,0.0,0,0,0,0,0,0,0,1,0,0,1,1
10983,157347,5ehf4EFN8WhDbvmb2WvfZwpaBD0cj1oj,7GRhBDsirIGkRZBtSMEzNTyDr2JQm4xx,14,13,1,0,1,0,5,0,20,2.857142857142857,3,0.0,0,1,0,1,13,0,0,5,0,2,18,1
10984,157349,3RPGU51kghTa1yQ8sk1JkQkDTlLpjaeu,5X6FeZozNMgE2VRi3MJYjkkFK8SETtu2,2,0,0,0,0,0,7,0,7,1.0,3,0.0,0,0,0,0,0,0,0,7,0,0,7,1
10985,157377,DJXmR0KXC00UhtfnxnB0CPGhSlDcn5wL,7GRhBDsirIGkRZBtSMEzNTyDr2JQm4xx,1,0,0,0,0,0,1,0,1,0.14285714285714285,1,0.0,0,0,0,0,0,0,0,1,0,0,1,1
10986,157427,WycpsYuTE6aqZnahZR7CdEWycxuFvS1v,5X6FeZozNMgE2VRi3MJYjkkFK8SETtu2,2,0,0,0,0,0,2,0,2,0.2857142857142857,1,0.0,0,0,0,0,0,0,0,2,0,0,2,1
10987,157488,abZjyy6CkJwLuRnRyGB2GrxhAkPifaxi,7GRhBDsirIGkRZBtSMEzNTyDr2JQm4xx,8,7,0,0,0,1,9,0,17,2.4285714285714284,2,0.0,0,0,0,0,7,1,0,9,0,0,17,1
10988,157520,JUDJxps7BFb6uV0z9D16sg9erfu9YhJk,5X6FeZozNMgE2VRi3MJYjkkFK8SETtu2,31,29,8,0,25,0,2,1,65,9.285714285714286,1,0.0,20,8,0,25,9,0,0,2,1,53,12,1
10989,157544,23qYgK59sBhKVlqVOyc6Eo1KSrAZuYOK,5X6FeZozNMgE2VRi3MJYjkkFK8SETtu2,1,0,0,0,0,0,1,0,1,0.14285714285714285,1,0.0,0,0,0,0,0,0,0,1,0,0,1,1
10990,157627,xHfGdYj0sYZXXCzkQp0eF5wBXW7C2C6R,7GRhBDsirIGkRZBtSMEzNTyDr2JQm4xx,1,0,0,0,0,0,1,0,1,0.14285714285714285,1,0.0,0,0,0,0,0,0,0,1,0,0,1,1
10991,157633,LWIOfEf4G2x8q0gnnLAngYfTwedbhqfN,5Gyp41oLVo7Gg7vF4vpmggWP5MU70QO6,10,14,6,4,4,23,4,2,57,8.142857142857142,2,0.0,1,6,2,4,13,23,2,4,2,13,44,1
10992,157669,WEnfjbLNrVMT3GFjQA4iWW3hf0GRPkfb,5Gyp41oLVo7Gg7vF4vpmggWP5MU70QO6,10,4,2,4,2,2,4,1,19,2.7142857142857144,1,0.0,2,2,3,2,2,2,1,4,1,9,10,1
10993,157718,IthMAYNztWJoCFBWzNdp86Bo47edo7Kr,5Gyp41oLVo7Gg7vF4vpmggWP5MU70QO6,9,6,5,0,3,0,3,0,17,2.4285714285714284,1,0.0,0,5,0,3,6,0,0,3,0,8,9,1
10994,157719,HTGHrKrt9bt2no7NEjeTqA36pNapNLke,5Gyp41oLVo7Gg7vF4vpmggWP5MU70QO6,8,6,3,2,1,0,2,0,14,2.0,1,0.0,2,3,1,1,4,0,1,2,0,7,7,1
10995,157736,R9r67sxIPOn54lhnIEKJJZdT5cvreYeI,5Gyp41oLVo7Gg7vF4vpmggWP5MU70QO6,4,2,0,0,1,0,2,0,5,0.7142857142857143,1,0.0,0,0,0,1,2,0,0,2,0,1,4,1
10996,157746,VXYzZfu6ih0keHE9HAJ1SdpDOLcLAbwC,5Gyp41oLVo7Gg7vF4vpmggWP5MU70QO6,5,2,1,0,1,0,4,0,8,1.1428571428571428,1,0.0,0,1,0,1,2,0,0,4,0,2,6,1
10997,157762,2DAo11CCHa1ykO991IcFGBvBlIWgvVCY,5Gyp41oLVo7Gg7vF4vpmggWP5MU70QO6,4,2,1,0,1,0,2,0,6,0.8571428571428571,2,0.0,0,1,0,1,2,0,0,2,0,2,4,1
10998,157772,70ji2rgpVjNQHb0uAYu1Dlkzz8Vozt3h,5Gyp41oLVo7Gg7vF4vpmggWP5MU70QO6,10,8,4,4,3,0,2,0,21,3.0,2,0.0,2,4,3,3,6,0,1,2,0,12,9,0
10999,157802,M5VVteWQySX3L3J4dk5RJz0FGibCUyC6,5Gyp41oLVo7Gg7vF4vpmggWP5MU70QO6,12,27,14,0,6,3,9,1,60,8.571428571428571,4,0.0,4,14,0,6,23,3,0,9,1,24,36,1
11000,157856,ztVA2w1PZ0cPjSAHpOBD7HJ0VZDDjFrc,5Gyp41oLVo7Gg7vF4vpmggWP5MU70QO6,5,3,2,0,2,0,2,0,9,1.2857142857142858,1,0.0,0,2,0,2,3,0,0,2,0,4,5,0
11001,157857,GP0VAUJvMCs1edl21WedxXJbyeSp4smq,5Gyp41oLVo7Gg7vF4vpmggWP5MU70QO6,8,5,4,0,2,0,3,0,14,2.0,2,0.0,0,4,0,2,5,0,0,3,0,6,8,1
11002,157895,5Sfx079BTP0V5IioYsBhlrfBGdWoPDWP,5Gyp41oLVo7Gg7vF4vpmggWP5MU70QO6,10,23,5,1,2,2,4,0,37,5.285714285714286,1,0.0,15,5,1,2,8,2,0,4,0,23,14,1
11003,157915,A6EtE2eKPjGPEsSDEue5cwGo2zp7DviG,5Gyp41oLVo7Gg7vF4vpmggWP5MU70QO6,5,3,1,0,1,0,2,0,7,1.0,1,0.0,0,1,0,1,3,0,0,2,0,2,5,1
11004,157916,FGJh9lbE5Tn49JmYTykhj6B5KNIkrzwf,5Gyp41oLVo7Gg7vF4vpmggWP5MU70QO6,1,0,0,0,0,0,1,0,1,0.14285714285714285,1,0.0,0,0,0,0,0,0,0,1,0,0,1,1
11005,157933,ZKYPDfjHbDNy826bRbgfwUg0sAVAo2R5,5Gyp41oLVo7Gg7vF4vpmggWP5MU70QO6,7,7,3,0,2,0,3,0,15,2.142857142857143,1,0.0,1,3,0,2,6,0,0,3,0,6,9,1
11006,157942,869csXTSxmz5a3Iq4YX4us05akITQ5bo,5Gyp41oLVo7Gg7vF4vpmggWP5MU70QO6,1,0,0,0,0,0,2,0,2,0.2857142857142857,1,0.0,0,0,0,0,0,0,0,2,0,0,2,1
11007,157948,UTQI3stNnZIKednJcKCTrHPD5NsTO42m,5Gyp41oLVo7Gg7vF4vpmggWP5MU70QO6,1,0,0,0,0,0,1,0,1,0.14285714285714285,1,0.0,0,0,0,0,0,0,0,1,0,0,1,1
11008,157954,bXli2OVtRnaQ20Z1gieE0Vtj83YMuZrL,5Gyp41oLVo7Gg7vF4vpmggWP5MU70QO6,7,3,2,0,1,0,9,0,15,2.142857142857143,1,0.0,0,2,0,1,3,0,0,9,0,3,12,1
11009,157989,OYQCjjV0jebV4LN4hg0D6dY6fyaV2c47,5Gyp41oLVo7Gg7vF4vpmggWP5MU70QO6,1,0,0,0,0,0,2,0,2,0.2857142857142857,1,0.0,0,0,0,0,0,0,0,2,0,0,2,1
11010,157996,CIiWe6ULrETFuvq6ceby0e46t5dQ6ZDk,5Gyp41oLVo7Gg7vF4vpmggWP5MU70QO6,5,2,1,0,1,1,3,0,8,1.1428571428571428,1,0.0,0,1,0,1,2,1,0,3,0,2,6,1
11011,157997,79FsGRj8oZJZd2OwJDKEfUqABiV1ZA7r,5Gyp41oLVo7Gg7vF4vpmggWP5MU70QO6,8,5,2,0,2,4,6,0,19,2.7142857142857144,1,0.0,1,2,0,2,4,4,0,6,0,5,14,1
11012,158002,vLcoMjl52bAkwS2Nrqx0BG2I0tRsoKBa,5Gyp41oLVo7Gg7vF4vpmggWP5MU70QO6,5,1,1,0,1,1,2,0,6,0.8571428571428571,1,0.0,0,1,0,1,1,1,0,2,0,2,4,1
11013,158024,8irCUZa4UAKsYYFeHrY9ttb5xgcL2ou7,5Gyp41oLVo7Gg7vF4vpmggWP5MU70QO6,12,7,6,0,3,0,2,0,18,2.5714285714285716,1,0.0,0,6,0,3,7,0,0,2,0,9,9,1
11014,158035,Io3VzTK6sP3a0ZVRKkRhFNz8A2ULjris,5Gyp41oLVo7Gg7vF4vpmggWP5MU70QO6,9,12,9,0,0,11,8,1,41,5.857142857142857,2,0.0,0,9,0,0,12,11,0,8,1,9,32,1
11015,158036,ZqvxyeZYRSzaK0NeAJVghR0lBOIaaZqV,5Gyp41oLVo7Gg7vF4vpmggWP5MU70QO6,12,20,11,10,7,0,1,0,49,7.0,1,0.0,7,11,6,7,13,0,4,1,0,31,18,1
11016,158065,BBJ3vKTyvStRa10Tpfc6k0oOhgY721Pq,5Gyp41oLVo7Gg7vF4vpmggWP5MU70QO6,1,0,0,0,0,0,1,0,1,0.14285714285714285,1,0.0,0,0,0,0,0,0,0,1,0,0,1,1
11017,158066,rBi9e8T21gI6VJkURQRxwM6NnqVXHHAq,5Gyp41oLVo7Gg7vF4vpmggWP5MU70QO6,9,8,6,0,4,0,2,0,20,2.857142857142857,1,0.0,1,6,0,4,7,0,0,2,0,11,9,1
11018,158093,ef6Fua3z8OcLsUmVPoEWH2QwTgDEN5UV,5Gyp41oLVo7Gg7vF4vpmggWP5MU70QO6,1,0,0,0,0,0,1,0,1,0.14285714285714285,1,0.0,0,0,0,0,0,0,0,1,0,0,1,1
11019,158119,WxVM9kOqNmenlQy1YKMo3yVYKYKkewCz,5Gyp41oLVo7Gg7vF4vpmggWP5MU70QO6,9,19,8,13,2,0,7,0,49,7.0,4,0.0,5,8,10,2,14,0,3,7,0,25,24,1
11020,158130,bSKPqUrgPKXVRzWsWyAdkxmj7bsvJTtN,5Gyp41oLVo7Gg7vF4vpmggWP5MU70QO6,20,35,18,15,10,0,9,0,87,12.428571428571429,3,0.0,9,18,10,10,26,0,5,9,0,47,40,1
11021,158145,NWcsS6t3wOq2pf5qHyOJUoZH0ORQTv1z,5Gyp41oLVo7Gg7vF4vpmggWP5MU70QO6,1,0,0,0,0,0,1,0,1,0.14285714285714285,1,0.0,0,0,0,0,0,0,0,1,0,0,1,1
11022,158148,uqbMFekfs67CmLzvJypjQ2YDZvOTDl5M,5Gyp41oLVo7Gg7vF4vpmggWP5MU70QO6,1,0,0,0,0,0,1,0,1,0.14285714285714285,1,0.0,0,0,0,0,0,0,0,1,0,0,1,1
11023,158177,Go1arppSMxFevdTxkc0brt4Bh3dCTs43,5Gyp41oLVo7Gg7vF4vpmggWP5MU70QO6,8,19,4,0,1,1,4,0,29,4.142857142857143,2,0.0,9,4,0,1,10,1,0,4,0,14,15,1
11024,158178,gy7pyC3wBMgheQXSZM4NwZVXK08J1Yb4,5Gyp41oLVo7Gg7vF4vpmggWP5MU70QO6,1,0,0,0,0,0,1,0,1,0.14285714285714285,1,0.0,0,0,0,0,0,0,0,1,0,0,1,1
11025,158190,ouZJjXOMfv0cgbezRQ2yVqJJVKJPFP9g,5Gyp41oLVo7Gg7vF4vpmggWP5MU70QO6,1,0,0,0,0,0,1,0,1,0.14285714285714285,1,0.0,0,0,0,0,0,0,0,1,0,0,1,1
11026,158203,HkcPmWCSdk3INCYsquWGQGZKijdTCD0w,5Gyp41oLVo7Gg7vF4vpmggWP5MU70QO6,1,0,0,0,0,0,1,0,1,0.14285714285714285,1,0.0,0,0,0,0,0,0,0,1,0,0,1,0
11027,158215,XPiygQf4f2L0UgTrmMFFqxeKe6BZR3ej,5Gyp41oLVo7Gg7vF4vpmggWP5MU70QO6,1,0,0,0,0,0,2,0,2,0.2857142857142857,2,0.0,0,0,0,0,0,0,0,2,0,0,2,1
11028,158217,5UGNuDKo01BQkwP5FIZp50YNYJe8fXVs,5Gyp41oLVo7Gg7vF4vpmggWP5MU70QO6,19,29,16,0,11,0,12,0,68,9.714285714285714,2,0.0,9,16,0,11,20,0,0,12,0,36,32,1
11029,158223,NvaDpy1hgf8rWDMhliIL6XiIMyJMBjqV,5Gyp41oLVo7Gg7vF4vpmggWP5MU70QO6,1,0,0,0,0,0,1,0,1,0.14285714285714285,1,0.0,0,0,0,0,0,0,0,1,0,0,1,1
11030,158248,Im0Jt8ZsNMpNfAcwspOxwhIuEx5EhBXC,5Gyp41oLVo7Gg7vF4vpmggWP5MU70QO6,1,0,0,0,0,0,1,0,1,0.14285714285714285,1,0.0,0,0,0,0,0,0,0,1,0,0,1,1
11031,158267,JlM44bI5crrtGE7iI2BHTiesGaSh9jLm,5Gyp41oLVo7Gg7vF4vpmggWP5MU70QO6,6,5,3,0,3,0,1,0,12,1.7142857142857142,1,0.0,0,3,0,3,5,0,0,1,0,6,6,1
11032,158304,s9zVSTKcBCSQqiONTkBdJFyXlfd2TpPb,5Gyp41oLVo7Gg7vF4vpmggWP5MU70QO6,14,15,9,0,6,1,4,0,35,5.0,2,0.0,1,9,0,6,14,1,0,4,0,16,19,1
11033,158306,e8QZ92AvjJI6opw2slSevZ0L8RtvMAlZ,5Gyp41oLVo7Gg7vF4vpmggWP5MU70QO6,7,3,2,0,2,0,2,0,9,1.2857142857142858,1,0.0,0,2,0,2,3,0,0,2,0,4,5,1
11034,158314,rqoGLMWp7ee8Ppu4OdHSBl6vmRxDZvKU,5Gyp41oLVo7Gg7vF4vpmggWP5MU70QO6,10,18,5,3,3,0,4,0,33,4.714285714285714,2,0.0,5,5,2,3,13,0,1,4,0,15,18,1
11035,158341,6uFOxAyka7QrtMUYdvjsolvFWloaK2QU,5Gyp41oLVo7Gg7vF4vpmggWP5MU70QO6,10,8,5,0,6,0,1,0,20,2.857142857142857,1,0.0,0,5,0,6,8,0,0,1,0,11,9,1
11036,158348,UqdIUFHnGaXiXqYDnRaaG3a8Ckuse0hd,5Gyp41oLVo7Gg7vF4vpmggWP5MU70QO6,4,2,1,0,1,0,1,0,5,0.7142857142857143,1,0.0,0,1,0,1,2,0,0,1,0,2,3,1
11037,158363,bXMaalfz1ZqHKnJWw6VXCAoemSeuw45Q,5Gyp41oLVo7Gg7vF4vpmggWP5MU70QO6,9,7,4,3,0,0,7,0,21,3.0,3,0.0,3,4,3,0,4,0,0,7,0,10,11,1
11038,158373,V0KwOaUHQenVt4j6XdWENbsPxRLl95xt,5Gyp41oLVo7Gg7vF4vpmggWP5MU70QO6,1,0,0,0,0,0,1,0,1,0.14285714285714285,1,0.0,0,0,0,0,0,0,0,1,0,0,1,1
11039,158387,b8ok99SfWosLE8bC830yWvnFESGW3si2,5Gyp41oLVo7Gg7vF4vpmggWP5MU70QO6,22,21,19,0,8,1,15,1,65,9.285714285714286,2,0.0,1,19,0,8,20,1,0,15,1,28,37,1
11040,158408,lECqbqrkQ3HlfeNWRN0jqJEeRHxVUCOh,5Gyp41oLVo7Gg7vF4vpmggWP5MU70QO6,30,44,18,10,20,10,17,1,120,17.142857142857142,5,0.0,14,18,8,20,30,10,2,17,1,60,60,1
11041,158414,GttyptGQfSjuAltdswFjfTtOCrx992oK,5Gyp41oLVo7Gg7vF4vpmggWP5MU70QO6,1,0,0,0,0,0,1,0,1,0.14285714285714285,1,0.0,0,0,0,0,0,0,0,1,0,0,1,1
11042,158456,crFFvCkJsUWvruc5uCB1uKzbtgTYoPqU,5Gyp41oLVo7Gg7vF4vpmggWP5MU70QO6,7,10,5,4,0,0,2,0,21,3.0,1,0.0,1,5,2,0,9,0,2,2,0,8,13,1
11043,158463,vpYgNvzZy52Oh1tIBbe2df7KZVnqAmZK,5Gyp41oLVo7Gg7vF4vpmggWP5MU70QO6,4,2,1,0,1,0,2,0,6,0.8571428571428571,2,0.0,0,1,0,1,2,0,0,2,0,2,4,1
11044,158464,THXvaeyPhVQwJsTFbHjyopJ1nNCELuyj,5Gyp41oLVo7Gg7vF4vpmggWP5MU70QO6,5,5,2,0,2,0,3,0,12,1.7142857142857142,2,0.0,0,2,0,2,5,0,0,3,0,4,8,1
11045,158479,9pT3HP4ciM7AgX5da5QzYZtPA6fxeste,5Gyp41oLVo7Gg7vF4vpmggWP5MU70QO6,11,17,8,7,2,11,5,0,50,7.142857142857143,3,0.0,1,8,5,2,16,11,2,5,0,16,34,1
11046,158487,L5aguIiqOewAgGrhJVNv8Wafy1P8kRt9,5Gyp41oLVo7Gg7vF4vpmggWP5MU70QO6,1,0,0,0,0,0,1,0,1,0.14285714285714285,1,0.0,0,0,0,0,0,0,0,1,0,0,1,1
11047,158496,fRucRBw44zpZn0NZGLJPqsXONojt7uSi,5Gyp41oLVo7Gg7vF4vpmggWP5MU70QO6,5,3,1,0,1,0,2,0,7,1.0,1,0.0,0,1,0,1,3,0,0,2,0,2,5,1
11048,158511,D0CsW9G2S7ulJStlNy1QB5IxfGgJKMqm,5Gyp41oLVo7Gg7vF4vpmggWP5MU70QO6,12,29,17,6,4,26,5,0,87,12.428571428571429,2,0.0,3,17,4,4,26,26,2,5,0,28,59,0
11049,158524,WOgGW6t7ivkfrL4Z5Ocp4QdCm4d6AMkz,5Gyp41oLVo7Gg7vF4vpmggWP5MU70QO6,7,4,1,0,2,0,1,0,8,1.1428571428571428,1,0.0,0,1,0,2,4,0,0,1,0,3,5,1
11050,158525,WE2BbGXOVoTrjhAJmFH0Or7kVd39V4vi,5Gyp41oLVo7Gg7vF4vpmggWP5MU70QO6,7,5,3,0,2,0,1,0,11,1.5714285714285714,1,0.0,1,3,0,2,4,0,0,1,0,6,5,1
11051,158535,PxyKXDtaR2mbq9weELx4ZBr6DLDWNqy9,5Gyp41oLVo7Gg7vF4vpmggWP5MU70QO6,6,3,2,0,2,0,1,0,8,1.1428571428571428,1,0.0,0,2,0,2,3,0,0,1,0,4,4,1
11052,158539,VXCd64m0Z7xUSwqq3nKNQ9weISoBu0LD,5Gyp41oLVo7Gg7vF4vpmggWP5MU70QO6,6,3,2,0,2,0,1,0,8,1.1428571428571428,1,0.0,0,2,0,2,3,0,0,1,0,4,4,1
11053,158559,PKljiaQmLbZG5ONmJlKJEPvGakMbHbYU,5Gyp41oLVo7Gg7vF4vpmggWP5MU70QO6,6,3,2,0,2,0,1,0,8,1.1428571428571428,1,0.0,0,2,0,2,3,0,0,1,0,4,4,1
11054,158561,RM5Si3x1ttYcDbiTcjvVOJ3RWIjU0zI5,5Gyp41oLVo7Gg7vF4vpmggWP5MU70QO6,6,4,3,0,2,0,1,0,10,1.4285714285714286,1,0.0,0,3,0,2,4,0,0,1,0,5,5,1
11055,158568,9FlBeR38sxQqTfTtonzJZ0Irx7qBpmor,5Gyp41oLVo7Gg7vF4vpmggWP5MU70QO6,7,6,2,0,2,0,2,0,12,1.7142857142857142,2,0.0,0,2,0,2,6,0,0,2,0,4,8,1
11056,158573,klui28KhyhClftadsamLTvXW9muuN6Qc,5Gyp41oLVo7Gg7vF4vpmggWP5MU70QO6,14,18,10,2,5,19,6,0,60,8.571428571428571,1,0.0,7,10,1,5,11,19,1,6,0,23,37,1
11057,158586,2zFsyHLRIVr61iaQkzpRvzQtauWJlCfW,5Gyp41oLVo7Gg7vF4vpmggWP5MU70QO6,1,0,0,0,0,0,4,0,4,0.5714285714285714,2,0.0,0,0,0,0,0,0,0,4,0,0,4,1
11058,158607,W7RgW1HKGO83Xx4btgMFqalp32Qehjoi,5Gyp41oLVo7Gg7vF4vpmggWP5MU70QO6,1,0,0,0,0,0,1,0,1,0.14285714285714285,1,0.0,0,0,0,0,0,0,0,1,0,0,1,1
11059,158611,VW2nlrlfxtuKc79c7VsAkYHSZK2oNi0Q,5Gyp41oLVo7Gg7vF4vpmggWP5MU70QO6,1,0,0,0,0,0,1,0,1,0.14285714285714285,1,0.0,0,0,0,0,0,0,0,1,0,0,1,1
11060,158637,hBjHZojv3ifn1BGe2j9vzNNV7zRAWgCr,5Gyp41oLVo7Gg7vF4vpmggWP5MU70QO6,6,5,2,0,0,3,3,0,13,1.8571428571428572,1,0.0,3,2,0,0,2,3,0,3,0,5,8,0
11061,158645,eb7ZybPnI910hHaYVoCo6nxLkIiXwzRa,5Gyp41oLVo7Gg7vF4vpmggWP5MU70QO6,11,26,13,8,4,18,3,0,72,10.285714285714286,1,0.0,4,13,6,4,22,18,2,3,0,27,45,1
11062,158651,UrSGv4civCcLiCxcgwsTEMeJJdN6l4Vv,5Gyp41oLVo7Gg7vF4vpmggWP5MU70QO6,10,6,3,2,1,0,9,1,22,3.142857142857143,1,0.0,2,3,1,1,4,0,1,9,1,7,15,1
11063,158676,czPkaZkbqFY5spUFhBAHMOHBEtbhDqHw,5Gyp41oLVo7Gg7vF4vpmggWP5MU70QO6,1,0,0,0,0,0,1,0,1,0.14285714285714285,1,0.0,0,0,0,0,0,0,0,1,0,0,1,1
11064,158693,PZ0JMRr6vxivy5yXBEs4L9qx3vBiHfoH,5Gyp41oLVo7Gg7vF4vpmggWP5MU70QO6,3,2,1,0,0,0,2,0,5,0.7142857142857143,1,0.0,0,1,0,0,2,0,0,2,0,1,4,1
11065,158698,4zrvABDjO8Ut5BB3dmSF06xVwPlHi7pK,5Gyp41oLVo7Gg7vF4vpmggWP5MU70QO6,24,40,4,28,11,15,5,0,103,14.714285714285714,4,0.0,7,4,19,11,33,15,9,5,0,41,62,1
11066,158701,qs5RIk0lD4q937ua1wEd8DEKzji32nQh,5Gyp41oLVo7Gg7vF4vpmggWP5MU70QO6,10,10,7,0,1,0,10,0,28,4.0,2,0.0,0,7,0,1,10,0,0,10,0,8,20,1
11067,158702,3BgmezVALuv9uoIS0qfmdL9i3MeTTmPt,5Gyp41oLVo7Gg7vF4vpmggWP5MU70QO6,6,1,1,0,1,0,3,0,6,0.8571428571428571,1,0.0,0,1,0,1,1,0,0,3,0,2,4,1
11068,158719,AfqKObEuXEhKe7HKfvuLG5yfR6wayO2s,5Gyp41oLVo7Gg7vF4vpmggWP5MU70QO6,4,2,1,0,1,3,1,0,8,1.1428571428571428,1,0.0,0,1,0,1,2,3,0,1,0,2,6,1
11069,158742,ZKCE8IiEiAnUeDcb4cE1R1Dd1dkSRr7l,5Gyp41oLVo7Gg7vF4vpmggWP5MU70QO6,1,0,0,0,0,0,1,0,1,0.14285714285714285,1,0.0,0,0,0,0,0,0,0,1,0,0,1,1
11070,158745,j6kVkVGKYZT7ozL2NE5rOIexD3a1ewYn,5Gyp41oLVo7Gg7vF4vpmggWP5MU70QO6,18,28,15,0,10,0,4,0,57,8.142857142857142,4,0.0,4,15,0,10,24,0,0,4,0,29,28,1
11071,158767,Y9GqNI8HKN8AZelF8dSXK2b9zuzFq9b9,5Gyp41oLVo7Gg7vF4vpmggWP5MU70QO6,1,0,0,0,0,0,1,0,1,0.14285714285714285,1,0.0,0,0,0,0,0,0,0,1,0,0,1,1
11072,158773,Qz8c2nguCNNLZ9pqTyROsw55vrPvMhBX,5Gyp41oLVo7Gg7vF4vpmggWP5MU70QO6,1,0,0,0,0,0,1,0,1,0.14285714285714285,1,0.0,0,0,0,0,0,0,0,1,0,0,1,1
11073,158786,xbOq1vQjtSXkblyY2nHeiP49AGiDrHEq,5Gyp41oLVo7Gg7vF4vpmggWP5MU70QO6,9,5,2,0,2,0,3,1,13,1.8571428571428572,1,0.0,0,2,0,2,5,0,0,3,1,4,9,1
11074,158787,cqgRy8cKV9KWJxlMsO4aIE8n8O67vbnc,5Gyp41oLVo7Gg7vF4vpmggWP5MU70QO6,1,0,0,0,0,0,1,0,1,0.14285714285714285,1,0.0,0,0,0,0,0,0,0,1,0,0,1,1
11075,158800,y4h2O96Qbtxic4CWRw5MpvxobIWcm5af,5Gyp41oLVo7Gg7vF4vpmggWP5MU70QO6,1,0,0,0,0,0,1,0,1,0.14285714285714285,1,0.0,0,0,0,0,0,0,0,1,0,0,1,0
11076,158801,aK8nJQFJ6r54m0ZnhsCvwO5IU3VoJh3J,5Gyp41oLVo7Gg7vF4vpmggWP5MU70QO6,6,3,2,0,2,0,1,0,8,1.1428571428571428,1,0.0,0,2,0,2,3,0,0,1,0,4,4,1
11077,158803,SkZlhcjqZI4qlpvHtuOmZh7bgPo5Ar9M,5Gyp41oLVo7Gg7vF4vpmggWP5MU70QO6,1,0,0,0,0,0,1,0,1,0.14285714285714285,1,0.0,0,0,0,0,0,0,0,1,0,0,1,1
11078,158816,QAaGqoCRVYYJLVC9SEo8gPzESLmuOfNy,5Gyp41oLVo7Gg7vF4vpmggWP5MU70QO6,7,7,5,0,4,0,2,0,18,2.5714285714285716,2,0.0,0,5,0,4,7,0,0,2,0,9,9,1
11079,158825,11kRNihr0NAT65KuJwbNyDYQBbxmyBN8,5Gyp41oLVo7Gg7vF4vpmggWP5MU70QO6,1,0,0,0,0,0,1,0,1,0.14285714285714285,1,0.0,0,0,0,0,0,0,0,1,0,0,1,1
11080,158836,IqTYyD7L0euRgN3diEzqrprrc2W9uyF6,5Gyp41oLVo7Gg7vF4vpmggWP5MU70QO6,1,0,0,0,0,0,1,0,1,0.14285714285714285,1,0.0,0,0,0,0,0,0,0,1,0,0,1,1
11081,158845,ttGUUk3v7K6K40muYhPlMRiZFKv5tO0S,5Gyp41oLVo7Gg7vF4vpmggWP5MU70QO6,10,22,7,0,5,19,6,2,61,8.714285714285714,2,0.0,11,7,0,5,11,19,0,6,2,23,38,1
11082,158852,O5FAv2WJ9y2Iw3ydNqVb8wtG4rpJE8Qp,5Gyp41oLVo7Gg7vF4vpmggWP5MU70QO6,5,2,1,0,1,0,2,0,6,0.8571428571428571,1,0.0,0,1,0,1,2,0,0,2,0,2,4,1
11083,158854,UEdPzk5lpERU6G2eKfLVYTTH6XB7mNs4,5Gyp41oLVo7Gg7vF4vpmggWP5MU70QO6,4,3,0,0,0,0,2,0,5,0.7142857142857143,1,0.0,0,0,0,0,3,0,0,2,0,0,5,1
11084,158879,u3uODDQpEAolitLmmjyCLIJGPgvL6DtJ,5Gyp41oLVo7Gg7vF4vpmggWP5MU70QO6,10,15,6,0,3,1,5,0,30,4.285714285714286,2,0.0,1,6,0,3,14,1,0,5,0,10,20,1
11085,158899,IU3vKWuiW6wCWOTUkaeGx6t4iWGP45U9,5Gyp41oLVo7Gg7vF4vpmggWP5MU70QO6,9,12,4,10,2,0,2,0,30,4.285714285714286,1,0.0,6,4,5,2,6,0,5,2,0,17,13,1
11086,158910,ZNtimub0Pnr6wqfsPPl3Sbndp7E26Wcv,5Gyp41oLVo7Gg7vF4vpmggWP5MU70QO6,5,5,0,0,0,0,2,0,7,1.0,1,0.0,0,0,0,0,5,0,0,2,0,0,7,1
11087,158946,pg6dNcT7XD6y7ZZgUgbDLgNz6s04xyRX,5Gyp41oLVo7Gg7vF4vpmggWP5MU70QO6,1,0,0,0,0,0,1,0,1,0.14285714285714285,1,0.0,0,0,0,0,0,0,0,1,0,0,1,1
11088,158958,uiNG5J16zJ9t1Kkj0d6RAfq7YahYnDSP,5Gyp41oLVo7Gg7vF4vpmggWP5MU70QO6,3,2,1,0,0,0,1,0,4,0.5714285714285714,1,0.0,0,1,0,0,2,0,0,1,0,1,3,1
11089,158966,aRBsP3RNC28m05qU4AuLdcShaMIKbk0T,5Gyp41oLVo7Gg7vF4vpmggWP5MU70QO6,4,2,0,0,1,0,2,0,5,0.7142857142857143,2,0.0,0,0,0,1,2,0,0,2,0,1,4,1
11090,158968,MJQ9fDBlASWun8zwf4Tzkw3mhN2vL079,5Gyp41oLVo7Gg7vF4vpmggWP5MU70QO6,6,4,3,0,3,0,1,0,11,1.5714285714285714,1,0.0,0,3,0,3,4,0,0,1,0,6,5,1
11091,158985,rm52Ts2OWqvT4Vv3xYPH49SI4hdPJFK7,5Gyp41oLVo7Gg7vF4vpmggWP5MU70QO6,6,5,3,0,1,0,2,0,11,1.5714285714285714,2,0.0,0,3,0,1,5,0,0,2,0,4,7,1
11092,158994,MkldcyT3fi43Q6hm3R8ytVSF6gTGp4B6,5Gyp41oLVo7Gg7vF4vpmggWP5MU70QO6,10,7,2,6,2,0,2,0,19,2.7142857142857144,1,0.0,3,2,4,2,4,0,2,2,0,11,8,1
11093,159020,ss112lznmTTi1F5ygDUn8Q7DXK4Lr60G,5Gyp41oLVo7Gg7vF4vpmggWP5MU70QO6,7,4,2,0,2,0,3,0,11,1.5714285714285714,1,0.0,0,2,0,2,4,0,0,3,0,4,7,1
11094,159079,SNiDuvy4k2MAVtt9cv0oUwtlEw7cNBTi,5Gyp41oLVo7Gg7vF4vpmggWP5MU70QO6,8,2,2,0,2,0,5,0,11,1.5714285714285714,1,0.0,0,2,0,2,2,0,0,5,0,4,7,0
11095,159082,wWgbRBmslbZN35SazWe1TBDDIPzRJTHP,5Gyp41oLVo7Gg7vF4vpmggWP5MU70QO6,1,0,0,0,0,0,1,0,1,0.14285714285714285,1,0.0,0,0,0,0,0,0,0,1,0,0,1,1
11096,159086,pMvcDr7ozoLQB2BowYw5E8bebetADaFB,5Gyp41oLVo7Gg7vF4vpmggWP5MU70QO6,1,0,0,0,0,0,1,0,1,0.14285714285714285,1,0.0,0,0,0,0,0,0,0,1,0,0,1,1
11097,159121,MCumU93NOEJEZgGjsdOCZ3frEeJLiSz8,5Gyp41oLVo7Gg7vF4vpmggWP5MU70QO6,7,10,4,0,2,0,4,0,20,2.857142857142857,2,0.0,4,4,0,2,6,0,0,4,0,10,10,1
11098,159247,o5uaFzVgRB6HZGhAqs7wLGbES9siaN1U,5Gyp41oLVo7Gg7vF4vpmggWP5MU70QO6,1,0,0,0,0,0,1,0,1,0.14285714285714285,1,0.0,0,0,0,0,0,0,0,1,0,0,1,1
11099,159250,uwiNEmfqjqQ8VnSzp11dqdzmq9E0v6wt,5Gyp41oLVo7Gg7vF4vpmggWP5MU70QO6,6,3,2,0,2,0,1,0,8,1.1428571428571428,1,0.0,0,2,0,2,3,0,0,1,0,4,4,1
11100,159293,DqSDsD0a7h5cIm6YV6lhbJNYg2dSjWOn,5Gyp41oLVo7Gg7vF4vpmggWP5MU70QO6,13,14,10,0,7,0,2,0,33,4.714285714285714,1,0.0,3,10,0,7,11,0,0,2,0,20,13,0
11101,159321,ExM9Lv23n8avgHjMrBycTC6XnL5xfxSf,5Gyp41oLVo7Gg7vF4vpmggWP5MU70QO6,6,3,2,0,2,0,1,0,8,1.1428571428571428,1,0.0,0,2,0,2,3,0,0,1,0,4,4,0
11102,159332,5x7PJKAlpwjJHVKa6EUCDUMMHmJ1P3I6,5Gyp41oLVo7Gg7vF4vpmggWP5MU70QO6,13,12,5,0,9,0,1,0,27,3.857142857142857,1,0.0,5,5,0,9,7,0,0,1,0,19,8,1
11103,159442,9zFbkWWvpkj5lTNTKw4CVexfRitoPB2s,5Gyp41oLVo7Gg7vF4vpmggWP5MU70QO6,10,7,5,0,4,0,3,0,19,2.7142857142857144,2,0.0,0,5,0,4,7,0,0,3,0,9,10,1
11104,159443,KFG6G55toGAeaWBt5UmyioW5n1NVxSjT,5Gyp41oLVo7Gg7vF4vpmggWP5MU70QO6,4,2,1,0,1,0,1,0,5,0.7142857142857143,1,0.0,0,1,0,1,2,0,0,1,0,2,3,1
11105,159470,iQo5RkVZ49BhRnWvwNkx46Qf4Btl7Mld,5Gyp41oLVo7Gg7vF4vpmggWP5MU70QO6,8,4,4,0,4,7,10,0,29,4.142857142857143,1,0.0,0,4,0,4,4,7,0,10,0,8,21,1
11106,159514,Rlh0CLP4VxcLN7b2ea5Tx2FXxIm69SzJ,5Gyp41oLVo7Gg7vF4vpmggWP5MU70QO6,1,0,0,0,0,0,3,0,3,0.42857142857142855,1,0.0,0,0,0,0,0,0,0,3,0,0,3,1
11107,159533,dBixMyB1zwngnxNe4g7FQP33nARkTGdD,5Gyp41oLVo7Gg7vF4vpmggWP5MU70QO6,11,8,4,3,1,0,2,0,18,2.5714285714285716,1,0.0,3,4,3,1,5,0,0,2,0,11,7,1
11108,159555,StVnBhGEHUacVEE9QqYiv43rhePbl3Ev,5Gyp41oLVo7Gg7vF4vpmggWP5MU70QO6,6,2,1,0,1,0,4,0,8,1.1428571428571428,1,0.0,0,1,0,1,2,0,0,4,0,2,6,1
11109,159621,5nF7gQcqoLIyo2zojM6XQZUTJgs5pdB5,5Gyp41oLVo7Gg7vF4vpmggWP5MU70QO6,6,5,2,2,1,0,2,0,12,1.7142857142857142,1,0.0,3,2,2,1,2,0,0,2,0,8,4,1
11110,159640,4bFhEzvRwZ7PdanfX4z6RakGNadHbLWJ,5Gyp41oLVo7Gg7vF4vpmggWP5MU70QO6,6,3,2,0,2,0,1,0,8,1.1428571428571428,1,0.0,0,2,0,2,3,0,0,1,0,4,4,1
11111,159668,r0yZNwEG828V0TMkCl61Reya5Y5HO5aR,5Gyp41oLVo7Gg7vF4vpmggWP5MU70QO6,29,108,31,42,26,28,18,0,253,36.142857142857146,8,0.0,27,31,24,26,81,28,18,18,0,108,145,1
11112,159701,A9rYFlzCgttvzhslfm7OUVPZpZiJJf0K,5Gyp41oLVo7Gg7vF4vpmggWP5MU70QO6,1,0,0,0,0,0,1,0,1,0.14285714285714285,1,0.0,0,0,0,0,0,0,0,1,0,0,1,1
11113,159714,DwNOCMUuBk1Sx3txS2QF8DIdqY152Zxm,5Gyp41oLVo7Gg7vF4vpmggWP5MU70QO6,1,0,0,0,0,0,1,0,1,0.14285714285714285,1,0.0,0,0,0,0,0,0,0,1,0,0,1,1
11114,159769,MDdhn4ypSdCL9rtPmmJxa6as45ud6vdU,5Gyp41oLVo7Gg7vF4vpmggWP5MU70QO6,7,3,2,0,2,0,2,0,9,1.2857142857142858,1,0.0,0,2,0,2,3,0,0,2,0,4,5,1
11115,159782,4D3Mr9GTnnSeHqe4k4RduVTIffzivKXV,5Gyp41oLVo7Gg7vF4vpmggWP5MU70QO6,16,19,8,0,9,0,1,0,37,5.285714285714286,1,0.0,9,8,0,9,10,0,0,1,0,26,11,1
11116,159833,9004rNJewJ39XaW2hk6oIhScWS9lZShw,5Gyp41oLVo7Gg7vF4vpmggWP5MU70QO6,22,18,10,14,4,1,6,1,54,7.714285714285714,2,0.0,6,10,9,4,12,1,5,6,1,29,25,1
11117,159837,wg2hD1uJp9o6wldft2AXmXetp4caKo6A,5Gyp41oLVo7Gg7vF4vpmggWP5MU70QO6,1,0,0,0,0,0,1,0,1,0.14285714285714285,1,0.0,0,0,0,0,0,0,0,1,0,0,1,1
11118,159900,UIvm4I88x5RkegSMmjCWI0Aa78hSxiI7,5Gyp41oLVo7Gg7vF4vpmggWP5MU70QO6,4,3,0,0,0,0,2,0,5,0.7142857142857143,1,0.0,0,0,0,0,3,0,0,2,0,0,5,1
11119,159915,PsnbKiLxwYQcdN1QgtL66LMiQGsGsFtT,5Gyp41oLVo7Gg7vF4vpmggWP5MU70QO6,6,3,2,0,2,0,1,0,8,1.1428571428571428,1,0.0,0,2,0,2,3,0,0,1,0,4,4,1
11120,159929,j1PmVnHtioi6Uez7oNPozWMLhg4Dtbeh,5Gyp41oLVo7Gg7vF4vpmggWP5MU70QO6,4,2,1,0,1,0,1,0,5,0.7142857142857143,1,0.0,0,1,0,1,2,0,0,1,0,2,3,1
11121,159934,8ySChdMhILkWrFidrAeAcbpscZk12bIK,5Gyp41oLVo7Gg7vF4vpmggWP5MU70QO6,9,5,2,0,2,0,7,2,18,2.5714285714285716,1,0.0,0,2,0,2,5,0,0,7,2,4,14,1
11122,159954,JVLI7A5lCC8vytnApAKqUt9UOeJAwcls,5Gyp41oLVo7Gg7vF4vpmggWP5MU70QO6,13,15,9,1,6,0,3,0,34,4.857142857142857,1,0.0,3,9,1,6,12,0,0,3,0,19,15,1
11123,159956,v5iApkmhvY5lJ00J4XwrZQIU8c5P9IaZ,5Gyp41oLVo7Gg7vF4vpmggWP5MU70QO6,4,0,0,0,0,1,8,0,9,1.2857142857142858,1,0.0,0,0,0,0,0,1,0,8,0,0,9,1
11124,159971,QI9EzexYPWHRHVCBGslgW0AvjHtPQ1QU,5Gyp41oLVo7Gg7vF4vpmggWP5MU70QO6,18,41,18,13,11,17,12,1,113,16.142857142857142,2,0.0,16,18,8,11,25,17,5,12,1,53,60,0
11125,159985,VXQ2SH5NpNeOdjfSqoTUSjd17dMyQU7B,5Gyp41oLVo7Gg7vF4vpmggWP5MU70QO6,5,2,1,0,1,0,3,0,7,1.0,1,0.0,0,1,0,1,2,0,0,3,0,2,5,0
11126,160002,M2SXUdkaWE8H9bWvYf0ecWlPhiTUs1C2,5Gyp41oLVo7Gg7vF4vpmggWP5MU70QO6,8,11,4,0,2,0,3,0,20,2.857142857142857,2,0.0,5,4,0,2,6,0,0,3,0,11,9,0
11127,160004,djqc16BoIC2pbpl3dfVzrOF8kdnGmVrv,5Gyp41oLVo7Gg7vF4vpmggWP5MU70QO6,6,2,1,0,1,1,3,0,8,1.1428571428571428,1,0.0,0,1,0,1,2,1,0,3,0,2,6,1
11128,160021,I53IHn49d9jA3ujannaQ1EL7fa34NUbN,5Gyp41oLVo7Gg7vF4vpmggWP5MU70QO6,1,0,0,0,0,0,2,0,2,0.2857142857142857,1,0.0,0,0,0,0,0,0,0,2,0,0,2,1
11129,160041,cTS1VRUiS4HLb1hYfBHS46ENH91IaUnD,5Gyp41oLVo7Gg7vF4vpmggWP5MU70QO6,9,5,3,0,1,1,9,3,22,3.142857142857143,1,0.0,1,3,0,1,4,1,0,9,3,5,17,1
11130,160071,x8IFjwCPBRlQP9uuBa1tGX8WpsXCLtes,5Gyp41oLVo7Gg7vF4vpmggWP5MU70QO6,12,6,3,0,3,1,5,1,19,2.7142857142857144,1,0.0,1,3,0,3,5,1,0,5,1,7,12,1
11131,160110,T98zNuyaq1c57UMY75g4KO1G5az00Coj,5Gyp41oLVo7Gg7vF4vpmggWP5MU70QO6,1,0,0,0,0,0,1,0,1,0.14285714285714285,1,0.0,0,0,0,0,0,0,0,1,0,0,1,1
11132,160116,QxsZiQs6l3WHXGZuWRTVrtDchLVSC6tb,5Gyp41oLVo7Gg7vF4vpmggWP5MU70QO6,1,0,0,0,0,0,1,0,1,0.14285714285714285,1,0.0,0,0,0,0,0,0,0,1,0,0,1,1
11133,160128,gbYUHxxKDGWDbytDUcXlcbADJemufrHf,5Gyp41oLVo7Gg7vF4vpmggWP5MU70QO6,1,0,0,0,0,0,1,0,1,0.14285714285714285,1,0.0,0,0,0,0,0,0,0,1,0,0,1,1
11134,160131,zIWANVeOfIJIdeHybRvCtwUcB98TTOpL,5Gyp41oLVo7Gg7vF4vpmggWP5MU70QO6,2,0,0,0,0,0,2,0,2,0.2857142857142857,1,0.0,0,0,0,0,0,0,0,2,0,0,2,1
11135,160135,sKzMNkDeHIi8syZ76swNfxxh91gZITsv,5Gyp41oLVo7Gg7vF4vpmggWP5MU70QO6,7,3,2,0,2,0,2,0,9,1.2857142857142858,1,0.0,0,2,0,2,3,0,0,2,0,4,5,1
11136,160139,bFjABbdR1dlTY9Y5AEt2waKTA1nARIIh,5Gyp41oLVo7Gg7vF4vpmggWP5MU70QO6,13,15,8,0,4,1,9,0,37,5.285714285714286,4,0.0,2,8,0,4,13,1,0,9,0,14,23,1
11137,160141,Dthitlv0F9zbzKpJAaiVYQaLDbO378Ad,5Gyp41oLVo7Gg7vF4vpmggWP5MU70QO6,8,5,3,0,1,0,4,0,13,1.8571428571428572,2,0.0,0,3,0,1,5,0,0,4,0,4,9,1
11138,160170,Lb9Gj7pPDc1QE23Bu2s3x3cOrKzxpjuK,5Gyp41oLVo7Gg7vF4vpmggWP5MU70QO6,13,19,13,0,7,0,10,1,50,7.142857142857143,4,0.0,0,13,0,7,19,0,0,10,1,20,30,1
11139,160205,4OkWc7AllK9B53ey36nbTO4aY8tdeeMj,5Gyp41oLVo7Gg7vF4vpmggWP5MU70QO6,6,4,2,0,1,0,5,0,12,1.7142857142857142,1,0.0,0,2,0,1,4,0,0,5,0,3,9,1
11140,160211,SJYgxGIZwGEovDKTbdgFGDB0NgYchbJQ,5Gyp41oLVo7Gg7vF4vpmggWP5MU70QO6,1,0,0,0,0,0,1,0,1,0.14285714285714285,1,0.0,0,0,0,0,0,0,0,1,0,0,1,1
11141,160234,9nglU8OgDtRacfs7a6WY4ICVbLFZTWEo,5Gyp41oLVo7Gg7vF4vpmggWP5MU70QO6,8,11,6,0,2,0,8,0,27,3.857142857142857,2,0.0,0,6,0,2,11,0,0,8,0,8,19,1
11142,160235,2jrpxtUIXsWPIVOxhzZkmXgvu9KlY2UV,5Gyp41oLVo7Gg7vF4vpmggWP5MU70QO6,10,7,4,0,1,2,10,1,25,3.5714285714285716,2,0.0,1,4,0,1,6,2,0,10,1,6,19,1
11143,160263,4DdK8TmenB23ZCgCZB7QoDxAHSAI2lo5,5Gyp41oLVo7Gg7vF4vpmggWP5MU70QO6,6,3,2,0,2,0,1,0,8,1.1428571428571428,1,0.0,0,2,0,2,3,0,0,1,0,4,4,1
11144,160267,lzRXPa2daOWcsGy08A8GxR3RWWZNjwrx,5Gyp41oLVo7Gg7vF4vpmggWP5MU70QO6,6,4,2,0,1,0,3,0,10,1.4285714285714286,2,0.0,0,2,0,1,4,0,0,3,0,3,7,1
11145,160270,CYT8FcwBIu8rFIWalrdbKzma2fAiNifJ,5Gyp41oLVo7Gg7vF4vpmggWP5MU70QO6,7,8,2,0,2,0,3,0,15,2.142857142857143,1,0.0,1,2,0,2,7,0,0,3,0,5,10,1
11146,160309,m1fBxfdP24tbh5rWoiFGny0cd2DQDU7n,7GRhBDsirIGkRZBtSMEzNTyDr2JQm4xx,2,0,0,0,0,0,2,0,2,0.2857142857142857,1,0.0,0,0,0,0,0,0,0,2,0,0,2,1
11147,160343,oCUO9XlUIOh3Ij7ThU6V6i4UFCJQT7mf,7GRhBDsirIGkRZBtSMEzNTyDr2JQm4xx,1,0,0,0,0,0,1,0,1,0.14285714285714285,1,0.0,0,0,0,0,0,0,0,1,0,0,1,1
11148,160370,SWQaeOMzpLQ0O6BdWhgpESQIJJfRIjcf,7GRhBDsirIGkRZBtSMEzNTyDr2JQm4xx,1,0,0,0,0,0,1,0,1,0.14285714285714285,1,0.0,0,0,0,0,0,0,0,1,0,0,1,1
11149,160374,YxPma1Wq13D1SO5XQzSvHgBwRYOIrVRk,7GRhBDsirIGkRZBtSMEzNTyDr2JQm4xx,1,0,0,0,0,0,1,0,1,0.14285714285714285,1,0.0,0,0,0,0,0,0,0,1,0,0,1,1
11150,160404,5va1sV2BwXc5BtIB3Klat9ON2fDXMGdg,7GRhBDsirIGkRZBtSMEzNTyDr2JQm4xx,1,0,0,0,0,0,1,0,1,0.14285714285714285,1,0.0,0,0,0,0,0,0,0,1,0,0,1,1
11151,160417,nrol5VxiNERghlxTlRYzcM0aTVUVOtUp,7GRhBDsirIGkRZBtSMEzNTyDr2JQm4xx,1,0,0,0,0,0,1,0,1,0.14285714285714285,1,0.0,0,0,0,0,0,0,0,1,0,0,1,1
11152,160434,XBCkMYdRHaBwbyaKg5wVLPpzX1Jqu9p0,5X6FeZozNMgE2VRi3MJYjkkFK8SETtu2,1,0,0,0,0,0,1,0,1,0.14285714285714285,1,0.0,0,0,0,0,0,0,0,1,0,0,1,1
11153,160447,VaYYfZ3JVOT6bOWghdrqK1SOwK0gM5y2,7GRhBDsirIGkRZBtSMEzNTyDr2JQm4xx,1,0,0,0,0,0,1,0,1,0.14285714285714285,1,0.0,0,0,0,0,0,0,0,1,0,0,1,1
11154,160460,HE0yFYNeyW3jGh5EhXv7uoc6O18ATk5R,5X6FeZozNMgE2VRi3MJYjkkFK8SETtu2,5,2,1,0,1,0,2,0,6,0.8571428571428571,1,0.0,0,1,0,1,2,0,0,2,0,2,4,1
11155,160484,3dMTqy9UaX95tijarQCVCsrBbHtrB6FG,5X6FeZozNMgE2VRi3MJYjkkFK8SETtu2,7,2,1,0,1,1,6,2,13,1.8571428571428572,1,0.0,0,1,0,1,2,1,0,6,2,2,11,1
11156,160487,PRfZLzeSQB5SIGo2mbBK9MaxsrpewgA0,7GRhBDsirIGkRZBtSMEzNTyDr2JQm4xx,10,6,2,0,2,3,11,0,24,3.4285714285714284,1,0.0,2,2,0,2,4,3,0,11,0,6,18,1
11157,160547,tux1nJHnpyqhcOoiw1MV4RnTUB7tHphL,3VkHkmOtom3jM2wCu94xgzzu1d6Dn7or,11,15,5,5,5,2,7,5,44,6.285714285714286,3,0.0,7,5,4,5,8,2,1,7,5,21,23,0
11158,160551,POGRFFRZzlPiBHiCHXnlCDCb459JTEzc,3VkHkmOtom3jM2wCu94xgzzu1d6Dn7or,16,38,12,8,14,2,4,0,78,11.142857142857142,2,0.0,13,12,7,14,25,2,1,4,0,46,32,1
11159,160553,e8LRAhAOFng89p8JJF7TiEnvKfbSN9ym,3VkHkmOtom3jM2wCu94xgzzu1d6Dn7or,16,13,7,8,5,5,9,0,47,6.714285714285714,1,0.0,4,7,6,5,9,5,2,9,0,22,25,1
11160,160559,yaIwB9oAZxRWa5unEH2OfjYBy42G5Xep,3VkHkmOtom3jM2wCu94xgzzu1d6Dn7or,10,12,7,0,4,3,4,0,30,4.285714285714286,1,0.0,0,7,0,4,12,3,0,4,0,11,19,1
11161,160560,W5xMb1oaLltJC8m8QRzmcqQd0MnYQ67p,3VkHkmOtom3jM2wCu94xgzzu1d6Dn7or,1,0,0,0,0,0,2,0,2,0.2857142857142857,1,0.0,0,0,0,0,0,0,0,2,0,0,2,1
11162,160570,V3DfmcB8Lep37Vh5JmHjDDVz1sJceKfd,3VkHkmOtom3jM2wCu94xgzzu1d6Dn7or,6,3,1,0,0,0,11,0,15,2.142857142857143,2,0.0,0,1,0,0,3,0,0,11,0,1,14,1
11163,160572,ufk8FCBpI5vYfstuZlggO1Y28eb7bImN,3VkHkmOtom3jM2wCu94xgzzu1d6Dn7or,48,98,46,7,33,9,18,5,216,30.857142857142858,5,0.0,39,46,6,33,59,9,1,18,5,124,92,1
11164,160573,ON99TJ0pKRUnztHDcW3atf1KvDAtOgg0,3VkHkmOtom3jM2wCu94xgzzu1d6Dn7or,4,2,1,0,1,3,1,0,8,1.1428571428571428,1,0.0,0,1,0,1,2,3,0,1,0,2,6,1
11165,160579,fYoTVrGjUKZwCkGEQxj8tszSZ9oEr7BE,3VkHkmOtom3jM2wCu94xgzzu1d6Dn7or,7,3,2,0,1,4,5,1,16,2.2857142857142856,2,0.0,0,2,0,1,3,4,0,5,1,3,13,1
11166,160583,FjNocaCbEZVV6QnFhI2aCTLxYn49ydPr,3VkHkmOtom3jM2wCu94xgzzu1d6Dn7or,4,4,2,0,0,0,2,0,8,1.1428571428571428,2,0.0,0,2,0,0,4,0,0,2,0,2,6,1
11167,160587,E5AOt738rPpvgttJUJXTmXlvkPdwDRTT,3VkHkmOtom3jM2wCu94xgzzu1d6Dn7or,12,11,8,0,6,0,5,0,30,4.285714285714286,2,0.0,0,8,0,6,11,0,0,5,0,14,16,1
11168,160588,lPSI3MXEDOIZcEaSDr27uEjSntA5zsxV,3VkHkmOtom3jM2wCu94xgzzu1d6Dn7or,8,6,5,0,5,17,31,3,67,9.571428571428571,1,0.0,0,5,0,5,6,17,0,31,3,10,57,1
11169,160589,8xxdjMOkKKpGpEkgXEKryo7pYxyFO4br,3VkHkmOtom3jM2wCu94xgzzu1d6Dn7or,13,34,7,13,7,2,6,0,69,9.857142857142858,3,0.0,14,7,12,7,20,2,1,6,0,40,29,1
11170,160597,NsRniELODLBwlHTlgOJXYbjQ6DHqlBm3,3VkHkmOtom3jM2wCu94xgzzu1d6Dn7or,5,2,1,0,0,1,4,0,8,1.1428571428571428,1,0.0,0,1,0,0,2,1,0,4,0,1,7,1
11171,160599,Lts94kduN78OeA0WwV6B3SZh72BhrePm,3VkHkmOtom3jM2wCu94xgzzu1d6Dn7or,1,0,0,0,0,0,1,0,1,0.14285714285714285,1,0.0,0,0,0,0,0,0,0,1,0,0,1,1
11172,160600,spo2AoBcB8z4JnQ75NfCsXxxs58G8kjU,3VkHkmOtom3jM2wCu94xgzzu1d6Dn7or,2,0,0,0,0,0,2,0,2,0.2857142857142857,1,0.0,0,0,0,0,0,0,0,2,0,0,2,1
11173,160614,IwiyUREIy0Si5m4yLyehVgcNCLgljmxe,3VkHkmOtom3jM2wCu94xgzzu1d6Dn7or,1,0,0,0,0,0,2,0,2,0.2857142857142857,1,0.0,0,0,0,0,0,0,0,2,0,0,2,1
11174,160616,Ur5YqRaNsaD6KYfRfGA2p4Zmd8kpRITc,3VkHkmOtom3jM2wCu94xgzzu1d6Dn7or,27,61,13,14,22,0,3,0,113,16.142857142857142,2,0.0,42,13,14,22,19,0,0,3,0,91,22,1
11175,160617,hNzlmKj8vgcJBX1sWWjxRKB2qdgZF0wZ,3VkHkmOtom3jM2wCu94xgzzu1d6Dn7or,6,4,0,0,0,3,4,1,12,1.7142857142857142,1,0.0,0,0,0,0,4,3,0,4,1,0,12,1
11176,160629,F3SHG1z7OgoLXdkanDOsekC6CBMSi06b,3VkHkmOtom3jM2wCu94xgzzu1d6Dn7or,10,3,2,0,2,0,5,1,13,1.8571428571428572,1,0.0,0,2,0,2,3,0,0,5,1,4,9,1
11177,160631,fLFbYqgYkQPvS88S70VXHaI22Kt7HIqv,3VkHkmOtom3jM2wCu94xgzzu1d6Dn7or,17,20,13,0,11,0,5,0,49,7.0,3,0.0,2,13,0,11,18,0,0,5,0,26,23,0
11178,160634,uO6B8AZ3RktSZCnxuirzwVNISGYsGx5x,3VkHkmOtom3jM2wCu94xgzzu1d6Dn7or,2,0,0,0,0,0,2,0,2,0.2857142857142857,1,0.0,0,0,0,0,0,0,0,2,0,0,2,1
11179,160642,GpiN6lsRAa2Ly5yBnG0V8l5XBa7RReG2,3VkHkmOtom3jM2wCu94xgzzu1d6Dn7or,1,0,0,0,0,0,1,0,1,0.14285714285714285,1,0.0,0,0,0,0,0,0,0,1,0,0,1,1
11180,160647,L9bMFFUO9ZxDqzJhL0R1CsTNOo0vgnOe,3VkHkmOtom3jM2wCu94xgzzu1d6Dn7or,6,2,1,0,1,0,3,0,7,1.0,1,0.0,0,1,0,1,2,0,0,3,0,2,5,1
11181,160648,vn23DIWRrAEzn9fZbpdnHWjE4KJK94Gq,3VkHkmOtom3jM2wCu94xgzzu1d6Dn7or,1,0,0,0,0,0,1,0,1,0.14285714285714285,1,0.0,0,0,0,0,0,0,0,1,0,0,1,1
11182,160652,zhVJXmFLaEK3d9mnR8DIEZwnQXcgBVPh,3VkHkmOtom3jM2wCu94xgzzu1d6Dn7or,11,10,5,2,3,2,7,0,29,4.142857142857143,2,0.0,2,5,2,3,8,2,0,7,0,12,17,1
11183,160655,FmXADKmYeGxuiSES1esCMAyjWM6jBoqK,3VkHkmOtom3jM2wCu94xgzzu1d6Dn7or,5,2,1,0,1,0,3,0,7,1.0,1,0.0,0,1,0,1,2,0,0,3,0,2,5,1
11184,160657,pIa1D3wCDIb9b1KWIrcaDbP4NnyOfk1s,3VkHkmOtom3jM2wCu94xgzzu1d6Dn7or,1,0,0,0,0,0,1,0,1,0.14285714285714285,1,0.0,0,0,0,0,0,0,0,1,0,0,1,1
11185,160659,y5YQp7RAOiS0YZDSM8UkvactNfPZluHS,3VkHkmOtom3jM2wCu94xgzzu1d6Dn7or,5,2,1,0,1,0,2,0,6,0.8571428571428571,1,0.0,0,1,0,1,2,0,0,2,0,2,4,1
11186,160660,PZyZDM2uyBRGPZg3kQscavWjpR2bFYiU,3VkHkmOtom3jM2wCu94xgzzu1d6Dn7or,5,4,1,0,1,0,1,0,7,1.0,1,0.0,0,1,0,1,4,0,0,1,0,2,5,1
11187,160661,aqVmdMiZpCTrV5e1kemczDugNWjSn9Qa,3VkHkmOtom3jM2wCu94xgzzu1d6Dn7or,4,2,1,0,1,0,1,0,5,0.7142857142857143,1,0.0,0,1,0,1,2,0,0,1,0,2,3,1
11188,160667,upDfebJXS3DnZDQaslj5x1jzbdhtsJRw,3VkHkmOtom3jM2wCu94xgzzu1d6Dn7or,5,2,1,0,1,0,2,0,6,0.8571428571428571,1,0.0,0,1,0,1,2,0,0,2,0,2,4,1
11189,160693,0bGwsopOrJy9wTuBbyPfl2hvYAxstsYA,7GRhBDsirIGkRZBtSMEzNTyDr2JQm4xx,1,0,0,0,0,0,1,0,1,0.14285714285714285,1,0.0,0,0,0,0,0,0,0,1,0,0,1,1
11190,160716,Jov3UvG5K4pASWh5oCQTME29q3GomczT,7GRhBDsirIGkRZBtSMEzNTyDr2JQm4xx,1,0,0,0,0,0,1,0,1,0.14285714285714285,1,0.0,0,0,0,0,0,0,0,1,0,0,1,1
11191,160717,Jov3UvG5K4pASWh5oCQTME29q3GomczT,SpATywNh6bZuzm8s1ceuBUnMUAeoAHHw,5,2,1,0,1,0,3,0,7,1.0,1,0.0,0,1,0,1,2,0,0,3,0,2,5,1
11192,160726,8E88mVxxHiSEV3ReMbiLkIuYAxJ6YXeO,bWdj2GDclj5ofokWjzoa5jAwMkxCykd6,8,15,9,0,1,0,8,0,33,4.714285714285714,4,0.0,0,9,0,1,15,0,0,8,0,10,23,1
11193,160732,MzU3MmP4toJ6yskX1OF0at1dK7zTkzfY,SpATywNh6bZuzm8s1ceuBUnMUAeoAHHw,24,23,6,19,6,0,12,1,67,9.571428571428571,1,0.0,4,6,16,6,19,0,3,12,1,32,35,0
11194,160751,tqKMiWS5jNidhKBAfVWKPtrUsR6QJ6KL,SpATywNh6bZuzm8s1ceuBUnMUAeoAHHw,1,0,0,0,0,0,1,0,1,0.14285714285714285,1,0.0,0,0,0,0,0,0,0,1,0,0,1,1
11195,160754,8GLYZdO7UCSjonDyYGMLl1knruaKaWMX,SpATywNh6bZuzm8s1ceuBUnMUAeoAHHw,7,4,2,0,2,0,2,0,10,1.4285714285714286,1,0.0,0,2,0,2,4,0,0,2,0,4,6,1
11196,160766,WpwD79l1tHxSYGvzddD5jkm0kQD6YzUK,SpATywNh6bZuzm8s1ceuBUnMUAeoAHHw,35,40,2,33,1,2,12,2,92,13.142857142857142,3,0.0,0,2,31,1,40,2,2,12,2,34,58,0
11197,160782,ayXSJHlkjoyFUB4Y9YHZnlOXt35wvwwu,bWdj2GDclj5ofokWjzoa5jAwMkxCykd6,1,0,0,0,0,0,1,0,1,0.14285714285714285,1,0.0,0,0,0,0,0,0,0,1,0,0,1,0
11198,160795,rIZoWdOeGZeRfVMhTAsV9qUPMO6tuYZB,SpATywNh6bZuzm8s1ceuBUnMUAeoAHHw,8,4,2,0,2,0,2,0,10,1.4285714285714286,1,0.0,0,2,0,2,4,0,0,2,0,4,6,0
11199,160802,vaWLVKWyrsUzDV0qs20ZUq8M3VNW01Uk,SpATywNh6bZuzm8s1ceuBUnMUAeoAHHw,1,0,0,0,0,0,3,0,3,0.42857142857142855,2,0.0,0,0,0,0,0,0,0,3,0,0,3,1
11200,160806,NCIbndfMFM2iKF0OTJODt5hHOzzc7Cip,5X6FeZozNMgE2VRi3MJYjkkFK8SETtu2,5,2,1,0,1,0,2,0,6,0.8571428571428571,1,0.0,0,1,0,1,2,0,0,2,0,2,4,1
11201,160811,ycYabaRFVayOcZp1HtLrl0En4pTKGtZt,SpATywNh6bZuzm8s1ceuBUnMUAeoAHHw,1,0,0,0,0,0,1,0,1,0.14285714285714285,1,0.0,0,0,0,0,0,0,0,1,0,0,1,1
11202,160819,PMZJ7vxYEpwybeGWTMZuFimiDLzBBGfH,SpATywNh6bZuzm8s1ceuBUnMUAeoAHHw,4,2,1,0,1,0,1,0,5,0.7142857142857143,1,0.0,0,1,0,1,2,0,0,1,0,2,3,0
11203,160830,oob3uoRmVlrLelgs4IyBNCaSMyry4nil,SpATywNh6bZuzm8s1ceuBUnMUAeoAHHw,4,3,1,0,1,0,1,0,6,0.8571428571428571,1,0.0,0,1,0,1,3,0,0,1,0,2,4,0
11204,160841,uugcqDT99r37esUG18otF2qi3eWqvBzw,bWdj2GDclj5ofokWjzoa5jAwMkxCykd6,3,2,0,0,0,0,1,0,3,0.42857142857142855,1,0.0,0,0,0,0,2,0,0,1,0,0,3,1
11205,160843,OGCZFcT7KAxnQBI1KHMJM1XRttzsLllz,SpATywNh6bZuzm8s1ceuBUnMUAeoAHHw,1,0,0,0,0,0,1,0,1,0.14285714285714285,1,0.0,0,0,0,0,0,0,0,1,0,0,1,0
11206,160869,d6UIJk9NUDRN8JabPVMRicFHGb3nzVOP,SpATywNh6bZuzm8s1ceuBUnMUAeoAHHw,2,0,0,0,0,0,2,0,2,0.2857142857142857,1,0.0,0,0,0,0,0,0,0,2,0,0,2,1
11207,160873,tyipDckPuzvrGCZj8cKFnXKzo4Vg29Em,SpATywNh6bZuzm8s1ceuBUnMUAeoAHHw,3,0,0,0,0,0,4,0,4,0.5714285714285714,1,0.0,0,0,0,0,0,0,0,4,0,0,4,1
11208,160899,8PXiKfJoqz8Hmb7EnbWamVfqw2MPOhjw,SpATywNh6bZuzm8s1ceuBUnMUAeoAHHw,1,0,0,0,0,0,1,0,1,0.14285714285714285,1,0.0,0,0,0,0,0,0,0,1,0,0,1,1
11209,160908,UtNvwiEIu7iQRo2Po9FxglHJbAYaDW68,bWdj2GDclj5ofokWjzoa5jAwMkxCykd6,4,2,0,0,0,0,2,0,4,0.5714285714285714,1,0.0,0,0,0,0,2,0,0,2,0,0,4,0
11210,160916,Rgv9cfcWYCSiDg97xzG0SSFr5zlG94CN,SpATywNh6bZuzm8s1ceuBUnMUAeoAHHw,4,3,0,0,0,0,4,0,7,1.0,1,0.0,0,0,0,0,3,0,0,4,0,0,7,0
11211,160933,FST1alg2W8P1xoNNnUXxqeytGPkod2O2,bWdj2GDclj5ofokWjzoa5jAwMkxCykd6,2,0,0,0,0,0,4,0,4,0.5714285714285714,1,0.0,0,0,0,0,0,0,0,4,0,0,4,1
11212,160946,ncZpzPYvUtQjJgcrnY99CiTzo4JQVsl8,5X6FeZozNMgE2VRi3MJYjkkFK8SETtu2,6,6,4,0,2,0,4,0,16,2.2857142857142856,2,0.0,0,4,0,2,6,0,0,4,0,6,10,1
11213,160960,q5GRE4iMJnU5VlaBu2tBq8kc3M9ewWuy,bWdj2GDclj5ofokWjzoa5jAwMkxCykd6,7,5,3,0,2,0,4,0,14,2.0,1,0.0,0,3,0,2,5,0,0,4,0,5,9,1
11214,161007,1b3NSfxfxI6DroelosS7m4rEEtzhJZdR,SpATywNh6bZuzm8s1ceuBUnMUAeoAHHw,1,0,0,0,0,0,1,0,1,0.14285714285714285,1,0.0,0,0,0,0,0,0,0,1,0,0,1,1
11215,161011,1b3NSfxfxI6DroelosS7m4rEEtzhJZdR,7GRhBDsirIGkRZBtSMEzNTyDr2JQm4xx,1,0,0,0,0,0,1,0,1,0.14285714285714285,1,0.0,0,0,0,0,0,0,0,1,0,0,1,1
11216,161026,CetRT5zy2dJHyaPU2zMnW0reXnT8Dv2y,SpATywNh6bZuzm8s1ceuBUnMUAeoAHHw,5,2,1,0,1,0,2,0,6,0.8571428571428571,1,0.0,0,1,0,1,2,0,0,2,0,2,4,0
11217,161038,O3s5tRj8DFxm9UNNiXCCBZ18BghuFmc4,SpATywNh6bZuzm8s1ceuBUnMUAeoAHHw,5,2,1,0,1,0,2,0,6,0.8571428571428571,1,0.0,0,1,0,1,2,0,0,2,0,2,4,1
11218,161065,2JYViuOLvusjF5jXM0OPt6GS91aIip1x,SpATywNh6bZuzm8s1ceuBUnMUAeoAHHw,8,11,5,0,2,0,3,0,21,3.0,2,0.0,0,5,0,2,11,0,0,3,0,7,14,1
11219,161093,arNPxppCkzMz1gGc2TmsQpnfYJBVyy0s,SpATywNh6bZuzm8s1ceuBUnMUAeoAHHw,2,0,0,0,0,0,2,0,2,0.2857142857142857,1,0.0,0,0,0,0,0,0,0,2,0,0,2,1
11220,161094,eQpeedcGPvRtB1QbHe05ACFjTUBxB0ZU,SpATywNh6bZuzm8s1ceuBUnMUAeoAHHw,48,80,38,51,22,68,39,0,298,42.57142857142857,4,0.0,26,38,44,22,54,68,7,39,0,130,168,0
11221,161097,SMrxJLFhYhaOOjtJi52Arp2l9UXKs7cW,SpATywNh6bZuzm8s1ceuBUnMUAeoAHHw,7,5,2,0,2,0,2,0,11,1.5714285714285714,1,0.0,0,2,0,2,5,0,0,2,0,4,7,0
11222,161100,xo7oGzW3nYlhgIgUWC4ru6wx9F159DbL,SpATywNh6bZuzm8s1ceuBUnMUAeoAHHw,6,5,3,0,1,0,2,0,11,1.5714285714285714,1,0.0,0,3,0,1,5,0,0,2,0,4,7,0
11223,161119,UAE7k3whY8BUnHHgiIeFo6Rzc8eEYhRN,A3fsA9Zfv1X2fVEQhTw51lKENdNrEqT3,5,3,1,0,1,0,2,0,7,1.0,1,0.0,0,1,0,1,3,0,0,2,0,2,5,1
11224,161131,qwqKZAQkfeWQ67eZcwQZ2Pew9z9DtY1Q,5X6FeZozNMgE2VRi3MJYjkkFK8SETtu2,4,0,0,0,0,0,3,1,4,0.5714285714285714,1,0.0,0,0,0,0,0,0,0,3,1,0,4,1
11225,161136,OqHA9mZmMht3i9Un3rbhhtIvmbOSfs4Z,SpATywNh6bZuzm8s1ceuBUnMUAeoAHHw,6,3,1,0,1,0,2,0,7,1.0,1,0.0,0,1,0,1,3,0,0,2,0,2,5,1
11226,161138,1yAfuEW0CNQiRXnPO0v79LFUyx4hhTWm,SpATywNh6bZuzm8s1ceuBUnMUAeoAHHw,2,0,0,0,0,0,2,0,2,0.2857142857142857,1,0.0,0,0,0,0,0,0,0,2,0,0,2,0
11227,161139,zX1TLWT3E7MpbG4kzvZO6rEOvxyi9iAE,A3fsA9Zfv1X2fVEQhTw51lKENdNrEqT3,8,4,3,0,3,0,1,0,11,1.5714285714285714,1,0.0,0,3,0,3,4,0,0,1,0,6,5,0
11228,161149,dxSpsLbxmhgsxHbYO6vXC8uZhMZfZoZS,SpATywNh6bZuzm8s1ceuBUnMUAeoAHHw,9,3,3,0,3,0,5,1,15,2.142857142857143,2,0.0,0,3,0,3,3,0,0,5,1,6,9,1
11229,161152,FKqGzWb3VsmU7jpYPJbCVaVAzRrOMrbY,SpATywNh6bZuzm8s1ceuBUnMUAeoAHHw,4,2,0,0,0,0,5,0,7,1.0,1,0.0,0,0,0,0,2,0,0,5,0,0,7,0
11230,161161,KiMSMY3t4vpg2Jm87S0dTTvy9nzys8P4,SpATywNh6bZuzm8s1ceuBUnMUAeoAHHw,6,4,1,0,1,0,2,0,8,1.1428571428571428,1,0.0,0,1,0,1,4,0,0,2,0,2,6,1
11231,161168,KVaAyVapZn7TCcVPpLWhPyp5FohYKlip,5X6FeZozNMgE2VRi3MJYjkkFK8SETtu2,6,10,2,0,3,0,4,1,20,2.857142857142857,1,0.0,7,2,0,3,3,0,0,4,1,12,8,1
11232,161171,rhgA2X0g2BW5I3tYIXFENYW4L8ORdfpR,7GRhBDsirIGkRZBtSMEzNTyDr2JQm4xx,14,11,2,28,3,0,2,0,46,6.571428571428571,1,0.0,6,2,25,3,5,0,3,2,0,36,10,1
11233,161212,CQ38E7dWWAGhaKdf2HW2bq2TNjrXL8X5,bWdj2GDclj5ofokWjzoa5jAwMkxCykd6,8,5,3,0,2,0,4,0,14,2.0,1,0.0,0,3,0,2,5,0,0,4,0,5,9,1
11234,161218,IoUEv205kL70u2MwbYRNexNGlv0hD8vn,SpATywNh6bZuzm8s1ceuBUnMUAeoAHHw,19,27,15,27,0,1,3,0,73,10.428571428571429,2,0.0,10,15,26,0,17,1,1,3,0,51,22,1
11235,161220,zWs820lsV2FDqGxLhLdDwGTeCBmo6dtP,A3fsA9Zfv1X2fVEQhTw51lKENdNrEqT3,9,9,0,0,0,0,10,0,19,2.7142857142857144,2,0.0,0,0,0,0,9,0,0,10,0,0,19,0
11236,161234,9OJ5A7uGdzNYawJUDofemHIUlKea4Sz4,A3fsA9Zfv1X2fVEQhTw51lKENdNrEqT3,1,0,0,0,0,0,1,0,1,0.14285714285714285,1,0.0,0,0,0,0,0,0,0,1,0,0,1,1
11237,161244,F5WXvUA8z1Vfdvlva1pujweut7tGE04r,7GRhBDsirIGkRZBtSMEzNTyDr2JQm4xx,2,0,0,0,0,0,2,0,2,0.2857142857142857,1,0.0,0,0,0,0,0,0,0,2,0,0,2,1
11238,161259,Y3gsCZFaxymMatDWsWatKuPgHf7K4ip1,SpATywNh6bZuzm8s1ceuBUnMUAeoAHHw,2,0,0,0,0,0,2,0,2,0.2857142857142857,1,0.0,0,0,0,0,0,0,0,2,0,0,2,0
11239,161260,UCfUKOyK5uUjEk3TmCgOz7fzBa03NWgI,SpATywNh6bZuzm8s1ceuBUnMUAeoAHHw,2,0,0,0,0,0,2,0,2,0.2857142857142857,1,0.0,0,0,0,0,0,0,0,2,0,0,2,1
11240,161288,b2XDhIVbFblOcApbzil5AzxhyGQXvGyd,SpATywNh6bZuzm8s1ceuBUnMUAeoAHHw,2,0,0,0,0,0,2,0,2,0.2857142857142857,1,0.0,0,0,0,0,0,0,0,2,0,0,2,1
11241,161295,c1dkmvtCXqoLmdO0DrAflEy9543BIWEo,SpATywNh6bZuzm8s1ceuBUnMUAeoAHHw,1,0,0,0,0,0,1,0,1,0.14285714285714285,1,0.0,0,0,0,0,0,0,0,1,0,0,1,1
11242,161310,B5jlZpEDxUNGCe4UQsaYbJ99Z8y5d2lN,7GRhBDsirIGkRZBtSMEzNTyDr2JQm4xx,9,4,3,0,3,0,2,0,12,1.7142857142857142,1,0.0,0,3,0,3,4,0,0,2,0,6,6,1
11243,161323,bJL9tMKUGb25WAZwIxllLNRiypLk0j5b,bWdj2GDclj5ofokWjzoa5jAwMkxCykd6,1,0,0,0,0,0,3,0,3,0.42857142857142855,1,0.0,0,0,0,0,0,0,0,3,0,0,3,1
11244,161347,3xYJeK1UnxabH81MSfXfKVYAvC2wbZN0,SpATywNh6bZuzm8s1ceuBUnMUAeoAHHw,2,0,0,0,0,0,2,0,2,0.2857142857142857,1,0.0,0,0,0,0,0,0,0,2,0,0,2,1
11245,161359,SwqoqjW0TNnc2WEyycy2rbxki7Ac08G0,bWdj2GDclj5ofokWjzoa5jAwMkxCykd6,1,0,0,0,0,0,1,0,1,0.14285714285714285,1,0.0,0,0,0,0,0,0,0,1,0,0,1,1
11246,161368,vkVcAL32x89gCUbijn0COpSie0zSVcTg,A3fsA9Zfv1X2fVEQhTw51lKENdNrEqT3,3,0,0,0,0,0,3,0,3,0.42857142857142855,1,0.0,0,0,0,0,0,0,0,3,0,0,3,1
11247,161369,NMciPbdIeB9uIZwCMcw6mXU2i3BtnB5v,7GRhBDsirIGkRZBtSMEzNTyDr2JQm4xx,7,5,4,0,4,0,2,0,15,2.142857142857143,1,0.0,0,4,0,4,5,0,0,2,0,8,7,1
11248,161411,wd0QkE7pIzOAfDrbcSy32eTspXTGk9O9,5X6FeZozNMgE2VRi3MJYjkkFK8SETtu2,1,0,0,0,0,0,1,0,1,0.14285714285714285,1,0.0,0,0,0,0,0,0,0,1,0,0,1,1
11249,161424,vVoYtG2vzUhg3qXoaTM1GNiznwKfFexh,A3fsA9Zfv1X2fVEQhTw51lKENdNrEqT3,11,7,2,0,2,0,5,1,17,2.4285714285714284,2,0.0,0,2,0,2,7,0,0,5,1,4,13,1
11250,161445,DeUewOzCdPyRhXnh51f0IFE7UZF18OTz,A3fsA9Zfv1X2fVEQhTw51lKENdNrEqT3,5,3,2,0,1,0,1,0,7,1.0,1,0.0,0,2,0,1,3,0,0,1,0,3,4,1
11251,161448,TqLkmogP9A8wj7y0peV7PS3deY5AXfKI,SpATywNh6bZuzm8s1ceuBUnMUAeoAHHw,1,0,0,0,0,0,1,0,1,0.14285714285714285,1,0.0,0,0,0,0,0,0,0,1,0,0,1,1
11252,161471,zaNSPOR4IS7zKdvjdYki2EBZZU490yUi,A3fsA9Zfv1X2fVEQhTw51lKENdNrEqT3,9,4,3,0,3,0,2,0,12,1.7142857142857142,1,0.0,0,3,0,3,4,0,0,2,0,6,6,0
11253,161486,04oY3yfeJmljGE9WXI2DTTCncGlWy3gp,A3fsA9Zfv1X2fVEQhTw51lKENdNrEqT3,9,6,5,0,4,0,5,0,20,2.857142857142857,1,0.0,0,5,0,4,6,0,0,5,0,9,11,0
11254,161492,oUmwVombS6NjLsRPIqFZmyPTr8sWT4gd,SpATywNh6bZuzm8s1ceuBUnMUAeoAHHw,13,9,1,4,1,0,4,2,21,3.0,1,0.0,2,1,3,1,7,0,1,4,2,7,14,1
11255,161507,YHCFD6ILIDjyRD7M7cIc3yLqAh9Ht9sk,SpATywNh6bZuzm8s1ceuBUnMUAeoAHHw,8,3,2,0,1,1,6,0,13,1.8571428571428572,1,0.0,0,2,0,1,3,1,0,6,0,3,10,1
11256,161520,MH2dufcdc5plwSw55pPAPhNOJ4cLMg4S,5X6FeZozNMgE2VRi3MJYjkkFK8SETtu2,1,0,0,0,0,0,1,0,1,0.14285714285714285,1,0.0,0,0,0,0,0,0,0,1,0,0,1,1
11257,161526,6HIBebNSnNEoSeekVShzxF3x0IcbgohT,7GRhBDsirIGkRZBtSMEzNTyDr2JQm4xx,1,0,0,0,0,0,1,0,1,0.14285714285714285,1,0.0,0,0,0,0,0,0,0,1,0,0,1,1
11258,161531,6HIBebNSnNEoSeekVShzxF3x0IcbgohT,bWdj2GDclj5ofokWjzoa5jAwMkxCykd6,1,0,0,0,0,0,1,0,1,0.14285714285714285,1,0.0,0,0,0,0,0,0,0,1,0,0,1,1
11259,161542,5BpbARnwXgpEbj3Ht3AkiPd8rcOlJGqp,A3fsA9Zfv1X2fVEQhTw51lKENdNrEqT3,14,9,7,0,7,3,8,0,34,4.857142857142857,1,0.0,0,7,0,7,9,3,0,8,0,14,20,1
11260,161544,uEpHGx8FG6Yf4rfXG6TIX7HmCKO0iTmF,bWdj2GDclj5ofokWjzoa5jAwMkxCykd6,3,0,0,0,0,0,3,0,3,0.42857142857142855,1,0.0,0,0,0,0,0,0,0,3,0,0,3,1
11261,161547,RLNntF5rFo8KXK4eTpLpYQEgboayIABF,5X6FeZozNMgE2VRi3MJYjkkFK8SETtu2,12,32,9,16,4,0,5,0,66,9.428571428571429,3,0.0,10,9,13,4,22,0,3,5,0,36,30,1
11262,161554,VpfhwAal2QDOMcATeWkcMC5JFfWpIreN,SpATywNh6bZuzm8s1ceuBUnMUAeoAHHw,7,4,3,0,3,0,2,0,12,1.7142857142857142,1,0.0,0,3,0,3,4,0,0,2,0,6,6,0
11263,161567,5BpbARnwXgpEbj3Ht3AkiPd8rcOlJGqp,bWdj2GDclj5ofokWjzoa5jAwMkxCykd6,2,0,0,0,0,0,2,0,2,0.2857142857142857,1,0.0,0,0,0,0,0,0,0,2,0,0,2,1
11264,161578,Xo1RSitSiG1YTKsWiGb48lb1j1pDp5LC,7GRhBDsirIGkRZBtSMEzNTyDr2JQm4xx,1,0,0,0,0,0,1,0,1,0.14285714285714285,1,0.0,0,0,0,0,0,0,0,1,0,0,1,1
11265,161582,sz4V6qMGkd9m0sEXeHagyrfOWbrJXBoa,A3fsA9Zfv1X2fVEQhTw51lKENdNrEqT3,13,6,5,0,5,0,3,0,19,2.7142857142857144,1,0.0,0,5,0,5,6,0,0,3,0,10,9,1
11266,161624,70IALIEGaW8EtZk6S4KeyPiqgaOEQ4Zv,SpATywNh6bZuzm8s1ceuBUnMUAeoAHHw,2,0,0,0,0,0,4,0,4,0.5714285714285714,1,0.0,0,0,0,0,0,0,0,4,0,0,4,0
11267,161625,RK0jz5WZ1rbgqGh2azNn9bq0VP0jJWBp,SpATywNh6bZuzm8s1ceuBUnMUAeoAHHw,5,3,0,0,0,0,2,0,5,0.7142857142857143,1,0.0,0,0,0,0,3,0,0,2,0,0,5,1
11268,161642,zT5Abo7SNHsAkCFKMvhJJJDWNu2sl4mh,bWdj2GDclj5ofokWjzoa5jAwMkxCykd6,8,6,1,0,0,2,10,3,22,3.142857142857143,2,0.0,0,1,0,0,6,2,0,10,3,1,21,1
11269,161649,4GMbKnTV7f2uA3paM09GNAdyVnypDTbs,5X6FeZozNMgE2VRi3MJYjkkFK8SETtu2,23,38,2,34,10,0,5,0,89,12.714285714285714,2,0.0,26,2,31,10,12,0,3,5,0,69,20,1
11270,161651,duiafYmd83oRbyknFPTBEW7Isdk2COdZ,A3fsA9Zfv1X2fVEQhTw51lKENdNrEqT3,6,2,1,0,1,0,4,1,9,1.2857142857142858,2,0.0,0,1,0,1,2,0,0,4,1,2,7,1
11271,161663,BPNm4UxYP3nT4mXqQKvGW9qF5RBHsWqc,SpATywNh6bZuzm8s1ceuBUnMUAeoAHHw,4,2,1,0,0,0,2,0,5,0.7142857142857143,1,0.0,0,1,0,0,2,0,0,2,0,1,4,1
11272,161670,IFqWOl32JJm0W3Ap2jxVCpJeXeLJlYDp,7GRhBDsirIGkRZBtSMEzNTyDr2JQm4xx,1,0,0,0,0,0,1,0,1,0.14285714285714285,1,0.0,0,0,0,0,0,0,0,1,0,0,1,1
11273,161671,Rlp934Hm4YHO5gcLihEiFevqZ5FBvHF8,SpATywNh6bZuzm8s1ceuBUnMUAeoAHHw,19,36,4,0,4,0,6,0,50,7.142857142857143,3,0.0,0,4,0,4,36,0,0,6,0,8,42,0
11274,161682,HE0yFYNeyW3jGh5EhXv7uoc6O18ATk5R,7GRhBDsirIGkRZBtSMEzNTyDr2JQm4xx,16,15,10,6,8,0,1,0,40,5.714285714285714,1,0.0,3,10,6,8,12,0,0,1,0,27,13,1
11275,161688,m9Qm8mLtAjxJkCkfPktOdlTYWgPjs32n,A3fsA9Zfv1X2fVEQhTw51lKENdNrEqT3,1,0,0,0,0,0,1,0,1,0.14285714285714285,1,0.0,0,0,0,0,0,0,0,1,0,0,1,1
11276,161695,5UJZmEar1AX3gQXOzkh3MnQcYdErI17M,7GRhBDsirIGkRZBtSMEzNTyDr2JQm4xx,5,3,1,4,1,0,1,0,10,1.4285714285714286,1,0.0,1,1,3,1,2,0,1,1,0,6,4,1
11277,161702,wT2PCRFj23I7HDSSujNYjrYVx91GnsP3,5X6FeZozNMgE2VRi3MJYjkkFK8SETtu2,9,6,4,0,3,0,2,0,15,2.142857142857143,1,0.0,1,4,0,3,5,0,0,2,0,8,7,1
11278,161723,SKx8r8WhDZSzytfk5iQ25ROJsaDkrIXF,7GRhBDsirIGkRZBtSMEzNTyDr2JQm4xx,11,7,4,0,0,0,22,1,34,4.857142857142857,2,0.0,0,4,0,0,7,0,0,22,1,4,30,1
11279,161731,dhx591nKY6SWOCES2fET5BrfIJeIVgiB,5X6FeZozNMgE2VRi3MJYjkkFK8SETtu2,6,1,1,0,1,0,4,0,7,1.0,1,0.0,0,1,0,1,1,0,0,4,0,2,5,1
11280,161736,QnyfwZyfjleoLWOw3jVeDLlIVv3UkBPV,A3fsA9Zfv1X2fVEQhTw51lKENdNrEqT3,66,23,13,168,3,18,28,2,255,36.42857142857143,1,0.0,9,13,146,3,14,18,22,28,2,171,84,0
11281,161781,WbYmIN32kCZgmPLiKiqZkBoi6u7qfnP4,A3fsA9Zfv1X2fVEQhTw51lKENdNrEqT3,15,8,6,8,5,2,5,1,35,5.0,1,0.0,0,6,7,5,8,2,1,5,1,18,17,1
11282,161805,UCk78TeP5wO91gE0mNeB2p1adOEwLGvE,7GRhBDsirIGkRZBtSMEzNTyDr2JQm4xx,1,0,0,0,0,0,1,0,1,0.14285714285714285,1,0.0,0,0,0,0,0,0,0,1,0,0,1,1
11283,161809,IW1yqY6AJLLD0UdkPHoBC5FNys4RF3Rc,A3fsA9Zfv1X2fVEQhTw51lKENdNrEqT3,10,7,1,0,0,1,14,1,24,3.4285714285714284,3,0.0,0,1,0,0,7,1,0,14,1,1,23,0
11284,161816,UA9f9Gmzx7Ooogr5DsTel41RFjYGmpHY,A3fsA9Zfv1X2fVEQhTw51lKENdNrEqT3,9,9,4,0,3,0,2,0,18,2.5714285714285716,1,0.0,0,4,0,3,9,0,0,2,0,7,11,1
11285,161856,MDFjVXgtYzZVyK4QPMD7X2zkYyaEYCUs,A3fsA9Zfv1X2fVEQhTw51lKENdNrEqT3,2,0,0,0,0,0,2,0,2,0.2857142857142857,1,0.0,0,0,0,0,0,0,0,2,0,0,2,0
11286,161860,XWulLs8vbnA3SFvatYUqLQya4PNZCGWN,7GRhBDsirIGkRZBtSMEzNTyDr2JQm4xx,2,0,0,0,0,0,2,0,2,0.2857142857142857,1,0.0,0,0,0,0,0,0,0,2,0,0,2,1
11287,161885,OpzkfHewiSMfOmQKF5XpZzGA1W0RFLn9,5X6FeZozNMgE2VRi3MJYjkkFK8SETtu2,1,0,0,0,0,0,1,0,1,0.14285714285714285,1,0.0,0,0,0,0,0,0,0,1,0,0,1,1
11288,161891,Tld0Cp8nhQFMldHTc4wNbAWPalDRQyks,A3fsA9Zfv1X2fVEQhTw51lKENdNrEqT3,7,4,1,0,1,0,5,0,11,1.5714285714285714,1,0.0,0,1,0,1,4,0,0,5,0,2,9,1
11289,161918,SYWOoChsgDN3vqDh0zFb5J4GFaNN5CHm,7GRhBDsirIGkRZBtSMEzNTyDr2JQm4xx,2,0,0,0,0,0,2,0,2,0.2857142857142857,1,0.0,0,0,0,0,0,0,0,2,0,0,2,1
11290,161927,OhL5zrdNWQNDdkrpoCKKJc0ohGhIkdNF,7GRhBDsirIGkRZBtSMEzNTyDr2JQm4xx,7,3,1,0,1,0,6,0,11,1.5714285714285714,1,0.0,0,1,0,1,3,0,0,6,0,2,9,1
11291,161959,AZZvRPcRkLSa6vwofzfwsEULTUhiKy0E,7GRhBDsirIGkRZBtSMEzNTyDr2JQm4xx,1,0,0,0,0,0,1,0,1,0.14285714285714285,1,0.0,0,0,0,0,0,0,0,1,0,0,1,1
11292,161969,MaC2my4u05k7bh5sqzN5aBA80G2sJbiN,7GRhBDsirIGkRZBtSMEzNTyDr2JQm4xx,2,0,0,0,0,0,2,0,2,0.2857142857142857,1,0.0,0,0,0,0,0,0,0,2,0,0,2,1
11293,161977,1eR532KvihOWCrlFgRH6WOHtkLSsyMIL,7GRhBDsirIGkRZBtSMEzNTyDr2JQm4xx,1,0,0,0,0,0,1,0,1,0.14285714285714285,1,0.0,0,0,0,0,0,0,0,1,0,0,1,1
11294,161989,QTUZiw3Jw7W7WAfaSZy42tMMiSl9TyEf,5X6FeZozNMgE2VRi3MJYjkkFK8SETtu2,6,2,0,0,0,0,7,1,10,1.4285714285714286,1,0.0,0,0,0,0,2,0,0,7,1,0,10,1
11295,162021,zEeoIZORCHI2d73VPIkIvoJfr8OXEKux,7GRhBDsirIGkRZBtSMEzNTyDr2JQm4xx,2,0,0,0,0,0,4,0,4,0.5714285714285714,1,0.0,0,0,0,0,0,0,0,4,0,0,4,1
11296,162029,OUbrW18OgibVb4I41eHFiFhkobpgjEP2,A3fsA9Zfv1X2fVEQhTw51lKENdNrEqT3,88,59,48,0,41,0,16,0,164,23.428571428571427,6,0.0,0,48,0,41,59,0,0,16,0,89,75,0
11297,162030,Xipj7T5lLiw1KZ1W0l4R2RMWExB1p24F,A3fsA9Zfv1X2fVEQhTw51lKENdNrEqT3,1,0,0,0,0,0,1,0,1,0.14285714285714285,1,0.0,0,0,0,0,0,0,0,1,0,0,1,1
11298,162051,EPVEir3f8DxjouE65Q4kYI9YaQMxGE89,7GRhBDsirIGkRZBtSMEzNTyDr2JQm4xx,1,0,0,0,0,0,1,0,1,0.14285714285714285,1,0.0,0,0,0,0,0,0,0,1,0,0,1,1
11299,162066,UORxoPAW78CaMQ97e33lObwUPeUxu7Pe,5X6FeZozNMgE2VRi3MJYjkkFK8SETtu2,6,6,2,0,2,0,3,0,13,1.8571428571428572,1,0.0,0,2,0,2,6,0,0,3,0,4,9,1
11300,162089,KN2cc8h9ZKfIgxIX3NczsQQI5NEtrUt5,7GRhBDsirIGkRZBtSMEzNTyDr2JQm4xx,1,0,0,0,0,0,1,0,1,0.14285714285714285,1,0.0,0,0,0,0,0,0,0,1,0,0,1,1
11301,162101,OtKlBJczZZ9HdAGTiOJJ8MePX1GCshtH,A3fsA9Zfv1X2fVEQhTw51lKENdNrEqT3,10,7,5,0,3,0,2,0,17,2.4285714285714284,1,0.0,0,5,0,3,7,0,0,2,0,8,9,1
11302,162127,ganxR6HGA35mA8rG8lqwM374IiEISz9t,A3fsA9Zfv1X2fVEQhTw51lKENdNrEqT3,1,0,0,0,0,0,1,0,1,0.14285714285714285,1,0.0,0,0,0,0,0,0,0,1,0,0,1,1
11303,162174,WUH5fKgyK0ITY5YtWCIxwze8XvwwESM5,7GRhBDsirIGkRZBtSMEzNTyDr2JQm4xx,5,4,1,0,1,1,1,0,8,1.1428571428571428,1,0.0,0,1,0,1,4,1,0,1,0,2,6,1
11304,162177,1K0DpvOOuk8vTEPD17uO46UmxJ6dP2I7,7GRhBDsirIGkRZBtSMEzNTyDr2JQm4xx,23,41,14,8,7,0,4,0,74,10.571428571428571,1,0.0,21,14,8,7,20,0,0,4,0,50,24,1
11305,162180,H2y5GoDHJ4wmWVWaUEfJWp7KoPtATjtS,A3fsA9Zfv1X2fVEQhTw51lKENdNrEqT3,1,0,0,0,0,0,1,0,1,0.14285714285714285,1,0.0,0,0,0,0,0,0,0,1,0,0,1,0
11306,162182,o69BaNn8nNwkn0WRwXTNaYgGrUvOyxv9,7GRhBDsirIGkRZBtSMEzNTyDr2JQm4xx,1,0,0,0,0,0,1,0,1,0.14285714285714285,1,0.0,0,0,0,0,0,0,0,1,0,0,1,1
11307,162210,DtMnsqy6X2aMCS8gI4UYHBMONV1kA6dl,7GRhBDsirIGkRZBtSMEzNTyDr2JQm4xx,6,2,1,0,1,0,3,0,7,1.0,1,0.0,0,1,0,1,2,0,0,3,0,2,5,1
11308,162227,uuKeKkPXlaVWeKPj7Eoyh2mpLD36WFad,7GRhBDsirIGkRZBtSMEzNTyDr2JQm4xx,4,2,1,0,0,0,3,0,6,0.8571428571428571,1,0.0,1,1,0,0,1,0,0,3,0,2,4,1
11309,162252,pUVYMZKME7oxYlcseSFG7zGaoCPbxz6o,7GRhBDsirIGkRZBtSMEzNTyDr2JQm4xx,1,0,0,0,0,0,1,0,1,0.14285714285714285,1,0.0,0,0,0,0,0,0,0,1,0,0,1,1
11310,162274,WjvGLSVrYi9V0QdvJaEuJKf33hyIxl38,A3fsA9Zfv1X2fVEQhTw51lKENdNrEqT3,2,0,0,0,0,1,1,0,2,0.2857142857142857,1,0.0,0,0,0,0,0,1,0,1,0,0,2,1
11311,162284,vcAIQrvSpc5jpQ7bCbnjOGeJTYapI81O,5X6FeZozNMgE2VRi3MJYjkkFK8SETtu2,1,0,0,0,0,0,1,0,1,0.14285714285714285,1,0.0,0,0,0,0,0,0,0,1,0,0,1,1
11312,162327,IY2XGmMLdQpnN2CAArJJlJXjbbQc8pm5,A3fsA9Zfv1X2fVEQhTw51lKENdNrEqT3,1,0,0,0,0,0,1,0,1,0.14285714285714285,1,0.0,0,0,0,0,0,0,0,1,0,0,1,1
11313,162347,d0EMfPN6PawhWgPDlCBNVjvE3wPPt43m,7GRhBDsirIGkRZBtSMEzNTyDr2JQm4xx,6,4,2,0,1,1,3,0,11,1.5714285714285714,1,0.0,0,2,0,1,4,1,0,3,0,3,8,1
11314,162349,zk5xG4pcHt1p18byPNiVKqMo96VaCzrd,A3fsA9Zfv1X2fVEQhTw51lKENdNrEqT3,6,1,1,0,1,0,6,0,9,1.2857142857142858,1,0.0,0,1,0,1,1,0,0,6,0,2,7,0
11315,162440,nxaczHF9lQRqN1CMkR3TcgnQsmf5O5ak,3VkHkmOtom3jM2wCu94xgzzu1d6Dn7or,4,2,1,0,1,0,1,0,5,0.7142857142857143,1,0.0,0,1,0,1,2,0,0,1,0,2,3,1
11316,162447,ZVURpQaazMitnYFMAbkQuPrH9TNZf1sy,3VkHkmOtom3jM2wCu94xgzzu1d6Dn7or,1,0,0,0,0,0,1,0,1,0.14285714285714285,1,0.0,0,0,0,0,0,0,0,1,0,0,1,1
11317,162486,4o8oFRzfQkVEw0BIiqicQA8RmeOEgsqb,3VkHkmOtom3jM2wCu94xgzzu1d6Dn7or,1,0,0,0,0,0,1,0,1,0.14285714285714285,1,0.0,0,0,0,0,0,0,0,1,0,0,1,1
11318,162498,yF9MXH4yBFaNzkeHhEwugParmE2tjGJ2,3VkHkmOtom3jM2wCu94xgzzu1d6Dn7or,8,2,1,0,1,0,6,1,11,1.5714285714285714,1,0.0,0,1,0,1,2,0,0,6,1,2,9,1
11319,162516,ox17FQMF44gCKSCdMI3aDt3HMnQOA1En,3VkHkmOtom3jM2wCu94xgzzu1d6Dn7or,6,2,1,0,1,0,6,0,10,1.4285714285714286,1,0.0,0,1,0,1,2,0,0,6,0,2,8,1
11320,162524,ZMZpmEOYjqi3PuNrDa9qC7SMGAO1RfMn,3VkHkmOtom3jM2wCu94xgzzu1d6Dn7or,2,0,0,0,0,0,2,0,2,0.2857142857142857,1,0.0,0,0,0,0,0,0,0,2,0,0,2,1
11321,162525,VuKnRHYrKL9qTcfMl51bpkebPNNIYpjU,3VkHkmOtom3jM2wCu94xgzzu1d6Dn7or,1,0,0,0,0,0,2,0,2,0.2857142857142857,1,0.0,0,0,0,0,0,0,0,2,0,0,2,1
11322,162533,i1weaEaafaiWi31Ms4bwoF6JM4IRf714,3VkHkmOtom3jM2wCu94xgzzu1d6Dn7or,6,5,3,0,2,0,4,0,14,2.0,3,0.0,0,3,0,2,5,0,0,4,0,5,9,1
11323,162538,1oncQhszk7F9F86Iu7dLWHgiUY5z8CKs,3VkHkmOtom3jM2wCu94xgzzu1d6Dn7or,1,0,0,0,0,0,1,0,1,0.14285714285714285,1,0.0,0,0,0,0,0,0,0,1,0,0,1,1
11324,162569,jsfwkzqF5Uv9m2DunSrE74XnYh9ND3OD,3VkHkmOtom3jM2wCu94xgzzu1d6Dn7or,1,0,0,0,0,0,1,0,1,0.14285714285714285,1,0.0,0,0,0,0,0,0,0,1,0,0,1,1
11325,162575,D6eOCZGhdodEIUvZxH12PiS70TaJdmcx,3VkHkmOtom3jM2wCu94xgzzu1d6Dn7or,1,0,0,0,0,0,1,0,1,0.14285714285714285,1,0.0,0,0,0,0,0,0,0,1,0,0,1,1
11326,162577,HJCW8zUVg09Eg230mK668iH5yjSli4EE,3VkHkmOtom3jM2wCu94xgzzu1d6Dn7or,1,0,0,0,0,0,1,0,1,0.14285714285714285,1,0.0,0,0,0,0,0,0,0,1,0,0,1,1
11327,162578,B04bEh4wvZOg7i7EW9b9kKxk3PCLcFBb,3VkHkmOtom3jM2wCu94xgzzu1d6Dn7or,1,0,0,0,0,0,2,0,2,0.2857142857142857,1,0.0,0,0,0,0,0,0,0,2,0,0,2,1
11328,162582,D2R3pPwD7a1prmPsDdVzQ9z7yXwv1C89,3VkHkmOtom3jM2wCu94xgzzu1d6Dn7or,1,0,0,0,0,0,1,0,1,0.14285714285714285,1,0.0,0,0,0,0,0,0,0,1,0,0,1,1
11329,162593,WSCktYZqeZlAr4CBsNsYbm97xd94qsUC,3VkHkmOtom3jM2wCu94xgzzu1d6Dn7or,3,5,0,0,0,0,1,0,6,0.8571428571428571,1,0.0,0,0,0,0,5,0,0,1,0,0,6,1
11330,162653,6yKvwDs84lm1ZlLZzY92MDe16cYzJo5V,fbPkOYLVPtPgIt0MxizjfFJov3JbHyAi,7,6,3,0,4,0,2,0,15,2.142857142857143,1,0.0,2,3,0,4,4,0,0,2,0,9,6,1
11331,162654,8sS5OxFNiGXZ5DUb7jXq3k5CIC9MaMcF,fbPkOYLVPtPgIt0MxizjfFJov3JbHyAi,11,5,2,0,2,10,5,1,25,3.5714285714285716,1,0.0,0,2,0,2,5,10,0,5,1,4,21,1
11332,162655,G8NfWWfRwceCubJJsygDkNdWqvz6p8r7,fbPkOYLVPtPgIt0MxizjfFJov3JbHyAi,4,3,0,0,0,0,3,0,6,0.8571428571428571,1,0.0,0,0,0,0,3,0,0,3,0,0,6,1
11333,162662,7SOATalw6HkrZim2p905lRKSzVKbYoeJ,fbPkOYLVPtPgIt0MxizjfFJov3JbHyAi,1,0,0,0,0,0,1,0,1,0.14285714285714285,1,0.0,0,0,0,0,0,0,0,1,0,0,1,1
11334,162663,HDuNX4LLsLDTkuyYIBGkGV7jAGXEtOuc,fbPkOYLVPtPgIt0MxizjfFJov3JbHyAi,2,0,0,0,0,0,3,0,3,0.42857142857142855,1,0.0,0,0,0,0,0,0,0,3,0,0,3,1
11335,162664,92eKrHML8uFDQVHOmZmmhaJ4gTyx9NDt,fbPkOYLVPtPgIt0MxizjfFJov3JbHyAi,8,4,2,0,2,0,5,0,13,1.8571428571428572,1,0.0,1,2,0,2,3,0,0,5,0,5,8,1
11336,162665,1jbzhg6dAhJ3AT5rxEEXSMGEXTVvHdIx,fbPkOYLVPtPgIt0MxizjfFJov3JbHyAi,2,0,0,0,0,0,3,0,3,0.42857142857142855,1,0.0,0,0,0,0,0,0,0,3,0,0,3,1
11337,162667,ftYE47yTOAFIMqTQk12eUimylWQiUH5C,fbPkOYLVPtPgIt0MxizjfFJov3JbHyAi,5,2,1,0,1,0,3,0,7,1.0,1,0.0,0,1,0,1,2,0,0,3,0,2,5,1
11338,162668,UVZ0046mDQtSPXatD3KanD1N0mcrpfEe,fbPkOYLVPtPgIt0MxizjfFJov3JbHyAi,1,0,0,0,0,0,1,0,1,0.14285714285714285,1,0.0,0,0,0,0,0,0,0,1,0,0,1,1
11339,162669,MEiWJmtZSdxLL8HEGVkX5lxXxAUsGu0A,fbPkOYLVPtPgIt0MxizjfFJov3JbHyAi,1,0,0,0,0,0,1,0,1,0.14285714285714285,1,0.0,0,0,0,0,0,0,0,1,0,0,1,1
11340,162670,0FtVS7ZBI4rrErVUUUqJzFuZedQkaBu3,fbPkOYLVPtPgIt0MxizjfFJov3JbHyAi,1,0,0,0,0,0,1,0,1,0.14285714285714285,1,0.0,0,0,0,0,0,0,0,1,0,0,1,1
11341,162672,tBbrCdeCzTMG76NlqGynFt4AvfyJdikM,fbPkOYLVPtPgIt0MxizjfFJov3JbHyAi,43,32,15,48,13,1,5,1,115,16.428571428571427,1,0.0,14,15,42,13,18,1,6,5,1,84,31,1
11342,162674,Kz3qhdfTJukDJF9DtNWUYj5BtfRsMvnw,fbPkOYLVPtPgIt0MxizjfFJov3JbHyAi,2,0,0,0,0,0,2,0,2,0.2857142857142857,1,0.0,0,0,0,0,0,0,0,2,0,0,2,1
11343,162675,rde4SOUWKvk9DJZt1L0gZmVDXeNYiqdM,fbPkOYLVPtPgIt0MxizjfFJov3JbHyAi,11,6,4,0,3,0,7,1,21,3.0,1,0.0,1,4,0,3,5,0,0,7,1,8,13,1
11344,162677,JJDWSR5T5OI58OQCJ2rXYW6lv04IiDvD,fbPkOYLVPtPgIt0MxizjfFJov3JbHyAi,12,6,3,0,3,15,7,1,35,5.0,2,0.0,0,3,0,3,6,15,0,7,1,6,29,1
11345,162683,8zAtOSKV7R70cZuke03f42P9Tj2cyqBy,fbPkOYLVPtPgIt0MxizjfFJov3JbHyAi,5,3,1,0,1,0,2,0,7,1.0,1,0.0,0,1,0,1,3,0,0,2,0,2,5,1
11346,162684,EehddsodITByQl4qGuajkHZ7QOdMQQgV,fbPkOYLVPtPgIt0MxizjfFJov3JbHyAi,7,7,2,0,4,0,2,0,15,2.142857142857143,1,0.0,4,2,0,4,3,0,0,2,0,10,5,1
11347,162686,HIfBwadqUOHP4H0miQANqcPd7btb1kCW,fbPkOYLVPtPgIt0MxizjfFJov3JbHyAi,1,0,0,0,0,0,1,0,1,0.14285714285714285,1,0.0,0,0,0,0,0,0,0,1,0,0,1,1
11348,162688,TfMiuu9vyAM0w8qFqC2lCZDreJEc3tGS,fbPkOYLVPtPgIt0MxizjfFJov3JbHyAi,6,0,0,0,0,1,21,1,23,3.2857142857142856,2,0.0,0,0,0,0,0,1,0,21,1,0,23,1
11349,162700,M9qzbHqIRAsNV3bD2hj1DPeNp2k6AjqO,fbPkOYLVPtPgIt0MxizjfFJov3JbHyAi,6,2,1,0,1,0,4,0,8,1.1428571428571428,1,0.0,0,1,0,1,2,0,0,4,0,2,6,1
11350,162702,hS70rXH0G94qmb9N1eBGrleH41NX9STz,fbPkOYLVPtPgIt0MxizjfFJov3JbHyAi,2,0,0,0,0,0,5,0,5,0.7142857142857143,1,0.0,0,0,0,0,0,0,0,5,0,0,5,1
11351,162704,fX40yNA4s3myhUDdO7ujIUD2VjxgqD1R,fbPkOYLVPtPgIt0MxizjfFJov3JbHyAi,1,0,0,0,0,0,1,0,1,0.14285714285714285,1,0.0,0,0,0,0,0,0,0,1,0,0,1,1
11352,162706,4D3Mr9GTnnSeHqe4k4RduVTIffzivKXV,fbPkOYLVPtPgIt0MxizjfFJov3JbHyAi,10,16,5,0,3,2,11,0,37,5.285714285714286,2,0.0,0,5,0,3,16,2,0,11,0,8,29,1
11353,162708,C9lLMTQ4ry2uksEvYVANv0oVpPhZMbc2,fbPkOYLVPtPgIt0MxizjfFJov3JbHyAi,8,5,3,0,2,0,4,0,14,2.0,1,0.0,0,3,0,2,5,0,0,4,0,5,9,1
11354,162710,724Z1dFlMACAt3kWIjNXL2F7EImzegCP,fbPkOYLVPtPgIt0MxizjfFJov3JbHyAi,1,0,0,0,0,0,1,0,1,0.14285714285714285,1,0.0,0,0,0,0,0,0,0,1,0,0,1,1
11355,162711,xIi7bi5lsr2kQs0Ruk7tQjf4xYRaSVFg,fbPkOYLVPtPgIt0MxizjfFJov3JbHyAi,9,6,4,0,3,0,2,0,15,2.142857142857143,1,0.0,0,4,0,3,6,0,0,2,0,7,8,1
11356,162713,FEsfreZNllfO9KbF7SZ3ITs14Rmiz03Y,fbPkOYLVPtPgIt0MxizjfFJov3JbHyAi,1,0,0,0,0,0,1,0,1,0.14285714285714285,1,0.0,0,0,0,0,0,0,0,1,0,0,1,1
11357,162724,FGdh9HPOiTAfXZsL6lEzMEnHg7J5TRwT,5Gyp41oLVo7Gg7vF4vpmggWP5MU70QO6,1,0,0,0,0,0,1,0,1,0.14285714285714285,1,0.0,0,0,0,0,0,0,0,1,0,0,1,1
11358,162771,ssRnwmrFPp2w8rauG68PQC7q5Dnmmn2N,5Gyp41oLVo7Gg7vF4vpmggWP5MU70QO6,8,4,3,0,3,0,1,0,11,1.5714285714285714,1,0.0,0,3,0,3,4,0,0,1,0,6,5,1
11359,162828,xBFzqYj7zL8zEp5CYjAk76ik08Duknlp,5Gyp41oLVo7Gg7vF4vpmggWP5MU70QO6,5,2,1,0,1,0,4,0,8,1.1428571428571428,2,0.0,0,1,0,1,2,0,0,4,0,2,6,1
11360,162833,0XEdPp3w1uBYDQWPrz9gkZoYIRnTvyMJ,5Gyp41oLVo7Gg7vF4vpmggWP5MU70QO6,5,2,1,0,1,0,2,0,6,0.8571428571428571,1,0.0,0,1,0,1,2,0,0,2,0,2,4,1
11361,162838,yarIIX8WmyVXpsrhL9pB32FFf4ft3jZw,5Gyp41oLVo7Gg7vF4vpmggWP5MU70QO6,7,7,2,0,2,0,4,0,15,2.142857142857143,1,0.0,4,2,0,2,3,0,0,4,0,8,7,1
11362,162858,QiOW9TXJhtJN4Upe2lgfNCol4hcsuoG0,5Gyp41oLVo7Gg7vF4vpmggWP5MU70QO6,1,0,0,0,0,0,1,0,1,0.14285714285714285,1,0.0,0,0,0,0,0,0,0,1,0,0,1,1
11363,162879,eOM17mBlMQlBTkfbWTDTGHBTm3dD6ouv,5Gyp41oLVo7Gg7vF4vpmggWP5MU70QO6,1,0,0,0,0,0,1,0,1,0.14285714285714285,1,0.0,0,0,0,0,0,0,0,1,0,0,1,1
11364,162893,Z5Lqu6KlNXkxDiGVdPztKUtmARQE8v4L,5Gyp41oLVo7Gg7vF4vpmggWP5MU70QO6,13,16,7,2,4,0,6,1,36,5.142857142857143,1,0.0,3,7,1,4,13,0,1,6,1,15,21,1
11365,162895,YM9Z89N137bY5qphnaUaFSAicUvT78c0,5Gyp41oLVo7Gg7vF4vpmggWP5MU70QO6,1,0,0,0,0,0,1,0,1,0.14285714285714285,1,0.0,0,0,0,0,0,0,0,1,0,0,1,1
11366,162918,TJqPE04kRYVY9YYt84lPRwnjVxee9Pon,5Gyp41oLVo7Gg7vF4vpmggWP5MU70QO6,12,12,5,0,7,2,7,1,34,4.857142857142857,1,0.0,5,5,0,7,7,2,0,7,1,17,17,0
11367,162926,9XHHoSauXri3orblmJ9JFLzfmtRELpUB,5Gyp41oLVo7Gg7vF4vpmggWP5MU70QO6,10,12,7,5,3,1,4,0,32,4.571428571428571,1,0.0,3,7,3,3,9,1,2,4,0,16,16,1
11368,162927,FqxZInDGuTXmPgpy2HmrKGvUbRHydqL9,5Gyp41oLVo7Gg7vF4vpmggWP5MU70QO6,5,4,0,0,0,0,3,0,7,1.0,3,0.0,0,0,0,0,4,0,0,3,0,0,7,0
11369,162945,VLFgC7A4MAFfXbNuQP4gI0ZzVKAF55Dd,5Gyp41oLVo7Gg7vF4vpmggWP5MU70QO6,2,0,0,0,0,0,2,0,2,0.2857142857142857,1,0.0,0,0,0,0,0,0,0,2,0,0,2,1
11370,163127,t8ZEhvFH2BnmQYnifk2af72nBHnXSrH4,5X6FeZozNMgE2VRi3MJYjkkFK8SETtu2,6,7,2,0,2,0,3,0,14,2.0,2,0.0,2,2,0,2,5,0,0,3,0,6,8,1
11371,163130,Mms6sMIkW4Omst3uLD38oJJ4C0ZCQcDW,5X6FeZozNMgE2VRi3MJYjkkFK8SETtu2,1,0,0,0,0,0,1,0,1,0.14285714285714285,1,0.0,0,0,0,0,0,0,0,1,0,0,1,1
11372,163144,aRhm894PfzFLkP3cntp8AtlxvYw2TjcZ,5X6FeZozNMgE2VRi3MJYjkkFK8SETtu2,1,0,0,0,0,0,1,0,1,0.14285714285714285,1,0.0,0,0,0,0,0,0,0,1,0,0,1,1
11373,163208,afMatYBEskDEx2mzVDW2B6YoXRt9RGEu,7GRhBDsirIGkRZBtSMEzNTyDr2JQm4xx,1,0,0,0,0,0,1,0,1,0.14285714285714285,1,0.0,0,0,0,0,0,0,0,1,0,0,1,1
11374,163258,z2cHyYlWiw7oxTsa0shPd3Lc7pBNdjgZ,5X6FeZozNMgE2VRi3MJYjkkFK8SETtu2,3,2,0,0,0,0,1,0,3,0.42857142857142855,1,0.0,0,0,0,0,2,0,0,1,0,0,3,1
11375,163263,4i5hqm1gfzAWGRB4svclJb7LMO8qbrVL,7GRhBDsirIGkRZBtSMEzNTyDr2JQm4xx,4,3,1,0,0,0,2,0,6,0.8571428571428571,1,0.0,0,1,0,0,3,0,0,2,0,1,5,1
11376,163295,kgapU06uO2FTgFvaWXJYj3aeIVCjcJ3p,7GRhBDsirIGkRZBtSMEzNTyDr2JQm4xx,1,0,0,0,0,0,1,0,1,0.14285714285714285,1,0.0,0,0,0,0,0,0,0,1,0,0,1,1
11377,163305,sPLn9Z0P7AWvSFd67DQFXqDRTnVlsDDq,7GRhBDsirIGkRZBtSMEzNTyDr2JQm4xx,7,4,3,0,3,0,2,0,12,1.7142857142857142,1,0.0,0,3,0,3,4,0,0,2,0,6,6,1
11378,163310,TpVcNSSZgwZ6DE3d1K8SPrDWLNQ6MrgR,7GRhBDsirIGkRZBtSMEzNTyDr2JQm4xx,1,0,0,0,0,0,1,0,1,0.14285714285714285,1,0.0,0,0,0,0,0,0,0,1,0,0,1,1
11379,163446,vYZLFtHzbRZEyiuRAYkPU2TurFaRRb3e,bWdj2GDclj5ofokWjzoa5jAwMkxCykd6,7,7,4,0,3,0,3,0,17,2.4285714285714284,3,0.0,1,4,0,3,6,0,0,3,0,8,9,1
11380,163447,CR6hbwvXPZHEYYcI4AAX4civM4Pp6Aex,bWdj2GDclj5ofokWjzoa5jAwMkxCykd6,7,2,1,0,1,0,4,0,8,1.1428571428571428,2,0.0,0,1,0,1,2,0,0,4,0,2,6,1
11381,163451,rUr3hxt1niPeDbjT1dWASqAoHDERYMHJ,bWdj2GDclj5ofokWjzoa5jAwMkxCykd6,26,15,6,100,2,5,3,0,131,18.714285714285715,3,0.0,4,6,90,2,11,5,10,3,0,102,29,0
11382,163452,CLgDvHjU8d0JuEtHgdUcLQg1OZ6hE3A8,RXDvfPUBYFlVdlueBFbLW0mhhAyGEqpt,21,24,15,22,8,2,6,0,77,11.0,3,0.0,4,15,22,8,20,2,0,6,0,49,28,1
11383,163456,QW07WKWuMa47F3DVH5YhQbGmBNCRc0FZ,SpATywNh6bZuzm8s1ceuBUnMUAeoAHHw,9,5,1,16,1,2,4,1,30,4.285714285714286,1,0.0,2,1,13,1,3,2,3,4,1,17,13,1
11384,163459,eq3avF6QxxFlcD9gaMIYsKSt5Td1igiD,SpATywNh6bZuzm8s1ceuBUnMUAeoAHHw,12,16,2,18,0,0,5,0,41,5.857142857142857,1,0.0,5,2,15,0,11,0,3,5,0,22,19,1
11385,163463,hFpufo5lTiocFSjp5de4hLz459xEY6dx,G8EPVSXsOYB5YQWZGiz1aVq5Pgr2GrQu,12,5,3,0,2,4,8,1,23,3.2857142857142856,1,0.0,0,3,0,2,5,4,0,8,1,5,18,1
11386,163468,GGdBzvTskjxKAvNdibnhPPkGKFTKpZaL,SpATywNh6bZuzm8s1ceuBUnMUAeoAHHw,4,3,0,0,0,0,3,0,6,0.8571428571428571,1,0.0,0,0,0,0,3,0,0,3,0,0,6,1
11387,163473,m580K62zl9ih2EBTcM6Y53ygfq7rAv69,RXDvfPUBYFlVdlueBFbLW0mhhAyGEqpt,1,0,0,0,0,0,1,0,1,0.14285714285714285,1,0.0,0,0,0,0,0,0,0,1,0,0,1,1
11388,163474,2sDQ5DmJB14fdhYiHWrjTNImvS7e7hHg,RXDvfPUBYFlVdlueBFbLW0mhhAyGEqpt,9,6,5,0,4,1,5,1,22,3.142857142857143,2,0.0,0,5,0,4,6,1,0,5,1,9,13,1
11389,163489,5IM8g7YMOYo5qH7Yu3x31T3JkVOH9iqe,RXDvfPUBYFlVdlueBFbLW0mhhAyGEqpt,8,12,4,0,2,0,1,0,19,2.7142857142857144,2,0.0,1,4,0,2,11,0,0,1,0,7,12,1
11390,163492,ni5dUdHYqNJ6ClZBex2HryO1vDE1ZkoU,SpATywNh6bZuzm8s1ceuBUnMUAeoAHHw,4,1,0,0,0,0,3,0,4,0.5714285714285714,1,0.0,0,0,0,0,1,0,0,3,0,0,4,1
11391,163495,ww05exVvqmTpHRLpMlcyyiyf25IJQarF,bWdj2GDclj5ofokWjzoa5jAwMkxCykd6,4,2,1,0,1,0,2,0,6,0.8571428571428571,1,0.0,0,1,0,1,2,0,0,2,0,2,4,1
11392,163498,KemVogD4rWuutYcMfAZRpTjVQNkGCf1a,bWdj2GDclj5ofokWjzoa5jAwMkxCykd6,6,6,2,0,2,0,1,0,11,1.5714285714285714,1,0.0,2,2,0,2,4,0,0,1,0,6,5,1
11393,163503,q1KcO9Dg3vZiLgj3uBWo2HFsUXBuH0Hl,RXDvfPUBYFlVdlueBFbLW0mhhAyGEqpt,12,8,1,21,1,0,2,0,33,4.714285714285714,1,0.0,2,1,17,1,6,0,4,2,0,21,12,1
11394,163511,i0ksX07HnsV5rQlWqOr1uKEuc7yNU24c,bWdj2GDclj5ofokWjzoa5jAwMkxCykd6,13,25,11,0,6,48,15,1,106,15.142857142857142,3,0.0,7,11,0,6,18,48,0,15,1,24,82,1
11395,163517,RAAFt7jgkqGMpy4rUVomxkKt5lfbto8C,SpATywNh6bZuzm8s1ceuBUnMUAeoAHHw,5,1,0,0,0,1,7,1,10,1.4285714285714286,2,0.0,0,0,0,0,1,1,0,7,1,0,10,1
11396,163520,gFwcy6HlQMHgKm8VCXe5qQxUXfgM5CMM,RXDvfPUBYFlVdlueBFbLW0mhhAyGEqpt,18,31,11,2,5,0,3,0,52,7.428571428571429,2,0.0,1,11,2,5,30,0,0,3,0,19,33,1
11397,163521,vvZAdi1giBsqNJd2MIMUF2BeNIuSYzIL,bWdj2GDclj5ofokWjzoa5jAwMkxCykd6,5,2,1,0,1,0,2,0,6,0.8571428571428571,1,0.0,0,1,0,1,2,0,0,2,0,2,4,1
11398,163522,0z2VYcRtlKJQ1Og2a3In5C7pwhw0mXLE,SpATywNh6bZuzm8s1ceuBUnMUAeoAHHw,30,68,35,29,15,203,28,4,382,54.57142857142857,6,0.0,19,35,27,15,49,203,2,28,4,96,286,1
11399,163524,Qp6nTYSBUXdSPjEoOGaLaIU4K702QdpX,SpATywNh6bZuzm8s1ceuBUnMUAeoAHHw,9,3,2,0,2,0,6,1,14,2.0,1,0.0,0,2,0,2,3,0,0,6,1,4,10,1
11400,163545,aNuWWNOgxdbqnpWne8VHd2WyMrEEuUHw,SpATywNh6bZuzm8s1ceuBUnMUAeoAHHw,13,13,0,24,0,3,5,6,51,7.285714285714286,1,0.0,6,0,19,0,7,3,5,5,6,25,26,1
11401,163548,MYL9KYDmBF9vDici6Dv3saVcxgkvpmKP,SpATywNh6bZuzm8s1ceuBUnMUAeoAHHw,8,2,2,0,2,0,3,0,9,1.2857142857142858,2,0.0,0,2,0,2,2,0,0,3,0,4,5,1
11402,163553,RfHHoRL5TB9R1ardH3KUBDMoKbTvmS64,G8EPVSXsOYB5YQWZGiz1aVq5Pgr2GrQu,9,2,1,0,1,2,8,1,15,2.142857142857143,1,0.0,0,1,0,1,2,2,0,8,1,2,13,1
11403,163556,x1RDUiG4hzdFvWaarIV1g7s3ecNKiDPi,bWdj2GDclj5ofokWjzoa5jAwMkxCykd6,6,5,1,0,1,6,3,0,16,2.2857142857142856,1,0.0,2,1,0,1,3,6,0,3,0,4,12,1
11404,163561,0QwOyzDB4SU53NQhq9XNeT5ngIq83qZV,SpATywNh6bZuzm8s1ceuBUnMUAeoAHHw,14,20,6,18,4,4,5,0,57,8.142857142857142,1,0.0,12,6,16,4,8,4,2,5,0,38,19,1
11405,163566,7OkCZWJW1Ow4wpTBUq53amL13pV2vy2v,bWdj2GDclj5ofokWjzoa5jAwMkxCykd6,1,0,0,0,0,0,1,0,1,0.14285714285714285,1,0.0,0,0,0,0,0,0,0,1,0,0,1,1
11406,163575,pUCG45Dx4PCk37xolhUilbrK2zyzqYUw,SpATywNh6bZuzm8s1ceuBUnMUAeoAHHw,5,2,1,0,1,0,2,0,6,0.8571428571428571,1,0.0,0,1,0,1,2,0,0,2,0,2,4,1
11407,163584,pUCG45Dx4PCk37xolhUilbrK2zyzqYUw,RXDvfPUBYFlVdlueBFbLW0mhhAyGEqpt,5,2,1,0,1,0,2,0,6,0.8571428571428571,1,0.0,0,1,0,1,2,0,0,2,0,2,4,1
11408,163587,LOW2vjVehrf0M1x4W4dAc3vEUlAV2GoS,SpATywNh6bZuzm8s1ceuBUnMUAeoAHHw,1,0,0,0,0,0,1,0,1,0.14285714285714285,1,0.0,0,0,0,0,0,0,0,1,0,0,1,1
11409,163591,pvAe37z1FjLTGYdwlJFjXex25zlpyHtu,SpATywNh6bZuzm8s1ceuBUnMUAeoAHHw,1,0,0,0,0,0,1,0,1,0.14285714285714285,1,0.0,0,0,0,0,0,0,0,1,0,0,1,1
11410,163594,cJ2sQIvcbMYmAtm7wZLrjdPU3A4J8Vmy,RXDvfPUBYFlVdlueBFbLW0mhhAyGEqpt,1,0,0,0,0,0,1,0,1,0.14285714285714285,1,0.0,0,0,0,0,0,0,0,1,0,0,1,1
11411,163602,1n5nYyRZ2V4rGDvhlysxQQrSnQWtjpF0,SpATywNh6bZuzm8s1ceuBUnMUAeoAHHw,5,2,0,0,0,0,4,0,6,0.8571428571428571,1,0.0,0,0,0,0,2,0,0,4,0,0,6,1
11412,163606,muDFJRueLAzQJIObWxRY78oBQLrrl8ME,RXDvfPUBYFlVdlueBFbLW0mhhAyGEqpt,5,1,1,0,1,0,2,0,5,0.7142857142857143,1,0.0,0,1,0,1,1,0,0,2,0,2,3,1
11413,163608,zgldUj8PQLoCMFvq4CFx27ajGTiUzuNA,SpATywNh6bZuzm8s1ceuBUnMUAeoAHHw,8,3,1,0,1,0,5,1,11,1.5714285714285714,1,0.0,0,1,0,1,3,0,0,5,1,2,9,1
11414,163610,shpNJBWz5XXztT7QSTTkv5TBZhc2j7a5,bWdj2GDclj5ofokWjzoa5jAwMkxCykd6,5,2,1,0,1,0,2,0,6,0.8571428571428571,1,0.0,0,1,0,1,2,0,0,2,0,2,4,1
11415,163620,BRQa1dSoPdGgh4T8YhbATcVtUAwS3CTv,G8EPVSXsOYB5YQWZGiz1aVq5Pgr2GrQu,1,0,0,0,0,0,1,0,1,0.14285714285714285,1,0.0,0,0,0,0,0,0,0,1,0,0,1,1
11416,163624,J4pjYRUS78455k3x6FlgE0qLyKCkWPB4,SpATywNh6bZuzm8s1ceuBUnMUAeoAHHw,5,5,2,0,1,0,6,0,14,2.0,2,0.0,0,2,0,1,5,0,0,6,0,3,11,1
11417,163626,h1vKdFPTvdJ38bRqZwCXLGITqLqjjxQ8,bWdj2GDclj5ofokWjzoa5jAwMkxCykd6,2,0,0,0,0,0,5,0,5,0.7142857142857143,4,0.0,0,0,0,0,0,0,0,5,0,0,5,1
11418,163633,loY20pnf7suv2LWREXjC0h3XNawzaj7l,SpATywNh6bZuzm8s1ceuBUnMUAeoAHHw,15,13,4,13,3,0,5,0,38,5.428571428571429,1,0.0,5,4,11,3,8,0,2,5,0,23,15,1
11419,163657,3NITGQuylcrTi63aoWqnzXuF5Rtf7QVq,bWdj2GDclj5ofokWjzoa5jAwMkxCykd6,15,24,12,52,8,0,4,0,100,14.285714285714286,2,0.0,9,12,51,8,15,0,1,4,0,80,20,1
11420,163661,TC06DZHDGaAT9UQHd1v4hOYj6DcF04C0,SpATywNh6bZuzm8s1ceuBUnMUAeoAHHw,1,0,0,0,0,0,1,0,1,0.14285714285714285,1,0.0,0,0,0,0,0,0,0,1,0,0,1,1
11421,163664,75QwID9vkHNyAC3jIqeF9fNTGOKWDCMd,SpATywNh6bZuzm8s1ceuBUnMUAeoAHHw,35,81,2,71,1,12,23,5,195,27.857142857142858,5,0.0,27,2,53,1,54,12,18,23,5,83,112,0
11422,163665,mSLVZlcG3d9P9nR1btPulwDUjqta6d8Y,RXDvfPUBYFlVdlueBFbLW0mhhAyGEqpt,2,0,0,0,0,0,2,0,2,0.2857142857142857,1,0.0,0,0,0,0,0,0,0,2,0,0,2,1
11423,163668,BB5Nl9ZKGNNXpCTY1I2k14qOsWmBwuLj,SpATywNh6bZuzm8s1ceuBUnMUAeoAHHw,5,2,1,0,1,0,2,0,6,0.8571428571428571,1,0.0,0,1,0,1,2,0,0,2,0,2,4,1
11424,163670,zBcT1Z0xXooVqe1Y23Zi33CckLeXOFNF,RXDvfPUBYFlVdlueBFbLW0mhhAyGEqpt,1,0,0,0,0,0,1,0,1,0.14285714285714285,1,0.0,0,0,0,0,0,0,0,1,0,0,1,1
11425,163671,jMDxIZZpgmR8gnZ9CfiXAFFCthv2NGRW,SpATywNh6bZuzm8s1ceuBUnMUAeoAHHw,15,13,8,14,3,6,7,0,51,7.285714285714286,2,0.0,2,8,12,3,11,6,2,7,0,25,26,1
11426,163672,Xdw2Hwx0RPjHhvzIV1hR51APAU4mGupY,SpATywNh6bZuzm8s1ceuBUnMUAeoAHHw,5,5,2,0,2,0,1,0,10,1.4285714285714286,1,0.0,1,2,0,2,4,0,0,1,0,5,5,1
11427,163676,JoqAGqbao71wc04PyVzx7SVvlZZ0knbI,bWdj2GDclj5ofokWjzoa5jAwMkxCykd6,11,15,7,24,4,13,5,0,68,9.714285714285714,2,0.0,3,7,22,4,12,13,2,5,0,36,32,1
11428,163677,HcOpBFh3ZPBJu7PjBFffM3Zedw54RSXN,bWdj2GDclj5ofokWjzoa5jAwMkxCykd6,4,3,1,0,1,0,2,0,7,1.0,2,0.0,0,1,0,1,3,0,0,2,0,2,5,1
11429,163682,vqdEPdTaMaLXqSh5cxznXuMHlVEqT6bt,SpATywNh6bZuzm8s1ceuBUnMUAeoAHHw,12,29,22,0,8,0,9,1,69,9.857142857142858,2,0.0,0,22,0,8,29,0,0,9,1,30,39,0
11430,163688,cENALtdHRJFXtEKpdDktmgl2ZGC3sBgO,SpATywNh6bZuzm8s1ceuBUnMUAeoAHHw,12,9,1,17,0,0,4,0,31,4.428571428571429,1,0.0,4,1,15,0,5,0,2,4,0,20,11,1
11431,163690,komVuIpJ79AnXgdOwFqR0q8Eqk6fTXb3,SpATywNh6bZuzm8s1ceuBUnMUAeoAHHw,1,0,0,0,0,0,1,0,1,0.14285714285714285,1,0.0,0,0,0,0,0,0,0,1,0,0,1,1
11432,163694,sEHJPtMDHp3vOEZBdXoH3aRuuTFrugcC,G8EPVSXsOYB5YQWZGiz1aVq5Pgr2GrQu,10,22,13,0,8,2,5,0,50,7.142857142857143,2,0.0,4,13,0,8,18,2,0,5,0,25,25,1
11433,163698,pDVnQJMhWdSLNejm9F2A6uzPWohSMQmu,G8EPVSXsOYB5YQWZGiz1aVq5Pgr2GrQu,20,21,2,18,2,15,6,1,65,9.285714285714286,3,0.0,7,2,10,2,14,15,8,6,1,21,44,1
11434,163700,zUFpvfPNIssMYrypcxpRp9lQfW6g2Sf6,SpATywNh6bZuzm8s1ceuBUnMUAeoAHHw,7,7,0,0,0,6,11,0,24,3.4285714285714284,1,0.0,2,0,0,0,5,6,0,11,0,2,22,1
11435,163706,CrPF9cMk7uOWPFKqLXtVzkBmR606gvwU,SpATywNh6bZuzm8s1ceuBUnMUAeoAHHw,13,8,4,15,3,2,4,0,36,5.142857142857143,1,0.0,3,4,14,3,5,2,1,4,0,24,12,1
11436,163720,2nKcL79UGpRMTprt0KTar2VFqD9nuGkh,SpATywNh6bZuzm8s1ceuBUnMUAeoAHHw,2,0,0,0,0,0,2,0,2,0.2857142857142857,1,0.0,0,0,0,0,0,0,0,2,0,0,2,1
11437,163724,0YUJjVhFBVhA8wNUqY2rEXkCnd7riq8C,G8EPVSXsOYB5YQWZGiz1aVq5Pgr2GrQu,62,154,40,114,28,14,10,0,360,51.42857142857143,5,0.0,54,40,65,28,100,14,49,10,0,187,173,1
11438,163729,S6XUZDRPe3B3jFFcpBw3sZVQuamNJyiN,SpATywNh6bZuzm8s1ceuBUnMUAeoAHHw,10,6,2,0,2,0,11,1,22,3.142857142857143,1,0.0,0,2,0,2,6,0,0,11,1,4,18,1
11439,163741,D9KO1ppIRpnoCoycPkHQYcH9KJWpl4W7,bWdj2GDclj5ofokWjzoa5jAwMkxCykd6,4,3,1,0,1,0,1,0,6,0.8571428571428571,1,0.0,0,1,0,1,3,0,0,1,0,2,4,1
11440,163745,etVgnbIdb29nIYhfw4jRXWTSVqDVpgA6,bWdj2GDclj5ofokWjzoa5jAwMkxCykd6,5,2,1,0,1,0,2,0,6,0.8571428571428571,1,0.0,0,1,0,1,2,0,0,2,0,2,4,1
11441,163750,Cyn71axG1s2H4lOUgGzQPfwHEpQH7ztK,SpATywNh6bZuzm8s1ceuBUnMUAeoAHHw,15,19,8,12,4,12,3,0,58,8.285714285714286,2,0.0,8,8,12,4,11,12,0,3,0,32,26,1
11442,163768,RqamfvIhC4c7Es8bljx9jvwLrjWv2ac0,RXDvfPUBYFlVdlueBFbLW0mhhAyGEqpt,2,0,0,0,0,0,4,0,4,0.5714285714285714,1,0.0,0,0,0,0,0,0,0,4,0,0,4,1
11443,163778,btnHCoy9MQOM6yfSVhDpkIBjedtnrWxU,RXDvfPUBYFlVdlueBFbLW0mhhAyGEqpt,8,5,4,0,2,0,1,0,12,1.7142857142857142,1,0.0,0,4,0,2,5,0,0,1,0,6,6,1
11444,163779,NerpsmnngCHcZrL9Hd5ZneLeL3p095KD,SpATywNh6bZuzm8s1ceuBUnMUAeoAHHw,6,5,3,0,1,0,4,0,13,1.8571428571428572,1,0.0,0,3,0,1,5,0,0,4,0,4,9,1
11445,163786,SkZlhcjqZI4qlpvHtuOmZh7bgPo5Ar9M,bWdj2GDclj5ofokWjzoa5jAwMkxCykd6,2,0,0,0,0,0,2,0,2,0.2857142857142857,1,0.0,0,0,0,0,0,0,0,2,0,0,2,1
11446,163788,n3c2ApJ73TKxIh3DdiEwlTAkgOAhKXpG,SpATywNh6bZuzm8s1ceuBUnMUAeoAHHw,17,21,12,25,4,16,16,2,96,13.714285714285714,1,0.0,5,12,19,4,16,16,6,16,2,40,56,1
11447,163792,l2L8xysJvlmTPvgXglY4OYbhmyGaWoEy,RXDvfPUBYFlVdlueBFbLW0mhhAyGEqpt,16,8,6,42,3,0,11,1,71,10.142857142857142,1,0.0,2,6,34,3,6,0,8,11,1,45,26,1
11448,163795,YgSP6VTXTaMFsmPeWIUxWWzafDI82Gyz,SpATywNh6bZuzm8s1ceuBUnMUAeoAHHw,5,4,1,0,0,0,5,0,10,1.4285714285714286,3,0.0,0,1,0,0,4,0,0,5,0,1,9,1
11449,163797,Cmo75ZUENQku9o2Ve6I8FB5t9KDDKDgA,SpATywNh6bZuzm8s1ceuBUnMUAeoAHHw,4,4,1,0,1,0,2,0,8,1.1428571428571428,1,0.0,2,1,0,1,2,0,0,2,0,4,4,1
11450,163807,ejqIFmdt0kSod99aitO8eyB1a9BPL17H,SpATywNh6bZuzm8s1ceuBUnMUAeoAHHw,1,0,0,0,0,0,1,0,1,0.14285714285714285,1,0.0,0,0,0,0,0,0,0,1,0,0,1,1
11451,163815,Kp1vLJAjI5XcavfLMkR7KVaehYzBATxU,bWdj2GDclj5ofokWjzoa5jAwMkxCykd6,8,2,1,0,1,1,8,1,14,2.0,1,0.0,0,1,0,1,2,1,0,8,1,2,12,1
11452,163818,Jk2x4OpxMPaHdO7EMry509YRkCM2Yc2p,SpATywNh6bZuzm8s1ceuBUnMUAeoAHHw,12,10,4,16,0,8,7,1,46,6.571428571428571,1,0.0,6,4,14,0,4,8,2,7,1,24,22,1
11453,163843,6ifSGyv1OJBX59YUfupEGQzaFg12QLcw,RXDvfPUBYFlVdlueBFbLW0mhhAyGEqpt,31,36,29,0,7,0,13,2,87,12.428571428571429,4,0.0,0,29,0,7,36,0,0,13,2,36,51,1
11454,163848,KL1kUzCOuvYfkjBJ6sFRxEo1isQ1OD4Z,bWdj2GDclj5ofokWjzoa5jAwMkxCykd6,4,3,0,0,0,0,2,0,5,0.7142857142857143,1,0.0,0,0,0,0,3,0,0,2,0,0,5,1
11455,163856,xKB2JQIJ9xKYEvQWCbLYsbszDegqqoDj,bWdj2GDclj5ofokWjzoa5jAwMkxCykd6,4,3,1,0,1,0,1,0,6,0.8571428571428571,1,0.0,1,1,0,1,2,0,0,1,0,3,3,1
11456,163861,dIc7Ag2KIstBuuBNcnhZG1Qo98HOHtHH,SpATywNh6bZuzm8s1ceuBUnMUAeoAHHw,1,0,0,0,0,0,1,0,1,0.14285714285714285,1,0.0,0,0,0,0,0,0,0,1,0,0,1,1
11457,163872,bUOsk5wGaEvBO4I3alFT753psxzUkzse,RXDvfPUBYFlVdlueBFbLW0mhhAyGEqpt,5,2,1,0,1,0,2,0,6,0.8571428571428571,1,0.0,0,1,0,1,2,0,0,2,0,2,4,1
11458,163876,SSpeewBDHUNKkvUJM5ASinNHvMXIOEwr,SpATywNh6bZuzm8s1ceuBUnMUAeoAHHw,7,7,3,0,1,6,4,0,21,3.0,3,0.0,0,3,0,1,7,6,0,4,0,4,17,1
11459,163878,jX1wtG8uym7vm2Ny85W79HCXnEeqhUm4,SpATywNh6bZuzm8s1ceuBUnMUAeoAHHw,1,0,0,0,0,0,1,0,1,0.14285714285714285,1,0.0,0,0,0,0,0,0,0,1,0,0,1,1
11460,163891,GyWTABuPpZEqO585EnNTIpM2B2faPYN3,bWdj2GDclj5ofokWjzoa5jAwMkxCykd6,4,2,1,0,1,0,1,0,5,0.7142857142857143,1,0.0,0,1,0,1,2,0,0,1,0,2,3,1
11461,163897,HPHciqd0NAfLXfMlyuoYEVDWJNUonGj0,bWdj2GDclj5ofokWjzoa5jAwMkxCykd6,7,59,6,0,4,0,5,0,74,10.571428571428571,2,0.0,3,6,0,4,56,0,0,5,0,13,61,1
11462,163912,KAW52VBDXCvurEAry0tITiLWjcxVkV8S,RXDvfPUBYFlVdlueBFbLW0mhhAyGEqpt,41,34,20,96,13,2,4,0,169,24.142857142857142,1,0.0,9,20,86,13,25,2,10,4,0,128,41,1
11463,163913,aKmGG28IIMsmRYbcnkO5kp7ipo4I9wj0,SpATywNh6bZuzm8s1ceuBUnMUAeoAHHw,9,7,1,6,0,1,5,1,21,3.0,2,0.0,0,1,5,0,7,1,1,5,1,6,15,1
11464,163921,MSZ49Aqf4KMvK8xA9amgTCzlSE1z7F0F,bWdj2GDclj5ofokWjzoa5jAwMkxCykd6,2,0,0,0,0,0,2,0,2,0.2857142857142857,1,0.0,0,0,0,0,0,0,0,2,0,0,2,1
11465,163926,2K1Z8MHkxSfa3IoXQMOOkvPRYry0VFvS,bWdj2GDclj5ofokWjzoa5jAwMkxCykd6,10,9,4,0,1,1,8,1,24,3.4285714285714284,2,0.0,0,4,0,1,9,1,0,8,1,5,19,0
11466,163933,caAQbOI1NkkZKVF3oGPK3OdsY0lbDlYb,RXDvfPUBYFlVdlueBFbLW0mhhAyGEqpt,1,0,0,0,0,0,2,0,2,0.2857142857142857,1,0.0,0,0,0,0,0,0,0,2,0,0,2,1
11467,163943,MIuMzVdl8gwQZWh4ux7IRLhRo5aprHQC,SpATywNh6bZuzm8s1ceuBUnMUAeoAHHw,1,0,0,0,0,0,1,0,1,0.14285714285714285,1,0.0,0,0,0,0,0,0,0,1,0,0,1,1
11468,163953,YgxPec9PZk03SxcMpde0DWwnbgHU13wT,SpATywNh6bZuzm8s1ceuBUnMUAeoAHHw,1,0,0,0,0,0,1,0,1,0.14285714285714285,1,0.0,0,0,0,0,0,0,0,1,0,0,1,1
11469,163958,0bsBNQsCMEE2O55Mpr8lzwhfGggHG2nb,SpATywNh6bZuzm8s1ceuBUnMUAeoAHHw,5,2,1,0,1,0,2,0,6,0.8571428571428571,1,0.0,0,1,0,1,2,0,0,2,0,2,4,1
11470,163964,ncIBIt1kRS23NRG3HklaOrwS2ep1UY7z,SpATywNh6bZuzm8s1ceuBUnMUAeoAHHw,2,0,0,0,0,0,2,0,2,0.2857142857142857,1,0.0,0,0,0,0,0,0,0,2,0,0,2,1
11471,163969,0bsBNQsCMEE2O55Mpr8lzwhfGggHG2nb,G8EPVSXsOYB5YQWZGiz1aVq5Pgr2GrQu,5,2,1,0,1,0,2,0,6,0.8571428571428571,1,0.0,0,1,0,1,2,0,0,2,0,2,4,1
11472,163989,u4a9xsMW9UMqx1X32x8LQI0FlTLRy0KL,SpATywNh6bZuzm8s1ceuBUnMUAeoAHHw,2,0,0,0,0,9,1,0,10,1.4285714285714286,1,0.0,0,0,0,0,0,9,0,1,0,0,10,0
11473,163991,anEiPiaERCYvJFKhHPaXaVlQmETZOxzh,SpATywNh6bZuzm8s1ceuBUnMUAeoAHHw,1,0,0,0,0,0,2,0,2,0.2857142857142857,1,0.0,0,0,0,0,0,0,0,2,0,0,2,1
11474,163992,RiuaU3j9glvJbW4ph026KXgBcE6tugPM,RXDvfPUBYFlVdlueBFbLW0mhhAyGEqpt,1,0,0,0,0,0,1,0,1,0.14285714285714285,1,0.0,0,0,0,0,0,0,0,1,0,0,1,1
11475,164011,JRm4q27yt4AaEMn6KL3V0UaldpldX8N9,SpATywNh6bZuzm8s1ceuBUnMUAeoAHHw,6,1,1,0,1,0,4,0,7,1.0,2,0.0,0,1,0,1,1,0,0,4,0,2,5,1
11476,164016,2CKOPbc4gInQJsnnTPuzmf6nPJ7m7X0V,bWdj2GDclj5ofokWjzoa5jAwMkxCykd6,1,0,0,0,0,0,1,0,1,0.14285714285714285,1,0.0,0,0,0,0,0,0,0,1,0,0,1,1
11477,164019,zDzmXMYgrAR2y36omcEUWoshe9A93Rqa,G8EPVSXsOYB5YQWZGiz1aVq5Pgr2GrQu,3,2,0,0,0,0,4,0,6,0.8571428571428571,1,0.0,0,0,0,0,2,0,0,4,0,0,6,1
11478,164042,HmNDAe5361OzVlrz8LBClXTWLyGOsfB7,SpATywNh6bZuzm8s1ceuBUnMUAeoAHHw,11,12,3,0,2,9,14,0,40,5.714285714285714,2,0.0,0,3,0,2,12,9,0,14,0,5,35,1
11479,164055,eeroiGZDLkmy8hYlMjhf0wHZNeoAekbw,SpATywNh6bZuzm8s1ceuBUnMUAeoAHHw,9,19,7,0,2,1,7,0,36,5.142857142857143,4,0.0,0,7,0,2,19,1,0,7,0,9,27,1
11480,164057,YKkBpxb8WAuGDSQU1z7LvNmikgJLWtZj,SpATywNh6bZuzm8s1ceuBUnMUAeoAHHw,14,23,1,6,1,0,9,0,40,5.714285714285714,4,0.0,1,1,5,1,22,0,1,9,0,8,32,1
11481,164069,NoDqq3WQEPxb31LrvCuk6iDV8wGhNbVA,G8EPVSXsOYB5YQWZGiz1aVq5Pgr2GrQu,17,25,12,24,8,0,3,0,72,10.285714285714286,3,0.0,9,12,18,8,16,0,6,3,0,47,25,1
11482,164070,Rv6gVo5TL2yRLbTriDaWEPebl1P4Qs2d,SpATywNh6bZuzm8s1ceuBUnMUAeoAHHw,15,39,17,13,7,27,11,0,114,16.285714285714285,3,0.0,3,17,12,7,36,27,1,11,0,39,75,1
11483,164080,om0kp3yKpxrkFaqYJciQiQMcbCOWwtTu,SpATywNh6bZuzm8s1ceuBUnMUAeoAHHw,7,6,3,0,2,1,3,1,16,2.2857142857142856,1,0.0,1,3,0,2,5,1,0,3,1,6,10,1
11484,164082,p3rNyoksJ9TEfFEu0f5KZsbSwUZIEvsu,SpATywNh6bZuzm8s1ceuBUnMUAeoAHHw,15,11,4,10,3,2,5,3,38,5.428571428571429,1,0.0,3,4,8,3,8,2,2,5,3,18,20,1
11485,164084,sjjMSkWB5IXcRcDmE2j3kfDFuBFIoN8k,bWdj2GDclj5ofokWjzoa5jAwMkxCykd6,12,21,9,26,6,1,9,1,73,10.428571428571429,1,0.0,6,9,25,6,15,1,1,9,1,46,27,1
11486,164085,EstzqNEYeufsEWzgLWtGlb7e6FUCscoH,SpATywNh6bZuzm8s1ceuBUnMUAeoAHHw,1,0,0,0,0,0,1,0,1,0.14285714285714285,1,0.0,0,0,0,0,0,0,0,1,0,0,1,1
11487,164096,WZJCLDDXV5Wl4Svb3H2g8hACnctxCrNZ,G8EPVSXsOYB5YQWZGiz1aVq5Pgr2GrQu,9,6,2,8,1,0,4,1,22,3.142857142857143,1,0.0,4,2,6,1,2,0,2,4,1,13,9,1
11488,164099,T0RArQ3lSZeSD0MbnDejlzkMufYho8lt,bWdj2GDclj5ofokWjzoa5jAwMkxCykd6,12,12,8,0,8,0,7,2,37,5.285714285714286,3,0.0,0,8,0,8,12,0,0,7,2,16,21,1
11489,164103,LuPgMCIdX2ugHzDAngaEsA394qOat0id,bWdj2GDclj5ofokWjzoa5jAwMkxCykd6,6,9,4,0,0,0,8,0,21,3.0,2,0.0,0,4,0,0,9,0,0,8,0,4,17,1
11490,164104,e6HjcHFSQL7s0bn6pVFAYgFBkk1qs0K8,SpATywNh6bZuzm8s1ceuBUnMUAeoAHHw,4,4,0,0,0,0,2,0,6,0.8571428571428571,1,0.0,1,0,0,0,3,0,0,2,0,1,5,1
11491,164133,C800geUBh3GYBhoh4cW6ReKUGj5LAMGi,RXDvfPUBYFlVdlueBFbLW0mhhAyGEqpt,1,0,0,0,0,0,1,0,1,0.14285714285714285,1,0.0,0,0,0,0,0,0,0,1,0,0,1,1
11492,164145,sG64hLkOLC3BnIsKXDBdltBd6B2Qop5m,SpATywNh6bZuzm8s1ceuBUnMUAeoAHHw,16,23,19,0,13,2,5,0,62,8.857142857142858,3,0.0,0,19,0,13,23,2,0,5,0,32,30,1
11493,164147,jSIHGu9DhhauxAb5p4KNEdGcYL30YLp5,SpATywNh6bZuzm8s1ceuBUnMUAeoAHHw,13,10,1,26,1,0,15,1,54,7.714285714285714,2,0.0,4,1,21,1,6,0,5,15,1,27,27,1
11494,164151,qxuL6lm7O1L6ePIrQ7pAlpyCErX7NoG2,G8EPVSXsOYB5YQWZGiz1aVq5Pgr2GrQu,2,0,0,0,0,0,2,0,2,0.2857142857142857,1,0.0,0,0,0,0,0,0,0,2,0,0,2,0
11495,164161,hf4d4QAFiVVt3bxQ1i3sb92NQtXr4NWg,RXDvfPUBYFlVdlueBFbLW0mhhAyGEqpt,7,5,3,0,1,0,3,0,12,1.7142857142857142,1,0.0,0,3,0,1,5,0,0,3,0,4,8,1
11496,164166,VNMcZCNkGFRxehwmtxH5s6s6Jm24lIUf,G8EPVSXsOYB5YQWZGiz1aVq5Pgr2GrQu,6,8,3,0,2,0,2,0,15,2.142857142857143,1,0.0,3,3,0,2,5,0,0,2,0,8,7,1
11497,164169,g8GaCwXJUf6SPnVxk3h41vOpn1g2rMNj,G8EPVSXsOYB5YQWZGiz1aVq5Pgr2GrQu,25,19,13,20,5,5,11,1,74,10.571428571428571,2,0.0,0,13,18,5,19,5,2,11,1,36,38,1
11498,164174,CVy4kNAaUGvRYYQgXmKQWG6L2OSWreYS,SpATywNh6bZuzm8s1ceuBUnMUAeoAHHw,10,12,1,0,2,1,6,1,23,3.2857142857142856,2,0.0,3,1,0,2,9,1,0,6,1,6,17,1
11499,164183,w4DmyCRPmcVeeul1i1ztSEkbof1km1Nb,bWdj2GDclj5ofokWjzoa5jAwMkxCykd6,5,2,1,0,1,0,2,0,6,0.8571428571428571,1,0.0,0,1,0,1,2,0,0,2,0,2,4,1
11500,164193,ciqNol40it2TXmTV6HAJsQTHc113ipRy,bWdj2GDclj5ofokWjzoa5jAwMkxCykd6,10,24,7,56,5,0,10,0,102,14.571428571428571,2,0.0,11,7,56,5,13,0,0,10,0,79,23,1
11501,164194,nGALou9220OOdyTmGQUn7ZDRMR4UkSXJ,SpATywNh6bZuzm8s1ceuBUnMUAeoAHHw,13,5,4,0,3,0,6,1,19,2.7142857142857144,1,0.0,0,4,0,3,5,0,0,6,1,7,12,1
11502,164206,2YuUQch1UOdzblixrhGJqRyfiL57cYEN,RXDvfPUBYFlVdlueBFbLW0mhhAyGEqpt,2,0,0,0,0,0,2,0,2,0.2857142857142857,1,0.0,0,0,0,0,0,0,0,2,0,0,2,1
11503,164227,DSUKhhpRDohNouwSJME8rOv0HnE7IUjD,G8EPVSXsOYB5YQWZGiz1aVq5Pgr2GrQu,5,1,1,0,1,1,2,0,6,0.8571428571428571,1,0.0,0,1,0,1,1,1,0,2,0,2,4,1
11504,164233,kuZwBvEdgeUtKZ495C2FptBbxEtLtmVH,G8EPVSXsOYB5YQWZGiz1aVq5Pgr2GrQu,9,6,3,0,0,0,7,0,16,2.2857142857142856,2,0.0,0,3,0,0,6,0,0,7,0,3,13,1
11505,164239,puEuN6Xf1uW7cjSgYlTKI73OSHVfNsuZ,SpATywNh6bZuzm8s1ceuBUnMUAeoAHHw,13,12,6,0,4,8,5,1,36,5.142857142857143,1,0.0,5,6,0,4,7,8,0,5,1,15,21,1
11506,164242,wFvodFqghxL7iISMFbYXkYNq6P6eK5gH,bWdj2GDclj5ofokWjzoa5jAwMkxCykd6,1,0,0,0,0,0,2,0,2,0.2857142857142857,1,0.0,0,0,0,0,0,0,0,2,0,0,2,1
11507,164251,vBJL7coMRkaE4FxkSvahGksjBaWY15De,bWdj2GDclj5ofokWjzoa5jAwMkxCykd6,5,2,1,0,1,2,2,0,8,1.1428571428571428,1,0.0,0,1,0,1,2,2,0,2,0,2,6,1
11508,164258,Or6EoLeKHgxe5lrewrc5kj5wcFrtEOsX,G8EPVSXsOYB5YQWZGiz1aVq5Pgr2GrQu,16,20,5,34,2,0,3,0,64,9.142857142857142,4,0.0,2,5,29,2,18,0,5,3,0,38,26,1
11509,164264,Kch5WBTMofTOaqsqvrCwdJnTOQRJP2KH,RXDvfPUBYFlVdlueBFbLW0mhhAyGEqpt,8,5,4,0,2,0,1,0,12,1.7142857142857142,1,0.0,0,4,0,2,5,0,0,1,0,6,6,1
11510,164274,oTNjNy2VCNhMEHkpw5RoIwGj6ModXkSd,SpATywNh6bZuzm8s1ceuBUnMUAeoAHHw,8,2,2,0,2,0,5,0,11,1.5714285714285714,1,0.0,0,2,0,2,2,0,0,5,0,4,7,1
11511,164282,wBacPbVnOV4SRh0JUUHmWhDIds03R7aM,bWdj2GDclj5ofokWjzoa5jAwMkxCykd6,15,23,14,66,5,0,11,0,119,17.0,5,0.0,3,14,63,5,20,0,3,11,0,85,34,1
11512,164286,kargVzTieknsOD52RwWWxzR3bhPo7xCn,bWdj2GDclj5ofokWjzoa5jAwMkxCykd6,2,0,0,0,0,0,2,0,2,0.2857142857142857,1,0.0,0,0,0,0,0,0,0,2,0,0,2,1
11513,164289,OimNh540xAgKAtol4nYQSyjwRKBWvHjV,bWdj2GDclj5ofokWjzoa5jAwMkxCykd6,9,23,8,0,4,1,9,2,47,6.714285714285714,2,0.0,0,8,0,4,23,1,0,9,2,12,35,1
11514,164305,wm5eo4PFQKBWWCDwO21MewWgtJRcPge6,SpATywNh6bZuzm8s1ceuBUnMUAeoAHHw,9,8,5,0,3,1,8,2,27,3.857142857142857,2,0.0,0,5,0,3,8,1,0,8,2,8,19,1
11515,164309,kIQJn1ZGNZIZ21dizjiWH4EHSNMGXOiq,SpATywNh6bZuzm8s1ceuBUnMUAeoAHHw,6,2,1,0,1,0,3,0,7,1.0,1,0.0,0,1,0,1,2,0,0,3,0,2,5,1
11516,164315,cYibpCaMUGq0WjgUWfTv0iIvJ7QbFj5E,bWdj2GDclj5ofokWjzoa5jAwMkxCykd6,1,0,0,0,0,0,1,0,1,0.14285714285714285,1,0.0,0,0,0,0,0,0,0,1,0,0,1,0
11517,164330,5JojY8Vvgh7rjfcAS5764ZRMTC8fo9QP,G8EPVSXsOYB5YQWZGiz1aVq5Pgr2GrQu,21,31,0,36,1,0,4,0,72,10.285714285714286,1,0.0,15,0,28,1,16,0,8,4,0,44,28,1
11518,164370,K6SnVyYj4JLYSaBAXjv9gYLyrrnyqRP0,SpATywNh6bZuzm8s1ceuBUnMUAeoAHHw,4,0,0,0,0,1,5,0,6,0.8571428571428571,1,0.0,0,0,0,0,0,1,0,5,0,0,6,1
11519,164371,5fUv2a4WMEi2Bc60cQo0Uzo1I7SufPfI,RXDvfPUBYFlVdlueBFbLW0mhhAyGEqpt,21,26,0,52,1,15,9,6,109,15.571428571428571,2,0.0,6,0,48,1,20,15,4,9,6,55,54,1
11520,164373,HIaaOq9UrLvo3UC4FIJStVsYhdTvdkJ9,SpATywNh6bZuzm8s1ceuBUnMUAeoAHHw,10,12,0,10,0,0,5,0,27,3.857142857142857,1,0.0,3,0,8,0,9,0,2,5,0,11,16,1
11521,164374,ocTIjxG8zBs0mQRpUtpuAKc7MDpzU7Sd,bWdj2GDclj5ofokWjzoa5jAwMkxCykd6,19,19,8,34,6,19,14,0,100,14.285714285714286,2,0.0,8,8,30,6,11,19,4,14,0,52,48,0
11522,164380,V3KgKcJl8bgXAGMp5c8bz9HnZzQfd0IE,SpATywNh6bZuzm8s1ceuBUnMUAeoAHHw,22,35,17,6,9,9,4,0,80,11.428571428571429,2,0.0,0,17,5,9,35,9,1,4,0,31,49,1
11523,164385,zhF9aamFaaPbw8uvKpkg1m1HOa3rg91T,RXDvfPUBYFlVdlueBFbLW0mhhAyGEqpt,34,25,19,0,13,0,7,0,64,9.142857142857142,3,0.0,0,19,0,13,25,0,0,7,0,32,32,1
11524,164389,9XEvRIJ3KorQF4OT61u2doOr3f5pwaHZ,bWdj2GDclj5ofokWjzoa5jAwMkxCykd6,3,3,1,0,0,0,1,0,5,0.7142857142857143,1,0.0,0,1,0,0,3,0,0,1,0,1,4,1
11525,164392,vfnNYDz3ao0khQiXn6s0MRVTGqDcFM0x,bWdj2GDclj5ofokWjzoa5jAwMkxCykd6,5,5,0,0,1,0,3,1,10,1.4285714285714286,1,0.0,3,0,0,1,2,0,0,3,1,4,6,1
11526,164393,gh8ZFa6DAiOnR8V5MntcWerJGzv2wFJI,SpATywNh6bZuzm8s1ceuBUnMUAeoAHHw,15,24,9,4,5,3,5,0,50,7.142857142857143,2,0.0,10,9,4,5,14,3,0,5,0,28,22,1
11527,164397,xmv8WUz0fQb7fJNMHkcUN733RgAFZjFP,bWdj2GDclj5ofokWjzoa5jAwMkxCykd6,5,10,1,0,1,0,6,0,18,2.5714285714285716,1,0.0,2,1,0,1,8,0,0,6,0,4,14,1
11528,164398,0dNy0sRvDF0sROrAnnVZV2SWJaZTZV2q,SpATywNh6bZuzm8s1ceuBUnMUAeoAHHw,3,2,0,0,0,0,1,0,3,0.42857142857142855,1,0.0,0,0,0,0,2,0,0,1,0,0,3,1
11529,164408,O7I8HNg1rvyItYLfAtm0x1WuepktYnst,SpATywNh6bZuzm8s1ceuBUnMUAeoAHHw,8,11,4,0,4,1,1,0,21,3.0,1,0.0,0,4,0,4,11,1,0,1,0,8,13,1
11530,164422,svMXR8fHg4TBhSD6JDFH6qsNGvdxTr0h,RXDvfPUBYFlVdlueBFbLW0mhhAyGEqpt,11,7,0,0,0,2,8,1,18,2.5714285714285716,1,0.0,0,0,0,0,7,2,0,8,1,0,18,1
11531,164439,g61tiKR5XFhd8PF4WUyM648Aa5Kvlcf3,G8EPVSXsOYB5YQWZGiz1aVq5Pgr2GrQu,6,1,1,0,1,4,4,0,11,1.5714285714285714,2,0.0,0,1,0,1,1,4,0,4,0,2,9,1
11532,164459,viXqqg0vx2jNkZn6Nty7fAz4j4zmpVoE,SpATywNh6bZuzm8s1ceuBUnMUAeoAHHw,20,48,19,23,4,30,21,2,147,21.0,8,0.0,10,19,18,4,38,30,5,21,2,51,96,0
11533,164462,gD7dR7qYBA1tFY5jHEs9UR01plTA8iId,SpATywNh6bZuzm8s1ceuBUnMUAeoAHHw,20,32,15,11,7,2,4,0,71,10.142857142857142,3,0.0,5,15,10,7,27,2,1,4,0,37,34,0
11534,164463,aczUQgOO0ASt0xksHzYEHmyu3n5i1eK4,SpATywNh6bZuzm8s1ceuBUnMUAeoAHHw,10,14,8,0,4,0,8,0,34,4.857142857142857,1,0.0,3,8,0,4,11,0,0,8,0,15,19,1
11535,164464,Xg16SpIo3MJ3Q7kbAScLhtP5JZXXJDfv,SpATywNh6bZuzm8s1ceuBUnMUAeoAHHw,8,6,4,0,3,0,3,0,16,2.2857142857142856,1,0.0,0,4,0,3,6,0,0,3,0,7,9,1
11536,164465,viXqqg0vx2jNkZn6Nty7fAz4j4zmpVoE,G8EPVSXsOYB5YQWZGiz1aVq5Pgr2GrQu,13,14,6,0,5,0,2,0,27,3.857142857142857,1,0.0,0,6,0,5,14,0,0,2,0,11,16,1
11537,164466,4IAsFbl3b7m8BHNHwE02AfsOFCbBUG0L,SpATywNh6bZuzm8s1ceuBUnMUAeoAHHw,6,4,2,0,2,0,1,0,9,1.2857142857142858,1,0.0,1,2,0,2,3,0,0,1,0,5,4,1
11538,164470,XF7WFiRmBAV2t6CIl4aiymZi2mf5tiFp,SpATywNh6bZuzm8s1ceuBUnMUAeoAHHw,9,3,2,0,2,0,6,0,13,1.8571428571428572,1,0.0,0,2,0,2,3,0,0,6,0,4,9,1
11539,164490,c6KChK06Rh7fb4zwLQYLlfB5pAi9XDtG,bWdj2GDclj5ofokWjzoa5jAwMkxCykd6,8,4,4,0,4,0,3,0,15,2.142857142857143,1,0.0,0,4,0,4,4,0,0,3,0,8,7,1
11540,164493,hjoHxSgIY6b9g4BQWlz8arItNzc0bPJL,G8EPVSXsOYB5YQWZGiz1aVq5Pgr2GrQu,5,2,1,0,1,0,2,0,6,0.8571428571428571,1,0.0,0,1,0,1,2,0,0,2,0,2,4,1
11541,164502,gjOO3qwnQCAatqMKu7gZIW5sztiBAppS,SpATywNh6bZuzm8s1ceuBUnMUAeoAHHw,1,0,0,0,0,0,2,0,2,0.2857142857142857,2,0.0,0,0,0,0,0,0,0,2,0,0,2,1
11542,164506,uydIb4MWCn95KWcEhKwj3VRfjvxXo8Nj,RXDvfPUBYFlVdlueBFbLW0mhhAyGEqpt,6,4,3,0,0,0,2,0,9,1.2857142857142858,1,0.0,0,3,0,0,4,0,0,2,0,3,6,1
11543,164510,mMPoHvW2FNyPz9OBdiCmgMl0cCEFfarc,SpATywNh6bZuzm8s1ceuBUnMUAeoAHHw,10,19,6,0,4,5,3,0,37,5.285714285714286,1,0.0,5,6,0,4,14,5,0,3,0,15,22,1
11544,164511,uydIb4MWCn95KWcEhKwj3VRfjvxXo8Nj,G8EPVSXsOYB5YQWZGiz1aVq5Pgr2GrQu,5,3,2,0,0,0,2,0,7,1.0,1,0.0,0,2,0,0,3,0,0,2,0,2,5,1
11545,164512,Pkfxv8tlzjsegGEz3Xh7AUnCzKYEVDxE,bWdj2GDclj5ofokWjzoa5jAwMkxCykd6,6,4,2,0,1,0,3,0,10,1.4285714285714286,1,0.0,0,2,0,1,4,0,0,3,0,3,7,1
11546,164521,VKk9JpwG9p3VFd3uL9koumwFrK1tXoky,RXDvfPUBYFlVdlueBFbLW0mhhAyGEqpt,10,5,4,0,3,0,2,0,14,2.0,1,0.0,0,4,0,3,5,0,0,2,0,7,7,1
11547,164540,jPMuHTmaLyG60VmyNtfExbwyn5kE5j3d,bWdj2GDclj5ofokWjzoa5jAwMkxCykd6,1,0,0,0,0,0,1,0,1,0.14285714285714285,1,0.0,0,0,0,0,0,0,0,1,0,0,1,1
11548,164543,SFDSK6D3ITcq2gCqSV4NXsxobQMiKjKb,bWdj2GDclj5ofokWjzoa5jAwMkxCykd6,5,2,1,0,1,0,3,0,7,1.0,1,0.0,0,1,0,1,2,0,0,3,0,2,5,1
11549,164548,w7L1HWyOfKnPicf69CWEIAgi9ciJCz91,SpATywNh6bZuzm8s1ceuBUnMUAeoAHHw,11,12,1,12,0,0,3,1,29,4.142857142857143,1,0.0,7,1,10,0,5,0,2,3,1,18,11,1
11550,164549,uDLEkuBy3ymjXkWGDerrVKjWfVpjtLcy,SpATywNh6bZuzm8s1ceuBUnMUAeoAHHw,13,18,4,10,3,0,3,2,40,5.714285714285714,1,0.0,10,4,9,3,8,0,1,3,2,26,14,1
11551,164551,Cs1l7tXWhg4bHVkjgKntjzb2IwXtRhyR,RXDvfPUBYFlVdlueBFbLW0mhhAyGEqpt,5,2,1,0,1,0,3,0,7,1.0,1,0.0,0,1,0,1,2,0,0,3,0,2,5,1
11552,164563,PFKfwO5QSawWdwaylbr1GRPNNNfcQLNj,SpATywNh6bZuzm8s1ceuBUnMUAeoAHHw,23,31,13,22,9,6,16,1,98,14.0,3,0.0,13,13,17,9,18,6,5,16,1,52,46,1
11553,164564,ldTrxeIYDfkDUNaJhbVmYcQDlmvbdP2w,bWdj2GDclj5ofokWjzoa5jAwMkxCykd6,10,3,2,0,2,0,6,0,13,1.8571428571428572,1,0.0,0,2,0,2,3,0,0,6,0,4,9,1
11554,164569,p5rebimhkI0boSbnQg3KGGgWIQAEeFXU,SpATywNh6bZuzm8s1ceuBUnMUAeoAHHw,5,4,2,0,1,2,2,0,11,1.5714285714285714,1,0.0,0,2,0,1,4,2,0,2,0,3,8,1
11555,164572,Vlk2b9egCmW1kemn8Fl1v1olMRLDZnR0,SpATywNh6bZuzm8s1ceuBUnMUAeoAHHw,7,4,3,0,2,0,3,0,12,1.7142857142857142,1,0.0,0,3,0,2,4,0,0,3,0,5,7,1
11556,164577,LzbTNpWVn6fl2StGvYLxuW4MppuRwiQH,G8EPVSXsOYB5YQWZGiz1aVq5Pgr2GrQu,13,10,1,28,0,0,1,0,40,5.714285714285714,1,0.0,0,1,24,0,10,0,4,1,0,25,15,1
11557,164579,qo9UDSPYx7cYCq1gHLr348Aal9eXzAVb,SpATywNh6bZuzm8s1ceuBUnMUAeoAHHw,5,2,1,0,1,0,2,0,6,0.8571428571428571,1,0.0,0,1,0,1,2,0,0,2,0,2,4,1
11558,164584,cd5M4uWjG6TOaf0Pz31O3hIF99iIERs5,RXDvfPUBYFlVdlueBFbLW0mhhAyGEqpt,5,6,1,0,0,1,2,0,10,1.4285714285714286,2,0.0,2,1,0,0,4,1,0,2,0,3,7,1
11559,164589,sXsn7NeZRfEp7S6T00dl609YN1DnViK8,bWdj2GDclj5ofokWjzoa5jAwMkxCykd6,5,2,1,0,1,0,2,0,6,0.8571428571428571,1,0.0,0,1,0,1,2,0,0,2,0,2,4,1
11560,164590,JHnOuSquWHAEnk5XcKmxcm446qLMalAz,SpATywNh6bZuzm8s1ceuBUnMUAeoAHHw,13,32,12,15,9,1,7,0,76,10.857142857142858,1,0.0,9,12,14,9,23,1,1,7,0,44,32,0
11561,164593,SufYsQHcxz6kvXSXszQU44Defcxsd4P8,RXDvfPUBYFlVdlueBFbLW0mhhAyGEqpt,20,30,20,14,8,2,11,6,91,13.0,5,0.0,3,20,14,8,27,2,0,11,6,45,46,1
11562,164595,Mjc1uhwVJSwBIY7NCmz9HAIqxkVGiNWp,SpATywNh6bZuzm8s1ceuBUnMUAeoAHHw,1,0,0,0,0,0,1,0,1,0.14285714285714285,1,0.0,0,0,0,0,0,0,0,1,0,0,1,1
11563,164597,WI9rk8aS11tBAJzjcX0JSIgomYYRQVjW,G8EPVSXsOYB5YQWZGiz1aVq5Pgr2GrQu,4,3,1,0,1,0,1,0,6,0.8571428571428571,1,0.0,0,1,0,1,3,0,0,1,0,2,4,1
11564,164607,2TfX1z2kNH0aJpmX3zI7D0BaWO1JZh1N,G8EPVSXsOYB5YQWZGiz1aVq5Pgr2GrQu,7,2,1,0,1,2,3,0,9,1.2857142857142858,1,0.0,0,1,0,1,2,2,0,3,0,2,7,1
11565,164613,EBMQHva9lsULDK4s7iJrovR7inTeu6Ks,SpATywNh6bZuzm8s1ceuBUnMUAeoAHHw,14,22,9,11,5,0,3,0,50,7.142857142857143,3,0.0,7,9,9,5,15,0,2,3,0,30,20,1
11566,164627,rCsU9p98QKUXEKegYmRuzzYV8BmhIRdS,SpATywNh6bZuzm8s1ceuBUnMUAeoAHHw,1,0,0,0,0,0,1,0,1,0.14285714285714285,1,0.0,0,0,0,0,0,0,0,1,0,0,1,1
11567,164640,Oi8ENv1r0fh4xZfmyvx6AY0XCiLDaP57,SpATywNh6bZuzm8s1ceuBUnMUAeoAHHw,5,2,1,0,1,0,2,0,6,0.8571428571428571,1,0.0,0,1,0,1,2,0,0,2,0,2,4,1
11568,164641,mneYPOl2fXbFIQgZuY7V0tw2SDw7ktpW,SpATywNh6bZuzm8s1ceuBUnMUAeoAHHw,8,11,2,0,0,0,5,0,18,2.5714285714285716,3,0.0,0,2,0,0,11,0,0,5,0,2,16,1
11569,164643,YxEAEqB4R6GTRBWDvga1GWE0URAxGc6U,bWdj2GDclj5ofokWjzoa5jAwMkxCykd6,3,2,1,0,0,0,1,0,4,0.5714285714285714,1,0.0,0,1,0,0,2,0,0,1,0,1,3,1
11570,164646,iMWyVW74QNpkzwAJujvmKOU3siri8Fgn,RXDvfPUBYFlVdlueBFbLW0mhhAyGEqpt,21,22,9,15,9,0,3,0,58,8.285714285714286,2,0.0,11,9,15,9,11,0,0,3,0,44,14,1
11571,164653,NzAcUY76dhfwRLfnT8WUtgPXMkNyrCBL,SpATywNh6bZuzm8s1ceuBUnMUAeoAHHw,5,2,1,0,1,0,2,0,6,0.8571428571428571,1,0.0,0,1,0,1,2,0,0,2,0,2,4,1
11572,164659,xs8FwmyIICdFtTqViprbjnWxSS7J89Al,G8EPVSXsOYB5YQWZGiz1aVq5Pgr2GrQu,4,7,0,0,0,0,1,0,8,1.1428571428571428,1,0.0,3,0,0,0,4,0,0,1,0,3,5,1
11573,164660,yqw7ro5WJlrZH88vsKBmg60OfoWnl19q,SpATywNh6bZuzm8s1ceuBUnMUAeoAHHw,6,6,2,0,2,0,2,0,12,1.7142857142857142,2,0.0,0,2,0,2,6,0,0,2,0,4,8,1
11574,164673,5HX4czL6Sp8ee3UX2kWAHqmFW5CMMTjE,SpATywNh6bZuzm8s1ceuBUnMUAeoAHHw,1,0,0,0,0,0,1,0,1,0.14285714285714285,1,0.0,0,0,0,0,0,0,0,1,0,0,1,1
11575,164676,3SCBHiEI4HvwPrOQDNTIAqp1rZOAx5IK,SpATywNh6bZuzm8s1ceuBUnMUAeoAHHw,13,11,6,16,3,0,3,0,39,5.571428571428571,2,0.0,3,6,14,3,8,0,2,3,0,26,13,1
11576,164679,3SCBHiEI4HvwPrOQDNTIAqp1rZOAx5IK,G8EPVSXsOYB5YQWZGiz1aVq5Pgr2GrQu,27,9,5,142,0,0,5,0,161,23.0,3,0.0,0,5,124,0,9,0,18,5,0,129,32,1
11577,164683,RLJL0sLgyeMOTE7yAIublGPUVoAHuvDx,G8EPVSXsOYB5YQWZGiz1aVq5Pgr2GrQu,18,17,16,20,10,0,2,0,65,9.285714285714286,1,0.0,0,16,16,10,17,0,4,2,0,42,23,1
11578,164692,yc3vj6DBU7J8xD482LnMAUcmHp7gOl84,SpATywNh6bZuzm8s1ceuBUnMUAeoAHHw,1,0,0,0,0,0,3,0,3,0.42857142857142855,2,0.0,0,0,0,0,0,0,0,3,0,0,3,1
11579,164727,caSt06ZROuiH9pArEzpLM7jwlm2pIP8u,SpATywNh6bZuzm8s1ceuBUnMUAeoAHHw,1,0,0,0,0,0,3,0,3,0.42857142857142855,1,0.0,0,0,0,0,0,0,0,3,0,0,3,1
11580,164748,m5oXLk5fStXUe1mP1ujV3P2Gk727qBkB,SpATywNh6bZuzm8s1ceuBUnMUAeoAHHw,1,0,0,0,0,0,1,0,1,0.14285714285714285,1,0.0,0,0,0,0,0,0,0,1,0,0,1,1
11581,164756,tedGThhHMqVARfBh6zyzyocTKbTJYJpB,RXDvfPUBYFlVdlueBFbLW0mhhAyGEqpt,5,3,2,0,0,0,2,0,7,1.0,1,0.0,0,2,0,0,3,0,0,2,0,2,5,1
11582,164761,DhCQzcFGsfZK6cdFiI5FQU3kb44TMCVX,SpATywNh6bZuzm8s1ceuBUnMUAeoAHHw,3,0,0,0,0,1,2,0,3,0.42857142857142855,1,0.0,0,0,0,0,0,1,0,2,0,0,3,1
11583,164774,ztw81mUsVcWqQkxlUbURYmOFyO40Z11S,SpATywNh6bZuzm8s1ceuBUnMUAeoAHHw,1,0,0,0,0,0,1,0,1,0.14285714285714285,1,0.0,0,0,0,0,0,0,0,1,0,0,1,1
11584,164777,VGDu6m0Ea8YNSzlZeUPCdOS7FC8K56j0,SpATywNh6bZuzm8s1ceuBUnMUAeoAHHw,12,23,10,19,4,0,6,0,62,8.857142857142858,4,0.0,2,10,16,4,21,0,3,6,0,32,30,1
11585,164782,AZ1a6e6HDgHh4sN10TmubQgIG7lRhvX7,bWdj2GDclj5ofokWjzoa5jAwMkxCykd6,3,3,1,0,0,1,1,0,6,0.8571428571428571,1,0.0,0,1,0,0,3,1,0,1,0,1,5,1
11586,164783,HNOiqLBLlemqEjDq99MX1KCbGHtf7sfC,SpATywNh6bZuzm8s1ceuBUnMUAeoAHHw,6,4,2,0,1,1,5,0,13,1.8571428571428572,2,0.0,0,2,0,1,4,1,0,5,0,3,10,1
11587,164784,vuyiZXIHubBxUI6I8fEoaPJZI5irtStd,SpATywNh6bZuzm8s1ceuBUnMUAeoAHHw,12,22,16,0,10,1,7,2,58,8.285714285714286,2,0.0,2,16,0,10,20,1,0,7,2,28,30,1
11588,164789,0drSvAjmQGn3JsM9rLj67sU9ycFdNRi4,SpATywNh6bZuzm8s1ceuBUnMUAeoAHHw,5,13,0,0,1,0,1,0,15,2.142857142857143,2,0.0,3,0,0,1,10,0,0,1,0,4,11,1
11589,164810,j9RRCN4Cgg3M5ymRYEPqwWpJ0OwCWsXl,G8EPVSXsOYB5YQWZGiz1aVq5Pgr2GrQu,1,0,0,0,0,0,1,0,1,0.14285714285714285,1,0.0,0,0,0,0,0,0,0,1,0,0,1,1
11590,164876,jqdafBVztOaU7B8oBuajiXxvz1FDItGv,SpATywNh6bZuzm8s1ceuBUnMUAeoAHHw,1,0,0,0,0,0,1,0,1,0.14285714285714285,1,0.0,0,0,0,0,0,0,0,1,0,0,1,1
11591,164881,R7ptDQN35cKkqrWYU1EoWDk89h01yGje,RXDvfPUBYFlVdlueBFbLW0mhhAyGEqpt,1,0,0,0,0,0,1,0,1,0.14285714285714285,1,0.0,0,0,0,0,0,0,0,1,0,0,1,1
11592,164889,DivG3ogmCJeK3pKkDuguqXmAxv3265HB,bWdj2GDclj5ofokWjzoa5jAwMkxCykd6,8,11,1,0,2,0,10,0,24,3.4285714285714284,2,0.0,2,1,0,2,9,0,0,10,0,5,19,1
11593,164895,fr5elk998a9p9TdUbECrRSQ9rGDS8c9D,SpATywNh6bZuzm8s1ceuBUnMUAeoAHHw,3,0,0,0,0,1,2,0,3,0.42857142857142855,1,0.0,0,0,0,0,0,1,0,2,0,0,3,1
11594,164900,vqI4nA1oYdvinhdwhAimFfTLZs6qGSC5,G8EPVSXsOYB5YQWZGiz1aVq5Pgr2GrQu,8,6,2,4,2,0,2,0,16,2.2857142857142856,1,0.0,3,2,3,2,3,0,1,2,0,10,6,1
11595,164909,DttwjifTB7tngrOzE4lsIB8DzMDnSPZc,SpATywNh6bZuzm8s1ceuBUnMUAeoAHHw,8,2,1,0,1,1,6,1,12,1.7142857142857142,1,0.0,0,1,0,1,2,1,0,6,1,2,10,0
11596,164914,VAF0Nhm4Uogjf17s6SveryaIcEEMWJow,SpATywNh6bZuzm8s1ceuBUnMUAeoAHHw,6,7,2,0,2,0,2,0,13,1.8571428571428572,2,0.0,0,2,0,2,7,0,0,2,0,4,9,1
11597,164918,R7wdnz7rd7yU47Qq2pD3NnafkKkL5gzl,bWdj2GDclj5ofokWjzoa5jAwMkxCykd6,3,2,0,0,0,0,1,0,3,0.42857142857142855,1,0.0,0,0,0,0,2,0,0,1,0,0,3,1
11598,164919,re5aCokPT0KNmuJHbgQvisAT0CcTxib5,SpATywNh6bZuzm8s1ceuBUnMUAeoAHHw,7,5,1,0,1,0,3,0,10,1.4285714285714286,2,0.0,0,1,0,1,5,0,0,3,0,2,8,1
11599,164922,JYJhzhhLcfWnYO62UZR1KbHHs0q9wRVk,bWdj2GDclj5ofokWjzoa5jAwMkxCykd6,13,18,12,0,11,5,14,3,63,9.0,3,0.0,0,12,0,11,18,5,0,14,3,23,40,1
11600,164923,Zoez9P6Io2KASPtKsQZfhyeC8nEU9r7r,SpATywNh6bZuzm8s1ceuBUnMUAeoAHHw,9,3,2,0,2,1,6,0,14,2.0,1,0.0,0,2,0,2,3,1,0,6,0,4,10,1
11601,164927,qr1Y8xuPrcpdzScNHYsirGXqasfUdOVa,bWdj2GDclj5ofokWjzoa5jAwMkxCykd6,8,10,6,0,3,1,8,0,28,4.0,2,0.0,0,6,0,3,10,1,0,8,0,9,19,1
11602,164937,i39wrwOFUT4cBFVx9tMMQ3lQ2qJwZK9W,G8EPVSXsOYB5YQWZGiz1aVq5Pgr2GrQu,4,7,1,0,0,0,2,0,10,1.4285714285714286,1,0.0,0,1,0,0,7,0,0,2,0,1,9,1
11603,164942,OOJh2Yrr6RQf9QAHFBo7EBzeZ2OAmLfw,bWdj2GDclj5ofokWjzoa5jAwMkxCykd6,5,5,2,0,1,0,2,0,10,1.4285714285714286,2,0.0,0,2,0,1,5,0,0,2,0,3,7,1
11604,164944,stWyUqkAGnjcutkepILPjL3dk2mkjbHM,SpATywNh6bZuzm8s1ceuBUnMUAeoAHHw,1,0,0,0,0,0,1,0,1,0.14285714285714285,1,0.0,0,0,0,0,0,0,0,1,0,0,1,1
11605,164953,8lCrBaMkcXk8KsL7M8AYgjnsyFuSP4yK,RXDvfPUBYFlVdlueBFbLW0mhhAyGEqpt,9,10,7,0,3,0,3,0,23,3.2857142857142856,2,0.0,0,7,0,3,10,0,0,3,0,10,13,1
11606,164975,QWhWii7LiCaC2aGmlsc9abDahkygX2yj,RXDvfPUBYFlVdlueBFbLW0mhhAyGEqpt,35,54,1,52,16,6,15,2,146,20.857142857142858,3,0.0,39,1,52,16,15,6,0,15,2,108,38,1
11607,164977,PEXlBba7AOVIBit4NUGVqaiGwqnJFccE,SpATywNh6bZuzm8s1ceuBUnMUAeoAHHw,7,2,1,0,1,1,6,7,18,2.5714285714285716,1,0.0,0,1,0,1,2,1,0,6,7,2,16,1
11608,164986,lOmRRXGlwgiYmSj7mCzKIIlzTAddACO4,G8EPVSXsOYB5YQWZGiz1aVq5Pgr2GrQu,5,3,0,0,0,0,2,0,5,0.7142857142857143,1,0.0,0,0,0,0,3,0,0,2,0,0,5,1
11609,164996,jXdIWOuPNFgWCy1owZ0YCDgHmNjNpxj3,A3fsA9Zfv1X2fVEQhTw51lKENdNrEqT3,1,0,0,0,0,0,1,0,1,0.14285714285714285,1,0.0,0,0,0,0,0,0,0,1,0,0,1,1
11610,165010,vl5hKvQ1HbHB8mWdynets5dYianhkkEw,SpATywNh6bZuzm8s1ceuBUnMUAeoAHHw,23,26,2,41,1,2,8,0,80,11.428571428571429,1,0.0,9,2,34,1,17,2,7,8,0,46,34,1
11611,165032,KAsAnmW0W2sAx9iOumNKdePG23m5o5NZ,G8EPVSXsOYB5YQWZGiz1aVq5Pgr2GrQu,5,2,1,0,1,0,2,0,6,0.8571428571428571,1,0.0,0,1,0,1,2,0,0,2,0,2,4,1
11612,165033,YtmzH8LgN5OvtPELquH1F749iO0gQ3Tb,A3fsA9Zfv1X2fVEQhTw51lKENdNrEqT3,2,0,0,0,0,0,2,0,2,0.2857142857142857,1,0.0,0,0,0,0,0,0,0,2,0,0,2,1
11613,165036,qLiLNfiu26gzDxiYwA4Ap7WJgGvbO54T,G8EPVSXsOYB5YQWZGiz1aVq5Pgr2GrQu,18,11,10,18,9,0,1,0,49,7.0,1,0.0,0,10,14,9,11,0,4,1,0,33,16,1
11614,165060,YroV7xThop5SUet6C6S1SEBaTvc7XX29,bWdj2GDclj5ofokWjzoa5jAwMkxCykd6,4,2,1,0,1,0,1,0,5,0.7142857142857143,1,0.0,0,1,0,1,2,0,0,1,0,2,3,1
11615,165071,gW23nkmgj3NMln4Q9bQA0x4tJhRu8aiU,SpATywNh6bZuzm8s1ceuBUnMUAeoAHHw,16,25,11,16,6,0,10,1,69,9.857142857142858,1,0.0,6,11,15,6,19,0,1,10,1,38,31,1
11616,165081,L0W17t6QNDHcTTYTnmTQY5Vw4L806sfw,SpATywNh6bZuzm8s1ceuBUnMUAeoAHHw,9,7,5,0,3,0,3,0,18,2.5714285714285716,2,0.0,0,5,0,3,7,0,0,3,0,8,10,1
11617,165092,HA5bOUyNRCHCSCRIajqqX7k2ZeKuADcF,A3fsA9Zfv1X2fVEQhTw51lKENdNrEqT3,1,0,0,0,0,0,1,0,1,0.14285714285714285,1,0.0,0,0,0,0,0,0,0,1,0,0,1,1
11618,165093,S58o7T8J2JcEBTi3bdMATXeMdhJbXqYq,A3fsA9Zfv1X2fVEQhTw51lKENdNrEqT3,3,0,0,0,0,0,4,0,4,0.5714285714285714,1,0.0,0,0,0,0,0,0,0,4,0,0,4,1
11619,165099,eSLdnCsz2kfsBjZ0LZmqHuo4kYNor6E7,SpATywNh6bZuzm8s1ceuBUnMUAeoAHHw,20,22,1,17,0,7,3,0,50,7.142857142857143,1,0.0,6,1,17,0,16,7,0,3,0,24,26,1
11620,165101,RdxIloCKNwZUjAJCbmYybZmkq8rwh2UY,bWdj2GDclj5ofokWjzoa5jAwMkxCykd6,4,2,1,0,1,0,1,0,5,0.7142857142857143,1,0.0,0,1,0,1,2,0,0,1,0,2,3,1
11621,165138,iqnxkAIvXEPq7LutRrGOzst5meEvTsYz,SpATywNh6bZuzm8s1ceuBUnMUAeoAHHw,15,13,5,1,4,0,8,0,31,4.428571428571429,3,0.0,5,5,1,4,8,0,0,8,0,15,16,1
11622,165145,DSvps80WgA0EgfU877YLgHsnaYGMmkvB,SpATywNh6bZuzm8s1ceuBUnMUAeoAHHw,8,3,2,0,2,7,3,1,18,2.5714285714285716,1,0.0,0,2,0,2,3,7,0,3,1,4,14,1
11623,165151,CXDFvBGg10x2RDdl5BC09Fv76dN9FJm7,G8EPVSXsOYB5YQWZGiz1aVq5Pgr2GrQu,18,25,11,16,3,2,2,0,59,8.428571428571429,2,0.0,7,11,9,3,18,2,7,2,0,30,29,1
11624,165162,5VFQZe1xiEoGXldz0K3uPFcNAeVpHehR,SpATywNh6bZuzm8s1ceuBUnMUAeoAHHw,10,4,4,0,3,0,4,0,15,2.142857142857143,1,0.0,0,4,0,3,4,0,0,4,0,7,8,1
11625,165188,3G9snyduwX0rdXWU1KviPhf7GghlChs3,RXDvfPUBYFlVdlueBFbLW0mhhAyGEqpt,10,12,7,0,1,4,11,0,35,5.0,1,0.0,0,7,0,1,12,4,0,11,0,8,27,1
11626,165191,gR8vpBOtEmg1p0U3mlFoyPZ2gKmD8M8k,A3fsA9Zfv1X2fVEQhTw51lKENdNrEqT3,1,0,0,0,0,0,1,0,1,0.14285714285714285,1,0.0,0,0,0,0,0,0,0,1,0,0,1,1
11627,165219,wxXN8RNX3CwZNnolATAAIEVSki3SPiEo,SpATywNh6bZuzm8s1ceuBUnMUAeoAHHw,2,0,0,0,0,0,2,0,2,0.2857142857142857,1,0.0,0,0,0,0,0,0,0,2,0,0,2,1
11628,165237,gKv0B6A68Wpl10k5COv8OtVYBXqYOYRH,SpATywNh6bZuzm8s1ceuBUnMUAeoAHHw,1,0,0,0,0,0,1,0,1,0.14285714285714285,1,0.0,0,0,0,0,0,0,0,1,0,0,1,1
11629,165253,muJ6MIRhOdDL6SrbHsZ7Ks5a50Iz9AeC,bWdj2GDclj5ofokWjzoa5jAwMkxCykd6,5,2,1,0,1,0,2,0,6,0.8571428571428571,1,0.0,0,1,0,1,2,0,0,2,0,2,4,0
11630,165271,jcO499WyDjlHOvUgk4ks7QVYWjH4e9LQ,SpATywNh6bZuzm8s1ceuBUnMUAeoAHHw,1,0,0,0,0,0,1,0,1,0.14285714285714285,1,0.0,0,0,0,0,0,0,0,1,0,0,1,1
11631,165281,GFb1F59UyYIHTp4jDg01zdNYbr3jH9yn,SpATywNh6bZuzm8s1ceuBUnMUAeoAHHw,11,5,3,0,2,3,8,2,23,3.2857142857142856,1,0.0,0,3,0,2,5,3,0,8,2,5,18,1
11632,165285,GFb1F59UyYIHTp4jDg01zdNYbr3jH9yn,A3fsA9Zfv1X2fVEQhTw51lKENdNrEqT3,1,0,0,0,0,0,1,0,1,0.14285714285714285,1,0.0,0,0,0,0,0,0,0,1,0,0,1,1
11633,165290,ACy24Kiib1ICxyQzhy0EUbYqbqlHiujI,bWdj2GDclj5ofokWjzoa5jAwMkxCykd6,10,8,3,0,2,1,4,1,19,2.7142857142857144,1,0.0,0,3,0,2,8,1,0,4,1,5,14,1
11634,165308,FGZPr41giRou6aZ5USTD1C0RRSJGXFKn,G8EPVSXsOYB5YQWZGiz1aVq5Pgr2GrQu,8,7,3,0,2,0,2,0,14,2.0,1,0.0,0,3,0,2,7,0,0,2,0,5,9,1
11635,165339,LOR1iUTDul78F0nRew73RCh87CQAgj7q,SpATywNh6bZuzm8s1ceuBUnMUAeoAHHw,1,0,0,0,0,0,1,0,1,0.14285714285714285,1,0.0,0,0,0,0,0,0,0,1,0,0,1,1
11636,165347,oaoj9be4jW2Hot8wYgYrzLRvB0RU4KYy,RXDvfPUBYFlVdlueBFbLW0mhhAyGEqpt,5,8,4,0,1,0,4,0,17,2.4285714285714284,4,0.0,0,4,0,1,8,0,0,4,0,5,12,1
11637,165351,5NsbP59FWlyl4NFONUzt3drLLr5EFRFj,SpATywNh6bZuzm8s1ceuBUnMUAeoAHHw,2,0,0,0,0,0,2,0,2,0.2857142857142857,1,0.0,0,0,0,0,0,0,0,2,0,0,2,1
11638,165355,gmPDrqW0AqIaoYWNfDXV8E4PTJ0tnkbT,SpATywNh6bZuzm8s1ceuBUnMUAeoAHHw,10,4,3,0,1,5,8,1,22,3.142857142857143,1,0.0,0,3,0,1,4,5,0,8,1,4,18,1
11639,165387,eXv6ACzt62C4hMSoDSIQMvmz4LEnGBtm,bWdj2GDclj5ofokWjzoa5jAwMkxCykd6,6,4,3,0,2,0,2,0,11,1.5714285714285714,1,0.0,0,3,0,2,4,0,0,2,0,5,6,1
11640,165391,4BWY4WoZwowebQpACrizuzaSUpqFUPYV,SpATywNh6bZuzm8s1ceuBUnMUAeoAHHw,7,2,0,0,0,1,8,2,13,1.8571428571428572,1,0.0,0,0,0,0,2,1,0,8,2,0,13,1
11641,165395,wJflvpFe05Aoyiv7JkqhQs7iDcvnIpoZ,SpATywNh6bZuzm8s1ceuBUnMUAeoAHHw,3,0,0,0,0,0,4,0,4,0.5714285714285714,1,0.0,0,0,0,0,0,0,0,4,0,0,4,1
11642,165397,4BWY4WoZwowebQpACrizuzaSUpqFUPYV,RXDvfPUBYFlVdlueBFbLW0mhhAyGEqpt,1,0,0,0,0,0,2,0,2,0.2857142857142857,1,0.0,0,0,0,0,0,0,0,2,0,0,2,1
11643,165408,PpFcLwYNJUnxth5yje9ruR1epB1qasdR,G8EPVSXsOYB5YQWZGiz1aVq5Pgr2GrQu,1,0,0,0,0,0,1,0,1,0.14285714285714285,1,0.0,0,0,0,0,0,0,0,1,0,0,1,1
11644,165416,7gfKKxmAEuUaewGGeFJgV5nEPJNQy1ri,bWdj2GDclj5ofokWjzoa5jAwMkxCykd6,6,3,1,0,1,0,2,0,7,1.0,1,0.0,0,1,0,1,3,0,0,2,0,2,5,1
11645,165421,MuPHXkwjCSwz1RoycqAjYJvCwPC5fRHQ,SpATywNh6bZuzm8s1ceuBUnMUAeoAHHw,4,2,0,0,0,0,3,0,5,0.7142857142857143,1,0.0,0,0,0,0,2,0,0,3,0,0,5,0
11646,165424,unnmDTt6VikDSSld76xj3NnZu4moxEml,SpATywNh6bZuzm8s1ceuBUnMUAeoAHHw,4,2,1,0,1,0,1,0,5,0.7142857142857143,1,0.0,0,1,0,1,2,0,0,1,0,2,3,1
11647,165443,Q9be6Sv8ddFyvZit7vIIJ8yY710RxCDU,A3fsA9Zfv1X2fVEQhTw51lKENdNrEqT3,2,0,0,0,0,0,3,0,3,0.42857142857142855,1,0.0,0,0,0,0,0,0,0,3,0,0,3,1
11648,165466,mURbRAHPKPnW9MwIb0RLcTIXqQNH7qbA,G8EPVSXsOYB5YQWZGiz1aVq5Pgr2GrQu,8,4,3,4,2,0,1,0,14,2.0,1,0.0,0,3,3,2,4,0,1,1,0,8,6,1
11649,165471,zrTXSfdUWbNWByIycayXKhWX2nhPdOah,SpATywNh6bZuzm8s1ceuBUnMUAeoAHHw,5,3,2,0,2,0,2,0,9,1.2857142857142858,1,0.0,0,2,0,2,3,0,0,2,0,4,5,1
11650,165474,ef55znmweQJrijlI0fO1Ekc271nZnV0m,bWdj2GDclj5ofokWjzoa5jAwMkxCykd6,4,0,0,0,0,0,3,1,4,0.5714285714285714,1,0.0,0,0,0,0,0,0,0,3,1,0,4,1
11651,165476,wg9kzusa79hS4fFC5hU9Laht66GWJcDA,SpATywNh6bZuzm8s1ceuBUnMUAeoAHHw,2,0,0,0,0,0,2,0,2,0.2857142857142857,1,0.0,0,0,0,0,0,0,0,2,0,0,2,1
11652,165480,u8gc5TatjVTaxEyEUtNlqAAFJuTBFyST,SpATywNh6bZuzm8s1ceuBUnMUAeoAHHw,1,0,0,0,0,0,1,0,1,0.14285714285714285,1,0.0,0,0,0,0,0,0,0,1,0,0,1,1
11653,165494,kVwgJQqzaO15lvZkwwinpycbi4tCASRL,G8EPVSXsOYB5YQWZGiz1aVq5Pgr2GrQu,17,23,3,18,4,13,2,1,64,9.142857142857142,1,0.0,15,3,10,4,8,13,8,2,1,32,32,1
11654,165498,khqyesGKZx6MpifmBhKg4XXFdITB5Rat,bWdj2GDclj5ofokWjzoa5jAwMkxCykd6,2,0,0,0,0,0,2,0,2,0.2857142857142857,1,0.0,0,0,0,0,0,0,0,2,0,0,2,1
11655,165517,K96pKWxanyeEDM8caXTjQInVlZNIUXf3,SpATywNh6bZuzm8s1ceuBUnMUAeoAHHw,25,19,9,19,6,15,11,2,81,11.571428571428571,2,0.0,7,9,16,6,12,15,3,11,2,38,43,1
11656,165533,CTzsOL49UPUArAP2sAfnnQhe79FdliFF,A3fsA9Zfv1X2fVEQhTw51lKENdNrEqT3,7,8,1,0,1,0,2,0,12,1.7142857142857142,1,0.0,2,1,0,1,6,0,0,2,0,4,8,1
11657,165544,cLRv4oHsLxWfkE6gs4eN6fO5y0RK8Odw,SpATywNh6bZuzm8s1ceuBUnMUAeoAHHw,21,22,3,23,1,0,5,0,54,7.714285714285714,2,0.0,7,3,22,1,15,0,1,5,0,33,21,1
11658,165551,8HRO39ObdbulUBajMG3YAwK0YHdJtgkL,SpATywNh6bZuzm8s1ceuBUnMUAeoAHHw,13,19,5,20,2,0,1,0,47,6.714285714285714,1,0.0,10,5,17,2,9,0,3,1,0,34,13,1
11659,165561,31ac9IJz27HinkIEt0yrmmYrar7i8NEX,SpATywNh6bZuzm8s1ceuBUnMUAeoAHHw,1,0,0,0,0,0,1,0,1,0.14285714285714285,1,0.0,0,0,0,0,0,0,0,1,0,0,1,1
11660,165574,JfftjOGdDbpgbrupi0Gwr899R0jzXikJ,G8EPVSXsOYB5YQWZGiz1aVq5Pgr2GrQu,17,18,10,0,5,2,9,1,45,6.428571428571429,4,0.0,0,10,0,5,18,2,0,9,1,15,30,1
11661,165575,8aKlO5cCI4yOnqtrz5S83gXv1equhodS,G8EPVSXsOYB5YQWZGiz1aVq5Pgr2GrQu,8,8,2,0,3,0,3,0,16,2.2857142857142856,1,0.0,6,2,0,3,2,0,0,3,0,11,5,1
11662,165579,L1KQaJmsFUgy5JpGUsnj3yIIihvD4WWY,SpATywNh6bZuzm8s1ceuBUnMUAeoAHHw,7,10,5,0,2,0,2,0,19,2.7142857142857144,1,0.0,3,5,0,2,7,0,0,2,0,10,9,1
11663,165580,qoIGs6RP8XMC5yN9VowJtSVp77FsPrRk,bWdj2GDclj5ofokWjzoa5jAwMkxCykd6,16,16,8,4,6,1,6,4,45,6.428571428571429,2,0.0,1,8,4,6,15,1,0,6,4,19,26,1
11664,165594,JlrarspOUiM43Q1LxxzJX6UJ5zQZ4pa3,G8EPVSXsOYB5YQWZGiz1aVq5Pgr2GrQu,4,2,1,0,1,0,1,0,5,0.7142857142857143,1,0.0,0,1,0,1,2,0,0,1,0,2,3,1
11665,165631,GEZRjwL8K0Izm01jtEreajWlGeO5rHqg,SpATywNh6bZuzm8s1ceuBUnMUAeoAHHw,10,9,3,22,1,0,5,0,40,5.714285714285714,2,0.0,3,3,18,1,6,0,4,5,0,25,15,1
11666,165637,OLNUzQUHvlNsi2WFlH5eEyaieqKXrEz7,G8EPVSXsOYB5YQWZGiz1aVq5Pgr2GrQu,1,0,0,0,0,0,1,0,1,0.14285714285714285,1,0.0,0,0,0,0,0,0,0,1,0,0,1,1
11667,165660,Jxd0Gyi2eFjuuzujg1eSA5QBX1QonMfb,A3fsA9Zfv1X2fVEQhTw51lKENdNrEqT3,8,8,7,0,7,0,4,0,26,3.7142857142857144,1,0.0,0,7,0,7,8,0,0,4,0,14,12,1
11668,165668,e4SJlWpUdMlW0LkwuTE29pgj3noS6rgx,SpATywNh6bZuzm8s1ceuBUnMUAeoAHHw,1,0,0,0,0,0,2,0,2,0.2857142857142857,2,0.0,0,0,0,0,0,0,0,2,0,0,2,1
11669,165670,ec1LcdXAjzvm4pz4UlXIURCzEb68OOjY,SpATywNh6bZuzm8s1ceuBUnMUAeoAHHw,1,0,0,0,0,0,1,0,1,0.14285714285714285,1,0.0,0,0,0,0,0,0,0,1,0,0,1,0
11670,165671,ldzbIC4VdNsM8t2O505cyUmYK0rWwYfY,bWdj2GDclj5ofokWjzoa5jAwMkxCykd6,5,0,0,0,0,0,4,1,5,0.7142857142857143,1,0.0,0,0,0,0,0,0,0,4,1,0,5,1
11671,165674,q8fKbbyHDwglzqbsTcqtDnNuKFFWoakG,SpATywNh6bZuzm8s1ceuBUnMUAeoAHHw,5,2,1,0,1,0,2,0,6,0.8571428571428571,1,0.0,0,1,0,1,2,0,0,2,0,2,4,1
11672,165687,rzRsiRIy5S5PJ3F6R6iAFiLgtXERTKGk,SpATywNh6bZuzm8s1ceuBUnMUAeoAHHw,12,16,9,0,2,1,5,1,34,4.857142857142857,1,0.0,0,9,0,2,16,1,0,5,1,11,23,1
11673,165704,aBWIo3Zb0x1GrHxSSFQ0sr4ViufznfA6,bWdj2GDclj5ofokWjzoa5jAwMkxCykd6,2,0,0,0,0,0,5,0,5,0.7142857142857143,2,0.0,0,0,0,0,0,0,0,5,0,0,5,0
11674,165720,EelpZh5xWl6mtPCPTTMGh3oiYl9f9eIu,SpATywNh6bZuzm8s1ceuBUnMUAeoAHHw,4,3,2,0,0,0,1,0,6,0.8571428571428571,1,0.0,0,2,0,0,3,0,0,1,0,2,4,1
11675,165753,K7gxH2H2bYXoDZcS1lp3t0a4OCfbOLwQ,bWdj2GDclj5ofokWjzoa5jAwMkxCykd6,6,1,1,0,1,0,5,0,8,1.1428571428571428,1,0.0,0,1,0,1,1,0,0,5,0,2,6,1
11676,165754,K6ObBSwI3jvthL8D7fF5vG4yQ857Kh2f,SpATywNh6bZuzm8s1ceuBUnMUAeoAHHw,1,0,0,0,0,0,1,0,1,0.14285714285714285,1,0.0,0,0,0,0,0,0,0,1,0,0,1,1
11677,165767,hbzbE3YW3TFJZGn3KQWHVTTu9qGbrE8v,bWdj2GDclj5ofokWjzoa5jAwMkxCykd6,5,2,1,0,1,0,2,0,6,0.8571428571428571,1,0.0,0,1,0,1,2,0,0,2,0,2,4,1
11678,165772,HpI5z92WE9TCj3JyfZi0b0yrE9hT84vs,A3fsA9Zfv1X2fVEQhTw51lKENdNrEqT3,1,0,0,0,0,0,1,0,1,0.14285714285714285,1,0.0,0,0,0,0,0,0,0,1,0,0,1,1
11679,165774,OOTqWE5x0MzBGyALni92jmdLSQIdjajZ,G8EPVSXsOYB5YQWZGiz1aVq5Pgr2GrQu,5,4,1,0,0,0,3,0,8,1.1428571428571428,1,0.0,0,1,0,0,4,0,0,3,0,1,7,1
11680,165784,rh0SgumcqbNnCp7Kv0VptrPMVPtrWDm8,RXDvfPUBYFlVdlueBFbLW0mhhAyGEqpt,1,0,0,0,0,0,1,0,1,0.14285714285714285,1,0.0,0,0,0,0,0,0,0,1,0,0,1,1
11681,165796,0Au7FrQGJI1dB5PAH0C5RtkL9GE7xsrQ,G8EPVSXsOYB5YQWZGiz1aVq5Pgr2GrQu,2,0,0,0,0,0,2,0,2,0.2857142857142857,1,0.0,0,0,0,0,0,0,0,2,0,0,2,1
11682,165809,Be8IM2i8TFABf4hrPs9xmqBicVH2EMoi,SpATywNh6bZuzm8s1ceuBUnMUAeoAHHw,5,2,1,0,1,0,2,0,6,0.8571428571428571,1,0.0,0,1,0,1,2,0,0,2,0,2,4,1
11683,165832,DsEUYz6X9eluw7uMTIk0Bks5jShm3Kz4,3VkHkmOtom3jM2wCu94xgzzu1d6Dn7or,5,3,2,0,2,0,1,0,8,1.1428571428571428,1,0.0,0,2,0,2,3,0,0,1,0,4,4,1
11684,165846,Dz9gcg38PEU0fPFKHBbhZdSYwftI3l5X,3VkHkmOtom3jM2wCu94xgzzu1d6Dn7or,4,2,1,0,1,0,1,0,5,0.7142857142857143,1,0.0,0,1,0,1,2,0,0,1,0,2,3,1
11685,165856,KAuI6A5sA3ZNhLENslgd2DMjOIVYSO57,3VkHkmOtom3jM2wCu94xgzzu1d6Dn7or,4,2,1,0,1,0,1,0,5,0.7142857142857143,1,0.0,0,1,0,1,2,0,0,1,0,2,3,1
11686,165860,VcIThiQQYy7X3fiKdorfTP06QuBPs7wb,3VkHkmOtom3jM2wCu94xgzzu1d6Dn7or,1,0,0,0,0,0,1,0,1,0.14285714285714285,1,0.0,0,0,0,0,0,0,0,1,0,0,1,1
11687,165870,iJ66ruppQ2ZGC9u9YoS6QTRYWukYIDHU,3VkHkmOtom3jM2wCu94xgzzu1d6Dn7or,4,2,1,0,1,0,1,0,5,0.7142857142857143,1,0.0,0,1,0,1,2,0,0,1,0,2,3,1
11688,165887,7fjHAZUsGh8E9GJNOmIK1zgkCrHxz6Gk,3VkHkmOtom3jM2wCu94xgzzu1d6Dn7or,4,2,1,0,1,0,1,0,5,0.7142857142857143,1,0.0,0,1,0,1,2,0,0,1,0,2,3,1
11689,165891,yoZNAuzIqGqES06DFjFVEjyfKc4SxTA2,3VkHkmOtom3jM2wCu94xgzzu1d6Dn7or,4,2,1,0,1,0,1,0,5,0.7142857142857143,1,0.0,0,1,0,1,2,0,0,1,0,2,3,1
11690,165899,hv7ufOIfPrDN5pcGE1HpmOksTENQn7IA,3VkHkmOtom3jM2wCu94xgzzu1d6Dn7or,3,0,0,0,0,2,7,0,9,1.2857142857142858,1,0.0,0,0,0,0,0,2,0,7,0,0,9,1
11691,165901,gs5hsE793p6vIwUmTj73hL5b3aFfrcXj,3VkHkmOtom3jM2wCu94xgzzu1d6Dn7or,5,2,1,0,1,0,2,0,6,0.8571428571428571,1,0.0,0,1,0,1,2,0,0,2,0,2,4,1
11692,165904,ZR3eaF7l6jay1l4TTUpJmfveN2PkauBJ,3VkHkmOtom3jM2wCu94xgzzu1d6Dn7or,4,0,0,0,0,0,7,1,8,1.1428571428571428,2,0.0,0,0,0,0,0,0,0,7,1,0,8,1
11693,165906,GSPOB3yRCsx1EoYGjPY73PCVbsYZcZfm,3VkHkmOtom3jM2wCu94xgzzu1d6Dn7or,8,15,6,5,5,3,3,0,37,5.285714285714286,2,0.0,7,6,4,5,8,3,1,3,0,22,15,1
11694,165907,mGZldDR5Izkdgn7Vr6A8rGIFa3IGgTNq,3VkHkmOtom3jM2wCu94xgzzu1d6Dn7or,1,0,0,0,0,0,1,0,1,0.14285714285714285,1,0.0,0,0,0,0,0,0,0,1,0,0,1,1
11695,165909,kfJTMMKERAVHubqtM8uKI9oGQ8qEzoGo,3VkHkmOtom3jM2wCu94xgzzu1d6Dn7or,4,2,1,0,1,0,1,0,5,0.7142857142857143,1,0.0,0,1,0,1,2,0,0,1,0,2,3,1
11696,165919,IjFWXq6Kv9kQBKxl05fLnKmzdzXFPd2S,3VkHkmOtom3jM2wCu94xgzzu1d6Dn7or,1,0,0,0,0,0,2,0,2,0.2857142857142857,1,0.0,0,0,0,0,0,0,0,2,0,0,2,1
11697,165923,Ae22hvALqv0MxUz0BtfyFRCZH8Unzasl,fbPkOYLVPtPgIt0MxizjfFJov3JbHyAi,9,6,2,0,1,0,4,0,13,1.8571428571428572,1,0.0,0,2,0,1,6,0,0,4,0,3,10,1
11698,165924,g4PsrTaWbf4PyAkwCyr7KPRrkKd1GQUF,fbPkOYLVPtPgIt0MxizjfFJov3JbHyAi,47,85,55,27,42,0,7,0,216,30.857142857142858,1,0.0,22,55,19,42,63,0,8,7,0,138,78,1
11699,165929,N0ztuAsLjfbstbT2QmcILqqvk7xyZRdK,fbPkOYLVPtPgIt0MxizjfFJov3JbHyAi,4,2,0,0,0,4,5,0,11,1.5714285714285714,1,0.0,0,0,0,0,2,4,0,5,0,0,11,1
11700,165932,2DzEePfp8vI6Xs0JiVvwLEBMcAhSfVlO,fbPkOYLVPtPgIt0MxizjfFJov3JbHyAi,27,15,13,0,11,0,2,0,41,5.857142857142857,1,0.0,0,13,0,11,15,0,0,2,0,24,17,1
11701,165933,AFquoviJC5pTQRr2e6rOoJKhtZPD68e6,fbPkOYLVPtPgIt0MxizjfFJov3JbHyAi,1,0,0,0,0,0,1,0,1,0.14285714285714285,1,0.0,0,0,0,0,0,0,0,1,0,0,1,1
11702,165935,n1KDgjl33Pixp3I97r6srvTiO5SuF7Nz,fbPkOYLVPtPgIt0MxizjfFJov3JbHyAi,2,0,0,0,0,0,3,0,3,0.42857142857142855,1,0.0,0,0,0,0,0,0,0,3,0,0,3,1
11703,165936,dEMaD0MQ8e6kvzK6uTaTqEapXiabfWOZ,fbPkOYLVPtPgIt0MxizjfFJov3JbHyAi,1,0,0,0,0,0,1,0,1,0.14285714285714285,1,0.0,0,0,0,0,0,0,0,1,0,0,1,1
11704,165937,Tinpz4fjOCtpep3uA5BTGuPzKNOjU7rZ,fbPkOYLVPtPgIt0MxizjfFJov3JbHyAi,8,2,1,0,1,0,6,1,11,1.5714285714285714,1,0.0,0,1,0,1,2,0,0,6,1,2,9,1
11705,165938,0KJ4hMwNKcU4u0kRo24XysZZkRQaIxT8,fbPkOYLVPtPgIt0MxizjfFJov3JbHyAi,11,6,4,0,3,1,5,0,19,2.7142857142857144,1,0.0,0,4,0,3,6,1,0,5,0,7,12,1
11706,165940,xQ2BABxu01BWouoal36eufzFXJFj8740,fbPkOYLVPtPgIt0MxizjfFJov3JbHyAi,5,2,1,0,1,0,4,0,8,1.1428571428571428,1,0.0,0,1,0,1,2,0,0,4,0,2,6,1
11707,165941,sYY4KU9duRm2WvtJaAqFW3lrzMYM9YTK,fbPkOYLVPtPgIt0MxizjfFJov3JbHyAi,1,0,0,0,0,0,1,0,1,0.14285714285714285,1,0.0,0,0,0,0,0,0,0,1,0,0,1,1
11708,165945,L4G4vKN8ytBRvs68XcSQcEruocF5VrXF,fbPkOYLVPtPgIt0MxizjfFJov3JbHyAi,11,12,4,1,7,0,5,0,29,4.142857142857143,1,0.0,7,4,1,7,5,0,0,5,0,19,10,1
11709,165946,PkAoACuemSFXbpeGyaVjPpfHQnZGDRZj,fbPkOYLVPtPgIt0MxizjfFJov3JbHyAi,1,0,0,0,0,0,1,0,1,0.14285714285714285,1,0.0,0,0,0,0,0,0,0,1,0,0,1,1
11710,165948,hkJlttz5bDZp3UAkxISJCqbBUU7zCJGE,fbPkOYLVPtPgIt0MxizjfFJov3JbHyAi,6,5,1,0,2,0,2,0,10,1.4285714285714286,1,0.0,2,1,0,2,3,0,0,2,0,5,5,1
11711,165950,nD4vzUC5IhneshAQmhqAnl7GVhvdL4Oa,fbPkOYLVPtPgIt0MxizjfFJov3JbHyAi,6,5,4,0,3,0,2,0,14,2.0,1,0.0,0,4,0,3,5,0,0,2,0,7,7,1
11712,165952,9qEU7W2Isd4L4gGJxLIjYzA3Il6E8bpq,fbPkOYLVPtPgIt0MxizjfFJov3JbHyAi,1,0,0,0,0,0,1,0,1,0.14285714285714285,1,0.0,0,0,0,0,0,0,0,1,0,0,1,1
11713,165953,Xi5jJx0Z2MOBm1fPpYwlvuzwElYhyszd,fbPkOYLVPtPgIt0MxizjfFJov3JbHyAi,8,6,3,0,1,0,3,1,14,2.0,1,0.0,0,3,0,1,6,0,0,3,1,4,10,1
11714,165959,nDEAbdtySU0D9dF3CpKEHZFDA8qmxdYa,fbPkOYLVPtPgIt0MxizjfFJov3JbHyAi,4,2,0,0,0,0,2,0,4,0.5714285714285714,1,0.0,0,0,0,0,2,0,0,2,0,0,4,1
11715,165960,7vIvISS7ijOom6TvJIkwXN5GvDUAFRxR,fbPkOYLVPtPgIt0MxizjfFJov3JbHyAi,1,0,0,0,0,0,1,0,1,0.14285714285714285,1,0.0,0,0,0,0,0,0,0,1,0,0,1,1
11716,165962,XVAhFtuqfyjnzPVdjpwB4j2TwuAUpbEa,fbPkOYLVPtPgIt0MxizjfFJov3JbHyAi,5,2,1,0,1,0,2,0,6,0.8571428571428571,1,0.0,0,1,0,1,2,0,0,2,0,2,4,1
11717,165966,ClOkOu5t4KsYmmlGT8TtbSp6RHO1dS7b,fbPkOYLVPtPgIt0MxizjfFJov3JbHyAi,15,25,11,10,14,0,6,0,66,9.428571428571429,2,0.0,12,11,9,14,13,0,1,6,0,46,20,1
11718,165968,m2dEISaBvHWrLGQEI5zibEiH1nbUMDmE,fbPkOYLVPtPgIt0MxizjfFJov3JbHyAi,10,7,5,0,4,0,4,0,20,2.857142857142857,2,0.0,0,5,0,4,7,0,0,4,0,9,11,1
11719,165971,No3uaZVX8QfUWi2WuoYFYrVrLQNiuZit,fbPkOYLVPtPgIt0MxizjfFJov3JbHyAi,15,34,17,0,4,6,8,0,69,9.857142857142858,4,0.0,8,17,0,4,26,6,0,8,0,29,40,0
11720,165972,1FTDLU0hMqcHLpAYkeifJZgSteMYLeP4,fbPkOYLVPtPgIt0MxizjfFJov3JbHyAi,12,12,8,0,6,0,4,0,30,4.285714285714286,2,0.0,1,8,0,6,11,0,0,4,0,15,15,1
11721,165973,hJvv1gUOmLiHeeVGHBEcsZYIwyTiE5ff,fbPkOYLVPtPgIt0MxizjfFJov3JbHyAi,9,3,2,0,2,0,4,0,11,1.5714285714285714,1,0.0,0,2,0,2,3,0,0,4,0,4,7,1
11722,165980,toJoC2Dz4pkE4Zg9u6dfUofCepqbYSQk,fbPkOYLVPtPgIt0MxizjfFJov3JbHyAi,4,2,0,0,0,0,4,0,6,0.8571428571428571,1,0.0,0,0,0,0,2,0,0,4,0,0,6,1
11723,165981,LbU1jyqO2EUpiuLYtgaX21ombTqyoZWL,fbPkOYLVPtPgIt0MxizjfFJov3JbHyAi,5,4,0,0,0,0,6,0,10,1.4285714285714286,1,0.0,0,0,0,0,4,0,0,6,0,0,10,1
11724,165984,UQfv7o9p9lV4lRkL1vVMlZTP2dPtcdzG,fbPkOYLVPtPgIt0MxizjfFJov3JbHyAi,5,3,1,0,1,0,2,0,7,1.0,1,0.0,0,1,0,1,3,0,0,2,0,2,5,1
11725,165985,UAzjSo4qDf1pkQceftDVLCKsvfzQ6NyU,fbPkOYLVPtPgIt0MxizjfFJov3JbHyAi,18,16,8,0,7,1,2,0,34,4.857142857142857,1,0.0,0,8,0,7,16,1,0,2,0,15,19,1
11726,165988,GE48LtSsMWryASGs1FlnEw40AwktRNOT,fbPkOYLVPtPgIt0MxizjfFJov3JbHyAi,7,3,2,0,2,8,4,0,19,2.7142857142857144,1,0.0,0,2,0,2,3,8,0,4,0,4,15,1
11727,165989,b5WncJSLsMNsvTtUX4GOshLjrNYBfS0U,fbPkOYLVPtPgIt0MxizjfFJov3JbHyAi,1,0,0,0,0,0,1,0,1,0.14285714285714285,1,0.0,0,0,0,0,0,0,0,1,0,0,1,1
11728,165992,Wt8lglrVLSreEoovOJIO0VXJgpwg81lv,fbPkOYLVPtPgIt0MxizjfFJov3JbHyAi,9,6,3,0,2,0,5,1,17,2.4285714285714284,1,0.0,0,3,0,2,6,0,0,5,1,5,12,1
11729,165993,8yNyyy8aPKd19nuqwaynaLkU67KuROpn,fbPkOYLVPtPgIt0MxizjfFJov3JbHyAi,17,10,9,0,9,0,2,0,30,4.285714285714286,1,0.0,0,9,0,9,10,0,0,2,0,18,12,1
11730,165994,O5kAlgXfdKVePlq806YxmEVko0qCkZzG,fbPkOYLVPtPgIt0MxizjfFJov3JbHyAi,1,0,0,0,0,0,2,0,2,0.2857142857142857,1,0.0,0,0,0,0,0,0,0,2,0,0,2,1
11731,165995,zDgM2vvltn6gXNx1hUBDd8fFebbnmmWo,fbPkOYLVPtPgIt0MxizjfFJov3JbHyAi,1,0,0,0,0,0,1,0,1,0.14285714285714285,1,0.0,0,0,0,0,0,0,0,1,0,0,1,1
11732,165996,LXj1WYMapfbcZixGvlzo4y3R5Bt3m0Vn,fbPkOYLVPtPgIt0MxizjfFJov3JbHyAi,1,0,0,0,0,0,1,0,1,0.14285714285714285,1,0.0,0,0,0,0,0,0,0,1,0,0,1,1
11733,166000,PMOSmRt4fRUG27WzPyEHqHKXX14Xi4NX,fbPkOYLVPtPgIt0MxizjfFJov3JbHyAi,1,0,0,0,0,0,1,0,1,0.14285714285714285,1,0.0,0,0,0,0,0,0,0,1,0,0,1,1
11734,166001,Hc6XZmx7ZQQRjy23848JYEBkgJsujUuY,fbPkOYLVPtPgIt0MxizjfFJov3JbHyAi,5,2,1,0,1,0,3,0,7,1.0,1,0.0,0,1,0,1,2,0,0,3,0,2,5,1
11735,166004,r5jinF0G0Atp0uUdWzFeA9Dxz6JBtOHv,fbPkOYLVPtPgIt0MxizjfFJov3JbHyAi,8,3,2,0,2,0,3,0,10,1.4285714285714286,1,0.0,0,2,0,2,3,0,0,3,0,4,6,1
11736,166007,ffImGRf9pvFQSBFckBEzUfl1PucCkATq,fbPkOYLVPtPgIt0MxizjfFJov3JbHyAi,1,0,0,0,0,0,1,0,1,0.14285714285714285,1,0.0,0,0,0,0,0,0,0,1,0,0,1,1
11737,166008,q4qRNKt6T9G0qxbDK4nh8fPY4HlIZJpN,fbPkOYLVPtPgIt0MxizjfFJov3JbHyAi,1,0,0,0,0,0,1,0,1,0.14285714285714285,1,0.0,0,0,0,0,0,0,0,1,0,0,1,1
11738,166010,jTd3OCBirsXRXozKADIUhKrXCVzIgRme,fbPkOYLVPtPgIt0MxizjfFJov3JbHyAi,11,21,6,0,8,0,3,0,38,5.428571428571429,1,0.0,14,6,0,8,7,0,0,3,0,28,10,1
11739,166011,T2B2X3gb5fdopiXu62Tu4E2DMy7sMSD1,fbPkOYLVPtPgIt0MxizjfFJov3JbHyAi,1,0,0,0,0,0,1,0,1,0.14285714285714285,1,0.0,0,0,0,0,0,0,0,1,0,0,1,1
11740,166016,vpmKK2fvh0wwuItw5yJ4YzfFSwaX4K1i,fbPkOYLVPtPgIt0MxizjfFJov3JbHyAi,1,0,0,0,0,0,1,0,1,0.14285714285714285,1,0.0,0,0,0,0,0,0,0,1,0,0,1,1
11741,166017,ImymTAbHJfMMMPKBwnuXmdPedLhaLLQ4,fbPkOYLVPtPgIt0MxizjfFJov3JbHyAi,1,0,0,0,0,0,1,0,1,0.14285714285714285,1,0.0,0,0,0,0,0,0,0,1,0,0,1,1
11742,166041,LShHu6uYlRN5bIHuJkopPqEfnHxBTC8i,fbPkOYLVPtPgIt0MxizjfFJov3JbHyAi,2,0,0,0,0,0,5,0,5,0.7142857142857143,1,0.0,0,0,0,0,0,0,0,5,0,0,5,1
11743,166043,N9J0YMMUvYV85FVJ0qX5eo6FonnNSF85,fbPkOYLVPtPgIt0MxizjfFJov3JbHyAi,2,0,0,0,0,0,2,0,2,0.2857142857142857,1,0.0,0,0,0,0,0,0,0,2,0,0,2,1
11744,166046,r0yZNwEG828V0TMkCl61Reya5Y5HO5aR,fbPkOYLVPtPgIt0MxizjfFJov3JbHyAi,4,3,1,0,1,0,1,0,6,0.8571428571428571,1,0.0,0,1,0,1,3,0,0,1,0,2,4,0
11745,166050,dTKURyZ9dyqGbe4l7wsUGgSU85JHBAFq,fbPkOYLVPtPgIt0MxizjfFJov3JbHyAi,8,5,3,0,2,0,3,0,13,1.8571428571428572,2,0.0,0,3,0,2,5,0,0,3,0,5,8,0
11746,166051,zys4H0zoKgEwqaSlxuoMh0ylzZsMRp6B,fbPkOYLVPtPgIt0MxizjfFJov3JbHyAi,8,2,2,0,2,0,3,0,9,1.2857142857142858,1,0.0,0,2,0,2,2,0,0,3,0,4,5,1
11747,166052,zRVD6VEUKDrryOP1TvtbSCWZetILcTFA,fbPkOYLVPtPgIt0MxizjfFJov3JbHyAi,5,3,1,0,1,0,2,0,7,1.0,1,0.0,1,1,0,1,2,0,0,2,0,3,4,1
11748,166054,aCi7yBADL9TO8ilUuxPHdQalGIRg3aJr,fbPkOYLVPtPgIt0MxizjfFJov3JbHyAi,6,1,1,0,1,3,4,0,10,1.4285714285714286,1,0.0,0,1,0,1,1,3,0,4,0,2,8,1
11749,166055,dMp1KIJnUk3pJLRma1sY50MtqbX92XeU,fbPkOYLVPtPgIt0MxizjfFJov3JbHyAi,4,2,1,0,0,0,2,0,5,0.7142857142857143,1,0.0,0,1,0,0,2,0,0,2,0,1,4,1
11750,166056,RXpyLiihGXUCA8h1EctnHTjiraMHD0a4,fbPkOYLVPtPgIt0MxizjfFJov3JbHyAi,7,5,3,0,2,4,2,0,16,2.2857142857142856,1,0.0,0,3,0,2,5,4,0,2,0,5,11,1
11751,166061,8gVI3RCzdwrb0srHH9NO7stO8AUu1uCR,fbPkOYLVPtPgIt0MxizjfFJov3JbHyAi,3,0,0,0,0,34,2,0,36,5.142857142857143,1,0.0,0,0,0,0,0,34,0,2,0,0,36,1
11752,166063,tJFzrDg5BaUKwBS7uJ8wgIWbLiKiPTve,fbPkOYLVPtPgIt0MxizjfFJov3JbHyAi,2,0,0,0,0,0,3,0,3,0.42857142857142855,1,0.0,0,0,0,0,0,0,0,3,0,0,3,1
11753,166064,lxeXZ87M0UdQbm9QL7lTn6YACn14X0PC,fbPkOYLVPtPgIt0MxizjfFJov3JbHyAi,11,6,5,0,4,0,2,0,17,2.4285714285714284,1,0.0,0,5,0,4,6,0,0,2,0,9,8,1
11754,166065,ijyyGxSCkTNXshxGrWCb96rdtgSJNssR,fbPkOYLVPtPgIt0MxizjfFJov3JbHyAi,7,3,2,0,2,0,2,0,9,1.2857142857142858,1,0.0,0,2,0,2,3,0,0,2,0,4,5,1
11755,166067,7fC3V6ivG07wUIMOmiYFzSlyjWvbYnYf,fbPkOYLVPtPgIt0MxizjfFJov3JbHyAi,1,0,0,0,0,0,1,0,1,0.14285714285714285,1,0.0,0,0,0,0,0,0,0,1,0,0,1,1
11756,166068,uUEAEHuEOlAvsHurjyTj6J9XqJZTLr4r,fbPkOYLVPtPgIt0MxizjfFJov3JbHyAi,10,10,5,3,7,0,2,0,27,3.857142857142857,1,0.0,4,5,2,7,6,0,1,2,0,18,9,1
11757,166069,icJiAKjBBiURMzSKaDbpsCD4jk8ynifx,fbPkOYLVPtPgIt0MxizjfFJov3JbHyAi,3,0,0,0,0,0,7,0,7,1.0,1,0.0,0,0,0,0,0,0,0,7,0,0,7,1
11758,166070,lUDEsCpeeCxZyURyjEd7RvRXvuIDJHXc,fbPkOYLVPtPgIt0MxizjfFJov3JbHyAi,8,6,4,0,3,0,3,0,16,2.2857142857142856,1,0.0,0,4,0,3,6,0,0,3,0,7,9,1
11759,166073,Sy0IBVghIdDN5uhsYaAtE4EZP4lbDR6C,fbPkOYLVPtPgIt0MxizjfFJov3JbHyAi,10,7,5,0,4,0,7,0,23,3.2857142857142856,3,0.0,0,5,0,4,7,0,0,7,0,9,14,1
11760,166076,tlV5mNtKN8OpE3fnEW9HsMaTsOyR1fSl,fbPkOYLVPtPgIt0MxizjfFJov3JbHyAi,2,0,0,0,0,0,2,0,2,0.2857142857142857,1,0.0,0,0,0,0,0,0,0,2,0,0,2,1
11761,166077,rDqSuJj6Apw3Hgcfl96B8dsl8lD8BDlC,fbPkOYLVPtPgIt0MxizjfFJov3JbHyAi,23,27,11,9,14,12,7,0,80,11.428571428571429,2,0.0,12,11,7,14,15,12,2,7,0,44,36,1
11762,166080,MF5edVvM6lCZDxnMdHelos9TUh3KERjn,fbPkOYLVPtPgIt0MxizjfFJov3JbHyAi,74,84,36,64,29,0,18,0,231,33.0,2,0.0,35,36,52,29,49,0,12,18,0,152,79,1
11763,166086,jRCJSAPNhDe7WpHS8MGlUFkXUl5Z0C2H,fbPkOYLVPtPgIt0MxizjfFJov3JbHyAi,8,9,4,0,4,0,3,0,20,2.857142857142857,2,0.0,3,4,0,4,6,0,0,3,0,11,9,0
11764,166089,jTx5Aeic95quxv16xi3lPn6zbo3fKZ1n,fbPkOYLVPtPgIt0MxizjfFJov3JbHyAi,7,3,2,0,2,0,2,0,9,1.2857142857142858,1,0.0,0,2,0,2,3,0,0,2,0,4,5,1
11765,166091,H9oUp5XbVBfpayovEZIOezZu2OYGsjY0,fbPkOYLVPtPgIt0MxizjfFJov3JbHyAi,12,30,12,0,0,0,10,0,52,7.428571428571429,1,0.0,0,12,0,0,30,0,0,10,0,12,40,1
11766,166092,XORqJOT0dzDcZsLmbsjEYVk8CWEPk4Bk,fbPkOYLVPtPgIt0MxizjfFJov3JbHyAi,11,6,4,0,2,1,9,1,23,3.2857142857142856,1,0.0,0,4,0,2,6,1,0,9,1,6,17,1
11767,166094,llK8fagyfMYNfzir66LDw2wK1aEVZzh8,fbPkOYLVPtPgIt0MxizjfFJov3JbHyAi,19,46,13,16,16,0,4,0,95,13.571428571428571,1,0.0,26,13,13,16,20,0,3,4,0,68,27,1
11768,166095,3mfG7fNRo2Olskcz8rvhDW564qOg3V1b,fbPkOYLVPtPgIt0MxizjfFJov3JbHyAi,2,0,0,0,0,0,2,0,2,0.2857142857142857,1,0.0,0,0,0,0,0,0,0,2,0,0,2,0
11769,166096,d2dMin38z1mvwoR5boGKYx3URnEXiseW,fbPkOYLVPtPgIt0MxizjfFJov3JbHyAi,11,12,5,0,3,23,6,0,49,7.0,2,0.0,2,5,0,3,10,23,0,6,0,10,39,1
11770,166100,UU4bZ9dkx8XaNni7IsKElRXyqQ5agPiC,fbPkOYLVPtPgIt0MxizjfFJov3JbHyAi,1,0,0,0,0,0,1,0,1,0.14285714285714285,1,0.0,0,0,0,0,0,0,0,1,0,0,1,1
11771,166107,MY0jNTZ6QiVUHDF60H245aO9uCKq6peP,fbPkOYLVPtPgIt0MxizjfFJov3JbHyAi,10,6,4,0,3,0,4,0,17,2.4285714285714284,1,0.0,0,4,0,3,6,0,0,4,0,7,10,0
11772,166108,KEfjzEESeytjI3UZJcAYJSJQvmTeL6zl,fbPkOYLVPtPgIt0MxizjfFJov3JbHyAi,7,14,2,0,1,0,7,0,24,3.4285714285714284,2,0.0,2,2,0,1,12,0,0,7,0,5,19,1
11773,166109,z13ImFZvHgYdPVf9Fj2iJ55SJuiyT2fz,fbPkOYLVPtPgIt0MxizjfFJov3JbHyAi,2,0,0,0,0,0,2,0,2,0.2857142857142857,1,0.0,0,0,0,0,0,0,0,2,0,0,2,1
11774,166110,KPqQrTHq7UqL5k1ntnRrXkQR7MK7NLYL,fbPkOYLVPtPgIt0MxizjfFJov3JbHyAi,2,0,0,0,0,0,3,0,3,0.42857142857142855,1,0.0,0,0,0,0,0,0,0,3,0,0,3,1
11775,166136,yl1czWTsEc25eyLba69IHArFJ1AESbkB,fbPkOYLVPtPgIt0MxizjfFJov3JbHyAi,11,7,4,0,2,0,10,1,24,3.4285714285714284,2,0.0,0,4,0,2,7,0,0,10,1,6,18,1
11776,166137,BZAa5FHuzEdX48cxIhsFBf8tlybpBCLx,fbPkOYLVPtPgIt0MxizjfFJov3JbHyAi,1,0,0,0,0,0,1,0,1,0.14285714285714285,1,0.0,0,0,0,0,0,0,0,1,0,0,1,1
11777,166145,1drLxoSaZXWb9UC1qR0hH1CkYJWXeTKQ,fbPkOYLVPtPgIt0MxizjfFJov3JbHyAi,1,0,0,0,0,0,1,0,1,0.14285714285714285,1,0.0,0,0,0,0,0,0,0,1,0,0,1,1
11778,166146,RFGMjZRXt4tuFIbx8DYfxpBzyQc4B9QK,fbPkOYLVPtPgIt0MxizjfFJov3JbHyAi,2,0,0,0,0,0,7,0,7,1.0,1,0.0,0,0,0,0,0,0,0,7,0,0,7,1
11779,166147,uDXojcZmAjRrYpbHg6OiLrdKtE8isYPI,fbPkOYLVPtPgIt0MxizjfFJov3JbHyAi,1,0,0,0,0,0,1,0,1,0.14285714285714285,1,0.0,0,0,0,0,0,0,0,1,0,0,1,1
11780,166148,gEfA8oSIHqbidc8ueZMiKg0wULpPs9EE,fbPkOYLVPtPgIt0MxizjfFJov3JbHyAi,3,1,0,0,0,0,6,0,7,1.0,1,0.0,0,0,0,0,1,0,0,6,0,0,7,1
11781,166149,jz0z8WtMaF1l7Nd9g9Ta3D63c4ohIzb2,fbPkOYLVPtPgIt0MxizjfFJov3JbHyAi,5,2,1,0,1,0,2,0,6,0.8571428571428571,1,0.0,0,1,0,1,2,0,0,2,0,2,4,1
11782,166153,zXvDUt3LgrB0KNQc9FoWhJ1W2pAiQJPd,fbPkOYLVPtPgIt0MxizjfFJov3JbHyAi,1,0,0,0,0,0,1,0,1,0.14285714285714285,1,0.0,0,0,0,0,0,0,0,1,0,0,1,1
11783,166154,lSZoAh0N0Lt8L3rqDq2pbnhpzHs4jrDI,fbPkOYLVPtPgIt0MxizjfFJov3JbHyAi,5,2,1,0,1,0,4,0,8,1.1428571428571428,1,0.0,0,1,0,1,2,0,0,4,0,2,6,1
11784,166155,ef55znmweQJrijlI0fO1Ekc271nZnV0m,fbPkOYLVPtPgIt0MxizjfFJov3JbHyAi,5,2,1,0,1,0,2,0,6,0.8571428571428571,1,0.0,0,1,0,1,2,0,0,2,0,2,4,1
11785,166156,Gc9FbbmaGQGlnmnRUjTL7bYNyXYRT1nJ,fbPkOYLVPtPgIt0MxizjfFJov3JbHyAi,2,0,0,0,0,0,2,0,2,0.2857142857142857,1,0.0,0,0,0,0,0,0,0,2,0,0,2,1
11786,166157,tfQHC1cUfGIbjxrAzAZrBm9HnB72SzwU,fbPkOYLVPtPgIt0MxizjfFJov3JbHyAi,20,20,14,0,10,7,12,7,70,10.0,1,0.0,2,14,0,10,18,7,0,12,7,26,44,1
11787,166158,HMNOnIW6u5dbPy0UCu54RGHmZvKhZGzf,fbPkOYLVPtPgIt0MxizjfFJov3JbHyAi,5,11,1,0,1,0,4,0,17,2.4285714285714284,1,0.0,9,1,0,1,2,0,0,4,0,11,6,1
11788,166160,qQOsZomAFoKDKPSRrF5FYWs1Zz9uDJVk,fbPkOYLVPtPgIt0MxizjfFJov3JbHyAi,2,0,0,0,0,0,4,0,4,0.5714285714285714,1,0.0,0,0,0,0,0,0,0,4,0,0,4,1
11789,166163,vvtmzsrkptNlFQlQRiEFe3TANujrEqYp,fbPkOYLVPtPgIt0MxizjfFJov3JbHyAi,1,0,0,0,0,0,1,0,1,0.14285714285714285,1,0.0,0,0,0,0,0,0,0,1,0,0,1,1
11790,166164,5RdGNDILnjdvCJ7HdlzpCtXsdeo7gaMF,fbPkOYLVPtPgIt0MxizjfFJov3JbHyAi,1,0,0,0,0,0,1,0,1,0.14285714285714285,1,0.0,0,0,0,0,0,0,0,1,0,0,1,1
11791,166168,rqjy9MBaTbrPcPapKqAdlw4agDXaSEfE,fbPkOYLVPtPgIt0MxizjfFJov3JbHyAi,1,0,0,0,0,0,1,0,1,0.14285714285714285,1,0.0,0,0,0,0,0,0,0,1,0,0,1,1
11792,166170,kmvJp6nzoFXW8Oc5kR5gMGOAAX5QexyP,fbPkOYLVPtPgIt0MxizjfFJov3JbHyAi,1,0,0,0,0,0,1,0,1,0.14285714285714285,1,0.0,0,0,0,0,0,0,0,1,0,0,1,1
11793,166175,R3cwyGYX3VZeygFsQJH9jlsc69OIabHp,fbPkOYLVPtPgIt0MxizjfFJov3JbHyAi,4,3,0,0,0,0,2,0,5,0.7142857142857143,1,0.0,0,0,0,0,3,0,0,2,0,0,5,1
11794,166177,1GJwPJw465ARTw6DCRQ9CrmILllIR9bx,fbPkOYLVPtPgIt0MxizjfFJov3JbHyAi,2,0,0,0,0,0,2,0,2,0.2857142857142857,1,0.0,0,0,0,0,0,0,0,2,0,0,2,1
11795,166182,QuVyCkZrDonWxKYO9hgDhn6YwJRZulhs,fbPkOYLVPtPgIt0MxizjfFJov3JbHyAi,8,2,1,0,1,5,16,1,26,3.7142857142857144,1,0.0,0,1,0,1,2,5,0,16,1,2,24,1
11796,166186,HdUhc4G7VRJcbtjXjCH13w2JqJd1SSbb,fbPkOYLVPtPgIt0MxizjfFJov3JbHyAi,5,2,1,0,1,0,2,0,6,0.8571428571428571,1,0.0,0,1,0,1,2,0,0,2,0,2,4,1
11797,166187,zoMCPyYhAfGWkHGBJFERTWZdMBzykaRB,fbPkOYLVPtPgIt0MxizjfFJov3JbHyAi,4,4,2,0,0,0,1,0,7,1.0,1,0.0,0,2,0,0,4,0,0,1,0,2,5,1
11798,166188,6Lis3QiZL3noC9wlW2RHCrUdD9IiBvZi,fbPkOYLVPtPgIt0MxizjfFJov3JbHyAi,5,2,1,0,1,0,3,0,7,1.0,1,0.0,0,1,0,1,2,0,0,3,0,2,5,1
11799,166189,nEQJ6jbTp4ska93bUrSmQZHx5JprZiSY,fbPkOYLVPtPgIt0MxizjfFJov3JbHyAi,2,0,0,0,0,0,2,0,2,0.2857142857142857,1,0.0,0,0,0,0,0,0,0,2,0,0,2,1
11800,166194,YTGf8IW1bAvGMGrrIZgbZY9E8w2ZKJg9,fbPkOYLVPtPgIt0MxizjfFJov3JbHyAi,5,2,1,0,1,0,2,0,6,0.8571428571428571,1,0.0,0,1,0,1,2,0,0,2,0,2,4,1
11801,166198,ljbA5yUe3ZigWWTZVZHvaZzlcQ3OUJib,fbPkOYLVPtPgIt0MxizjfFJov3JbHyAi,8,5,1,0,1,0,8,1,16,2.2857142857142856,1,0.0,0,1,0,1,5,0,0,8,1,2,14,1
11802,166203,28rpiJDQpdq3215vdwQ3rsZ0mFqWnJQZ,fbPkOYLVPtPgIt0MxizjfFJov3JbHyAi,6,2,1,0,1,0,3,0,7,1.0,1,0.0,0,1,0,1,2,0,0,3,0,2,5,1
11803,166204,vAIC6rsvgV7HbKGkew8JoXcaRFgXoors,fbPkOYLVPtPgIt0MxizjfFJov3JbHyAi,5,2,1,0,0,0,5,0,8,1.1428571428571428,1,0.0,0,1,0,0,2,0,0,5,0,1,7,1
11804,166207,8y2thNQcTL5saoD2DkzYwLVOul0NGb55,fbPkOYLVPtPgIt0MxizjfFJov3JbHyAi,1,0,0,0,0,0,1,0,1,0.14285714285714285,1,0.0,0,0,0,0,0,0,0,1,0,0,1,1
11805,166210,KLos613TyBDKjmDfE1975SNolozt8fEs,fbPkOYLVPtPgIt0MxizjfFJov3JbHyAi,3,0,0,0,0,0,3,0,3,0.42857142857142855,1,0.0,0,0,0,0,0,0,0,3,0,0,3,1
11806,166213,qIz5uvx21yY3zTPvMFcPXhap84pBzDvR,fbPkOYLVPtPgIt0MxizjfFJov3JbHyAi,6,4,0,0,0,3,5,0,12,1.7142857142857142,1,0.0,0,0,0,0,4,3,0,5,0,0,12,1
11807,166215,0sg2jGIMVa15FUIKUaYVkaVNV1yVl35B,fbPkOYLVPtPgIt0MxizjfFJov3JbHyAi,7,3,2,0,2,0,2,0,9,1.2857142857142858,1,0.0,0,2,0,2,3,0,0,2,0,4,5,1
11808,166217,G8RQSDElGQvlM3p8kKR2TUxzTka4oOJb,fbPkOYLVPtPgIt0MxizjfFJov3JbHyAi,7,7,2,0,3,0,2,0,14,2.0,1,0.0,2,2,0,3,5,0,0,2,0,7,7,1
11809,166220,gJIxI0ytF6J0PbE93GpuuDnUUCLDIzYX,fbPkOYLVPtPgIt0MxizjfFJov3JbHyAi,1,0,0,0,0,0,2,0,2,0.2857142857142857,1,0.0,0,0,0,0,0,0,0,2,0,0,2,1
11810,166222,tEG8YJMefgmQpIrlmBvHrR6glsVPJZ6p,fbPkOYLVPtPgIt0MxizjfFJov3JbHyAi,1,0,0,0,0,0,2,0,2,0.2857142857142857,1,0.0,0,0,0,0,0,0,0,2,0,0,2,1
11811,166225,HJ92FBrq5yG61EaDVcrZGDa4ZRxYv0Cx,fbPkOYLVPtPgIt0MxizjfFJov3JbHyAi,10,8,6,0,5,3,3,0,25,3.5714285714285716,1,0.0,0,6,0,5,8,3,0,3,0,11,14,1
11812,166227,aM04j8B80UycNpLiy2mFNdgBiaLCgDBx,fbPkOYLVPtPgIt0MxizjfFJov3JbHyAi,7,5,0,0,0,0,3,1,9,1.2857142857142858,1,0.0,0,0,0,0,5,0,0,3,1,0,9,1
11813,166229,QjbLQSoFVavd6LHLH5XtUy4x4q9nhmtF,fbPkOYLVPtPgIt0MxizjfFJov3JbHyAi,1,0,0,0,0,0,1,0,1,0.14285714285714285,1,0.0,0,0,0,0,0,0,0,1,0,0,1,1
11814,166230,6V2GrQFILHPsB0ekNjtLouAcbsjILF5g,fbPkOYLVPtPgIt0MxizjfFJov3JbHyAi,6,3,1,0,1,0,3,0,8,1.1428571428571428,1,0.0,0,1,0,1,3,0,0,3,0,2,6,1
11815,166231,YClUw7DFcczmQH6YbCWf4FT5MXeix8uw,fbPkOYLVPtPgIt0MxizjfFJov3JbHyAi,2,0,0,0,0,0,2,0,2,0.2857142857142857,1,0.0,0,0,0,0,0,0,0,2,0,0,2,1
11816,166232,sjjdkFlcuWgdDM2N9WBHJl0FJpmG07bZ,fbPkOYLVPtPgIt0MxizjfFJov3JbHyAi,5,2,1,0,1,0,2,0,6,0.8571428571428571,1,0.0,0,1,0,1,2,0,0,2,0,2,4,1
11817,166233,nig5RNhFSqFXsyMzwiBEQh8ryEN4ZIW3,fbPkOYLVPtPgIt0MxizjfFJov3JbHyAi,5,2,1,0,1,0,2,0,6,0.8571428571428571,1,0.0,0,1,0,1,2,0,0,2,0,2,4,1
11818,166237,2wxemnlILR4SFHmJ1CKeBLLcblIV9xQc,fbPkOYLVPtPgIt0MxizjfFJov3JbHyAi,25,20,11,27,9,0,4,0,71,10.142857142857142,2,0.0,6,11,21,9,14,0,6,4,0,47,24,1
11819,166239,GOEtSHSk6DV4bxigVVOBhrHtzfU5WaJO,fbPkOYLVPtPgIt0MxizjfFJov3JbHyAi,1,0,0,0,0,0,1,0,1,0.14285714285714285,1,0.0,0,0,0,0,0,0,0,1,0,0,1,1
11820,166241,sMpDCfadCgwh9MAo1W5K6Ik5Xg8rzern,fbPkOYLVPtPgIt0MxizjfFJov3JbHyAi,5,2,1,0,1,0,2,0,6,0.8571428571428571,1,0.0,0,1,0,1,2,0,0,2,0,2,4,1
11821,166242,2ZLHuYdEPLeyzuC7GNPXNtQbYDCmU9Z1,fbPkOYLVPtPgIt0MxizjfFJov3JbHyAi,6,8,1,0,0,0,2,0,11,1.5714285714285714,1,0.0,0,1,0,0,8,0,0,2,0,1,10,1
11822,166244,Zr7j8ccseRGaMTB9CSbtk2OoktQLUUwZ,fbPkOYLVPtPgIt0MxizjfFJov3JbHyAi,6,3,2,0,2,0,2,0,9,1.2857142857142858,1,0.0,0,2,0,2,3,0,0,2,0,4,5,1
11823,166251,zVoLjf7Wywq3t0MyK9V8JzWR92KniZeU,fbPkOYLVPtPgIt0MxizjfFJov3JbHyAi,8,5,4,0,3,0,2,0,14,2.0,1,0.0,0,4,0,3,5,0,0,2,0,7,7,1
11824,166254,wngLvF30yMtlqza2OIUSM8afhkLgGdV8,fbPkOYLVPtPgIt0MxizjfFJov3JbHyAi,9,5,3,0,2,0,5,0,15,2.142857142857143,1,0.0,0,3,0,2,5,0,0,5,0,5,10,1
11825,166256,uV3c7rC8Ip9ENwSIvLcI3iDJv4HC7nU6,fbPkOYLVPtPgIt0MxizjfFJov3JbHyAi,2,0,0,0,0,0,2,0,2,0.2857142857142857,1,0.0,0,0,0,0,0,0,0,2,0,0,2,1
11826,166265,JiE41HEDLoDarEll7cozPc0WO4mcLeH6,fbPkOYLVPtPgIt0MxizjfFJov3JbHyAi,1,0,0,0,0,0,1,0,1,0.14285714285714285,1,0.0,0,0,0,0,0,0,0,1,0,0,1,1
11827,166266,hyVguxdlO834U7lJnfhtMwTqeljzE8To,fbPkOYLVPtPgIt0MxizjfFJov3JbHyAi,1,0,0,0,0,0,1,0,1,0.14285714285714285,1,0.0,0,0,0,0,0,0,0,1,0,0,1,1
11828,166268,VfDy4viU8b0DxX44uijydrR8w1btSfvR,fbPkOYLVPtPgIt0MxizjfFJov3JbHyAi,9,5,2,0,3,0,4,1,15,2.142857142857143,1,0.0,3,2,0,3,2,0,0,4,1,8,7,1
11829,166269,qAwHClVR46j65q8IKTsxQetmapBK6gNC,fbPkOYLVPtPgIt0MxizjfFJov3JbHyAi,7,3,2,0,2,0,2,0,9,1.2857142857142858,1,0.0,0,2,0,2,3,0,0,2,0,4,5,1
11830,166270,iKJVI2OnWgKnPrc0Q2cfGD7sAkCQTWo1,fbPkOYLVPtPgIt0MxizjfFJov3JbHyAi,3,0,0,0,0,0,3,0,3,0.42857142857142855,1,0.0,0,0,0,0,0,0,0,3,0,0,3,1
11831,166271,lG1PrdMGbnNZVltQvWyOn6wGH1s1gk5W,fbPkOYLVPtPgIt0MxizjfFJov3JbHyAi,1,0,0,0,0,0,1,0,1,0.14285714285714285,1,0.0,0,0,0,0,0,0,0,1,0,0,1,1
11832,166272,HYufVGFQGrizf7sdp2S51f0QPp8O4VIP,fbPkOYLVPtPgIt0MxizjfFJov3JbHyAi,7,3,2,0,2,0,2,0,9,1.2857142857142858,1,0.0,0,2,0,2,3,0,0,2,0,4,5,1
11833,166273,vwF9cLvOjQPJg8J8Y2uNLf6gHvdxzL30,SpATywNh6bZuzm8s1ceuBUnMUAeoAHHw,4,2,1,0,1,0,2,0,6,0.8571428571428571,2,0.0,0,1,0,1,2,0,0,2,0,2,4,1
11834,166289,GQO5pvF9fB0ke4HvwJNUQnKPfOMPwhu0,G8EPVSXsOYB5YQWZGiz1aVq5Pgr2GrQu,60,53,14,112,10,0,1,0,190,27.142857142857142,4,0.0,37,14,67,10,16,0,45,1,0,128,62,1
11835,166295,A9LNHFYBxavFsnHS2U7qtB3ibz5wKw5b,bWdj2GDclj5ofokWjzoa5jAwMkxCykd6,1,0,0,0,0,0,1,0,1,0.14285714285714285,1,0.0,0,0,0,0,0,0,0,1,0,0,1,1
11836,166298,OOJh2Yrr6RQf9QAHFBo7EBzeZ2OAmLfw,A3fsA9Zfv1X2fVEQhTw51lKENdNrEqT3,6,3,2,4,0,0,1,0,10,1.4285714285714286,1,0.0,0,2,4,0,3,0,0,1,0,6,4,1
11837,166311,LFPiiJVIeEKgwmiuE09C3QlUZFR5rtPM,RXDvfPUBYFlVdlueBFbLW0mhhAyGEqpt,14,11,10,0,6,5,4,0,36,5.142857142857143,1,0.0,0,10,0,6,11,5,0,4,0,16,20,1
11838,166339,NkHKP7XmU89AhYrwGvkJ0gX5lfpDGkiJ,SpATywNh6bZuzm8s1ceuBUnMUAeoAHHw,2,0,0,0,0,0,2,0,2,0.2857142857142857,1,0.0,0,0,0,0,0,0,0,2,0,0,2,1
11839,166361,QWw1s7G2LDYzdw5hFh2RBbUqb52YVk7z,G8EPVSXsOYB5YQWZGiz1aVq5Pgr2GrQu,28,44,2,48,3,1,9,0,107,15.285714285714286,2,0.0,20,2,34,3,24,1,14,9,0,59,48,0
11840,166369,s5BonLZqcYCYjyVoBrmolAFZYQqEpVbb,G8EPVSXsOYB5YQWZGiz1aVq5Pgr2GrQu,1,0,0,0,0,0,1,0,1,0.14285714285714285,1,0.0,0,0,0,0,0,0,0,1,0,0,1,0
11841,166379,LWaNb4rILMf9lRML9VmyknZzkoxWoxSQ,A3fsA9Zfv1X2fVEQhTw51lKENdNrEqT3,1,0,0,0,0,0,1,0,1,0.14285714285714285,1,0.0,0,0,0,0,0,0,0,1,0,0,1,1
11842,166384,rmly0YU7hFQRO8wpDGfNQC1vAS0Xq6hn,SpATywNh6bZuzm8s1ceuBUnMUAeoAHHw,14,9,5,7,3,0,2,0,26,3.7142857142857144,1,0.0,3,5,7,3,6,0,0,2,0,18,8,1
11843,166443,FCpDPyaXXEn58dtFe3pQEjUaayUuOg53,SpATywNh6bZuzm8s1ceuBUnMUAeoAHHw,6,4,0,0,0,0,13,0,17,2.4285714285714284,2,0.0,0,0,0,0,4,0,0,13,0,0,17,1
11844,166518,4kW33d8ryobHswayOAbGxV1Ajm5odAVu,A3fsA9Zfv1X2fVEQhTw51lKENdNrEqT3,2,0,0,0,0,0,2,0,2,0.2857142857142857,1,0.0,0,0,0,0,0,0,0,2,0,0,2,1
11845,166524,IOrrTEnPwrStZyNOLFQoK4fs0RpiYPV1,G8EPVSXsOYB5YQWZGiz1aVq5Pgr2GrQu,10,5,2,0,2,8,7,0,24,3.4285714285714284,1,0.0,0,2,0,2,5,8,0,7,0,4,20,1
11846,166548,uMeAc1BFeZrPyaawT7Nx4cOMjZQcepML,RXDvfPUBYFlVdlueBFbLW0mhhAyGEqpt,2,0,0,0,0,0,2,0,2,0.2857142857142857,1,0.0,0,0,0,0,0,0,0,2,0,0,2,1
11847,166552,9NLsBRyvwuJAnXVvkV43elEklDfakfqV,SpATywNh6bZuzm8s1ceuBUnMUAeoAHHw,2,0,0,0,0,0,2,0,2,0.2857142857142857,1,0.0,0,0,0,0,0,0,0,2,0,0,2,1
11848,166555,mFcnZc9xJHpcsnNSqrnt1TraJ39cAeOG,5X6FeZozNMgE2VRi3MJYjkkFK8SETtu2,1,0,0,0,0,0,1,0,1,0.14285714285714285,1,0.0,0,0,0,0,0,0,0,1,0,0,1,1
11849,166568,FkoJ32PRPnjEOGAz921mfwOw4fAtGvO0,SpATywNh6bZuzm8s1ceuBUnMUAeoAHHw,14,17,5,26,3,0,1,0,52,7.428571428571429,1,0.0,10,5,22,3,7,0,4,1,0,40,12,1
11850,166606,uZlOX0cgouu0bXrLq6YA6PRMU30ZaiaI,bWdj2GDclj5ofokWjzoa5jAwMkxCykd6,4,2,1,0,1,0,1,0,5,0.7142857142857143,1,0.0,0,1,0,1,2,0,0,1,0,2,3,1
11851,166625,fHuAxntSH65MvOE5PclQWU3EYpgmCRYz,5X6FeZozNMgE2VRi3MJYjkkFK8SETtu2,5,4,1,2,2,0,1,0,10,1.4285714285714286,1,0.0,2,1,2,2,2,0,0,1,0,7,3,1
11852,166633,BiNLDHg34tW2DztH304CnM3NbDxCatLY,bWdj2GDclj5ofokWjzoa5jAwMkxCykd6,7,7,0,26,3,1,6,0,43,6.142857142857143,1,0.0,6,0,24,3,1,1,2,6,0,33,10,1
11853,166639,9Ad0EBsep3vN2c8xQobr7UDwfMqhMFKU,SpATywNh6bZuzm8s1ceuBUnMUAeoAHHw,9,6,5,0,3,0,3,0,17,2.4285714285714284,2,0.0,0,5,0,3,6,0,0,3,0,8,9,0
11854,166678,aVeyGdrz6Ir4LmiLkJqBoRjG1lQ7MsV8,5X6FeZozNMgE2VRi3MJYjkkFK8SETtu2,6,25,6,0,1,2,5,0,39,5.571428571428571,4,0.0,9,6,0,1,16,2,0,5,0,16,23,1
11855,166748,F4CmkpkMtWFLCelouIUJgiRRRgpQv809,A3fsA9Zfv1X2fVEQhTw51lKENdNrEqT3,1,0,0,0,0,0,1,0,1,0.14285714285714285,1,0.0,0,0,0,0,0,0,0,1,0,0,1,1
11856,166776,mFcnZc9xJHpcsnNSqrnt1TraJ39cAeOG,RXDvfPUBYFlVdlueBFbLW0mhhAyGEqpt,1,0,0,0,0,0,1,0,1,0.14285714285714285,1,0.0,0,0,0,0,0,0,0,1,0,0,1,1
11857,166784,AjRTjBqF69K8qynYqEW0T141KyGuqhS2,5X6FeZozNMgE2VRi3MJYjkkFK8SETtu2,7,6,0,0,0,2,12,1,21,3.0,1,0.0,0,0,0,0,6,2,0,12,1,0,21,1
11858,166795,AjRTjBqF69K8qynYqEW0T141KyGuqhS2,A3fsA9Zfv1X2fVEQhTw51lKENdNrEqT3,1,0,0,0,0,0,1,0,1,0.14285714285714285,1,0.0,0,0,0,0,0,0,0,1,0,0,1,1
11859,166823,zhM73YZZY0lktyVnZ4AxEL9UuCvFGPVE,A3fsA9Zfv1X2fVEQhTw51lKENdNrEqT3,9,7,0,0,0,1,9,1,18,2.5714285714285716,1,0.0,0,0,0,0,7,1,0,9,1,0,18,1
11860,166849,MdggzNQQNxgbc1AXVjikoAJPUP3VWCUi,A3fsA9Zfv1X2fVEQhTw51lKENdNrEqT3,5,2,1,0,1,0,2,0,6,0.8571428571428571,1,0.0,0,1,0,1,2,0,0,2,0,2,4,1
11861,166852,WOjJXPk6hpVRJhHaF4hHfePlOcQhWUPY,SpATywNh6bZuzm8s1ceuBUnMUAeoAHHw,8,10,7,0,5,0,2,0,24,3.4285714285714284,2,0.0,0,7,0,5,10,0,0,2,0,12,12,1
11862,166909,bp0wAoMxu88KWfIqaBPqEsMxSHSKb7rw,A3fsA9Zfv1X2fVEQhTw51lKENdNrEqT3,1,0,0,0,0,0,1,0,1,0.14285714285714285,1,0.0,0,0,0,0,0,0,0,1,0,0,1,1
11863,166926,bp0wAoMxu88KWfIqaBPqEsMxSHSKb7rw,RXDvfPUBYFlVdlueBFbLW0mhhAyGEqpt,1,0,0,0,0,0,1,0,1,0.14285714285714285,1,0.0,0,0,0,0,0,0,0,1,0,0,1,1
11864,166933,Uaf2oDHJ8L0D42K5PrmMB0KrT5Tv0JEb,bWdj2GDclj5ofokWjzoa5jAwMkxCykd6,2,0,0,0,0,0,2,0,2,0.2857142857142857,1,0.0,0,0,0,0,0,0,0,2,0,0,2,1
11865,166945,Crt3eVh2fZmwU8n336w6v5vI95DwJSl7,SpATywNh6bZuzm8s1ceuBUnMUAeoAHHw,9,4,3,0,2,2,4,2,17,2.4285714285714284,1,0.0,0,3,0,2,4,2,0,4,2,5,12,1
11866,166952,V52G1wHOq5zd0Up8zjShFJCn7Er4GImu,SpATywNh6bZuzm8s1ceuBUnMUAeoAHHw,4,7,1,0,0,0,3,0,11,1.5714285714285714,2,0.0,0,1,0,0,7,0,0,3,0,1,10,1
11867,166954,diqtTQE3aIn9EfLQeyH3g1mHmhR3kGFy,SpATywNh6bZuzm8s1ceuBUnMUAeoAHHw,5,3,1,0,1,0,2,0,7,1.0,1,0.0,0,1,0,1,3,0,0,2,0,2,5,1
11868,166982,KsUm63CS66fccBaGn2XmCwaaNmurTIUr,SpATywNh6bZuzm8s1ceuBUnMUAeoAHHw,6,3,1,0,1,0,2,0,7,1.0,1,0.0,0,1,0,1,3,0,0,2,0,2,5,1
11869,166985,KVFLGfkLjESnixIuWE2enCugNN1bDzvq,A3fsA9Zfv1X2fVEQhTw51lKENdNrEqT3,11,11,1,0,0,0,1,0,13,1.8571428571428572,1,0.0,0,1,0,0,11,0,0,1,0,1,12,1
11870,166998,lzb8kR5dRzqO59ncQoQqbKNH1bW2854J,bWdj2GDclj5ofokWjzoa5jAwMkxCykd6,1,0,0,0,0,0,1,0,1,0.14285714285714285,1,0.0,0,0,0,0,0,0,0,1,0,0,1,1
11871,166999,dUop8tAAPSP400w8c2tq4wG1pwOMUqYS,A3fsA9Zfv1X2fVEQhTw51lKENdNrEqT3,7,3,2,0,2,0,6,0,13,1.8571428571428572,1,0.0,0,2,0,2,3,0,0,6,0,4,9,0
11872,167023,JpMQoarOn6JQcf557ZUmfYqpeHPAEtez,A3fsA9Zfv1X2fVEQhTw51lKENdNrEqT3,5,6,2,0,0,0,2,0,10,1.4285714285714286,2,0.0,0,2,0,0,6,0,0,2,0,2,8,1
11873,167049,3PdoM9BEkfijbap7ECEFU1pWsZq0D9Xk,5X6FeZozNMgE2VRi3MJYjkkFK8SETtu2,7,3,2,0,2,0,2,0,9,1.2857142857142858,1,0.0,0,2,0,2,3,0,0,2,0,4,5,1
11874,167056,STjQHRvW81iYlnhczfhr8jnAyuOyD8VG,bWdj2GDclj5ofokWjzoa5jAwMkxCykd6,3,2,0,0,0,0,1,0,3,0.42857142857142855,1,0.0,0,0,0,0,2,0,0,1,0,0,3,1
11875,167063,jWFFw5rdEwwLuLnKwYIpyv4HO3N0mTOS,G8EPVSXsOYB5YQWZGiz1aVq5Pgr2GrQu,7,9,5,0,2,0,3,0,19,2.7142857142857144,1,0.0,0,5,0,2,9,0,0,3,0,7,12,1
11876,167071,eip5MMGOVDSg5Q7RWXlSlAH5Sizgq4mr,G8EPVSXsOYB5YQWZGiz1aVq5Pgr2GrQu,17,14,1,24,1,4,5,1,50,7.142857142857143,1,0.0,3,1,21,1,11,4,3,5,1,26,24,1
11877,167076,OWbwbOuhTRx8Sll5Avvz5AZRO647LCJ4,SpATywNh6bZuzm8s1ceuBUnMUAeoAHHw,1,0,0,0,0,0,1,0,1,0.14285714285714285,1,0.0,0,0,0,0,0,0,0,1,0,0,1,1
11878,167080,OWbwbOuhTRx8Sll5Avvz5AZRO647LCJ4,bWdj2GDclj5ofokWjzoa5jAwMkxCykd6,1,0,0,0,0,0,1,0,1,0.14285714285714285,1,0.0,0,0,0,0,0,0,0,1,0,0,1,1
11879,167094,SoREPWdOHEFnyEXb3M5qgLwqpLSv5EJy,SpATywNh6bZuzm8s1ceuBUnMUAeoAHHw,1,0,0,0,0,0,1,0,1,0.14285714285714285,1,0.0,0,0,0,0,0,0,0,1,0,0,1,1
11880,167098,NuaG3GppxhXVOLv5fu633RlMWR7B08SC,SpATywNh6bZuzm8s1ceuBUnMUAeoAHHw,11,12,8,0,6,3,3,0,32,4.571428571428571,2,0.0,2,8,0,6,10,3,0,3,0,16,16,1
11881,167101,1Z0JbSMoZNTapARGDhipa6UEe1xrZepu,G8EPVSXsOYB5YQWZGiz1aVq5Pgr2GrQu,2,0,0,0,0,0,2,0,2,0.2857142857142857,1,0.0,0,0,0,0,0,0,0,2,0,0,2,1
11882,167115,WAC7RGZ1uYeT92igfYiLgTnHWPEtN2IA,A3fsA9Zfv1X2fVEQhTw51lKENdNrEqT3,9,8,6,0,3,0,4,0,21,3.0,3,0.0,0,6,0,3,8,0,0,4,0,9,12,1
11883,167120,woVLVXPiC8hhTnKZW3Z7hk3owLtphTuf,RXDvfPUBYFlVdlueBFbLW0mhhAyGEqpt,16,29,5,0,4,1,5,0,44,6.285714285714286,2,0.0,1,5,0,4,28,1,0,5,0,10,34,1
11884,167137,yxFacYGK53644aEjhoi40V3IIQttQjtF,SpATywNh6bZuzm8s1ceuBUnMUAeoAHHw,10,7,5,0,4,0,4,0,20,2.857142857142857,1,0.0,0,5,0,4,7,0,0,4,0,9,11,1
11885,167157,udF4jwSYeJ58QSIxsDPfAqb9mSqSCjuB,SpATywNh6bZuzm8s1ceuBUnMUAeoAHHw,19,60,3,16,1,6,17,1,104,14.857142857142858,1,0.0,16,3,14,1,44,6,2,17,1,34,70,1
11886,167166,4Mf2EKSJhzPrUZBvK6JSHuGanRWOAS1S,SpATywNh6bZuzm8s1ceuBUnMUAeoAHHw,10,13,8,0,0,0,6,0,27,3.857142857142857,2,0.0,2,8,0,0,11,0,0,6,0,10,17,0
11887,167176,O9Nc67keKxqXJVVorKEL2XWb1MEj7Kbn,5X6FeZozNMgE2VRi3MJYjkkFK8SETtu2,9,12,3,5,4,0,4,0,28,4.0,3,0.0,2,3,4,4,10,0,1,4,0,13,15,1
11888,167180,jQg5UakMQRKmdDEXjxxf2nAUZSauWzhl,A3fsA9Zfv1X2fVEQhTw51lKENdNrEqT3,1,0,0,0,0,0,1,0,1,0.14285714285714285,1,0.0,0,0,0,0,0,0,0,1,0,0,1,1
11889,167185,8RHWOUyn5mqf53McvuS18SiueTk2U6y2,bWdj2GDclj5ofokWjzoa5jAwMkxCykd6,1,0,0,0,0,0,1,0,1,0.14285714285714285,1,0.0,0,0,0,0,0,0,0,1,0,0,1,1
11890,167186,8RHWOUyn5mqf53McvuS18SiueTk2U6y2,G8EPVSXsOYB5YQWZGiz1aVq5Pgr2GrQu,1,0,0,0,0,0,1,0,1,0.14285714285714285,1,0.0,0,0,0,0,0,0,0,1,0,0,1,1
11891,167217,j0gxXks7DZitzyeEGG2agLKFp30HqXVu,A3fsA9Zfv1X2fVEQhTw51lKENdNrEqT3,6,9,4,0,0,1,11,0,25,3.5714285714285716,2,0.0,0,4,0,0,9,1,0,11,0,4,21,1
11892,167234,Me95BqnMi7W18LuJ9CGsC9vdXTLZ2e0Y,A3fsA9Zfv1X2fVEQhTw51lKENdNrEqT3,5,2,1,0,1,0,2,0,6,0.8571428571428571,1,0.0,0,1,0,1,2,0,0,2,0,2,4,1
11893,167236,yjqa4N4fhl3Uv2C3tR6TSWjlxDfm3vvM,SpATywNh6bZuzm8s1ceuBUnMUAeoAHHw,1,0,0,0,0,0,1,0,1,0.14285714285714285,1,0.0,0,0,0,0,0,0,0,1,0,0,1,1
11894,167244,Cie8MgBDvC4HVRvuqtFzP8SkWOhgrE8X,SpATywNh6bZuzm8s1ceuBUnMUAeoAHHw,12,30,21,0,9,0,10,0,70,10.0,2,0.0,3,21,0,9,27,0,0,10,0,33,37,1
11895,167251,5B2bGhS2BSsBKATjNqdTQPUYoxJcc0Mm,SpATywNh6bZuzm8s1ceuBUnMUAeoAHHw,4,2,0,0,0,0,2,0,4,0.5714285714285714,1,0.0,0,0,0,0,2,0,0,2,0,0,4,1
11896,167256,8BBrs2YJZdMAa1GwaqwG4BfeZccyZZAj,SpATywNh6bZuzm8s1ceuBUnMUAeoAHHw,6,3,1,0,1,0,2,0,7,1.0,1,0.0,0,1,0,1,3,0,0,2,0,2,5,1
11897,167261,Uylyq7LmmNSvSWdWZxt9uRF9NmGdfp0A,bWdj2GDclj5ofokWjzoa5jAwMkxCykd6,1,0,0,0,0,0,1,0,1,0.14285714285714285,1,0.0,0,0,0,0,0,0,0,1,0,0,1,1
11898,167268,srnnzUkIJr2Uisav8LfnV4SnpbNw9CLp,A3fsA9Zfv1X2fVEQhTw51lKENdNrEqT3,36,18,14,50,12,0,4,0,98,14.0,1,0.0,0,14,40,12,18,0,10,4,0,66,32,1
11899,167291,T1pFbYP74kktq7cBESkP625j6elO7EQ5,RXDvfPUBYFlVdlueBFbLW0mhhAyGEqpt,1,0,0,0,0,0,2,0,2,0.2857142857142857,1,0.0,0,0,0,0,0,0,0,2,0,0,2,1
11900,167301,AW6dihJ9WRBecrtuIS74toM8othH6GFu,A3fsA9Zfv1X2fVEQhTw51lKENdNrEqT3,1,0,0,0,0,0,1,0,1,0.14285714285714285,1,0.0,0,0,0,0,0,0,0,1,0,0,1,1
11901,167334,0gocHINf7b8BcvWaTrMFBEJhugD8UJOT,bWdj2GDclj5ofokWjzoa5jAwMkxCykd6,10,13,6,14,3,0,4,0,40,5.714285714285714,2,0.0,1,6,14,3,12,0,0,4,0,24,16,1
11902,167353,mtxEm66XLaiLgrwQ9kSbmVMuiNAGb6i1,G8EPVSXsOYB5YQWZGiz1aVq5Pgr2GrQu,7,4,3,0,1,0,3,0,11,1.5714285714285714,2,0.0,0,3,0,1,4,0,0,3,0,4,7,1
11903,167370,XF1lbfsr5ID8AfWQ0nphBhI7tZhRqdpu,SpATywNh6bZuzm8s1ceuBUnMUAeoAHHw,1,0,0,0,0,0,1,0,1,0.14285714285714285,1,0.0,0,0,0,0,0,0,0,1,0,0,1,1
11904,167371,khelYX1bk51SSadsVaUzKR0zRRNCX0tK,G8EPVSXsOYB5YQWZGiz1aVq5Pgr2GrQu,1,0,0,0,0,0,1,0,1,0.14285714285714285,1,0.0,0,0,0,0,0,0,0,1,0,0,1,1
11905,167376,PYjcXVq1OKher1f36I3CGAnm6VaLRVjt,SpATywNh6bZuzm8s1ceuBUnMUAeoAHHw,8,6,2,0,2,0,10,0,20,2.857142857142857,1,0.0,0,2,0,2,6,0,0,10,0,4,16,1
11906,167393,6HV2PEjNIKCVMQQpYRQLuV1rrZqqecaV,A3fsA9Zfv1X2fVEQhTw51lKENdNrEqT3,4,2,1,0,1,0,1,0,5,0.7142857142857143,1,0.0,0,1,0,1,2,0,0,1,0,2,3,1
11907,167418,IJukBY2O39rtRouJ47sBmIN9gUZZjnWA,G8EPVSXsOYB5YQWZGiz1aVq5Pgr2GrQu,10,8,0,2,0,3,5,1,19,2.7142857142857144,1,0.0,1,0,1,0,7,3,1,5,1,2,17,1
11908,167434,itD4TUoq2Q3TVeq59M2vmGREnVktdivl,SpATywNh6bZuzm8s1ceuBUnMUAeoAHHw,27,63,22,6,10,1,8,0,110,15.714285714285714,1,0.0,17,22,6,10,46,1,0,8,0,55,55,1
11909,167466,DnweC9zfy9ur38RHmjIuaW6oqiFXCgkS,bWdj2GDclj5ofokWjzoa5jAwMkxCykd6,7,8,1,0,0,0,11,1,21,3.0,1,0.0,0,1,0,0,8,0,0,11,1,1,20,1
11910,167472,CetRT5zy2dJHyaPU2zMnW0reXnT8Dv2y,A3fsA9Zfv1X2fVEQhTw51lKENdNrEqT3,2,0,0,0,0,0,2,0,2,0.2857142857142857,1,0.0,0,0,0,0,0,0,0,2,0,0,2,1
11911,167488,vVoYtG2vzUhg3qXoaTM1GNiznwKfFexh,bWdj2GDclj5ofokWjzoa5jAwMkxCykd6,1,0,0,0,0,0,1,0,1,0.14285714285714285,1,0.0,0,0,0,0,0,0,0,1,0,0,1,1
11912,167489,mSYAcGhYeeC24f8F6IWiUOGlXEIiXJkh,SpATywNh6bZuzm8s1ceuBUnMUAeoAHHw,6,4,1,0,1,0,2,0,8,1.1428571428571428,1,0.0,0,1,0,1,4,0,0,2,0,2,6,1
11913,167531,umctuhbIVZDh6EHjPhWargzhNqVIeFMx,A3fsA9Zfv1X2fVEQhTw51lKENdNrEqT3,6,2,1,0,0,0,4,0,7,1.0,1,0.0,0,1,0,0,2,0,0,4,0,1,6,0
11914,167541,Vhkg4eDJgn0Rp70JPNuOdQoUbRDAoXSb,A3fsA9Zfv1X2fVEQhTw51lKENdNrEqT3,1,0,0,0,0,0,1,0,1,0.14285714285714285,1,0.0,0,0,0,0,0,0,0,1,0,0,1,0
11915,167552,E8lMjkJcqZcrPtGwbo8pVkzTRx8M7QkS,bWdj2GDclj5ofokWjzoa5jAwMkxCykd6,1,0,0,0,0,0,1,0,1,0.14285714285714285,1,0.0,0,0,0,0,0,0,0,1,0,0,1,1
11916,167577,eHoAPmcAKzybBYPqIBAsLFgjVfVlCiap,SpATywNh6bZuzm8s1ceuBUnMUAeoAHHw,2,0,0,0,0,0,3,0,3,0.42857142857142855,1,0.0,0,0,0,0,0,0,0,3,0,0,3,1
11917,167624,9qQce5SZ6DqKQeFsRsFiD6wzPO21moby,A3fsA9Zfv1X2fVEQhTw51lKENdNrEqT3,2,0,0,0,0,0,2,0,2,0.2857142857142857,1,0.0,0,0,0,0,0,0,0,2,0,0,2,1
11918,167632,JRUKMEmBZ3p5F0JpSVHv1lQEiMQUvro3,5X6FeZozNMgE2VRi3MJYjkkFK8SETtu2,1,0,0,0,0,0,1,0,1,0.14285714285714285,1,0.0,0,0,0,0,0,0,0,1,0,0,1,1
11919,167635,VR79xuyJ7PSmMj6conPf0NxNjdhA8iEp,G8EPVSXsOYB5YQWZGiz1aVq5Pgr2GrQu,7,7,1,0,0,0,2,0,10,1.4285714285714286,2,0.0,0,1,0,0,7,0,0,2,0,1,9,1
11920,167641,JRUKMEmBZ3p5F0JpSVHv1lQEiMQUvro3,A3fsA9Zfv1X2fVEQhTw51lKENdNrEqT3,1,0,0,0,0,0,1,0,1,0.14285714285714285,1,0.0,0,0,0,0,0,0,0,1,0,0,1,1
11921,167655,NLi2kjhCXYFKfB8CCoscLBzBlekXHhro,SpATywNh6bZuzm8s1ceuBUnMUAeoAHHw,8,2,2,0,2,0,3,0,9,1.2857142857142858,1,0.0,0,2,0,2,2,0,0,3,0,4,5,1
11922,167690,ksWipsarCZTS7QX1xkzW3yKB8j25yNgG,bWdj2GDclj5ofokWjzoa5jAwMkxCykd6,4,1,0,0,0,0,3,0,4,0.5714285714285714,1,0.0,0,0,0,0,1,0,0,3,0,0,4,0
11923,167731,wXw48gUOB5BEkScgUyQMzs63eq0ygNDQ,A3fsA9Zfv1X2fVEQhTw51lKENdNrEqT3,2,0,0,0,0,0,2,0,2,0.2857142857142857,1,0.0,0,0,0,0,0,0,0,2,0,0,2,1
11924,167756,9oZb5hKpZvxzCcQaYVLX0TsS9OdCbI4H,bWdj2GDclj5ofokWjzoa5jAwMkxCykd6,8,10,6,0,3,0,6,0,25,3.5714285714285716,2,0.0,0,6,0,3,10,0,0,6,0,9,16,1
11925,167773,dv5Xzy3RizPqbGvGIMXlJIDl0kMrBVlb,A3fsA9Zfv1X2fVEQhTw51lKENdNrEqT3,5,2,1,0,1,0,2,0,6,0.8571428571428571,1,0.0,0,1,0,1,2,0,0,2,0,2,4,1
11926,167779,BWZyBrJDBbkcDEXyE3CSVFoVlT2CRRku,A3fsA9Zfv1X2fVEQhTw51lKENdNrEqT3,7,3,1,0,1,0,8,0,13,1.8571428571428572,2,0.0,0,1,0,1,3,0,0,8,0,2,11,1
11927,167790,qLSi3XQmUN8iJosa2X5FwVvEhgucVA2x,SpATywNh6bZuzm8s1ceuBUnMUAeoAHHw,10,13,3,0,1,0,8,0,25,3.5714285714285716,2,0.0,4,3,0,1,9,0,0,8,0,8,17,0
11928,167796,oxdAxF8oDPK7RK5K5ZEWwiPiTwAbAz6a,A3fsA9Zfv1X2fVEQhTw51lKENdNrEqT3,2,0,0,0,0,0,5,0,5,0.7142857142857143,1,0.0,0,0,0,0,0,0,0,5,0,0,5,1
11929,167797,oxdAxF8oDPK7RK5K5ZEWwiPiTwAbAz6a,bWdj2GDclj5ofokWjzoa5jAwMkxCykd6,1,0,0,0,0,0,1,0,1,0.14285714285714285,1,0.0,0,0,0,0,0,0,0,1,0,0,1,1
11930,167825,w50jSI5RjqfAgmbAtDpAViImkLRNEU1B,3VkHkmOtom3jM2wCu94xgzzu1d6Dn7or,4,2,1,0,1,0,1,0,5,0.7142857142857143,1,0.0,0,1,0,1,2,0,0,1,0,2,3,1
11931,167829,DuWvyGHQTe2nAVAqbwb2iRzai9QwBpBF,3VkHkmOtom3jM2wCu94xgzzu1d6Dn7or,5,2,1,0,1,0,2,0,6,0.8571428571428571,1,0.0,0,1,0,1,2,0,0,2,0,2,4,1
11932,167831,nQbLT1SRMbfcvKaLKuoWeofpEsFofHcY,3VkHkmOtom3jM2wCu94xgzzu1d6Dn7or,1,0,0,0,0,0,1,0,1,0.14285714285714285,1,0.0,0,0,0,0,0,0,0,1,0,0,1,1
11933,167842,CSm8iwWsU0HeDh8Nvu0QaEq7r9rC3pXi,3VkHkmOtom3jM2wCu94xgzzu1d6Dn7or,9,8,5,0,2,1,6,1,23,3.2857142857142856,1,0.0,0,5,0,2,8,1,0,6,1,7,16,1
11934,167848,Zuvakat0rRsl2Y7xnpQctqOYcmuQFCGc,3VkHkmOtom3jM2wCu94xgzzu1d6Dn7or,1,0,0,0,0,0,1,0,1,0.14285714285714285,1,0.0,0,0,0,0,0,0,0,1,0,0,1,1
11935,167852,1zu13GwMTvm6JeRi49ExLCOijiwrPgw5,3VkHkmOtom3jM2wCu94xgzzu1d6Dn7or,5,2,1,0,1,0,2,0,6,0.8571428571428571,2,0.0,0,1,0,1,2,0,0,2,0,2,4,1
11936,167869,S8zVRxklnOsXuBIBhjrKY81fUiuiIbyw,3VkHkmOtom3jM2wCu94xgzzu1d6Dn7or,6,3,1,0,0,0,5,0,9,1.2857142857142858,1,0.0,0,1,0,0,3,0,0,5,0,1,8,1
11937,167871,TUwVrd2hmfW6VyLzKbv0bNRWMKGDOGOV,3VkHkmOtom3jM2wCu94xgzzu1d6Dn7or,6,6,0,0,1,1,6,0,14,2.0,1,0.0,1,0,0,1,5,1,0,6,0,2,12,1
11938,167882,H1QsOOzkt1rMgjxLE3KdQ1oVfKimRTem,3VkHkmOtom3jM2wCu94xgzzu1d6Dn7or,2,0,0,0,0,0,3,0,3,0.42857142857142855,1,0.0,0,0,0,0,0,0,0,3,0,0,3,1
11939,167890,uw0jy2Q66SqttJaNPd8OcJODmC4v7GbR,3VkHkmOtom3jM2wCu94xgzzu1d6Dn7or,4,3,2,0,2,0,1,0,8,1.1428571428571428,1,0.0,0,2,0,2,3,0,0,1,0,4,4,1
11940,167891,zHKQnUugeGJMuRQOZYGje2WBIE2vaEFJ,3VkHkmOtom3jM2wCu94xgzzu1d6Dn7or,8,2,1,0,1,1,7,1,13,1.8571428571428572,1,0.0,0,1,0,1,2,1,0,7,1,2,11,1
11941,167894,aifGgPMvFpWHsSTqQ6XTzhfaWNOf55n4,3VkHkmOtom3jM2wCu94xgzzu1d6Dn7or,1,0,0,0,0,0,1,0,1,0.14285714285714285,1,0.0,0,0,0,0,0,0,0,1,0,0,1,1
11942,167907,ItnribwFpyCbaqDIrXmSOMBQ0RW2u9U9,3VkHkmOtom3jM2wCu94xgzzu1d6Dn7or,5,2,1,0,1,0,2,0,6,0.8571428571428571,1,0.0,0,1,0,1,2,0,0,2,0,2,4,1
11943,167910,ry89y5X9JAYmkcmxHDurtFUIgbrGCIEa,3VkHkmOtom3jM2wCu94xgzzu1d6Dn7or,7,4,2,0,1,0,5,0,12,1.7142857142857142,1,0.0,0,2,0,1,4,0,0,5,0,3,9,1
11944,167928,LPTn0tVsaHx75448aym62vRvPscf1ZBA,3VkHkmOtom3jM2wCu94xgzzu1d6Dn7or,2,0,0,0,0,0,3,0,3,0.42857142857142855,1,0.0,0,0,0,0,0,0,0,3,0,0,3,1
11945,167930,7Z8klAybvAyZGIIsQrZrpQ783NMpvdq7,3VkHkmOtom3jM2wCu94xgzzu1d6Dn7or,18,25,6,20,5,1,4,1,62,8.857142857142858,2,0.0,6,6,18,5,19,1,2,4,1,35,27,1
11946,167937,kS0U8tHee4noGncNrIbRrvTmtI5gjObk,3VkHkmOtom3jM2wCu94xgzzu1d6Dn7or,11,8,2,6,3,3,7,2,31,4.428571428571429,1,0.0,5,2,5,3,3,3,1,7,2,15,16,1
11947,167945,rn5hy4kLEAdjSMx6pi3quUc9lK76cxan,3VkHkmOtom3jM2wCu94xgzzu1d6Dn7or,7,11,1,4,3,0,1,0,20,2.857142857142857,1,0.0,7,1,3,3,4,0,1,1,0,14,6,1
11948,168015,Rh1vKzdCidGYpOFdiiTOGFQrX9OfRVrK,fbPkOYLVPtPgIt0MxizjfFJov3JbHyAi,16,21,9,11,8,0,6,2,57,8.142857142857142,1,0.0,8,9,8,8,13,0,3,6,2,33,24,1
11949,168019,xRwztXzP34GXcx4vKCvLpNuDFYBUsz25,fbPkOYLVPtPgIt0MxizjfFJov3JbHyAi,1,0,0,0,0,0,1,0,1,0.14285714285714285,1,0.0,0,0,0,0,0,0,0,1,0,0,1,1
11950,168020,tvBsBGirmDJVH8dehRY8Wk9DejDqHNQp,fbPkOYLVPtPgIt0MxizjfFJov3JbHyAi,5,2,1,0,1,2,2,0,8,1.1428571428571428,1,0.0,0,1,0,1,2,2,0,2,0,2,6,1
11951,168021,NGkJealfvLzyvMkO29aSPohtdMh2i3ow,fbPkOYLVPtPgIt0MxizjfFJov3JbHyAi,7,5,3,0,2,2,3,0,15,2.142857142857143,1,0.0,0,3,0,2,5,2,0,3,0,5,10,1
11952,168023,VkRjQK2qlHCknrchQonihFBxiFQQVGQO,fbPkOYLVPtPgIt0MxizjfFJov3JbHyAi,11,30,10,6,11,0,15,3,75,10.714285714285714,1,0.0,14,10,4,11,16,0,2,15,3,39,36,1
11953,168028,FGJh9lbE5Tn49JmYTykhj6B5KNIkrzwf,fbPkOYLVPtPgIt0MxizjfFJov3JbHyAi,1,0,0,0,0,0,1,0,1,0.14285714285714285,1,0.0,0,0,0,0,0,0,0,1,0,0,1,1
11954,168031,Eap9EiKeyqyLbVGyO4A2zaijmfNVHLXY,fbPkOYLVPtPgIt0MxizjfFJov3JbHyAi,10,4,2,8,2,0,4,1,21,3.0,1,0.0,2,2,6,2,2,0,2,4,1,12,9,1
11955,168032,eyimxuVK1iUaBa5XIHzsJwFV7NapmCZJ,fbPkOYLVPtPgIt0MxizjfFJov3JbHyAi,8,5,0,0,0,3,5,1,14,2.0,1,0.0,0,0,0,0,5,3,0,5,1,0,14,1
11956,168034,8rCgh1V1FnOt1VMiZt2feZ4FTdc3fpeV,fbPkOYLVPtPgIt0MxizjfFJov3JbHyAi,2,0,0,0,0,0,2,0,2,0.2857142857142857,1,0.0,0,0,0,0,0,0,0,2,0,0,2,1
11957,168035,heWJRVg7rEQJKctb9hAqhrrVJgE71Gu9,fbPkOYLVPtPgIt0MxizjfFJov3JbHyAi,1,0,0,0,0,0,1,0,1,0.14285714285714285,1,0.0,0,0,0,0,0,0,0,1,0,0,1,1
11958,168036,MMquCyNjUMgS5b34ju97Oi2r6jesXYK3,fbPkOYLVPtPgIt0MxizjfFJov3JbHyAi,1,0,0,0,0,0,1,0,1,0.14285714285714285,1,0.0,0,0,0,0,0,0,0,1,0,0,1,1
11959,168039,ZIkd5954CfxEZXjGpH9BuNCIQkDTlhtL,3VkHkmOtom3jM2wCu94xgzzu1d6Dn7or,3,0,0,0,0,0,3,0,3,0.42857142857142855,1,0.0,0,0,0,0,0,0,0,3,0,0,3,1
11960,168044,agO2Ru00XubrL0e4kzGQoZWj9imREUZ9,3VkHkmOtom3jM2wCu94xgzzu1d6Dn7or,6,3,1,0,1,3,4,1,13,1.8571428571428572,1,0.0,0,1,0,1,3,3,0,4,1,2,11,1
11961,168050,wR7MeRMuDjqJzIdX6xUDIhHYl6LZetsZ,3VkHkmOtom3jM2wCu94xgzzu1d6Dn7or,1,0,0,0,0,0,1,0,1,0.14285714285714285,1,0.0,0,0,0,0,0,0,0,1,0,0,1,1
11962,168052,Tdt2jo6FSzEcoRXiY9yw2yu67hyh4xhY,3VkHkmOtom3jM2wCu94xgzzu1d6Dn7or,1,0,0,0,0,0,1,0,1,0.14285714285714285,1,0.0,0,0,0,0,0,0,0,1,0,0,1,1
11963,168059,2XEzBTMWqAbDwimqhpYNFpmeQsMJgIYu,3VkHkmOtom3jM2wCu94xgzzu1d6Dn7or,5,0,0,0,0,0,11,1,12,1.7142857142857142,1,0.0,0,0,0,0,0,0,0,11,1,0,12,1
11964,168060,cv8pP2C7zo3M4L5aHmjPvGod8iwTqQAC,3VkHkmOtom3jM2wCu94xgzzu1d6Dn7or,3,2,1,0,0,0,1,0,4,0.5714285714285714,1,0.0,0,1,0,0,2,0,0,1,0,1,3,1
11965,168061,vNkyXjtvXeXvTJ0R5l3MEzTPr3QeDydS,3VkHkmOtom3jM2wCu94xgzzu1d6Dn7or,1,0,0,0,0,0,1,0,1,0.14285714285714285,1,0.0,0,0,0,0,0,0,0,1,0,0,1,1
11966,168077,qdrCejGYeJq7RFcgxxMCapyK4zpMSCop,3VkHkmOtom3jM2wCu94xgzzu1d6Dn7or,5,2,1,0,1,0,2,0,6,0.8571428571428571,1,0.0,0,1,0,1,2,0,0,2,0,2,4,1
11967,168089,11NHL7hbUJDC0P19HwO6czO0KD8tCMmJ,3VkHkmOtom3jM2wCu94xgzzu1d6Dn7or,1,0,0,0,0,0,1,0,1,0.14285714285714285,1,0.0,0,0,0,0,0,0,0,1,0,0,1,1
11968,168096,VJ6kZoKlg9Zf0JikQy89C9wmuItXDaaY,3VkHkmOtom3jM2wCu94xgzzu1d6Dn7or,3,0,0,0,0,0,4,0,4,0.5714285714285714,1,0.0,0,0,0,0,0,0,0,4,0,0,4,1
11969,168099,uCdgNfsOxrpsY6xF4ndmj3Egun0Rh7Cv,3VkHkmOtom3jM2wCu94xgzzu1d6Dn7or,13,11,8,0,3,2,7,1,32,4.571428571428571,1,0.0,0,8,0,3,11,2,0,7,1,11,21,1
11970,168102,2fI4wWrvurl3ODzFoF1kViu5y8Lc1NgZ,3VkHkmOtom3jM2wCu94xgzzu1d6Dn7or,5,4,1,0,2,0,3,0,10,1.4285714285714286,1,0.0,2,1,0,2,2,0,0,3,0,5,5,1
11971,168112,TzgPm4FTPrcVn51KvJ9nPbASPBwJN49G,3VkHkmOtom3jM2wCu94xgzzu1d6Dn7or,2,0,0,0,0,0,3,0,3,0.42857142857142855,1,0.0,0,0,0,0,0,0,0,3,0,0,3,1
11972,168116,CAshoVKvqnHK81BNgbgwkueL8tfZXRMD,3VkHkmOtom3jM2wCu94xgzzu1d6Dn7or,21,54,25,0,9,0,37,0,125,17.857142857142858,2,0.0,0,25,0,9,54,0,0,37,0,34,91,1
11973,168118,vYehDPhgNQtlmHh1y514ycZEmEdAJ0r0,3VkHkmOtom3jM2wCu94xgzzu1d6Dn7or,1,0,0,0,0,0,1,0,1,0.14285714285714285,1,0.0,0,0,0,0,0,0,0,1,0,0,1,1
11974,168123,sm8Pt42lYmt5RjZttn9EWmBp0Dzh6yOg,3VkHkmOtom3jM2wCu94xgzzu1d6Dn7or,7,4,3,0,3,0,2,0,12,1.7142857142857142,1,0.0,0,3,0,3,4,0,0,2,0,6,6,1
11975,168127,7G8Rik8u1uuQIuR6kuVHJF82hy9UDWIA,3VkHkmOtom3jM2wCu94xgzzu1d6Dn7or,5,2,1,0,1,0,5,0,9,1.2857142857142858,2,0.0,0,1,0,1,2,0,0,5,0,2,7,1
11976,168130,q5SuICv9n6fk3Gj0UBboD0DygELcDR8L,3VkHkmOtom3jM2wCu94xgzzu1d6Dn7or,10,9,4,0,4,0,1,0,18,2.5714285714285716,1,0.0,0,4,0,4,9,0,0,1,0,8,10,1
11977,168131,uggm3AdsFLBy2JtnSepLESRXBJfVPM0R,3VkHkmOtom3jM2wCu94xgzzu1d6Dn7or,2,0,0,0,0,0,2,0,2,0.2857142857142857,1,0.0,0,0,0,0,0,0,0,2,0,0,2,1
11978,168135,GRgjzx7VHY5z0cMezCfvrpSTKqpE3kNZ,3VkHkmOtom3jM2wCu94xgzzu1d6Dn7or,3,0,0,0,0,0,4,0,4,0.5714285714285714,1,0.0,0,0,0,0,0,0,0,4,0,0,4,0
11979,168138,IQl7iITPplsUEK81vvRW6Jh5ZlBMnohA,3VkHkmOtom3jM2wCu94xgzzu1d6Dn7or,13,26,13,12,8,8,6,0,73,10.428571428571429,2,0.0,7,13,10,8,19,8,2,6,0,38,35,1
11980,168140,hYCidWQrwCkhGcNer5p8OhehcNSTshYJ,3VkHkmOtom3jM2wCu94xgzzu1d6Dn7or,1,0,0,0,0,0,1,0,1,0.14285714285714285,1,0.0,0,0,0,0,0,0,0,1,0,0,1,1
11981,168146,nASd4bkg9iOQ5C6KGA8KokEbNySckLI3,3VkHkmOtom3jM2wCu94xgzzu1d6Dn7or,7,3,2,0,2,0,5,0,12,1.7142857142857142,4,0.0,0,2,0,2,3,0,0,5,0,4,8,1
11982,168151,mB8CkewoHHgxRRhNB2wtIGdwD4mVURIG,3VkHkmOtom3jM2wCu94xgzzu1d6Dn7or,7,2,1,0,1,2,7,1,14,2.0,1,0.0,0,1,0,1,2,2,0,7,1,2,12,1
11983,168157,wEHix8LAp0DQBJzQzg9nQJbNHoAylxAV,3VkHkmOtom3jM2wCu94xgzzu1d6Dn7or,1,0,0,0,0,0,1,0,1,0.14285714285714285,1,0.0,0,0,0,0,0,0,0,1,0,0,1,1
11984,168159,JZE0ZjzMd9hpjhitnrIYN3nfbAe7Xg7V,3VkHkmOtom3jM2wCu94xgzzu1d6Dn7or,9,5,4,0,4,10,6,0,29,4.142857142857143,1,0.0,0,4,0,4,5,10,0,6,0,8,21,1
11985,168164,nMKMZ6d7UNyqp8l1Z23oE7NBRpj50POO,3VkHkmOtom3jM2wCu94xgzzu1d6Dn7or,4,0,0,0,0,0,5,0,5,0.7142857142857143,1,0.0,0,0,0,0,0,0,0,5,0,0,5,1
11986,168165,KuPMRa6zx9uVQzQiiJfjbnqpuKQ7ehe6,3VkHkmOtom3jM2wCu94xgzzu1d6Dn7or,1,0,0,0,0,0,1,0,1,0.14285714285714285,1,0.0,0,0,0,0,0,0,0,1,0,0,1,1
11987,168166,uEbUnTaquYcI9HiXWys2O7OIJAInX4uE,3VkHkmOtom3jM2wCu94xgzzu1d6Dn7or,5,4,2,0,1,0,3,0,10,1.4285714285714286,1,0.0,0,2,0,1,4,0,0,3,0,3,7,1
11988,168170,BwAkSOoid8hSIsM9tqJ6rtQwQQPGyL2E,3VkHkmOtom3jM2wCu94xgzzu1d6Dn7or,1,0,0,0,0,0,3,0,3,0.42857142857142855,1,0.0,0,0,0,0,0,0,0,3,0,0,3,1
11989,169709,ZjaO90YO6SbarxJ3Cmlj3CTm7IehtZpd,fbPkOYLVPtPgIt0MxizjfFJov3JbHyAi,1,0,0,0,0,0,1,0,1,0.14285714285714285,1,0.0,0,0,0,0,0,0,0,1,0,0,1,1
11990,169711,gzmN8VLkF6QCaC4IobudOv6PTgb6exUk,fbPkOYLVPtPgIt0MxizjfFJov3JbHyAi,5,5,3,0,2,0,2,0,12,1.7142857142857142,2,0.0,0,3,0,2,5,0,0,2,0,5,7,1
11991,169712,on5DMrYwiqlqmQeDVhGtFBdUskUZZhIt,fbPkOYLVPtPgIt0MxizjfFJov3JbHyAi,1,0,0,0,0,0,1,0,1,0.14285714285714285,1,0.0,0,0,0,0,0,0,0,1,0,0,1,1
11992,169715,Uk2Y8qj9Cf6T7k2O1cxM5Fue4zKTF1K8,fbPkOYLVPtPgIt0MxizjfFJov3JbHyAi,16,9,4,13,3,3,8,1,41,5.857142857142857,2,0.0,2,4,11,3,7,3,2,8,1,20,21,1
11993,169717,TG3ZuEJuEwKy3hkCPL590sfXZmiZZmKY,fbPkOYLVPtPgIt0MxizjfFJov3JbHyAi,7,5,3,0,3,0,2,0,13,1.8571428571428572,1,0.0,0,3,0,3,5,0,0,2,0,6,7,1
11994,169718,1zErz13s8fNQRVaEvkOtvw6bLhr23yB4,fbPkOYLVPtPgIt0MxizjfFJov3JbHyAi,1,0,0,0,0,0,1,0,1,0.14285714285714285,1,0.0,0,0,0,0,0,0,0,1,0,0,1,1
11995,169719,3uqpbZSnLO1eJeHoknDZKcTUgItMaIsr,fbPkOYLVPtPgIt0MxizjfFJov3JbHyAi,1,0,0,0,0,0,1,0,1,0.14285714285714285,1,0.0,0,0,0,0,0,0,0,1,0,0,1,1
11996,169721,HNjmezOX8bu6iW67SYkfKBzixQs4v7AY,fbPkOYLVPtPgIt0MxizjfFJov3JbHyAi,2,0,0,0,0,0,2,0,2,0.2857142857142857,1,0.0,0,0,0,0,0,0,0,2,0,0,2,1
11997,169722,c7BQt6pwyr74vZa2XhmLGh7eET6ymX3O,fbPkOYLVPtPgIt0MxizjfFJov3JbHyAi,1,0,0,0,0,0,1,0,1,0.14285714285714285,1,0.0,0,0,0,0,0,0,0,1,0,0,1,1
11998,169723,3CWAStXWZfnymtslODBe0T4VwTot5qO9,fbPkOYLVPtPgIt0MxizjfFJov3JbHyAi,1,0,0,0,0,0,1,0,1,0.14285714285714285,1,0.0,0,0,0,0,0,0,0,1,0,0,1,1
11999,169729,z1u2jl8Hd3JcsLZgCFkCBR6j2KEKuIt6,fbPkOYLVPtPgIt0MxizjfFJov3JbHyAi,6,4,1,0,0,0,3,0,8,1.1428571428571428,1,0.0,0,1,0,0,4,0,0,3,0,1,7,1
12000,169732,BpDOkJmprkl3MzCUQelxcxGE9nfbBO8e,fbPkOYLVPtPgIt0MxizjfFJov3JbHyAi,3,0,0,0,0,4,5,0,9,1.2857142857142858,1,0.0,0,0,0,0,0,4,0,5,0,0,9,1
12001,169733,IvSFszPnr18KVZKYGSQ6sSbo1mXQ0RkU,fbPkOYLVPtPgIt0MxizjfFJov3JbHyAi,5,3,1,0,1,0,4,0,9,1.2857142857142858,1,0.0,0,1,0,1,3,0,0,4,0,2,7,1
12002,169741,bKVslXuzEQ1pv4c6iV5mVjs6X6avUbmL,5X6FeZozNMgE2VRi3MJYjkkFK8SETtu2,19,24,6,20,13,0,2,0,65,9.285714285714286,2,0.0,16,6,18,13,8,0,2,2,0,53,12,1
12003,169742,vBI9bFKpE2lZD2pCKedut3xzJe3InBGD,SpATywNh6bZuzm8s1ceuBUnMUAeoAHHw,34,34,15,29,10,0,8,0,96,13.714285714285714,4,0.0,8,15,26,10,26,0,3,8,0,59,37,0
12004,169760,sevSk5OvS8Sn7eCSBigrDJCqH5Hzftgi,5X6FeZozNMgE2VRi3MJYjkkFK8SETtu2,1,0,0,0,0,0,1,0,1,0.14285714285714285,1,0.0,0,0,0,0,0,0,0,1,0,0,1,1
12005,169764,O8pydf8wdA8EjOBMj6o80eWX7PkIMpuy,7GRhBDsirIGkRZBtSMEzNTyDr2JQm4xx,7,1,1,0,1,1,4,1,9,1.2857142857142858,1,0.0,0,1,0,1,1,1,0,4,1,2,7,1
12006,169767,l1rg3D8Gp1lv7dbBBYKvzTS3OZ5DRjWH,7GRhBDsirIGkRZBtSMEzNTyDr2JQm4xx,11,15,6,0,3,0,2,0,26,3.7142857142857144,2,0.0,0,6,0,3,15,0,0,2,0,9,17,1
12007,169797,npTxDxadULeYhHN8NazvZSh6FSHSOkNS,SpATywNh6bZuzm8s1ceuBUnMUAeoAHHw,6,4,3,0,2,0,3,0,12,1.7142857142857142,1,0.0,0,3,0,2,4,0,0,3,0,5,7,1
12008,169808,nq8bR2L0RLlBhmbma1mjdqiNKrD7Hg6k,5X6FeZozNMgE2VRi3MJYjkkFK8SETtu2,1,0,0,0,0,0,1,0,1,0.14285714285714285,1,0.0,0,0,0,0,0,0,0,1,0,0,1,1
12009,169813,T7I0bmVpFP7i0YadOfDRSUAzo81IilUz,A3fsA9Zfv1X2fVEQhTw51lKENdNrEqT3,6,5,2,0,2,0,1,0,10,1.4285714285714286,1,0.0,0,2,0,2,5,0,0,1,0,4,6,1
12010,169814,w7UkLHeAPhvA1M8odbbK7J9zzLA0KhPR,7GRhBDsirIGkRZBtSMEzNTyDr2JQm4xx,10,12,0,10,0,2,5,0,29,4.142857142857143,1,0.0,5,0,9,0,7,2,1,5,0,14,15,1
12011,169838,FzewIaS8n9FLjjmr86Fwneg2na5DKLsk,SpATywNh6bZuzm8s1ceuBUnMUAeoAHHw,5,2,1,0,1,0,5,0,9,1.2857142857142858,1,0.0,0,1,0,1,2,0,0,5,0,2,7,0
12012,169845,QFfUN9yxUlsMNYgpicOpe1up7xBAfW6Y,7GRhBDsirIGkRZBtSMEzNTyDr2JQm4xx,4,2,1,0,1,0,1,0,5,0.7142857142857143,1,0.0,0,1,0,1,2,0,0,1,0,2,3,1
12013,169853,Qi3PLuC7w2Yo9hFgq37MObjY8icnRdc6,7GRhBDsirIGkRZBtSMEzNTyDr2JQm4xx,14,25,9,14,1,2,4,0,55,7.857142857142857,1,0.0,6,9,12,1,19,2,2,4,0,28,27,1
12014,169876,dVenSfS9klH4q58uxaLQn2gbJOk5CBgU,A3fsA9Zfv1X2fVEQhTw51lKENdNrEqT3,1,0,0,0,0,0,1,0,1,0.14285714285714285,1,0.0,0,0,0,0,0,0,0,1,0,0,1,1
12015,169887,BWSUybrP5WF5o86qBDzFhcxUudwFIkgM,SpATywNh6bZuzm8s1ceuBUnMUAeoAHHw,7,17,1,0,1,0,3,0,22,3.142857142857143,1,0.0,0,1,0,1,17,0,0,3,0,2,20,1
12016,169893,S6HlGgJHN4fE4VtlVBKQWpgIrEWuiqMi,SpATywNh6bZuzm8s1ceuBUnMUAeoAHHw,10,13,7,0,1,6,9,1,37,5.285714285714286,3,0.0,2,7,0,1,11,6,0,9,1,10,27,1
12017,169898,BDOlU8SNOZffwyL4ZSOzluDyTbkYrcLY,A3fsA9Zfv1X2fVEQhTw51lKENdNrEqT3,2,0,0,0,0,0,3,0,3,0.42857142857142855,1,0.0,0,0,0,0,0,0,0,3,0,0,3,1
12018,169927,xTSfleEeHyuYGYALjmgY9nj7dgmrM7R4,5X6FeZozNMgE2VRi3MJYjkkFK8SETtu2,2,0,0,0,0,0,2,0,2,0.2857142857142857,1,0.0,0,0,0,0,0,0,0,2,0,0,2,1
12019,169963,i0ksX07HnsV5rQlWqOr1uKEuc7yNU24c,7GRhBDsirIGkRZBtSMEzNTyDr2JQm4xx,14,7,5,0,4,1,7,0,24,3.4285714285714284,1,0.0,1,5,0,4,6,1,0,7,0,10,14,1
12020,169965,yoLxxWVkkb8r6N5aDiWN8TSJAYwxngkl,SpATywNh6bZuzm8s1ceuBUnMUAeoAHHw,48,107,45,47,12,51,27,5,294,42.0,4,0.0,32,45,36,12,75,51,11,27,5,125,169,0
12021,169969,9dRmB3kQRyLzaAAPAp5pmf3CZroVQEBk,SpATywNh6bZuzm8s1ceuBUnMUAeoAHHw,18,21,12,0,5,2,8,3,51,7.285714285714286,1,0.0,2,12,0,5,19,2,0,8,3,19,32,1
12022,169984,f6KJlC1ScrQZtGOzsyUMpOtZeSqtR8rB,7GRhBDsirIGkRZBtSMEzNTyDr2JQm4xx,1,0,0,0,0,0,1,0,1,0.14285714285714285,1,0.0,0,0,0,0,0,0,0,1,0,0,1,1
12023,169997,6bQAu3lhZR1MLjYZGRxFtK6G9xGgxToy,A3fsA9Zfv1X2fVEQhTw51lKENdNrEqT3,4,2,1,0,1,0,1,0,5,0.7142857142857143,1,0.0,0,1,0,1,2,0,0,1,0,2,3,1
12024,170013,nVB1o73xluQXZjoI2dUYHGxbCDG8qiCL,5X6FeZozNMgE2VRi3MJYjkkFK8SETtu2,1,0,0,0,0,0,2,0,2,0.2857142857142857,2,0.0,0,0,0,0,0,0,0,2,0,0,2,1
12025,170016,nVB1o73xluQXZjoI2dUYHGxbCDG8qiCL,A3fsA9Zfv1X2fVEQhTw51lKENdNrEqT3,1,0,0,0,0,0,2,0,2,0.2857142857142857,2,0.0,0,0,0,0,0,0,0,2,0,0,2,1
12026,170023,c1BXmJNemroOPh6WUefTBD28s2WzSNwi,7GRhBDsirIGkRZBtSMEzNTyDr2JQm4xx,5,4,0,0,0,0,2,0,6,0.8571428571428571,1,0.0,1,0,0,0,3,0,0,2,0,1,5,1
12027,170043,n0HFF3TwqKuBMzzkdLCbvb8Mji5ZUnVX,7GRhBDsirIGkRZBtSMEzNTyDr2JQm4xx,5,2,1,0,1,0,2,0,6,0.8571428571428571,1,0.0,0,1,0,1,2,0,0,2,0,2,4,1
12028,170078,S6Mv1aKyTUf7xcwwDYCs3vpkSwBRaGU9,SpATywNh6bZuzm8s1ceuBUnMUAeoAHHw,4,4,0,0,0,0,2,0,6,0.8571428571428571,2,0.0,0,0,0,0,4,0,0,2,0,0,6,0
12029,170079,Gc94ylq1l33qmAFqvJxQNCYabgxfLjbY,bWdj2GDclj5ofokWjzoa5jAwMkxCykd6,10,15,5,60,0,0,2,0,82,11.714285714285714,1,0.0,5,5,55,0,10,0,5,2,0,65,17,1
12030,170102,3v1JFL0HMqiuFdQBduyDYGcupFiSmqdG,7GRhBDsirIGkRZBtSMEzNTyDr2JQm4xx,21,26,7,14,7,0,4,0,58,8.285714285714286,2,0.0,18,7,12,7,8,0,2,4,0,44,14,1
12031,170120,uSDVh18pcCwxI96mN9a9rvZLD88sOdeQ,RXDvfPUBYFlVdlueBFbLW0mhhAyGEqpt,2,0,0,0,0,0,2,0,2,0.2857142857142857,1,0.0,0,0,0,0,0,0,0,2,0,0,2,0
12032,170183,JJ2BrQ1QlR8nvrRwoiGYxLQ2LBkS2Wey,G8EPVSXsOYB5YQWZGiz1aVq5Pgr2GrQu,7,3,2,0,2,0,2,0,9,1.2857142857142858,1,0.0,0,2,0,2,3,0,0,2,0,4,5,1
12033,170184,JXFir7EgTVcRLR36C3eOl6MVr5FCwAGN,A3fsA9Zfv1X2fVEQhTw51lKENdNrEqT3,35,35,27,0,22,0,9,0,93,13.285714285714286,3,0.0,0,27,0,22,35,0,0,9,0,49,44,1
12034,170198,W8psMt8K6E7obsinwdemXzpwbpxCP9R1,7GRhBDsirIGkRZBtSMEzNTyDr2JQm4xx,5,10,5,0,0,0,2,0,17,2.4285714285714284,1,0.0,1,5,0,0,9,0,0,2,0,6,11,1
12035,170218,jkRVMwWglWyTDpeckcGigMAGHQXeoiC7,SpATywNh6bZuzm8s1ceuBUnMUAeoAHHw,6,4,3,0,3,0,1,0,11,1.5714285714285714,1,0.0,0,3,0,3,4,0,0,1,0,6,5,1
12036,170227,0rzsRgV74jtqobT7C3FDDTNVaVjJDj1m,SpATywNh6bZuzm8s1ceuBUnMUAeoAHHw,33,44,19,10,13,0,1,0,87,12.428571428571429,2,0.0,3,19,10,13,41,0,0,1,0,45,42,0
12037,170246,yLJyDzhntbH1XoSkElsVTG3uFtVGGuYx,SpATywNh6bZuzm8s1ceuBUnMUAeoAHHw,5,3,1,0,1,0,1,0,6,0.8571428571428571,1,0.0,0,1,0,1,3,0,0,1,0,2,4,1
12038,170248,9b2fchNyVZPjqpmxjleqzL9edi9EOH23,7GRhBDsirIGkRZBtSMEzNTyDr2JQm4xx,1,0,0,0,0,0,1,0,1,0.14285714285714285,1,0.0,0,0,0,0,0,0,0,1,0,0,1,1
12039,170259,F6PMIuaItZsVrgehXKA3QdyFlGSxSfCT,5X6FeZozNMgE2VRi3MJYjkkFK8SETtu2,8,13,1,6,5,0,2,0,27,3.857142857142857,1,0.0,8,1,6,5,5,0,0,2,0,20,7,1
12040,170266,OBC6Rr26MOMnvPdxf4UiZyK1TkKdkXdO,bWdj2GDclj5ofokWjzoa5jAwMkxCykd6,11,10,4,0,4,0,4,0,22,3.142857142857143,2,0.0,2,4,0,4,8,0,0,4,0,10,12,1
12041,170268,9IP5FYaoy3mLJ0e4bLrHDIO94Xx0pbLk,SpATywNh6bZuzm8s1ceuBUnMUAeoAHHw,10,23,10,0,0,0,2,0,35,5.0,2,0.0,0,10,0,0,23,0,0,2,0,10,25,1
12042,170271,iLrqT1cSiRqHGveKnknegGGgRshrAyXQ,A3fsA9Zfv1X2fVEQhTw51lKENdNrEqT3,1,0,0,0,0,0,1,0,1,0.14285714285714285,1,0.0,0,0,0,0,0,0,0,1,0,0,1,0
12043,170272,CvkCRHPN9Kdm6u8tUG5peGiWArNJEfk8,7GRhBDsirIGkRZBtSMEzNTyDr2JQm4xx,22,27,7,33,14,3,7,1,92,13.142857142857142,1,0.0,19,7,28,14,8,3,5,7,1,68,24,1
12044,170295,Hu1q9BM1uNTUWAtdnE0dGgL9CPbL7g91,bWdj2GDclj5ofokWjzoa5jAwMkxCykd6,4,3,2,0,2,1,1,0,9,1.2857142857142858,1,0.0,0,2,0,2,3,1,0,1,0,4,5,0
12045,170297,QHac5ChQi0jjis2Aa8598hG063M0Aev9,A3fsA9Zfv1X2fVEQhTw51lKENdNrEqT3,1,0,0,0,0,0,1,0,1,0.14285714285714285,1,0.0,0,0,0,0,0,0,0,1,0,0,1,1
12046,170318,UZZ4oED4itrD9fuKBxKj9qNTxIOc56Fd,5X6FeZozNMgE2VRi3MJYjkkFK8SETtu2,3,2,0,0,0,0,2,0,4,0.5714285714285714,1,0.0,0,0,0,0,2,0,0,2,0,0,4,1
12047,170321,c9mIdDAhRczXEb5UJiDqrnVR2zYNOBwR,5X6FeZozNMgE2VRi3MJYjkkFK8SETtu2,4,1,1,0,0,0,2,0,4,0.5714285714285714,1,0.0,0,1,0,0,1,0,0,2,0,1,3,1
12048,170327,fOnqWC7nQb9W53LcQzCrEMI7ZvS9gv3y,5X6FeZozNMgE2VRi3MJYjkkFK8SETtu2,1,0,0,0,0,0,1,0,1,0.14285714285714285,1,0.0,0,0,0,0,0,0,0,1,0,0,1,0
12049,170357,ung1DnQyYgd0tfz7mAKTwJrrm5UPHWt1,A3fsA9Zfv1X2fVEQhTw51lKENdNrEqT3,1,0,0,0,0,0,1,0,1,0.14285714285714285,1,0.0,0,0,0,0,0,0,0,1,0,0,1,1
12050,170370,1d0o1TrUuYYpxTQO8Zc2bQiGJ5e5RjS7,SpATywNh6bZuzm8s1ceuBUnMUAeoAHHw,6,4,1,6,0,0,2,0,13,1.8571428571428572,1,0.0,0,1,5,0,4,0,1,2,0,6,7,1
12051,170383,kInpuD24WAXDN2oDvgEQpEim21sGlNtt,SpATywNh6bZuzm8s1ceuBUnMUAeoAHHw,1,0,0,0,0,0,2,0,2,0.2857142857142857,1,0.0,0,0,0,0,0,0,0,2,0,0,2,1
12052,170404,AHBTTwifTV4kFq5PYNWRmN0YYbgueA3K,5X6FeZozNMgE2VRi3MJYjkkFK8SETtu2,2,0,0,0,0,0,2,0,2,0.2857142857142857,1,0.0,0,0,0,0,0,0,0,2,0,0,2,0
12053,170424,iKgnPLhvVQse7oL8jh4sOm9046t6sK9B,5X6FeZozNMgE2VRi3MJYjkkFK8SETtu2,2,0,0,0,0,0,2,0,2,0.2857142857142857,1,0.0,0,0,0,0,0,0,0,2,0,0,2,1
12054,170436,68jxA2PUjT1NQfZbUcdmPfGR0u6r2zeM,7GRhBDsirIGkRZBtSMEzNTyDr2JQm4xx,1,0,0,0,0,0,3,0,3,0.42857142857142855,1,0.0,0,0,0,0,0,0,0,3,0,0,3,1
12055,170437,KiFyZJyo9VTN2jnOIMRF0BEPiMc6llDh,SpATywNh6bZuzm8s1ceuBUnMUAeoAHHw,1,0,0,0,0,0,1,0,1,0.14285714285714285,1,0.0,0,0,0,0,0,0,0,1,0,0,1,1
12056,170446,68jxA2PUjT1NQfZbUcdmPfGR0u6r2zeM,SpATywNh6bZuzm8s1ceuBUnMUAeoAHHw,1,0,0,0,0,0,1,0,1,0.14285714285714285,1,0.0,0,0,0,0,0,0,0,1,0,0,1,1
12057,170452,68jxA2PUjT1NQfZbUcdmPfGR0u6r2zeM,bWdj2GDclj5ofokWjzoa5jAwMkxCykd6,1,0,0,0,0,0,1,0,1,0.14285714285714285,1,0.0,0,0,0,0,0,0,0,1,0,0,1,1
12058,170453,68jxA2PUjT1NQfZbUcdmPfGR0u6r2zeM,G8EPVSXsOYB5YQWZGiz1aVq5Pgr2GrQu,1,0,0,0,0,0,1,0,1,0.14285714285714285,1,0.0,0,0,0,0,0,0,0,1,0,0,1,1
12059,170454,68jxA2PUjT1NQfZbUcdmPfGR0u6r2zeM,A3fsA9Zfv1X2fVEQhTw51lKENdNrEqT3,1,0,0,0,0,0,2,0,2,0.2857142857142857,2,0.0,0,0,0,0,0,0,0,2,0,0,2,1
12060,170464,m8tZWvMesr1zQS0esJJogsiMlXHxe2Cd,bWdj2GDclj5ofokWjzoa5jAwMkxCykd6,1,0,0,0,0,0,1,0,1,0.14285714285714285,1,0.0,0,0,0,0,0,0,0,1,0,0,1,1
12061,170539,AM61RuK5BGw2QCAwj10qxPsGo5n0aSXg,SpATywNh6bZuzm8s1ceuBUnMUAeoAHHw,1,0,0,0,0,0,1,0,1,0.14285714285714285,1,0.0,0,0,0,0,0,0,0,1,0,0,1,1
12062,170543,Z4MdM7wvbK2oPoLlwXYYW0r3PZvWrL6Z,7GRhBDsirIGkRZBtSMEzNTyDr2JQm4xx,5,2,1,0,1,0,2,0,6,0.8571428571428571,1,0.0,0,1,0,1,2,0,0,2,0,2,4,1
12063,170558,40L77km5z19sJEVeJ6u4qpa9SAG2ZSIF,G8EPVSXsOYB5YQWZGiz1aVq5Pgr2GrQu,23,13,7,64,0,0,4,0,88,12.571428571428571,2,0.0,4,7,52,0,9,0,12,4,0,63,25,1
12064,170563,zaU4z26ajoscWieMrtG9dyjFX4jyC0Mh,SpATywNh6bZuzm8s1ceuBUnMUAeoAHHw,1,0,0,0,0,0,1,0,1,0.14285714285714285,1,0.0,0,0,0,0,0,0,0,1,0,0,1,1
12065,170568,aPM6Pkx8yXzDO1Wq6YMG1wXnFkTU2WLX,SpATywNh6bZuzm8s1ceuBUnMUAeoAHHw,1,0,0,0,0,0,1,0,1,0.14285714285714285,1,0.0,0,0,0,0,0,0,0,1,0,0,1,1
12066,170604,npbzydZfydGneeM7kdEFvQEFfvT3OFkh,SpATywNh6bZuzm8s1ceuBUnMUAeoAHHw,1,0,0,0,0,0,2,0,2,0.2857142857142857,2,0.0,0,0,0,0,0,0,0,2,0,0,2,1
12067,170606,jxxhPxoL1C2Q3sJ0zwG7rkjhVHAN9wuY,G8EPVSXsOYB5YQWZGiz1aVq5Pgr2GrQu,1,0,0,0,0,0,1,0,1,0.14285714285714285,1,0.0,0,0,0,0,0,0,0,1,0,0,1,1
12068,170608,jxxhPxoL1C2Q3sJ0zwG7rkjhVHAN9wuY,A3fsA9Zfv1X2fVEQhTw51lKENdNrEqT3,1,0,0,0,0,0,1,0,1,0.14285714285714285,1,0.0,0,0,0,0,0,0,0,1,0,0,1,1
12069,170618,TxlSnMAR26IaOfJh6C0k9qQhw2BgogEc,bWdj2GDclj5ofokWjzoa5jAwMkxCykd6,9,4,1,0,1,0,5,1,12,1.7142857142857142,1,0.0,0,1,0,1,4,0,0,5,1,2,10,1
12070,170628,1FJgNHNZRyIkv3hAgs29ZaCmWBTNZtcq,7GRhBDsirIGkRZBtSMEzNTyDr2JQm4xx,1,0,0,0,0,0,1,0,1,0.14285714285714285,1,0.0,0,0,0,0,0,0,0,1,0,0,1,1
12071,170635,dcCbaqbKHCs7CPRffWThbopWB8akROlP,7GRhBDsirIGkRZBtSMEzNTyDr2JQm4xx,8,3,1,0,1,0,5,3,13,1.8571428571428572,1,0.0,0,1,0,1,3,0,0,5,3,2,11,1
12072,170641,lF2uzhIawwPthZ8YuZGuLgbGDHXIrPbI,A3fsA9Zfv1X2fVEQhTw51lKENdNrEqT3,6,4,2,0,2,1,1,0,10,1.4285714285714286,1,0.0,0,2,0,2,4,1,0,1,0,4,6,1
12073,170668,uxpPi5YjzalklY0lH8OBSyWxa4yOJr6b,A3fsA9Zfv1X2fVEQhTw51lKENdNrEqT3,1,0,0,0,0,0,1,0,1,0.14285714285714285,1,0.0,0,0,0,0,0,0,0,1,0,0,1,1
12074,170680,xfIXdIbpI0XdgPBSDtKqxzOIzP21Dq8x,7GRhBDsirIGkRZBtSMEzNTyDr2JQm4xx,1,0,0,0,0,0,1,0,1,0.14285714285714285,1,0.0,0,0,0,0,0,0,0,1,0,0,1,1
12075,170682,K3RmvehnU0yLuzkdfShsHIJB4RyDPmXO,bWdj2GDclj5ofokWjzoa5jAwMkxCykd6,6,9,1,0,1,0,3,0,14,2.0,2,0.0,2,1,0,1,7,0,0,3,0,4,10,1
12076,170696,LJYBef7iIBiSZz8D7KTtMTsdkyd91gnR,5X6FeZozNMgE2VRi3MJYjkkFK8SETtu2,10,9,3,8,4,0,3,0,27,3.857142857142857,1,0.0,4,3,7,4,5,0,1,3,0,18,9,1
12077,170702,rZmq1xfHyezOQ1I4MHBeGbasPbzytcWo,7GRhBDsirIGkRZBtSMEzNTyDr2JQm4xx,5,3,1,0,1,0,3,0,8,1.1428571428571428,1,0.0,0,1,0,1,3,0,0,3,0,2,6,1
12078,170705,BAuOZksDAofxaiuwNawc5LNrXI2dqbAj,7GRhBDsirIGkRZBtSMEzNTyDr2JQm4xx,4,0,0,0,0,0,4,0,4,0.5714285714285714,1,0.0,0,0,0,0,0,0,0,4,0,0,4,1
12079,170726,ZKAk08L8Iriz8Uv5UOeqSbrNnzg1rlMz,7GRhBDsirIGkRZBtSMEzNTyDr2JQm4xx,7,3,2,8,0,0,2,0,15,2.142857142857143,1,0.0,0,2,8,0,3,0,0,2,0,10,5,0
12080,170729,DREmWIqc4qrvZwDSpHA26SV6hVqbkJG2,7GRhBDsirIGkRZBtSMEzNTyDr2JQm4xx,9,5,2,0,2,5,5,0,19,2.7142857142857144,1,0.0,0,2,0,2,5,5,0,5,0,4,15,0
12081,170733,MHt53JOUaGE51KCIrddgWHFrpxGB2EpZ,7GRhBDsirIGkRZBtSMEzNTyDr2JQm4xx,27,39,1,18,6,2,12,1,79,11.285714285714286,2,0.0,19,1,11,6,20,2,7,12,1,37,42,0
12082,170737,qr1Y8xuPrcpdzScNHYsirGXqasfUdOVa,7GRhBDsirIGkRZBtSMEzNTyDr2JQm4xx,2,0,0,0,0,0,2,0,2,0.2857142857142857,1,0.0,0,0,0,0,0,0,0,2,0,0,2,1
12083,170750,SafBDjMrdgI8ylQBKik25aaX2CxJ12jz,7GRhBDsirIGkRZBtSMEzNTyDr2JQm4xx,1,0,0,0,0,0,1,0,1,0.14285714285714285,1,0.0,0,0,0,0,0,0,0,1,0,0,1,1
12084,170777,NElV2n26Er7GqFUdQtsIGJE7FvU7cYME,5Gyp41oLVo7Gg7vF4vpmggWP5MU70QO6,6,3,1,0,1,0,2,1,8,1.1428571428571428,1,0.0,0,1,0,1,3,0,0,2,1,2,6,1
12085,170814,j7cKEzIFE4CxIsdlWhLymAub0pLUVNyX,5Gyp41oLVo7Gg7vF4vpmggWP5MU70QO6,8,5,3,0,2,0,4,0,14,2.0,1,0.0,0,3,0,2,5,0,0,4,0,5,9,1
12086,170819,KcmL8Zk4Ez99HWgGxzQ9DcI24ai75NjV,5Gyp41oLVo7Gg7vF4vpmggWP5MU70QO6,9,8,3,5,2,0,1,0,19,2.7142857142857144,1,0.0,4,3,3,2,4,0,2,1,0,12,7,1
12087,170831,DbO93Amt4Tjv1uRw8sUGPBiRutmMYEtj,5Gyp41oLVo7Gg7vF4vpmggWP5MU70QO6,13,9,1,0,5,1,7,1,24,3.4285714285714284,2,0.0,2,1,0,5,7,1,0,7,1,8,16,1
12088,170844,rDiZUR8IqJWXrAbcZYr2X23doFMMi6zI,5Gyp41oLVo7Gg7vF4vpmggWP5MU70QO6,7,7,4,0,2,0,1,0,14,2.0,1,0.0,0,4,0,2,7,0,0,1,0,6,8,1
12089,170859,1F6Z7dVChIrDg0fIBjrIJVhCuA2aRvKt,5Gyp41oLVo7Gg7vF4vpmggWP5MU70QO6,8,5,1,0,2,0,2,0,10,1.4285714285714286,1,0.0,1,1,0,2,4,0,0,2,0,4,6,1
12090,170874,16Rh83SGbwsKl4u12KoJxkqbYToorB8L,5Gyp41oLVo7Gg7vF4vpmggWP5MU70QO6,7,3,2,0,2,0,2,0,9,1.2857142857142858,1,0.0,0,2,0,2,3,0,0,2,0,4,5,1
12091,170888,6UmeN2LmLVTIBB0JmWuuEzp03JmJMIMk,5Gyp41oLVo7Gg7vF4vpmggWP5MU70QO6,5,3,2,0,1,0,1,0,7,1.0,1,0.0,0,2,0,1,3,0,0,1,0,3,4,1
12092,170892,xe9PdHtL47ijNdtrDmdC73RUGIc061NJ,5Gyp41oLVo7Gg7vF4vpmggWP5MU70QO6,7,14,7,0,0,0,4,0,25,3.5714285714285716,1,0.0,0,7,0,0,14,0,0,4,0,7,18,1
12093,170907,BLoa1RvSOgexbSH4hGzCihmBc8pXd0Db,5Gyp41oLVo7Gg7vF4vpmggWP5MU70QO6,14,13,8,0,4,7,7,1,40,5.714285714285714,2,0.0,2,8,0,4,11,7,0,7,1,14,26,1
12094,170934,K1Mr8ibRcxd3SAoDrX7638T2SELigCVm,5Gyp41oLVo7Gg7vF4vpmggWP5MU70QO6,17,18,10,10,4,13,7,2,64,9.142857142857142,2,0.0,3,10,8,4,15,13,2,7,2,25,39,1
12095,170957,J2UugGs6hVBOQWkbknVBYMLNhGLiI9aS,5Gyp41oLVo7Gg7vF4vpmggWP5MU70QO6,13,9,5,13,1,0,2,0,30,4.285714285714286,1,0.0,3,5,8,1,6,0,5,2,0,17,13,0
12096,170967,ZAxPvKt7nxIwMtWS73sUPoRTYD1C4K4s,5Gyp41oLVo7Gg7vF4vpmggWP5MU70QO6,16,9,6,2,4,0,5,0,26,3.7142857142857144,1,0.0,1,6,1,4,8,0,1,5,0,12,14,1
12097,171043,FBJBt2gVBj2QfyWMkz8U1ucypUDyZcGE,5Gyp41oLVo7Gg7vF4vpmggWP5MU70QO6,1,0,0,0,0,0,1,0,1,0.14285714285714285,1,0.0,0,0,0,0,0,0,0,1,0,0,1,1
12098,171063,8nSv6iVlspEmJhNJZhRrWeobuweFML73,5Gyp41oLVo7Gg7vF4vpmggWP5MU70QO6,4,2,1,0,1,0,4,0,8,1.1428571428571428,1,0.0,0,1,0,1,2,0,0,4,0,2,6,1
12099,171081,xXWa4DSZCmkNOniTZyQtEksuk96BYzru,5Gyp41oLVo7Gg7vF4vpmggWP5MU70QO6,4,2,0,0,0,0,3,0,5,0.7142857142857143,1,0.0,0,0,0,0,2,0,0,3,0,0,5,1
12100,171124,2eCfFbSmRHfXLNEqAQXwgq6fqbBiCxhL,5Gyp41oLVo7Gg7vF4vpmggWP5MU70QO6,13,22,9,12,2,0,3,0,48,6.857142857142857,3,0.0,7,9,10,2,15,0,2,3,0,28,20,1
12101,171164,lkpb1B28r0WoySNGL8tYf0anQJycU5Mu,5Gyp41oLVo7Gg7vF4vpmggWP5MU70QO6,7,5,3,0,2,0,2,0,12,1.7142857142857142,2,0.0,0,3,0,2,5,0,0,2,0,5,7,1
12102,171224,aLXOlEQWPWqccb0Upda6TUUDXRgu1qKZ,5Gyp41oLVo7Gg7vF4vpmggWP5MU70QO6,15,28,14,0,6,0,7,0,55,7.857142857142857,2,0.0,10,14,0,6,18,0,0,7,0,30,25,1
12103,171241,zikfbKKf6UwbalVzNX9BImZBlJFR20fk,5Gyp41oLVo7Gg7vF4vpmggWP5MU70QO6,13,29,11,0,0,3,9,1,53,7.571428571428571,1,0.0,13,11,0,0,16,3,0,9,1,24,29,1
12104,171290,1VJpXNJPzWFn2SXuVocsKvXImAZvB7bf,5Gyp41oLVo7Gg7vF4vpmggWP5MU70QO6,1,0,0,0,0,0,1,0,1,0.14285714285714285,1,0.0,0,0,0,0,0,0,0,1,0,0,1,1
12105,171323,MZAmGhAEWGPuVAzV6OtAggDJIouImErE,5Gyp41oLVo7Gg7vF4vpmggWP5MU70QO6,6,3,2,0,2,0,1,0,8,1.1428571428571428,1,0.0,0,2,0,2,3,0,0,1,0,4,4,1
12106,171327,94q4qnMa2LC25wamPAfS2ZimaITCFLoV,5Gyp41oLVo7Gg7vF4vpmggWP5MU70QO6,6,6,2,0,0,0,3,0,11,1.5714285714285714,2,0.0,0,2,0,0,6,0,0,3,0,2,9,0
12107,171328,pm85doNHXPjqLBCMZfpmajyMqA4KqeSF,5Gyp41oLVo7Gg7vF4vpmggWP5MU70QO6,4,3,1,0,0,0,2,0,6,0.8571428571428571,1,0.0,0,1,0,0,3,0,0,2,0,1,5,1
12108,171334,po02BHI8nF4qroi12z2tbBgRuT2ewh2W,5Gyp41oLVo7Gg7vF4vpmggWP5MU70QO6,8,5,4,0,4,0,1,0,14,2.0,1,0.0,0,4,0,4,5,0,0,1,0,8,6,1
12109,171358,X14gKVD1ZKu0qL0NchpqxwhoYSEpz9QI,5Gyp41oLVo7Gg7vF4vpmggWP5MU70QO6,28,31,16,24,10,12,16,10,119,17.0,4,0.0,9,16,20,10,22,12,4,16,10,55,64,1
12110,171362,6hq7AqI28Vviowv754yaCDqXhWGhIasa,5Gyp41oLVo7Gg7vF4vpmggWP5MU70QO6,10,19,9,0,4,0,2,0,34,4.857142857142857,1,0.0,7,9,0,4,12,0,0,2,0,20,14,0
12111,171386,cCDRpzTB8HHtN04WIxkJpUhVWagCQAze,5Gyp41oLVo7Gg7vF4vpmggWP5MU70QO6,11,8,5,0,4,2,5,1,25,3.5714285714285716,1,0.0,0,5,0,4,8,2,0,5,1,9,16,1
12112,171398,MAbPSnEy6ESOJbtOxM69x4qTaAjZoj0h,5Gyp41oLVo7Gg7vF4vpmggWP5MU70QO6,1,0,0,0,0,0,1,0,1,0.14285714285714285,1,0.0,0,0,0,0,0,0,0,1,0,0,1,1
12113,171421,eE4DAv5aHElS2DPaTad4VXPjk6A3xvPl,5Gyp41oLVo7Gg7vF4vpmggWP5MU70QO6,1,0,0,0,0,0,1,0,1,0.14285714285714285,1,0.0,0,0,0,0,0,0,0,1,0,0,1,1
12114,171446,g1Cr8oGjwnibXUxENrZW4o7CTbjhe1X9,5Gyp41oLVo7Gg7vF4vpmggWP5MU70QO6,9,7,3,2,2,0,3,0,17,2.4285714285714284,1,0.0,4,3,1,2,3,0,1,3,0,10,7,1
12115,171454,za2dBkPPLD9IPRBjooK7GJit2ulI5UgN,5Gyp41oLVo7Gg7vF4vpmggWP5MU70QO6,4,2,1,0,1,0,1,0,5,0.7142857142857143,1,0.0,0,1,0,1,2,0,0,1,0,2,3,1
12116,171458,b6Qe8q5Fclp7t6LX2p9zT67cdJXJuSE3,5Gyp41oLVo7Gg7vF4vpmggWP5MU70QO6,6,5,3,0,1,0,1,0,10,1.4285714285714286,1,0.0,0,3,0,1,5,0,0,1,0,4,6,1
12117,171470,ZBlB6Wg7Xnzn1aTO8CFqtYS2fTldmD0G,5Gyp41oLVo7Gg7vF4vpmggWP5MU70QO6,3,2,0,0,0,0,2,0,4,0.5714285714285714,1,0.0,0,0,0,0,2,0,0,2,0,0,4,1
12118,171494,bu1uIofAEXp6y759RqllOrvBV32SRihX,5Gyp41oLVo7Gg7vF4vpmggWP5MU70QO6,11,8,7,0,6,0,2,0,23,3.2857142857142856,1,0.0,0,7,0,6,8,0,0,2,0,13,10,1
12119,171509,ANC0sI5rGZOptNQXEXeynoEKn2Bpk1PU,5Gyp41oLVo7Gg7vF4vpmggWP5MU70QO6,19,24,11,13,6,0,2,0,56,8.0,1,0.0,10,11,9,6,14,0,4,2,0,36,20,1
12120,171537,aAOzFQFrcsF3yrT279qwdyVv9fLaubBQ,5Gyp41oLVo7Gg7vF4vpmggWP5MU70QO6,1,0,0,0,0,0,1,0,1,0.14285714285714285,1,0.0,0,0,0,0,0,0,0,1,0,0,1,1
12121,171540,KGKXtIu1hkHju7SCZs8gtmA9OwHIqK9w,5Gyp41oLVo7Gg7vF4vpmggWP5MU70QO6,5,4,2,0,2,0,5,0,13,1.8571428571428572,1,0.0,0,2,0,2,4,0,0,5,0,4,9,1
12122,171544,BCNID86vmrRX3R9DuKj7YIYUpL4fSJYm,5Gyp41oLVo7Gg7vF4vpmggWP5MU70QO6,8,5,3,0,2,0,7,0,17,2.4285714285714284,2,0.0,0,3,0,2,5,0,0,7,0,5,12,1
12123,171549,V2NRv3Sit8lMwet1uVs2Kp9JtB3zeCKG,5Gyp41oLVo7Gg7vF4vpmggWP5MU70QO6,4,2,1,0,1,0,1,0,5,0.7142857142857143,1,0.0,0,1,0,1,2,0,0,1,0,2,3,0
12124,171571,k9b7kQx2aSnkvqwGaVUq7WY7auu36Dlh,5Gyp41oLVo7Gg7vF4vpmggWP5MU70QO6,6,2,1,0,1,1,4,0,9,1.2857142857142858,1,0.0,0,1,0,1,2,1,0,4,0,2,7,1
12125,171592,Ru02EutTLrruwAny9ylOJgeAasEsHgbM,5Gyp41oLVo7Gg7vF4vpmggWP5MU70QO6,7,3,2,0,2,0,2,0,9,1.2857142857142858,1,0.0,0,2,0,2,3,0,0,2,0,4,5,1
12126,171598,5vJFPsrBBoU4mJIzAgQct6OtHErWZiWH,5Gyp41oLVo7Gg7vF4vpmggWP5MU70QO6,9,9,4,0,4,0,3,0,20,2.857142857142857,1,0.0,3,4,0,4,6,0,0,3,0,11,9,1
12127,171599,DYy3OcZHNqaAwRPZTK5mmyz2pajxcVFG,5Gyp41oLVo7Gg7vF4vpmggWP5MU70QO6,1,0,0,0,0,0,1,0,1,0.14285714285714285,1,0.0,0,0,0,0,0,0,0,1,0,0,1,1
12128,171601,iZHOjwd7SzBLuq5D09wXvvsBRsDWBAZv,5Gyp41oLVo7Gg7vF4vpmggWP5MU70QO6,1,0,0,0,0,0,1,0,1,0.14285714285714285,1,0.0,0,0,0,0,0,0,0,1,0,0,1,1
12129,171614,ouItlTj5Mb1NgXaWCx2kAeM4hlRK1Dxg,5Gyp41oLVo7Gg7vF4vpmggWP5MU70QO6,14,15,5,0,5,21,19,5,70,10.0,1,0.0,7,5,0,5,8,21,0,19,5,17,53,1
12130,171618,fmeeFnjhwYH2n4i1I5o29mG0vlPSXRPv,5Gyp41oLVo7Gg7vF4vpmggWP5MU70QO6,14,8,4,5,2,3,6,1,29,4.142857142857143,1,0.0,1,4,3,2,7,3,2,6,1,10,19,1
12131,171627,2semIfkfzXAn8VpP32yLN8VRWTW4LvFv,5Gyp41oLVo7Gg7vF4vpmggWP5MU70QO6,6,7,3,0,1,0,2,0,13,1.8571428571428572,1,0.0,0,3,0,1,7,0,0,2,0,4,9,1
12132,171631,9EXZe4rA73rjRwOXuPLFojXAu8sgDIhp,5Gyp41oLVo7Gg7vF4vpmggWP5MU70QO6,1,0,0,0,0,0,1,0,1,0.14285714285714285,1,0.0,0,0,0,0,0,0,0,1,0,0,1,1
12133,171691,OgdOPd05FB8JLqNf2tHQE32wi3JWR5UE,5Gyp41oLVo7Gg7vF4vpmggWP5MU70QO6,1,0,0,0,0,0,1,0,1,0.14285714285714285,1,0.0,0,0,0,0,0,0,0,1,0,0,1,1
12134,171698,wTl3XYUAYzqRMzZkwrXVjeSABzRutm4D,5Gyp41oLVo7Gg7vF4vpmggWP5MU70QO6,1,0,0,0,0,0,1,0,1,0.14285714285714285,1,0.0,0,0,0,0,0,0,0,1,0,0,1,1
12135,171748,cEuj1Vj3kd5U9dS7NtQ6BZ0f1gWSumY3,5Gyp41oLVo7Gg7vF4vpmggWP5MU70QO6,6,3,2,0,1,0,2,0,8,1.1428571428571428,1,0.0,0,2,0,1,3,0,0,2,0,3,5,1
12136,171778,hfDfEOXiIHuyd4ALvi6bYZuABJVi2R5C,5Gyp41oLVo7Gg7vF4vpmggWP5MU70QO6,11,10,7,0,5,0,8,0,30,4.285714285714286,1,0.0,0,7,0,5,10,0,0,8,0,12,18,1
12137,171808,DOUzBowgiBiSd0WY63LnmYU5H1Cyd4yG,5Gyp41oLVo7Gg7vF4vpmggWP5MU70QO6,4,2,1,0,1,0,1,0,5,0.7142857142857143,1,0.0,0,1,0,1,2,0,0,1,0,2,3,1
12138,171821,Xlh5ippHzZXKGtuFirBnUVeacsiFMGpO,5Gyp41oLVo7Gg7vF4vpmggWP5MU70QO6,24,31,11,15,8,2,7,0,74,10.571428571428571,1,0.0,16,11,11,8,15,2,4,7,0,46,28,1
12139,171838,SpJiooDi3NATxGKTLwjsTvo3USLI62CY,5Gyp41oLVo7Gg7vF4vpmggWP5MU70QO6,1,0,0,0,0,0,1,0,1,0.14285714285714285,1,0.0,0,0,0,0,0,0,0,1,0,0,1,1
12140,171842,vUswML4BOS4fQTYdJ1lhDZ3vYOA5s9Z9,5Gyp41oLVo7Gg7vF4vpmggWP5MU70QO6,1,0,0,0,0,0,1,0,1,0.14285714285714285,1,0.0,0,0,0,0,0,0,0,1,0,0,1,1
12141,171845,0mA7W6oH8rftuhpuksmenILG88c2ly8e,5Gyp41oLVo7Gg7vF4vpmggWP5MU70QO6,5,2,1,0,1,0,2,0,6,0.8571428571428571,1,0.0,0,1,0,1,2,0,0,2,0,2,4,0
12142,171850,ok0tlHkljrRyJLc4IxF19K0KxH1EmPpB,5Gyp41oLVo7Gg7vF4vpmggWP5MU70QO6,8,5,2,0,2,1,4,0,14,2.0,1,0.0,0,2,0,2,5,1,0,4,0,4,10,1
12143,171868,IOF8pS0IUBT5xGV0aUjNmWc3XN3KPDuB,5Gyp41oLVo7Gg7vF4vpmggWP5MU70QO6,3,3,1,0,0,0,1,0,5,0.7142857142857143,1,0.0,1,1,0,0,2,0,0,1,0,2,3,1
12144,171931,yNQJXdGIF6UXbO9gVDxTGblaDrQgDoSG,5Gyp41oLVo7Gg7vF4vpmggWP5MU70QO6,1,0,0,0,0,0,1,0,1,0.14285714285714285,1,0.0,0,0,0,0,0,0,0,1,0,0,1,1
12145,171982,K9G1vnDvIQqefCd1TXVzaB5mHYpxWwLV,5Gyp41oLVo7Gg7vF4vpmggWP5MU70QO6,6,2,1,0,1,0,4,0,8,1.1428571428571428,1,0.0,0,1,0,1,2,0,0,4,0,2,6,1
12146,172024,LYVTLxQ7DkIyGxqfGxrucEdheDHteZDT,5Gyp41oLVo7Gg7vF4vpmggWP5MU70QO6,8,9,4,0,5,0,1,0,19,2.7142857142857144,1,0.0,4,4,0,5,5,0,0,1,0,13,6,1
12147,172025,OD35qzGthshP80LHHJJjjzfdibBzRyRk,5Gyp41oLVo7Gg7vF4vpmggWP5MU70QO6,3,2,0,0,0,0,1,0,3,0.42857142857142855,1,0.0,0,0,0,0,2,0,0,1,0,0,3,1
12148,172044,5i9U6osFtARGJN7oErvhXsNBG4TY5tr6,5Gyp41oLVo7Gg7vF4vpmggWP5MU70QO6,10,6,3,6,2,0,2,0,19,2.7142857142857144,1,0.0,3,3,4,2,3,0,2,2,0,12,7,1
12149,172073,rqAQ39ogOkcjPbj0vGYhMl1MCDudE3TF,5Gyp41oLVo7Gg7vF4vpmggWP5MU70QO6,7,5,2,0,1,0,2,0,10,1.4285714285714286,1,0.0,0,2,0,1,5,0,0,2,0,3,7,1
12150,172079,JUXaUT76xGfe9CQCOTjnER9kYb6QPZYj,5Gyp41oLVo7Gg7vF4vpmggWP5MU70QO6,4,3,2,0,2,0,1,0,8,1.1428571428571428,1,0.0,0,2,0,2,3,0,0,1,0,4,4,1
12151,172109,M3wQgbZbbasIjodSdOQuP2oULc0pzjtd,5Gyp41oLVo7Gg7vF4vpmggWP5MU70QO6,8,5,3,0,2,0,3,0,13,1.8571428571428572,1,0.0,0,3,0,2,5,0,0,3,0,5,8,0
12152,172116,dw8UeboqdsSC29cEE9urly5h5PKlFfq8,5Gyp41oLVo7Gg7vF4vpmggWP5MU70QO6,1,0,0,0,0,0,1,0,1,0.14285714285714285,1,0.0,0,0,0,0,0,0,0,1,0,0,1,1
12153,172161,9DRj3AyeoqZYIgzePpOniNsOdPu9PJ5k,5Gyp41oLVo7Gg7vF4vpmggWP5MU70QO6,1,0,0,0,0,0,1,0,1,0.14285714285714285,1,0.0,0,0,0,0,0,0,0,1,0,0,1,1
12154,172162,kbRnk8jChBXXDiqQcJLnXCxKOzDJcEQL,5Gyp41oLVo7Gg7vF4vpmggWP5MU70QO6,5,2,1,0,1,0,2,0,6,0.8571428571428571,1,0.0,0,1,0,1,2,0,0,2,0,2,4,1
12155,172196,LEj3twDvm8YzuICCFE9K4bbYI9Q38Ol1,5Gyp41oLVo7Gg7vF4vpmggWP5MU70QO6,1,0,0,0,0,0,1,0,1,0.14285714285714285,1,0.0,0,0,0,0,0,0,0,1,0,0,1,1
12156,172204,UgIckIONRiYQsrSc5wzXuAP9VmdpXGB8,5Gyp41oLVo7Gg7vF4vpmggWP5MU70QO6,1,0,0,0,0,0,1,0,1,0.14285714285714285,1,0.0,0,0,0,0,0,0,0,1,0,0,1,1
12157,172208,CavZW7Z0WlWqhOFoQNMyOeE9Pj6P8ZHr,5Gyp41oLVo7Gg7vF4vpmggWP5MU70QO6,13,17,7,4,4,1,7,0,40,5.714285714285714,1,0.0,7,7,2,4,10,1,2,7,0,20,20,1
12158,172221,SpT1lJBmYgtY4qTLmB276cnQBIFA3YSB,5Gyp41oLVo7Gg7vF4vpmggWP5MU70QO6,6,0,0,0,0,0,6,1,7,1.0,1,0.0,0,0,0,0,0,0,0,6,1,0,7,1
12159,172245,Wuf3wFhPgxAHU2dsfRihBiOZfwQrF26A,5Gyp41oLVo7Gg7vF4vpmggWP5MU70QO6,2,0,0,0,0,0,10,0,10,1.4285714285714286,2,0.0,0,0,0,0,0,0,0,10,0,0,10,1
12160,172266,jDgR8hp3AGybm19tNOfLciB49pULFenE,5Gyp41oLVo7Gg7vF4vpmggWP5MU70QO6,5,4,1,0,1,0,1,0,7,1.0,1,0.0,0,1,0,1,4,0,0,1,0,2,5,1
12161,172269,XgVxftPVbIHL4AlzkoNcarSFDW4PqduV,5Gyp41oLVo7Gg7vF4vpmggWP5MU70QO6,1,0,0,0,0,0,1,0,1,0.14285714285714285,1,0.0,0,0,0,0,0,0,0,1,0,0,1,1
12162,172270,LP4glPC1eI0AUn2bsFmbsZm4O5jloMa1,5Gyp41oLVo7Gg7vF4vpmggWP5MU70QO6,16,21,9,2,6,0,5,1,44,6.285714285714286,2,0.0,10,9,1,6,11,0,1,5,1,26,18,1
12163,172273,0QuoKrP2mZHT58SMwYhNVh8QIa2Bx3jw,5Gyp41oLVo7Gg7vF4vpmggWP5MU70QO6,5,5,3,0,2,0,4,0,14,2.0,1,0.0,0,3,0,2,5,0,0,4,0,5,9,1
12164,172290,6A2JLpLWnCwUlo9pD1HHlgEwNLvzcllv,5Gyp41oLVo7Gg7vF4vpmggWP5MU70QO6,16,32,10,0,10,0,4,0,56,8.0,2,0.0,19,10,0,10,13,0,0,4,0,39,17,1
12165,172299,4n2Nl0tZzHoOppEWgxt4u2hY4geVVtJJ,5Gyp41oLVo7Gg7vF4vpmggWP5MU70QO6,1,0,0,0,0,0,1,0,1,0.14285714285714285,1,0.0,0,0,0,0,0,0,0,1,0,0,1,1
12166,172330,cJcuhtji0eqLhfXtnFSDlw6v5huTlvOS,5Gyp41oLVo7Gg7vF4vpmggWP5MU70QO6,9,8,4,0,2,0,4,0,18,2.5714285714285716,1,0.0,0,4,0,2,8,0,0,4,0,6,12,1
12167,172336,C7Kxgeum6WfhLueDjQns6qbe6TsxlPCK,5Gyp41oLVo7Gg7vF4vpmggWP5MU70QO6,1,0,0,0,0,0,1,0,1,0.14285714285714285,1,0.0,0,0,0,0,0,0,0,1,0,0,1,1
12168,172364,AJ07wanXtz0FO0onqW0kXx88fdVw4CUU,5Gyp41oLVo7Gg7vF4vpmggWP5MU70QO6,8,5,3,0,2,0,4,0,14,2.0,1,0.0,0,3,0,2,5,0,0,4,0,5,9,1
12169,172391,jVbyR2K2eRZglkuIyxRotkq1vJB87WuF,5Gyp41oLVo7Gg7vF4vpmggWP5MU70QO6,4,2,1,0,1,0,1,0,5,0.7142857142857143,1,0.0,0,1,0,1,2,0,0,1,0,2,3,1
12170,172393,ToHAGWzGsMuknDZcxMK3KQMB4qYRNYiR,5Gyp41oLVo7Gg7vF4vpmggWP5MU70QO6,4,2,1,0,0,0,2,0,5,0.7142857142857143,1,0.0,0,1,0,0,2,0,0,2,0,1,4,1
12171,172403,CCYjGlC3FnZWxpVxsninUJMYwb7GhaCL,5Gyp41oLVo7Gg7vF4vpmggWP5MU70QO6,10,6,4,0,2,0,4,0,16,2.2857142857142856,1,0.0,0,4,0,2,6,0,0,4,0,6,10,1
12172,172404,7KKCzQdQ8lXL2UI7NHtE6tx9MmBYSlHi,5Gyp41oLVo7Gg7vF4vpmggWP5MU70QO6,2,0,0,0,0,0,2,0,2,0.2857142857142857,2,0.0,0,0,0,0,0,0,0,2,0,0,2,1
12173,172407,Fvo2ym26Nb6MdSwJQ7nhdYr3i1DMB44W,5Gyp41oLVo7Gg7vF4vpmggWP5MU70QO6,8,12,0,4,0,0,6,0,22,3.142857142857143,1,0.0,6,0,2,0,6,0,2,6,0,8,14,1
12174,172435,Lz8ZDsT5UDCk6bIoizwb1zrh6ADfLJGp,5Gyp41oLVo7Gg7vF4vpmggWP5MU70QO6,8,2,1,0,1,3,7,1,15,2.142857142857143,2,0.0,0,1,0,1,2,3,0,7,1,2,13,1
12175,172452,hOcxouMMFbpEI2zTOGnFUWEG5s3cpCzo,5Gyp41oLVo7Gg7vF4vpmggWP5MU70QO6,6,2,1,0,1,0,4,1,9,1.2857142857142858,1,0.0,0,1,0,1,2,0,0,4,1,2,7,1
12176,172456,OeIZ0kLFk4McziHeHWjQ7xaXpzSyMdD7,5Gyp41oLVo7Gg7vF4vpmggWP5MU70QO6,9,4,2,0,3,2,5,1,17,2.4285714285714284,1,0.0,1,2,0,3,3,2,0,5,1,6,11,1
12177,172481,Dv4nP0an2ZA48lmeMFn0PJPZ7mStVpc5,5Gyp41oLVo7Gg7vF4vpmggWP5MU70QO6,13,46,12,4,2,0,7,0,71,10.142857142857142,3,0.0,2,12,2,2,44,0,2,7,0,18,53,1
12178,172485,wp0FEz5UfidQjtNkAoMN3675JDpXLboE,5Gyp41oLVo7Gg7vF4vpmggWP5MU70QO6,7,3,2,0,2,0,2,0,9,1.2857142857142858,1,0.0,0,2,0,2,3,0,0,2,0,4,5,1
12179,172523,LVDcSR91i9ppIWzVfGhXYeDNMblZuMMy,5Gyp41oLVo7Gg7vF4vpmggWP5MU70QO6,7,3,2,0,2,0,3,0,10,1.4285714285714286,1,0.0,0,2,0,2,3,0,0,3,0,4,6,1
12180,172580,WIulMAW8PLfyLvnliYk0w4Xs9IJHKZPS,7GRhBDsirIGkRZBtSMEzNTyDr2JQm4xx,1,0,0,0,0,0,1,0,1,0.14285714285714285,1,0.0,0,0,0,0,0,0,0,1,0,0,1,1
12181,172586,QSTrkUuhSEg0x9wjoRozsXEqzcdQePNj,7GRhBDsirIGkRZBtSMEzNTyDr2JQm4xx,1,0,0,0,0,0,1,0,1,0.14285714285714285,1,0.0,0,0,0,0,0,0,0,1,0,0,1,1
12182,172637,7fwVXF5ctPhb8pPmrNYDi2ycSDGABklq,7GRhBDsirIGkRZBtSMEzNTyDr2JQm4xx,1,0,0,0,0,0,2,0,2,0.2857142857142857,1,0.0,0,0,0,0,0,0,0,2,0,0,2,1
12183,172639,ZkfFwyK1OgVihBxVb6PuDCZttx0mY0GH,7GRhBDsirIGkRZBtSMEzNTyDr2JQm4xx,81,98,1,137,26,9,2,0,273,39.0,2,0.0,57,1,107,26,41,9,30,2,0,191,82,1
12184,172652,BQrTVd5AOKxfCXQ15n97ruZoGw3X3oOg,7GRhBDsirIGkRZBtSMEzNTyDr2JQm4xx,5,0,0,0,0,0,4,1,5,0.7142857142857143,1,0.0,0,0,0,0,0,0,0,4,1,0,5,1
12185,172653,GXhnYeLJGU7thFAyP76FesLSBQZtYEFj,7GRhBDsirIGkRZBtSMEzNTyDr2JQm4xx,1,0,0,0,0,0,1,0,1,0.14285714285714285,1,0.0,0,0,0,0,0,0,0,1,0,0,1,1
12186,172656,AWe1OrHic5QgI67j2F2SMPIoWgknbRTT,7GRhBDsirIGkRZBtSMEzNTyDr2JQm4xx,1,0,0,0,0,0,1,0,1,0.14285714285714285,1,0.0,0,0,0,0,0,0,0,1,0,0,1,1
12187,172680,bZ3XRxia6UScLuWULOu3ewlnF0TkayUX,7GRhBDsirIGkRZBtSMEzNTyDr2JQm4xx,4,3,1,0,0,0,2,0,6,0.8571428571428571,1,0.0,0,1,0,0,3,0,0,2,0,1,5,1
12188,172686,2umGjyQGiFi0nRyyzYdQU4YlPFMXEUMJ,7GRhBDsirIGkRZBtSMEzNTyDr2JQm4xx,5,2,0,0,0,0,3,0,5,0.7142857142857143,1,0.0,0,0,0,0,2,0,0,3,0,0,5,1
12189,172687,Hofgj6U6Hb3QZslFyBygVjWjwrzFRzS4,7GRhBDsirIGkRZBtSMEzNTyDr2JQm4xx,5,2,1,0,1,0,2,0,6,0.8571428571428571,1,0.0,0,1,0,1,2,0,0,2,0,2,4,1
12190,172698,4K9c4s8wbYa5MpdlPvKSdwuXWOFTVcAh,7GRhBDsirIGkRZBtSMEzNTyDr2JQm4xx,2,0,0,0,0,0,2,0,2,0.2857142857142857,1,0.0,0,0,0,0,0,0,0,2,0,0,2,1
12191,172735,Uxd7sramSgOYbTkMuTemo7Lms4lBJja0,7GRhBDsirIGkRZBtSMEzNTyDr2JQm4xx,33,31,17,0,13,0,6,0,67,9.571428571428571,2,0.0,0,17,0,13,31,0,0,6,0,30,37,1
12192,172741,Y51MqWhaiGyWdNickwBkKEZ7LC7se5uV,7GRhBDsirIGkRZBtSMEzNTyDr2JQm4xx,1,0,0,0,0,0,1,0,1,0.14285714285714285,1,0.0,0,0,0,0,0,0,0,1,0,0,1,1
12193,172746,0dwnge5EOc1G7OI2GIE4cTm6v44kkXQF,7GRhBDsirIGkRZBtSMEzNTyDr2JQm4xx,1,0,0,0,0,0,1,0,1,0.14285714285714285,1,0.0,0,0,0,0,0,0,0,1,0,0,1,1
12194,172763,o1UptbeOviyEjGY0uCAPQxZs9fzfyUsl,fbPkOYLVPtPgIt0MxizjfFJov3JbHyAi,1,0,0,0,0,0,1,0,1,0.14285714285714285,1,0.0,0,0,0,0,0,0,0,1,0,0,1,0
12195,172764,2Fiu2ToQOxpXAS5PdySG8JNslcQcfHbt,fbPkOYLVPtPgIt0MxizjfFJov3JbHyAi,7,3,2,0,2,0,2,0,9,1.2857142857142858,1,0.0,0,2,0,2,3,0,0,2,0,4,5,0
12196,172766,QkN5nvBbZszJiSQ2f66kudMZ2eWWY8sa,fbPkOYLVPtPgIt0MxizjfFJov3JbHyAi,13,31,14,0,11,0,12,0,68,9.714285714285714,1,0.0,7,14,0,11,24,0,0,12,0,32,36,0
12197,172770,A1zqAlol8cj15wsUw4Hy06zRYR65hqWX,fbPkOYLVPtPgIt0MxizjfFJov3JbHyAi,10,10,4,0,2,2,6,0,24,3.4285714285714284,1,0.0,0,4,0,2,10,2,0,6,0,6,18,1
12198,172773,Fyprxg8FSY1xRxMcSEB8g2qdW7HIqrOb,fbPkOYLVPtPgIt0MxizjfFJov3JbHyAi,4,2,1,0,1,3,2,0,9,1.2857142857142858,1,0.0,0,1,0,1,2,3,0,2,0,2,7,1
12199,172775,1ahaNbr5YZ3IpOgQelHrM05Cdnz4LKNQ,fbPkOYLVPtPgIt0MxizjfFJov3JbHyAi,12,11,6,3,6,0,4,0,30,4.285714285714286,1,0.0,4,6,3,6,7,0,0,4,0,19,11,1
12200,172776,1fw6Vhphihnnp4LoLcorlAZ7Ftif884W,fbPkOYLVPtPgIt0MxizjfFJov3JbHyAi,11,7,6,0,6,0,3,0,22,3.142857142857143,1,0.0,0,6,0,6,7,0,0,3,0,12,10,1
12201,172779,sAW5OueffXrHDi9OJn5sfKiFHR2Wetjn,fbPkOYLVPtPgIt0MxizjfFJov3JbHyAi,2,0,0,0,0,0,4,0,4,0.5714285714285714,1,0.0,0,0,0,0,0,0,0,4,0,0,4,1
12202,172780,GRZEBmREFPHaSEGbNTIsxYrZ7RqP41bT,fbPkOYLVPtPgIt0MxizjfFJov3JbHyAi,7,3,2,0,2,0,2,0,9,1.2857142857142858,1,0.0,0,2,0,2,3,0,0,2,0,4,5,1
12203,172781,rqEzbmzZimqrt0Sfmg3gp671kO3ZAOxK,fbPkOYLVPtPgIt0MxizjfFJov3JbHyAi,6,3,1,0,1,0,2,0,7,1.0,1,0.0,0,1,0,1,3,0,0,2,0,2,5,1
12204,172783,1lEtmFkqYNtAJd4xyiugkmcuZGqi1M5C,fbPkOYLVPtPgIt0MxizjfFJov3JbHyAi,1,0,0,0,0,0,1,0,1,0.14285714285714285,1,0.0,0,0,0,0,0,0,0,1,0,0,1,1
12205,172784,osbamwYgnI3KNh30lDpTfuiU6UKLtXa8,fbPkOYLVPtPgIt0MxizjfFJov3JbHyAi,5,3,1,0,2,0,3,0,9,1.2857142857142858,1,0.0,0,1,0,2,3,0,0,3,0,3,6,1
12206,172787,YY7yHizDn0UpGHVq4qoTfbulP3ev5TkC,fbPkOYLVPtPgIt0MxizjfFJov3JbHyAi,7,14,9,0,4,2,4,0,33,4.714285714285714,2,0.0,0,9,0,4,14,2,0,4,0,13,20,1
12207,173107,4Uyhf3xkbmSb7blGg2niZUhegHNb0hzL,RXDvfPUBYFlVdlueBFbLW0mhhAyGEqpt,4,3,1,0,0,0,2,0,6,0.8571428571428571,1,0.0,0,1,0,0,3,0,0,2,0,1,5,1
12208,173132,IiVLoMJOOO6WIlHpWZzTbrIoLgzhhi73,A3fsA9Zfv1X2fVEQhTw51lKENdNrEqT3,22,11,8,16,7,0,5,0,47,6.714285714285714,1,0.0,2,8,13,7,9,0,3,5,0,30,17,1
12209,173146,p9UNvuDUoGgEq49Fv2ZMxggXXq1CzTMu,SpATywNh6bZuzm8s1ceuBUnMUAeoAHHw,13,43,11,10,2,6,15,1,88,12.571428571428571,2,0.0,20,11,10,2,23,6,0,15,1,43,45,1
12210,173161,3OBHdoV61de7ICMrnWAXr689Eb2AyuN0,bWdj2GDclj5ofokWjzoa5jAwMkxCykd6,7,9,4,0,3,0,6,0,22,3.142857142857143,2,0.0,0,4,0,3,9,0,0,6,0,7,15,1
12211,173169,Q99tY6BQBfoYxTWMIDBzu9lKtLusDydm,SpATywNh6bZuzm8s1ceuBUnMUAeoAHHw,6,0,0,0,0,2,16,4,22,3.142857142857143,2,0.0,0,0,0,0,0,2,0,16,4,0,22,1
12212,173175,hg0Y9I3uepRleBrpQgMC0flFaJC1a5b5,SpATywNh6bZuzm8s1ceuBUnMUAeoAHHw,1,0,0,0,0,0,1,0,1,0.14285714285714285,1,0.0,0,0,0,0,0,0,0,1,0,0,1,1
12213,173216,55qFOvzjFp79P87tCKKcDPlhphK7gh3v,bWdj2GDclj5ofokWjzoa5jAwMkxCykd6,1,0,0,0,0,0,1,0,1,0.14285714285714285,1,0.0,0,0,0,0,0,0,0,1,0,0,1,1
12214,173230,G0Iaa3Ru4yPHix0W4Oym2wsHGEPhwa0d,bWdj2GDclj5ofokWjzoa5jAwMkxCykd6,7,6,1,0,1,0,5,1,14,2.0,1,0.0,2,1,0,1,4,0,0,5,1,4,10,1
12215,173235,eAe5usC174Ujb9GhpQmntkASbUTyc3ZW,SpATywNh6bZuzm8s1ceuBUnMUAeoAHHw,11,9,6,0,4,0,9,0,28,4.0,1,0.0,0,6,0,4,9,0,0,9,0,10,18,1
12216,173249,qggUO4B0NhIPqMhJwgIAZM8ZaIbpr9nE,bWdj2GDclj5ofokWjzoa5jAwMkxCykd6,9,16,10,0,5,0,5,0,36,5.142857142857143,1,0.0,1,10,0,5,15,0,0,5,0,16,20,1
12217,173267,8uSQsFhnhoJeSVZylwMfyqKR37MO9Qyr,RXDvfPUBYFlVdlueBFbLW0mhhAyGEqpt,4,2,1,0,1,0,1,0,5,0.7142857142857143,1,0.0,0,1,0,1,2,0,0,1,0,2,3,1
12218,173269,CVWG6F2iwkhpH91rOg9zh1AtSbOQkfbH,A3fsA9Zfv1X2fVEQhTw51lKENdNrEqT3,2,0,0,0,0,0,4,0,4,0.5714285714285714,1,0.0,0,0,0,0,0,0,0,4,0,0,4,1
12219,173304,g8m22R7W0Wo8v9RXY0TMbj5qf5RFgvht,5X6FeZozNMgE2VRi3MJYjkkFK8SETtu2,3,2,0,0,0,0,1,0,3,0.42857142857142855,1,0.0,0,0,0,0,2,0,0,1,0,0,3,1
12220,173310,Aoyawwq6v4aq2j3CtQEl64qkYlFXHmWo,5X6FeZozNMgE2VRi3MJYjkkFK8SETtu2,1,0,0,0,0,0,1,0,1,0.14285714285714285,1,0.0,0,0,0,0,0,0,0,1,0,0,1,1
12221,173330,l1rg3D8Gp1lv7dbBBYKvzTS3OZ5DRjWH,SpATywNh6bZuzm8s1ceuBUnMUAeoAHHw,1,0,0,0,0,0,1,0,1,0.14285714285714285,1,0.0,0,0,0,0,0,0,0,1,0,0,1,1
12222,173343,b7SUdO6QxE15XMARzgNrelIPh5ZxATAg,SpATywNh6bZuzm8s1ceuBUnMUAeoAHHw,16,20,9,23,4,2,3,1,62,8.857142857142858,1,0.0,7,9,19,4,13,2,4,3,1,39,23,1
12223,173373,1ZxIq2EElt84sjQ7d0VZrg3vpxtlpcZe,A3fsA9Zfv1X2fVEQhTw51lKENdNrEqT3,10,8,4,0,3,0,1,0,16,2.2857142857142856,1,0.0,0,4,0,3,8,0,0,1,0,7,9,0
12224,173395,1rAx2MzCP3OdnS9l4ZxlmSEx7YN3W0Gb,SpATywNh6bZuzm8s1ceuBUnMUAeoAHHw,7,7,1,0,1,0,4,0,13,1.8571428571428572,1,0.0,0,1,0,1,7,0,0,4,0,2,11,1
12225,173403,bHdLnMReyagsGG6h5n2AGBcImmRnOGBp,5X6FeZozNMgE2VRi3MJYjkkFK8SETtu2,4,3,1,0,1,0,3,0,8,1.1428571428571428,1,0.0,0,1,0,1,3,0,0,3,0,2,6,1
12226,173413,pZclLMasmWwcOV7UoObjB05HxqI7cJ5M,5X6FeZozNMgE2VRi3MJYjkkFK8SETtu2,1,0,0,0,0,0,1,0,1,0.14285714285714285,1,0.0,0,0,0,0,0,0,0,1,0,0,1,1
12227,173427,pZclLMasmWwcOV7UoObjB05HxqI7cJ5M,RXDvfPUBYFlVdlueBFbLW0mhhAyGEqpt,1,0,0,0,0,0,1,0,1,0.14285714285714285,1,0.0,0,0,0,0,0,0,0,1,0,0,1,1
12228,173429,pZclLMasmWwcOV7UoObjB05HxqI7cJ5M,A3fsA9Zfv1X2fVEQhTw51lKENdNrEqT3,1,0,0,0,0,0,1,0,1,0.14285714285714285,1,0.0,0,0,0,0,0,0,0,1,0,0,1,1
12229,173441,jQV5ACK38puVA98RZWJrb2Gyr0Mic373,SpATywNh6bZuzm8s1ceuBUnMUAeoAHHw,20,24,10,0,8,4,5,1,52,7.428571428571429,1,0.0,12,10,0,8,12,4,0,5,1,30,22,1
12230,173462,l1rg3D8Gp1lv7dbBBYKvzTS3OZ5DRjWH,RXDvfPUBYFlVdlueBFbLW0mhhAyGEqpt,1,0,0,0,0,0,1,0,1,0.14285714285714285,1,0.0,0,0,0,0,0,0,0,1,0,0,1,1
12231,173471,zvLkVcjFtCYyIxQ5AgxEHNEKFJjc1e0w,SpATywNh6bZuzm8s1ceuBUnMUAeoAHHw,17,11,8,12,5,3,8,1,48,6.857142857142857,2,0.0,2,8,9,5,9,3,3,8,1,24,24,1
12232,173480,z3ey1NJRJhuGG3iwCXYitfKXJ1Ty9TFL,bWdj2GDclj5ofokWjzoa5jAwMkxCykd6,6,4,1,0,0,0,5,0,10,1.4285714285714286,2,0.0,1,1,0,0,3,0,0,5,0,2,8,1
12233,173488,n6zGNJI1hLWYjlMIVXYesa3jTXjLwizj,5X6FeZozNMgE2VRi3MJYjkkFK8SETtu2,4,2,1,0,1,0,2,0,6,0.8571428571428571,1,0.0,0,1,0,1,2,0,0,2,0,2,4,1
12234,173547,miazgiIYkCwTjtM7t2vFOCBUAD25ypEf,5X6FeZozNMgE2VRi3MJYjkkFK8SETtu2,2,0,0,0,0,0,2,0,2,0.2857142857142857,1,0.0,0,0,0,0,0,0,0,2,0,0,2,1
12235,173551,VfzK5aO28OrAOvVXtOq353z79D2I5ZHx,SpATywNh6bZuzm8s1ceuBUnMUAeoAHHw,34,45,25,0,14,9,13,0,106,15.142857142857142,3,0.0,13,25,0,14,32,9,0,13,0,52,54,0
12236,173569,pPWrFxlyBbGTjAYm5iDIHfNugNgnbATN,G8EPVSXsOYB5YQWZGiz1aVq5Pgr2GrQu,32,34,18,74,9,12,10,1,158,22.571428571428573,1,0.0,12,18,62,9,22,12,12,10,1,101,57,1
12237,173570,5tgxttwTGvGdqr8cj2QgTLRxUmP4TAY4,SpATywNh6bZuzm8s1ceuBUnMUAeoAHHw,8,10,5,0,2,0,6,1,24,3.4285714285714284,1,0.0,2,5,0,2,8,0,0,6,1,9,15,1
12238,173576,5s2QZF0oRCYI8h2ElmgC6T7pH2gEDZ5h,SpATywNh6bZuzm8s1ceuBUnMUAeoAHHw,1,0,0,0,0,0,1,0,1,0.14285714285714285,1,0.0,0,0,0,0,0,0,0,1,0,0,1,1
12239,173606,5uCuxLE5XjM4y4nmjuWckCuNM8tm7Xz4,SpATywNh6bZuzm8s1ceuBUnMUAeoAHHw,3,2,0,0,0,0,1,0,3,0.42857142857142855,1,0.0,0,0,0,0,2,0,0,1,0,0,3,1
12240,173625,InWzQofmWk3UUIO2mLGTDK9j8XVQqQav,SpATywNh6bZuzm8s1ceuBUnMUAeoAHHw,1,0,0,0,0,0,1,0,1,0.14285714285714285,1,0.0,0,0,0,0,0,0,0,1,0,0,1,1
12241,173637,VYzWVw0iVQTX593OMNoOorSLmzZeKXaW,5X6FeZozNMgE2VRi3MJYjkkFK8SETtu2,1,0,0,0,0,0,1,0,1,0.14285714285714285,1,0.0,0,0,0,0,0,0,0,1,0,0,1,1
12242,173652,dzkU7a9rkvja83jr7hi3MLZJCXGqFq8k,bWdj2GDclj5ofokWjzoa5jAwMkxCykd6,4,2,0,0,0,0,2,0,4,0.5714285714285714,1,0.0,0,0,0,0,2,0,0,2,0,0,4,1
12243,173655,QfXTKSibNslqH18MyW3petQKWGiJxDlu,SpATywNh6bZuzm8s1ceuBUnMUAeoAHHw,5,10,4,0,0,0,2,0,16,2.2857142857142856,1,0.0,5,4,0,0,5,0,0,2,0,9,7,1
12244,173659,Lip64fuGzBG9bHRLCDw8nCt2gpYw3z1x,SpATywNh6bZuzm8s1ceuBUnMUAeoAHHw,4,2,1,0,1,0,1,0,5,0.7142857142857143,1,0.0,0,1,0,1,2,0,0,1,0,2,3,1
12245,173670,QqiwZUOB51djz0tMukIyFdlQb4Z6iwAX,SpATywNh6bZuzm8s1ceuBUnMUAeoAHHw,7,2,1,0,1,0,4,0,8,1.1428571428571428,1,0.0,0,1,0,1,2,0,0,4,0,2,6,1
12246,173672,vJ4UKNeuK5ggw4DX9ClwnqNtdiFYCRPF,G8EPVSXsOYB5YQWZGiz1aVq5Pgr2GrQu,1,0,0,0,0,0,1,0,1,0.14285714285714285,1,0.0,0,0,0,0,0,0,0,1,0,0,1,1
12247,173679,NN4GiQISIB9GdLTS8U7HRzfPuCQVrfY9,SpATywNh6bZuzm8s1ceuBUnMUAeoAHHw,16,15,5,34,2,2,7,0,65,9.285714285714286,1,0.0,9,5,31,2,6,2,3,7,0,47,18,1
12248,173694,g2VgGARpgGy9rA8aDCffqfXvItMu95Qi,SpATywNh6bZuzm8s1ceuBUnMUAeoAHHw,1,0,0,0,0,0,1,0,1,0.14285714285714285,1,0.0,0,0,0,0,0,0,0,1,0,0,1,1
12249,173748,wymqx0ld7yvIDGrfVTrgZliVZU4YCmE4,G8EPVSXsOYB5YQWZGiz1aVq5Pgr2GrQu,6,5,0,0,0,0,2,0,7,1.0,1,0.0,0,0,0,0,5,0,0,2,0,0,7,1
12250,173803,rZWsxN7JeP5OFYbUn0RS9NxjY5ZERM0R,bWdj2GDclj5ofokWjzoa5jAwMkxCykd6,5,2,1,0,1,0,3,0,7,1.0,2,0.0,0,1,0,1,2,0,0,3,0,2,5,1
12251,173837,mQIPwSx2V8b0TbdjDcVR3P8b5Z7qtGbP,5X6FeZozNMgE2VRi3MJYjkkFK8SETtu2,6,8,1,4,4,0,2,0,19,2.7142857142857144,1,0.0,6,1,4,4,2,0,0,2,0,15,4,1
12252,173854,quIYM1jY47tlZKkC1EmJRDFcBV4a3Pzy,A3fsA9Zfv1X2fVEQhTw51lKENdNrEqT3,1,0,0,0,0,0,1,0,1,0.14285714285714285,1,0.0,0,0,0,0,0,0,0,1,0,0,1,1
12253,173859,pPZkiQmDPKqQ9IZ0jTf8ExIfHdZSz9Tp,bWdj2GDclj5ofokWjzoa5jAwMkxCykd6,1,0,0,0,0,0,1,0,1,0.14285714285714285,1,0.0,0,0,0,0,0,0,0,1,0,0,1,1
12254,173869,oc7rYZFgg4c4rgCWuUOquFZJ5FqnUHSF,bWdj2GDclj5ofokWjzoa5jAwMkxCykd6,6,7,1,0,1,0,3,0,12,1.7142857142857142,1,0.0,1,1,0,1,6,0,0,3,0,3,9,1
12255,173872,Wx0PLmR8YQAVeoFy76pJe5bN12QOsMrr,A3fsA9Zfv1X2fVEQhTw51lKENdNrEqT3,3,5,0,0,0,0,1,0,6,0.8571428571428571,1,0.0,0,0,0,0,5,0,0,1,0,0,6,1
12256,173880,worFKZrD9eECXAuz5EQKtbbV0K7MG3Jl,A3fsA9Zfv1X2fVEQhTw51lKENdNrEqT3,5,2,1,0,1,0,2,0,6,0.8571428571428571,1,0.0,0,1,0,1,2,0,0,2,0,2,4,1
12257,173918,dr13KuqOo10EJH5V4oOgMy17ewEUhD7o,SpATywNh6bZuzm8s1ceuBUnMUAeoAHHw,3,2,1,0,0,0,1,0,4,0.5714285714285714,1,0.0,0,1,0,0,2,0,0,1,0,1,3,1
12258,173934,WI9rk8aS11tBAJzjcX0JSIgomYYRQVjW,RXDvfPUBYFlVdlueBFbLW0mhhAyGEqpt,20,20,1,0,1,2,11,3,38,5.428571428571429,2,0.0,0,1,0,1,20,2,0,11,3,2,36,0
12259,173958,wLc4w0avBex1xIgZCkms6IVr5BNBkA7D,bWdj2GDclj5ofokWjzoa5jAwMkxCykd6,1,0,0,0,0,0,1,0,1,0.14285714285714285,1,0.0,0,0,0,0,0,0,0,1,0,0,1,1
12260,173959,wLc4w0avBex1xIgZCkms6IVr5BNBkA7D,G8EPVSXsOYB5YQWZGiz1aVq5Pgr2GrQu,1,0,0,0,0,0,1,0,1,0.14285714285714285,1,0.0,0,0,0,0,0,0,0,1,0,0,1,1
12261,173987,8c8DYMmupcN8P2qPfMDQe6Ogszyz6VG1,5X6FeZozNMgE2VRi3MJYjkkFK8SETtu2,2,1,0,0,0,0,1,0,2,0.2857142857142857,1,0.0,0,0,0,0,1,0,0,1,0,0,2,1
12262,174032,WLXtV9xU02TWrBcV5JQ79YomKzdOBWBA,RXDvfPUBYFlVdlueBFbLW0mhhAyGEqpt,4,4,2,0,0,0,1,0,7,1.0,1,0.0,0,2,0,0,4,0,0,1,0,2,5,1
12263,174046,DXGwefPqbHu4FBeaKolUD6Ln1C2rCmyf,G8EPVSXsOYB5YQWZGiz1aVq5Pgr2GrQu,25,31,11,40,6,1,10,4,103,14.714285714285714,1,0.0,9,11,30,6,22,1,10,10,4,56,47,0
12264,174049,8X2IzVay8QcdAEdyXNzTeeH0ARyTPIC0,SpATywNh6bZuzm8s1ceuBUnMUAeoAHHw,6,8,3,0,4,0,1,0,16,2.2857142857142856,1,0.0,0,3,0,4,8,0,0,1,0,7,9,0
12265,174052,WXV25nLp7cw3t4qC0Fe3ygibuK55tgf8,G8EPVSXsOYB5YQWZGiz1aVq5Pgr2GrQu,2,0,0,0,0,0,2,0,2,0.2857142857142857,1,0.0,0,0,0,0,0,0,0,2,0,0,2,1
12266,174079,sheZ4N1GIaslz5kJhHqpayTxVaB6yF6h,5X6FeZozNMgE2VRi3MJYjkkFK8SETtu2,1,0,0,0,0,0,1,0,1,0.14285714285714285,1,0.0,0,0,0,0,0,0,0,1,0,0,1,1
12267,174082,Q3T5Pj9Os86NEqSmgUZNRoi8BUkSoDlj,A3fsA9Zfv1X2fVEQhTw51lKENdNrEqT3,1,0,0,0,0,0,3,0,3,0.42857142857142855,1,0.0,0,0,0,0,0,0,0,3,0,0,3,1
12268,174097,l3LjDqHkcoF39RE2r4Y8HQOp98eEYg6d,5X6FeZozNMgE2VRi3MJYjkkFK8SETtu2,1,0,0,0,0,0,1,0,1,0.14285714285714285,1,0.0,0,0,0,0,0,0,0,1,0,0,1,1
12269,174103,6F1lKjGTd159lFhX2roWh19Brj0u4Zbh,5X6FeZozNMgE2VRi3MJYjkkFK8SETtu2,1,0,0,0,0,0,1,0,1,0.14285714285714285,1,0.0,0,0,0,0,0,0,0,1,0,0,1,1
12270,174116,89IraAtUfhoGAQgzdMP1844g2s2iN4Ox,SpATywNh6bZuzm8s1ceuBUnMUAeoAHHw,16,13,6,13,4,0,4,0,40,5.714285714285714,3,0.0,4,6,13,4,9,0,0,4,0,27,13,1
12271,174121,y0CnonzJAddQ4oYr5LBSP0Y6KP3RgPGg,A3fsA9Zfv1X2fVEQhTw51lKENdNrEqT3,4,2,1,0,1,0,2,0,6,0.8571428571428571,1,0.0,0,1,0,1,2,0,0,2,0,2,4,1
12272,174126,TmcXoxCT48jZhYzJE3XlHytbzJ2TbpDY,A3fsA9Zfv1X2fVEQhTw51lKENdNrEqT3,7,4,2,6,0,0,3,0,15,2.142857142857143,1,0.0,0,2,5,0,4,0,1,3,0,7,8,1
12273,174151,CYfp5XD3W4sJRVjPRPe04xpN1AZbw9Yo,A3fsA9Zfv1X2fVEQhTw51lKENdNrEqT3,2,0,0,0,0,0,3,0,3,0.42857142857142855,1,0.0,0,0,0,0,0,0,0,3,0,0,3,1
12274,174168,y4jCbRq0ZMCabQVeAWisCVju9AF82joj,SpATywNh6bZuzm8s1ceuBUnMUAeoAHHw,11,24,1,21,0,3,6,0,55,7.857142857142857,2,0.0,16,1,20,0,8,3,1,6,0,37,18,1
12275,174181,lfpXyXNaegoXeiZXYzm52nn3ZFsKBMvI,SpATywNh6bZuzm8s1ceuBUnMUAeoAHHw,10,12,8,0,5,0,5,0,30,4.285714285714286,2,0.0,1,8,0,5,11,0,0,5,0,14,16,1
12276,174187,j7bASIUMnf4CT11rRWorZg0FZhBTc03O,A3fsA9Zfv1X2fVEQhTw51lKENdNrEqT3,14,8,6,0,6,1,5,1,27,3.857142857142857,1,0.0,0,6,0,6,8,1,0,5,1,12,15,1
12277,174206,8MuGb55gUM18pukCITXgZoTSobqXs9G4,RXDvfPUBYFlVdlueBFbLW0mhhAyGEqpt,1,0,0,0,0,0,2,0,2,0.2857142857142857,2,0.0,0,0,0,0,0,0,0,2,0,0,2,1
12278,174234,Dl6PswZ2ZYiCfnhIcCRn4UIAM0nQUpoC,G8EPVSXsOYB5YQWZGiz1aVq5Pgr2GrQu,3,2,0,0,0,0,1,0,3,0.42857142857142855,1,0.0,0,0,0,0,2,0,0,1,0,0,3,1
12279,174256,lb2vEQsRSFOUOLUPsaKbebc6S33mhh7Z,SpATywNh6bZuzm8s1ceuBUnMUAeoAHHw,2,0,0,0,0,0,2,0,2,0.2857142857142857,1,0.0,0,0,0,0,0,0,0,2,0,0,2,0
12280,174274,xzqF2LiZ7Zp1COlqOBger1kuvNL9t5JK,SpATywNh6bZuzm8s1ceuBUnMUAeoAHHw,1,0,0,0,0,0,1,0,1,0.14285714285714285,1,0.0,0,0,0,0,0,0,0,1,0,0,1,1
12281,174277,GQaFlkVp1r2Jb2YbiuWBbDDwc8QpDAHv,SpATywNh6bZuzm8s1ceuBUnMUAeoAHHw,9,8,6,0,3,2,1,0,20,2.857142857142857,1,0.0,0,6,0,3,8,2,0,1,0,9,11,1
12282,174290,m2ZLzpDl6tgvDR1yy6DPvftlSHnPZA0w,SpATywNh6bZuzm8s1ceuBUnMUAeoAHHw,1,0,0,0,0,0,1,0,1,0.14285714285714285,1,0.0,0,0,0,0,0,0,0,1,0,0,1,1
12283,174293,ZikrDKT0jI7fYxhfVuJrd7XXP7MsQajU,RXDvfPUBYFlVdlueBFbLW0mhhAyGEqpt,7,2,1,0,1,0,4,0,8,1.1428571428571428,1,0.0,0,1,0,1,2,0,0,4,0,2,6,1
12284,174301,m03K9KziYA4aijvIDRK7t2E4lIAdgRz2,RXDvfPUBYFlVdlueBFbLW0mhhAyGEqpt,6,5,3,0,2,0,3,0,13,1.8571428571428572,3,0.0,0,3,0,2,5,0,0,3,0,5,8,1
12285,174365,TDTdTCIURzk1Bl0eZfd6udEe9QlGGMaa,SpATywNh6bZuzm8s1ceuBUnMUAeoAHHw,1,0,0,0,0,0,1,0,1,0.14285714285714285,1,0.0,0,0,0,0,0,0,0,1,0,0,1,1
12286,174377,BeoWdDFNsVFqWVq3B4qjYh8vNjNTgwSB,bWdj2GDclj5ofokWjzoa5jAwMkxCykd6,12,12,8,0,4,0,22,0,46,6.571428571428571,2,0.0,0,8,0,4,12,0,0,22,0,12,34,1
12287,174421,mSZYyfRNnqnDs7qyuaQEMEvx5vC2JS4M,A3fsA9Zfv1X2fVEQhTw51lKENdNrEqT3,24,16,11,34,9,0,3,0,73,10.428571428571429,2,0.0,2,11,26,9,14,0,8,3,0,48,25,0
12288,174440,0t4jRqsyu2b51z09AohkTBv9a8OIUmuF,SpATywNh6bZuzm8s1ceuBUnMUAeoAHHw,2,0,0,0,0,0,2,0,2,0.2857142857142857,1,0.0,0,0,0,0,0,0,0,2,0,0,2,1
12289,174455,SjtyUL4RbrEJ36TmtDDzIzVYsveRIJ1b,bWdj2GDclj5ofokWjzoa5jAwMkxCykd6,4,2,0,0,0,0,2,0,4,0.5714285714285714,1,0.0,0,0,0,0,2,0,0,2,0,0,4,1
12290,174467,vnBONRqvzvm1KY9GmYXYArKs5stTyMmI,SpATywNh6bZuzm8s1ceuBUnMUAeoAHHw,43,43,27,33,13,4,17,7,144,20.571428571428573,3,0.0,6,27,28,13,37,4,5,17,7,74,70,0
12291,174478,EhHrinjt1AkEWC09AFZwBuP61S5NJgjn,SpATywNh6bZuzm8s1ceuBUnMUAeoAHHw,16,15,5,36,0,9,6,0,71,10.142857142857142,2,0.0,7,5,30,0,8,9,6,6,0,42,29,0
12292,174493,4G31JkuuWxQoMwYLKWmTZsOhrqR0raRg,SpATywNh6bZuzm8s1ceuBUnMUAeoAHHw,6,3,1,0,1,0,2,0,7,1.0,1,0.0,0,1,0,1,3,0,0,2,0,2,5,1
12293,174498,ZKJhytrxdXS5RaM2M9yN55tRum5T67Xk,SpATywNh6bZuzm8s1ceuBUnMUAeoAHHw,14,12,2,15,1,1,2,0,33,4.714285714285714,1,0.0,2,2,14,1,10,1,1,2,0,19,14,1
12294,174499,mBTzaYN6U4cNwjdbd3oK6uaVLfiAM7NK,G8EPVSXsOYB5YQWZGiz1aVq5Pgr2GrQu,7,4,1,0,2,0,2,0,9,1.2857142857142858,1,0.0,0,1,0,2,4,0,0,2,0,3,6,1
12295,174502,4G31JkuuWxQoMwYLKWmTZsOhrqR0raRg,A3fsA9Zfv1X2fVEQhTw51lKENdNrEqT3,10,7,1,0,1,0,2,0,11,1.5714285714285714,1,0.0,0,1,0,1,7,0,0,2,0,2,9,1
12296,174506,uHZhFUoOlSaoYs0uE4nLbnPxUYbY0Yrk,SpATywNh6bZuzm8s1ceuBUnMUAeoAHHw,4,2,1,0,1,0,1,0,5,0.7142857142857143,1,0.0,0,1,0,1,2,0,0,1,0,2,3,1
12297,174510,1JwhB7sCpqQuMWgVLCoQdnUSus34sW5p,SpATywNh6bZuzm8s1ceuBUnMUAeoAHHw,16,36,14,12,8,1,8,2,81,11.571428571428571,2,0.0,12,14,9,8,24,1,3,8,2,43,38,1
12298,174513,1JwhB7sCpqQuMWgVLCoQdnUSus34sW5p,A3fsA9Zfv1X2fVEQhTw51lKENdNrEqT3,8,12,1,0,0,0,5,0,18,2.5714285714285716,2,0.0,0,1,0,0,12,0,0,5,0,1,17,1
12299,174541,FOCCuGaJ7zYTl7CCCo7T3PqrLtxGVeiU,A3fsA9Zfv1X2fVEQhTw51lKENdNrEqT3,36,25,0,50,0,6,7,0,88,12.571428571428571,1,0.0,2,0,45,0,23,6,5,7,0,47,41,1
12300,174545,ghkFruWSKEsLlDR9iiyligX2yJuxgpBc,bWdj2GDclj5ofokWjzoa5jAwMkxCykd6,2,0,0,0,0,0,3,0,3,0.42857142857142855,1,0.0,0,0,0,0,0,0,0,3,0,0,3,1
12301,174563,m98O4dP1opmo7o2tpUGDqrUnbkirc7sM,A3fsA9Zfv1X2fVEQhTw51lKENdNrEqT3,12,17,0,0,0,1,2,0,20,2.857142857142857,1,0.0,1,0,0,0,16,1,0,2,0,1,19,1
12302,174581,SKmQOLoApKRqa0N0zki38NHNgkClkW5s,SpATywNh6bZuzm8s1ceuBUnMUAeoAHHw,1,0,0,0,0,0,1,0,1,0.14285714285714285,1,0.0,0,0,0,0,0,0,0,1,0,0,1,1
12303,174607,zbOrtc172Sp0ZiF8CTU6kMNb51nYxkNM,SpATywNh6bZuzm8s1ceuBUnMUAeoAHHw,7,3,2,0,2,0,2,0,9,1.2857142857142858,1,0.0,0,2,0,2,3,0,0,2,0,4,5,1
12304,174618,364stkhSwXjUJtELSEaOhKFcZM4gOjC8,SpATywNh6bZuzm8s1ceuBUnMUAeoAHHw,1,0,0,0,0,0,1,0,1,0.14285714285714285,1,0.0,0,0,0,0,0,0,0,1,0,0,1,1
12305,174662,lLiIUuRVh7zWAyO13URKYp0g2hIHe8bt,5X6FeZozNMgE2VRi3MJYjkkFK8SETtu2,6,7,4,0,2,0,6,0,19,2.7142857142857144,2,0.0,0,4,0,2,7,0,0,6,0,6,13,1
12306,174663,DJXmR0KXC00UhtfnxnB0CPGhSlDcn5wL,5X6FeZozNMgE2VRi3MJYjkkFK8SETtu2,2,0,0,0,0,0,2,0,2,0.2857142857142857,1,0.0,0,0,0,0,0,0,0,2,0,0,2,1
12307,174665,6WpUAvOn0104PVGU1qRupfdkikcVBl8O,bWdj2GDclj5ofokWjzoa5jAwMkxCykd6,5,6,3,0,1,0,2,0,12,1.7142857142857142,2,0.0,0,3,0,1,6,0,0,2,0,4,8,1
12308,174692,xMCJ7gcgv1mN5rb4Qh9dpQVUc9zQ1NLX,SpATywNh6bZuzm8s1ceuBUnMUAeoAHHw,11,18,4,2,0,16,16,3,59,8.428571428571429,4,0.0,0,4,2,0,18,16,0,16,3,6,53,1
12309,174699,Qn3OccgDXQpcut9yLA9jXfau6FPbS72n,G8EPVSXsOYB5YQWZGiz1aVq5Pgr2GrQu,1,0,0,0,0,0,3,0,3,0.42857142857142855,2,0.0,0,0,0,0,0,0,0,3,0,0,3,1
12310,174703,Nu3CWEbOlEVCvqetIYQvBCpTSFLSYvQK,SpATywNh6bZuzm8s1ceuBUnMUAeoAHHw,23,54,3,17,3,10,20,2,109,15.571428571428571,3,0.0,6,3,14,3,48,10,3,20,2,26,83,1
12311,174704,ExNrdfeKsdYl3xmpiJlCBa13JPKyssuX,bWdj2GDclj5ofokWjzoa5jAwMkxCykd6,1,0,0,0,0,0,2,0,2,0.2857142857142857,2,0.0,0,0,0,0,0,0,0,2,0,0,2,1
12312,174713,Bos3zEEnAcYzPXQktMkJJ0ak5mhGWCAf,5X6FeZozNMgE2VRi3MJYjkkFK8SETtu2,2,0,0,0,0,0,2,0,2,0.2857142857142857,1,0.0,0,0,0,0,0,0,0,2,0,0,2,1
12313,174718,Bos3zEEnAcYzPXQktMkJJ0ak5mhGWCAf,RXDvfPUBYFlVdlueBFbLW0mhhAyGEqpt,6,7,3,0,0,0,2,0,12,1.7142857142857142,1,0.0,1,3,0,0,6,0,0,2,0,4,8,1
12314,174776,Cx0tee2LW48hN6gexDH5QIypELm3snyx,SpATywNh6bZuzm8s1ceuBUnMUAeoAHHw,10,8,5,0,2,3,8,2,28,4.0,1,0.0,0,5,0,2,8,3,0,8,2,7,21,1
12315,174782,lJdTg9WUYwumFfeQmhmLXhBEAFP0NsAi,bWdj2GDclj5ofokWjzoa5jAwMkxCykd6,5,2,1,0,1,0,2,0,6,0.8571428571428571,1,0.0,0,1,0,1,2,0,0,2,0,2,4,1
12316,174791,KOAZzInqWpDIVXEW7JyQaWggITRPncK9,SpATywNh6bZuzm8s1ceuBUnMUAeoAHHw,1,0,0,0,0,0,1,0,1,0.14285714285714285,1,0.0,0,0,0,0,0,0,0,1,0,0,1,1
12317,174810,f3LuhvFBRGY0JOGlDxTNaj2JOJbt7lLA,SpATywNh6bZuzm8s1ceuBUnMUAeoAHHw,6,2,1,0,1,0,3,0,7,1.0,1,0.0,0,1,0,1,2,0,0,3,0,2,5,0
12318,174813,Bau8Ni7vPFHL0Lb3hYTZjsOuiN8oYfUJ,A3fsA9Zfv1X2fVEQhTw51lKENdNrEqT3,1,0,0,0,0,0,1,0,1,0.14285714285714285,1,0.0,0,0,0,0,0,0,0,1,0,0,1,1
12319,174820,JIZNiH5rUr2fGUoXZgKLocS74nHb5Kfe,SpATywNh6bZuzm8s1ceuBUnMUAeoAHHw,7,2,1,0,1,2,5,0,11,1.5714285714285714,1,0.0,0,1,0,1,2,2,0,5,0,2,9,1
12320,174878,fUQHFT4QEMRSPqJAQlXlvlyNwca9Q0dU,RXDvfPUBYFlVdlueBFbLW0mhhAyGEqpt,19,32,3,22,2,0,3,0,62,8.857142857142858,3,0.0,2,3,21,2,30,0,1,3,0,28,34,1
12321,174885,wRvAUuJF3e8pqF4oxebNspXV7iBtMI7e,SpATywNh6bZuzm8s1ceuBUnMUAeoAHHw,1,0,0,0,0,0,1,0,1,0.14285714285714285,1,0.0,0,0,0,0,0,0,0,1,0,0,1,1
12322,174900,5zea5vrXS7Bt1LjTuEN0slFtYiNlymMO,A3fsA9Zfv1X2fVEQhTw51lKENdNrEqT3,7,5,0,0,0,0,3,0,8,1.1428571428571428,1,0.0,0,0,0,0,5,0,0,3,0,0,8,1
12323,174911,A7SG5Yt68PpWuTq6repTaMGrRX2jTAUI,5X6FeZozNMgE2VRi3MJYjkkFK8SETtu2,21,77,28,31,20,50,20,3,229,32.714285714285715,3,0.0,38,28,22,20,39,50,9,20,3,108,121,0
12324,174927,A6qBZik0VBfWjUh1l97ldNrUQvZV7VDA,A3fsA9Zfv1X2fVEQhTw51lKENdNrEqT3,1,0,0,0,0,0,1,0,1,0.14285714285714285,1,0.0,0,0,0,0,0,0,0,1,0,0,1,1
12325,174949,YXkiTHpE2a6E2kDFUh3HT5sKHSlA7gXq,bWdj2GDclj5ofokWjzoa5jAwMkxCykd6,16,16,7,0,7,0,2,0,32,4.571428571428571,1,0.0,8,7,0,7,8,0,0,2,0,22,10,1
12326,174950,mwYPrzi4Um5Na0nVSY9kyLDHIIMuUNwA,5X6FeZozNMgE2VRi3MJYjkkFK8SETtu2,5,2,1,0,1,0,2,0,6,0.8571428571428571,1,0.0,0,1,0,1,2,0,0,2,0,2,4,1
12327,174969,KNwOU3S87AmXfVT27bvvRv8ipePthXCY,SpATywNh6bZuzm8s1ceuBUnMUAeoAHHw,11,21,1,13,0,1,2,0,38,5.428571428571429,1,0.0,15,1,10,0,6,1,3,2,0,26,12,1
12328,174982,0MmlbOf0DHxRZhBoMcyjh2941ezon8FA,SpATywNh6bZuzm8s1ceuBUnMUAeoAHHw,7,6,3,0,2,0,1,0,12,1.7142857142857142,1,0.0,0,3,0,2,6,0,0,1,0,5,7,1
12329,174991,UGNnaAmmHc9OFVaFlHMVxlDwTqvJ9WLn,bWdj2GDclj5ofokWjzoa5jAwMkxCykd6,1,0,0,0,0,0,1,0,1,0.14285714285714285,1,0.0,0,0,0,0,0,0,0,1,0,0,1,1
12330,174995,StcQZMEDAMldF4GFQUzkrPFNVNZnPaeq,5X6FeZozNMgE2VRi3MJYjkkFK8SETtu2,1,0,0,0,0,0,1,0,1,0.14285714285714285,1,0.0,0,0,0,0,0,0,0,1,0,0,1,1
12331,175009,bd7vHnljHgvVUg5G5sT2JbyZM9wuH2wF,SpATywNh6bZuzm8s1ceuBUnMUAeoAHHw,4,10,0,0,0,0,1,0,11,1.5714285714285714,1,0.0,2,0,0,0,8,0,0,1,0,2,9,1
12332,175021,cpZrl3oP8x5CfyDGz9KAwfLq9wo2kZMm,RXDvfPUBYFlVdlueBFbLW0mhhAyGEqpt,27,37,12,44,8,0,10,0,111,15.857142857142858,2,0.0,12,12,39,8,25,0,5,10,0,71,40,1
12333,175025,LkBKnxnSHkOGgNJ9NivPrJlZnjpZUjRj,5X6FeZozNMgE2VRi3MJYjkkFK8SETtu2,2,0,0,0,0,0,3,0,3,0.42857142857142855,1,0.0,0,0,0,0,0,0,0,3,0,0,3,1
12334,175028,RHEMdhoy3TVz84IqO3CiO0ZVmx7sjl4N,bWdj2GDclj5ofokWjzoa5jAwMkxCykd6,4,2,1,0,1,0,2,0,6,0.8571428571428571,1,0.0,0,1,0,1,2,0,0,2,0,2,4,1
12335,175037,Y3qAwvAkfEroY8Y6AzBfazMCosAJgRZ3,SpATywNh6bZuzm8s1ceuBUnMUAeoAHHw,6,2,1,0,1,0,3,0,7,1.0,1,0.0,0,1,0,1,2,0,0,3,0,2,5,1
12336,175055,O3zeeuO5s75bVIeVANx1rSMNWDZJgeIr,5X6FeZozNMgE2VRi3MJYjkkFK8SETtu2,2,0,0,0,0,0,2,0,2,0.2857142857142857,1,0.0,0,0,0,0,0,0,0,2,0,0,2,1
12337,175057,WoXtpP4H4ghgkRBv3UuiyrHP7GFAl55y,bWdj2GDclj5ofokWjzoa5jAwMkxCykd6,1,0,0,0,0,0,1,0,1,0.14285714285714285,1,0.0,0,0,0,0,0,0,0,1,0,0,1,1
12338,175069,4TvXiLQVsUU0sQ96NFZAreKy5tMXycWg,SpATywNh6bZuzm8s1ceuBUnMUAeoAHHw,4,2,0,0,0,0,2,0,4,0.5714285714285714,1,0.0,0,0,0,0,2,0,0,2,0,0,4,1
12339,175071,SP5kRtjsDOoGpzdvGCfZdzeWgxpoSNBK,G8EPVSXsOYB5YQWZGiz1aVq5Pgr2GrQu,1,0,0,0,0,0,2,0,2,0.2857142857142857,1,0.0,0,0,0,0,0,0,0,2,0,0,2,1
12340,175077,nG6erQ4cKSx83WV5mn5rC7gtfnWhkEmP,5X6FeZozNMgE2VRi3MJYjkkFK8SETtu2,2,0,0,0,0,0,2,0,2,0.2857142857142857,1,0.0,0,0,0,0,0,0,0,2,0,0,2,1
12341,175118,azb7CJ1Bmhkt4qbwHzuZGxEpJ1dCkFJu,G8EPVSXsOYB5YQWZGiz1aVq5Pgr2GrQu,5,2,1,0,1,0,3,0,7,1.0,1,0.0,0,1,0,1,2,0,0,3,0,2,5,1
12342,175132,0Vpaa5lAyqNTaFltvCAV7J9K7ZDbZPNf,SpATywNh6bZuzm8s1ceuBUnMUAeoAHHw,2,0,0,0,0,0,2,0,2,0.2857142857142857,1,0.0,0,0,0,0,0,0,0,2,0,0,2,1
12343,175152,WAC7RGZ1uYeT92igfYiLgTnHWPEtN2IA,bWdj2GDclj5ofokWjzoa5jAwMkxCykd6,4,2,1,0,1,0,1,0,5,0.7142857142857143,1,0.0,0,1,0,1,2,0,0,1,0,2,3,1
12344,175194,8RK6HQkv51lSsSE1n9EptQjyHrkMwfO0,A3fsA9Zfv1X2fVEQhTw51lKENdNrEqT3,1,0,0,0,0,0,1,0,1,0.14285714285714285,1,0.0,0,0,0,0,0,0,0,1,0,0,1,1
12345,175196,rtg3Ki4vk14kI9MkEBE0pkOCAO2AnCnU,bWdj2GDclj5ofokWjzoa5jAwMkxCykd6,19,31,19,106,4,6,13,1,180,25.714285714285715,3,0.0,4,19,103,4,27,6,3,13,1,130,50,1
12346,175206,cl2EKvvSJRHCOKFRMNWxvwP24f0kGb0G,SpATywNh6bZuzm8s1ceuBUnMUAeoAHHw,1,0,0,0,0,0,1,0,1,0.14285714285714285,1,0.0,0,0,0,0,0,0,0,1,0,0,1,1
12347,175238,lPm1TSKMUQ7eGKQEhVdTw2Bwzsvcola7,SpATywNh6bZuzm8s1ceuBUnMUAeoAHHw,1,0,0,0,0,0,1,0,1,0.14285714285714285,1,0.0,0,0,0,0,0,0,0,1,0,0,1,1
12348,175240,xCHQAq5m2mtyQES4gfg6MjCHDUVD1J71,A3fsA9Zfv1X2fVEQhTw51lKENdNrEqT3,5,6,0,0,0,0,2,0,8,1.1428571428571428,1,0.0,0,0,0,0,6,0,0,2,0,0,8,1
12349,175245,ltkP6i2vq0mcbwSjcj4Xv8kSZr3VUqSC,A3fsA9Zfv1X2fVEQhTw51lKENdNrEqT3,8,3,1,0,1,1,4,0,10,1.4285714285714286,1,0.0,0,1,0,1,3,1,0,4,0,2,8,1
12350,175246,kaNpWuIxNLxZkDfmjMzrYRVzuOgwIf0o,SpATywNh6bZuzm8s1ceuBUnMUAeoAHHw,1,0,0,0,0,0,3,0,3,0.42857142857142855,3,0.0,0,0,0,0,0,0,0,3,0,0,3,1
12351,175260,w2E5tS0N7MCQaF7A3ASAFp8VmrqDhyey,SpATywNh6bZuzm8s1ceuBUnMUAeoAHHw,14,8,6,0,5,0,3,0,22,3.142857142857143,2,0.0,0,6,0,5,8,0,0,3,0,11,11,1
12352,175267,gkFOg5eTAnAUv8n8zVKmC9VjpOwrpc30,SpATywNh6bZuzm8s1ceuBUnMUAeoAHHw,9,6,2,0,1,1,15,1,26,3.7142857142857144,2,0.0,0,2,0,1,6,1,0,15,1,3,23,1
12353,175284,Fl2rv0GIrb1pZGPCAVV4X3WnsKhjbfP2,A3fsA9Zfv1X2fVEQhTw51lKENdNrEqT3,8,3,1,0,1,0,5,0,10,1.4285714285714286,1,0.0,0,1,0,1,3,0,0,5,0,2,8,1
12354,175297,cZy6FfSysDXCciyaQBXiY1ElSSQnaYdy,A3fsA9Zfv1X2fVEQhTw51lKENdNrEqT3,1,0,0,0,0,0,1,0,1,0.14285714285714285,1,0.0,0,0,0,0,0,0,0,1,0,0,1,1
12355,175301,QHPjxy7GRZxkE11G18jf1qUIPRoUJGTA,A3fsA9Zfv1X2fVEQhTw51lKENdNrEqT3,2,0,0,0,0,0,2,0,2,0.2857142857142857,1,0.0,0,0,0,0,0,0,0,2,0,0,2,1
12356,175308,SZHxM16r0lTBVocJi0Li5OQAgxZ4K7jz,A3fsA9Zfv1X2fVEQhTw51lKENdNrEqT3,1,0,0,0,0,0,1,0,1,0.14285714285714285,1,0.0,0,0,0,0,0,0,0,1,0,0,1,1
12357,175312,RdEm3Fs8S0aOIDZ4Rs9JfR67o5xMZbr0,G8EPVSXsOYB5YQWZGiz1aVq5Pgr2GrQu,5,3,1,0,1,0,4,0,9,1.2857142857142858,1,0.0,0,1,0,1,3,0,0,4,0,2,7,1
12358,175343,GBFE5Y91W0Tc0xOvCqFBzxsDNroDv8Is,SpATywNh6bZuzm8s1ceuBUnMUAeoAHHw,2,0,0,0,0,0,2,0,2,0.2857142857142857,1,0.0,0,0,0,0,0,0,0,2,0,0,2,1
12359,175368,gs6GqCtB6XgQ6UWjy1alecSfvRxFU0T2,SpATywNh6bZuzm8s1ceuBUnMUAeoAHHw,2,0,0,0,0,0,2,0,2,0.2857142857142857,1,0.0,0,0,0,0,0,0,0,2,0,0,2,1
12360,175379,9WmzxyamLAgd2LnrO6zydiN7WV3MNZZt,bWdj2GDclj5ofokWjzoa5jAwMkxCykd6,8,8,6,0,2,4,6,1,27,3.857142857142857,2,0.0,0,6,0,2,8,4,0,6,1,8,19,1
12361,175402,Sy0IBVghIdDN5uhsYaAtE4EZP4lbDR6C,A3fsA9Zfv1X2fVEQhTw51lKENdNrEqT3,2,0,0,0,0,0,2,0,2,0.2857142857142857,1,0.0,0,0,0,0,0,0,0,2,0,0,2,1
12362,175405,VpSqFaUAI6VHKIVES1nyHNkouDYoubbm,SpATywNh6bZuzm8s1ceuBUnMUAeoAHHw,9,6,1,0,1,0,3,0,11,1.5714285714285714,1,0.0,1,1,0,1,5,0,0,3,0,3,8,1
12363,175407,wcdy3oa7dAkP6qisbcdJvc8HycOW6ePt,SpATywNh6bZuzm8s1ceuBUnMUAeoAHHw,3,0,0,0,0,0,3,0,3,0.42857142857142855,1,0.0,0,0,0,0,0,0,0,3,0,0,3,1
12364,175423,JLpYHpRsamf04qcVxCPYwLYYhT8v6H5r,bWdj2GDclj5ofokWjzoa5jAwMkxCykd6,8,6,4,0,3,0,4,0,17,2.4285714285714284,1,0.0,0,4,0,3,6,0,0,4,0,7,10,1
12365,175439,GYW6F4RrALjPRMj1o3hg6mOIhsonMLzv,fbPkOYLVPtPgIt0MxizjfFJov3JbHyAi,8,6,4,0,2,1,6,1,20,2.857142857142857,1,0.0,0,4,0,2,6,1,0,6,1,6,14,1
12366,175440,nNNmD0vjq4euECk9TASJLqcY7Yh4uOs7,fbPkOYLVPtPgIt0MxizjfFJov3JbHyAi,1,0,0,0,0,0,1,0,1,0.14285714285714285,1,0.0,0,0,0,0,0,0,0,1,0,0,1,1
12367,175444,m7igssBCJoYXk9iLEbegzoIoWBibQRze,fbPkOYLVPtPgIt0MxizjfFJov3JbHyAi,7,3,2,0,2,0,4,0,11,1.5714285714285714,1,0.0,0,2,0,2,3,0,0,4,0,4,7,1
12368,175445,G6eTAhE9AzVlPFZeS2VRSwDOXtmFA3PX,fbPkOYLVPtPgIt0MxizjfFJov3JbHyAi,4,2,1,0,1,0,1,0,5,0.7142857142857143,1,0.0,0,1,0,1,2,0,0,1,0,2,3,1
12369,175446,juzfwxHXCKii6ul7funGUBQbDVPCyrBB,fbPkOYLVPtPgIt0MxizjfFJov3JbHyAi,8,5,3,0,2,0,3,0,13,1.8571428571428572,1,0.0,0,3,0,2,5,0,0,3,0,5,8,1
12370,175447,S9lWYm9a6FVZ2ODtiJC49kgBYS9VqhGG,fbPkOYLVPtPgIt0MxizjfFJov3JbHyAi,1,0,0,0,0,0,1,0,1,0.14285714285714285,1,0.0,0,0,0,0,0,0,0,1,0,0,1,1
12371,175450,iM7LGMV4VAjVfcFaZFGWFvZYzMBFfU3L,fbPkOYLVPtPgIt0MxizjfFJov3JbHyAi,4,2,1,0,0,0,2,0,5,0.7142857142857143,1,0.0,0,1,0,0,2,0,0,2,0,1,4,1
12372,175451,CH7rIEiCYJderq7iXskzAGjPNDy8sGGS,fbPkOYLVPtPgIt0MxizjfFJov3JbHyAi,6,4,2,0,2,0,1,0,9,1.2857142857142858,1,0.0,0,2,0,2,4,0,0,1,0,4,5,1
12373,175453,BbTCRpsgAELmbNInOYYMcpD2adqJUxaz,fbPkOYLVPtPgIt0MxizjfFJov3JbHyAi,9,9,6,0,2,0,1,0,18,2.5714285714285716,1,0.0,0,6,0,2,9,0,0,1,0,8,10,1
12374,175458,QtQR4oqQYT2ypg7Ijhn9emxLfIBM3Int,fbPkOYLVPtPgIt0MxizjfFJov3JbHyAi,5,3,0,0,0,0,3,0,6,0.8571428571428571,1,0.0,0,0,0,0,3,0,0,3,0,0,6,1
12375,175459,DwjBo7B8hqv5XCU5nIWsl6HyuOZ8ub9E,fbPkOYLVPtPgIt0MxizjfFJov3JbHyAi,8,3,2,0,2,7,5,1,20,2.857142857142857,1,0.0,0,2,0,2,3,7,0,5,1,4,16,1
12376,175460,XCvldc0Z25dIQokzzDRNDq71ULXBAM8F,fbPkOYLVPtPgIt0MxizjfFJov3JbHyAi,1,0,0,0,0,0,1,0,1,0.14285714285714285,1,0.0,0,0,0,0,0,0,0,1,0,0,1,1
12377,175462,IxfgoqdA7w5aqdySNUMg1lSOzs1KfDTQ,fbPkOYLVPtPgIt0MxizjfFJov3JbHyAi,1,0,0,0,0,0,1,0,1,0.14285714285714285,1,0.0,0,0,0,0,0,0,0,1,0,0,1,1
12378,175463,X9Zz94IfisZgL8IIKroVo2fOO5DotKd5,fbPkOYLVPtPgIt0MxizjfFJov3JbHyAi,5,2,1,0,1,0,4,0,8,1.1428571428571428,1,0.0,0,1,0,1,2,0,0,4,0,2,6,1
12379,175464,lo7UFRSxvdl5IBJpBfFiWaG1K4lSvIph,fbPkOYLVPtPgIt0MxizjfFJov3JbHyAi,8,20,1,0,1,3,6,1,32,4.571428571428571,1,0.0,2,1,0,1,18,3,0,6,1,4,28,1
12380,175466,WOZ2OKb8udE0dHnoi6x9XrHwhNGFHraB,fbPkOYLVPtPgIt0MxizjfFJov3JbHyAi,9,5,4,0,4,0,6,0,19,2.7142857142857144,1,0.0,0,4,0,4,5,0,0,6,0,8,11,1
12381,175470,JVXyLCa1OOjkw5FBCNd333Deiv79lmst,fbPkOYLVPtPgIt0MxizjfFJov3JbHyAi,8,4,1,0,1,0,4,1,11,1.5714285714285714,1,0.0,0,1,0,1,4,0,0,4,1,2,9,1
12382,175472,h6X7uJXHEtMGd13bXyyZ1xP1ebsu9X0Q,fbPkOYLVPtPgIt0MxizjfFJov3JbHyAi,1,0,0,0,0,0,1,0,1,0.14285714285714285,1,0.0,0,0,0,0,0,0,0,1,0,0,1,1
12383,175473,DLoC6wyjO8HZpRQISW7NxAXHzLyIHStZ,fbPkOYLVPtPgIt0MxizjfFJov3JbHyAi,11,11,7,0,5,5,9,2,39,5.571428571428571,1,0.0,2,7,0,5,9,5,0,9,2,14,25,1
12384,175482,ifbjnZ4tXcK4dpvbMG3JmLnAWvMTSG5S,fbPkOYLVPtPgIt0MxizjfFJov3JbHyAi,10,6,4,0,3,1,5,1,20,2.857142857142857,1,0.0,0,4,0,3,6,1,0,5,1,7,13,1
12385,175483,1mlsGNriImtvI5bJf0wHc3mOCBScmLWj,fbPkOYLVPtPgIt0MxizjfFJov3JbHyAi,9,9,6,0,2,0,4,0,21,3.0,1,0.0,0,6,0,2,9,0,0,4,0,8,13,1
12386,175488,nQ8zyPaxuBVV0E4EnN5ZsvrgPzjbJntO,fbPkOYLVPtPgIt0MxizjfFJov3JbHyAi,1,0,0,0,0,0,1,0,1,0.14285714285714285,1,0.0,0,0,0,0,0,0,0,1,0,0,1,1
12387,175491,TSm2R7cUPaXhbTrj1LddmwVL7dduRSSa,fbPkOYLVPtPgIt0MxizjfFJov3JbHyAi,1,0,0,0,0,0,1,0,1,0.14285714285714285,1,0.0,0,0,0,0,0,0,0,1,0,0,1,1
12388,175495,zfwGGWHtlXaIDlcPdgrN93eHfeWgyv8l,fbPkOYLVPtPgIt0MxizjfFJov3JbHyAi,1,0,0,0,0,0,1,0,1,0.14285714285714285,1,0.0,0,0,0,0,0,0,0,1,0,0,1,1
12389,175498,1hpNOEDtPnezHqQbgrwjtuMuvCrx4S8A,fbPkOYLVPtPgIt0MxizjfFJov3JbHyAi,13,8,5,0,5,0,2,0,20,2.857142857142857,1,0.0,0,5,0,5,8,0,0,2,0,10,10,1
12390,175509,Nqm1BU7DDwtz5J6sAMZajfpCtdyka8BU,fbPkOYLVPtPgIt0MxizjfFJov3JbHyAi,6,2,0,0,0,1,5,1,9,1.2857142857142858,1,0.0,0,0,0,0,2,1,0,5,1,0,9,1
12391,175511,lFbeWg5shoMMNqLk9Vsb1yCv5tI9us0k,fbPkOYLVPtPgIt0MxizjfFJov3JbHyAi,10,7,3,1,4,0,2,0,17,2.4285714285714284,1,0.0,3,3,1,4,4,0,0,2,0,11,6,1
12392,175512,IybfLDxPgLkzxuWcMtBTeSNmrb96OWvv,fbPkOYLVPtPgIt0MxizjfFJov3JbHyAi,7,3,2,0,2,0,5,0,12,1.7142857142857142,1,0.0,0,2,0,2,3,0,0,5,0,4,8,1
12393,175513,PtpNjyWIZGFluToFVMnoVp1uIp4PTNlV,fbPkOYLVPtPgIt0MxizjfFJov3JbHyAi,4,2,1,0,1,0,1,0,5,0.7142857142857143,1,0.0,0,1,0,1,2,0,0,1,0,2,3,1
12394,175514,lreXxc1V0mKbQc1Fk3HBAHJga7i3ZlPb,fbPkOYLVPtPgIt0MxizjfFJov3JbHyAi,4,0,0,0,0,2,3,1,6,0.8571428571428571,1,0.0,0,0,0,0,0,2,0,3,1,0,6,1
12395,175517,vM4VSeTdZPRUwUiCQKf2BuawElru5sNo,fbPkOYLVPtPgIt0MxizjfFJov3JbHyAi,5,2,1,0,1,0,4,0,8,1.1428571428571428,1,0.0,0,1,0,1,2,0,0,4,0,2,6,1
12396,175519,zZcLo3UhXrAelR5FTKmHlxSZl0wW5YNH,fbPkOYLVPtPgIt0MxizjfFJov3JbHyAi,2,0,0,0,0,0,2,0,2,0.2857142857142857,1,0.0,0,0,0,0,0,0,0,2,0,0,2,1
12397,175521,Z6WF7UnPSWhERdL5zMrsQHVgRqZ42S1n,fbPkOYLVPtPgIt0MxizjfFJov3JbHyAi,2,0,0,0,0,0,2,0,2,0.2857142857142857,1,0.0,0,0,0,0,0,0,0,2,0,0,2,1
12398,175522,wmNYHs69T6CHydhCxfzhydbjA79LMuTD,fbPkOYLVPtPgIt0MxizjfFJov3JbHyAi,7,3,2,0,2,0,2,0,9,1.2857142857142858,1,0.0,0,2,0,2,3,0,0,2,0,4,5,1
12399,175525,QYaJtD7z5M6YcGNpdHV2JTsxqV4tXm9a,fbPkOYLVPtPgIt0MxizjfFJov3JbHyAi,1,0,0,0,0,0,1,0,1,0.14285714285714285,1,0.0,0,0,0,0,0,0,0,1,0,0,1,1
12400,175527,nWRrumnCgp6om94YmjE4CGN8JbKK91s6,fbPkOYLVPtPgIt0MxizjfFJov3JbHyAi,5,2,1,0,1,0,2,0,6,0.8571428571428571,1,0.0,0,1,0,1,2,0,0,2,0,2,4,1
12401,175529,vZY5RTyvAOyjF1AYeCntOYrEo9bIz6lQ,fbPkOYLVPtPgIt0MxizjfFJov3JbHyAi,4,2,1,0,1,0,1,0,5,0.7142857142857143,1,0.0,0,1,0,1,2,0,0,1,0,2,3,1
12402,175530,pmVmbJyOmxphdEXp0eyLXWB51e0e00i9,fbPkOYLVPtPgIt0MxizjfFJov3JbHyAi,7,4,2,0,2,0,3,0,11,1.5714285714285714,1,0.0,0,2,0,2,4,0,0,3,0,4,7,1
12403,175532,Fov1WBMQ9iK40YBqm6CCLgYUxW79OKx1,fbPkOYLVPtPgIt0MxizjfFJov3JbHyAi,10,10,4,0,3,2,9,2,30,4.285714285714286,1,0.0,4,4,0,3,6,2,0,9,2,11,19,1
12404,175538,8DjKcd2LJZN4ior4lkPdphxSMFfQLRGu,fbPkOYLVPtPgIt0MxizjfFJov3JbHyAi,3,0,0,0,0,4,2,0,6,0.8571428571428571,1,0.0,0,0,0,0,0,4,0,2,0,0,6,1
12405,175541,GrlLrE19mhpGaNnXMSNrKxn7KnB7PvUl,fbPkOYLVPtPgIt0MxizjfFJov3JbHyAi,7,4,3,0,3,0,2,0,12,1.7142857142857142,1,0.0,0,3,0,3,4,0,0,2,0,6,6,1
12406,175546,uCYmXbV69zfGcUg2j8bzRMpMZlMnqjT7,fbPkOYLVPtPgIt0MxizjfFJov3JbHyAi,1,0,0,0,0,0,1,0,1,0.14285714285714285,1,0.0,0,0,0,0,0,0,0,1,0,0,1,0
12407,175627,OXOYSOE5xESQ1Gjq8G2fhpSLV6URtrOK,5Gyp41oLVo7Gg7vF4vpmggWP5MU70QO6,4,3,1,0,0,0,4,0,8,1.1428571428571428,1,0.0,0,1,0,0,3,0,0,4,0,1,7,1
12408,175639,G218r5vAiYX0kE0Hge2wz8kLd1kzXR68,5Gyp41oLVo7Gg7vF4vpmggWP5MU70QO6,8,2,1,0,1,0,5,1,10,1.4285714285714286,1,0.0,0,1,0,1,2,0,0,5,1,2,8,1
12409,175641,zmQIE5mM7oLpM2IKO3AMgEeZhkuodsci,5Gyp41oLVo7Gg7vF4vpmggWP5MU70QO6,7,3,2,0,2,0,2,0,9,1.2857142857142858,1,0.0,0,2,0,2,3,0,0,2,0,4,5,1
12410,175675,6OEy5Qsip3QZp8NWdQCKQz0VG3aASwQd,5Gyp41oLVo7Gg7vF4vpmggWP5MU70QO6,9,4,1,0,2,0,6,1,14,2.0,1,0.0,1,1,0,2,3,0,0,6,1,4,10,0
12411,175688,2MXxsFodtPZQZbyoni7CUTGVtJgR6nz8,5Gyp41oLVo7Gg7vF4vpmggWP5MU70QO6,8,8,2,0,3,0,4,1,18,2.5714285714285716,1,0.0,3,2,0,3,5,0,0,4,1,8,10,1
12412,175709,OHv5eBJwDSofxA500UmLp6HtEa0aAaGY,5Gyp41oLVo7Gg7vF4vpmggWP5MU70QO6,7,3,2,0,2,0,2,0,9,1.2857142857142858,1,0.0,0,2,0,2,3,0,0,2,0,4,5,1
12413,175726,uCimH1JH6oHe0p4Vspf06pm160TYESmb,5Gyp41oLVo7Gg7vF4vpmggWP5MU70QO6,7,3,2,0,2,0,2,0,9,1.2857142857142858,1,0.0,0,2,0,2,3,0,0,2,0,4,5,1
12414,175737,DolNrwJKNdLotdaygIGHUrgpPWfyFClq,5Gyp41oLVo7Gg7vF4vpmggWP5MU70QO6,9,5,3,2,2,0,2,0,14,2.0,1,0.0,1,3,1,2,4,0,1,2,0,7,7,1
12415,175749,2IithoNfdrvM5eGRVjgTR9uolPixS4we,5Gyp41oLVo7Gg7vF4vpmggWP5MU70QO6,5,2,0,0,0,0,10,1,13,1.8571428571428572,1,0.0,0,0,0,0,2,0,0,10,1,0,13,1
12416,175768,2AHJHnjb8SXAMo7OtKtBYbb2sTZZwOZr,5Gyp41oLVo7Gg7vF4vpmggWP5MU70QO6,1,0,0,0,0,0,1,0,1,0.14285714285714285,1,0.0,0,0,0,0,0,0,0,1,0,0,1,1
12417,175770,kT1UDJ3b1RaguBPE2kXWbSAADTH3cQQD,5Gyp41oLVo7Gg7vF4vpmggWP5MU70QO6,11,9,8,0,8,0,7,0,32,4.571428571428571,1,0.0,0,8,0,8,9,0,0,7,0,16,16,1
12418,175773,UHhf3OS5KTsSmirrMDTBosghF0Ip6ptz,5Gyp41oLVo7Gg7vF4vpmggWP5MU70QO6,1,0,0,0,0,0,1,0,1,0.14285714285714285,1,0.0,0,0,0,0,0,0,0,1,0,0,1,1
12419,175774,aXwbww762RZoiNwx8tqGf3TROakJxF0X,5Gyp41oLVo7Gg7vF4vpmggWP5MU70QO6,1,0,0,0,0,0,1,0,1,0.14285714285714285,1,0.0,0,0,0,0,0,0,0,1,0,0,1,1
12420,175783,AnukCSBaHyReNig75Cna2HDQpC3ZFPPm,5Gyp41oLVo7Gg7vF4vpmggWP5MU70QO6,7,4,2,0,2,0,2,0,10,1.4285714285714286,1,0.0,0,2,0,2,4,0,0,2,0,4,6,1
12421,175812,vMjMvu2w7EqTJIdUYKacGvXxAvTKy2vm,5Gyp41oLVo7Gg7vF4vpmggWP5MU70QO6,1,0,0,0,0,0,1,0,1,0.14285714285714285,1,0.0,0,0,0,0,0,0,0,1,0,0,1,1
12422,175815,Sg92o0PEQpIFC9qNLkzOdhiftfF6FHXu,5Gyp41oLVo7Gg7vF4vpmggWP5MU70QO6,3,0,0,0,0,1,2,0,3,0.42857142857142855,1,0.0,0,0,0,0,0,1,0,2,0,0,3,1
12423,175837,3E1IiHuaaNr7V6JL7OW1lyuFpOSWkFGt,5Gyp41oLVo7Gg7vF4vpmggWP5MU70QO6,8,2,1,0,1,0,5,2,11,1.5714285714285714,1,0.0,0,1,0,1,2,0,0,5,2,2,9,1
12424,175905,ULWsHkINELJWirVgQ5povptML27OQ0Va,5Gyp41oLVo7Gg7vF4vpmggWP5MU70QO6,1,0,0,0,0,0,1,0,1,0.14285714285714285,1,0.0,0,0,0,0,0,0,0,1,0,0,1,1
12425,175913,TFGckN2p7irF2yrcTGKvlMtaBQ4cfPzU,5Gyp41oLVo7Gg7vF4vpmggWP5MU70QO6,7,2,1,0,1,1,4,1,10,1.4285714285714286,1,0.0,0,1,0,1,2,1,0,4,1,2,8,1
12426,175930,6nGA92YRip7jg71OkkPPooF7PcunylJo,5Gyp41oLVo7Gg7vF4vpmggWP5MU70QO6,1,0,0,0,0,0,1,0,1,0.14285714285714285,1,0.0,0,0,0,0,0,0,0,1,0,0,1,1
12427,175970,27QdoqoE4E9Ofii5y2HdEzNAfJST7pd2,5Gyp41oLVo7Gg7vF4vpmggWP5MU70QO6,6,4,1,0,1,0,3,0,9,1.2857142857142858,1,0.0,0,1,0,1,4,0,0,3,0,2,7,1
12428,175981,rHGDNXkG8lL5NzGEWERCUh2InM6QHuif,5Gyp41oLVo7Gg7vF4vpmggWP5MU70QO6,5,2,1,0,1,0,2,0,6,0.8571428571428571,1,0.0,0,1,0,1,2,0,0,2,0,2,4,1
12429,175994,L5pA3H7m2qYFia4DHW15gmoKoflabQUC,5Gyp41oLVo7Gg7vF4vpmggWP5MU70QO6,1,0,0,0,0,0,1,0,1,0.14285714285714285,1,0.0,0,0,0,0,0,0,0,1,0,0,1,1
12430,176001,BGCcw0fy5ZQWp2D5IsicQr89n1ir9IZ1,5Gyp41oLVo7Gg7vF4vpmggWP5MU70QO6,6,2,1,0,1,1,4,0,9,1.2857142857142858,1,0.0,0,1,0,1,2,1,0,4,0,2,7,1
12431,176020,Gjof7nwuuC0llLFQCxUKr52bfl2vEG8S,5Gyp41oLVo7Gg7vF4vpmggWP5MU70QO6,1,0,0,0,0,0,1,0,1,0.14285714285714285,1,0.0,0,0,0,0,0,0,0,1,0,0,1,1
12432,176034,YHML6rlViSGlLrxoBJcwm2Z7dntjADR7,5Gyp41oLVo7Gg7vF4vpmggWP5MU70QO6,10,13,5,0,4,0,4,0,26,3.7142857142857144,1,0.0,0,5,0,4,13,0,0,4,0,9,17,1
12433,176049,HoO8LKjjUMgJCeJcpwq1z7Z3nTHrSV55,5Gyp41oLVo7Gg7vF4vpmggWP5MU70QO6,1,0,0,0,0,0,1,0,1,0.14285714285714285,1,0.0,0,0,0,0,0,0,0,1,0,0,1,1
12434,176055,qV1S8QUOKPqreWUTjkx6WVJTN4pWj82J,5Gyp41oLVo7Gg7vF4vpmggWP5MU70QO6,1,0,0,0,0,0,1,0,1,0.14285714285714285,1,0.0,0,0,0,0,0,0,0,1,0,0,1,1
12435,176084,GZDQ8L9ZuAQpfRDMNlq0cQ9JgSDXkbdl,5Gyp41oLVo7Gg7vF4vpmggWP5MU70QO6,6,2,1,0,1,0,3,0,7,1.0,2,0.0,0,1,0,1,2,0,0,3,0,2,5,1
12436,176097,2qLjEwt5xNnoEg9w8OrKwqJNq7w6TcUE,5Gyp41oLVo7Gg7vF4vpmggWP5MU70QO6,1,0,0,0,0,0,1,0,1,0.14285714285714285,1,0.0,0,0,0,0,0,0,0,1,0,0,1,1
12437,176124,fwSNAXQt0hIgr6AkDrREt5ZXQgBknmEh,5Gyp41oLVo7Gg7vF4vpmggWP5MU70QO6,21,24,23,0,4,0,2,0,53,7.571428571428571,2,0.0,0,23,0,4,24,0,0,2,0,27,26,1
12438,176126,Ne25k1DU4nK81LWo7930HvBFWlFV2ZKt,5Gyp41oLVo7Gg7vF4vpmggWP5MU70QO6,10,5,3,0,4,0,5,0,17,2.4285714285714284,2,0.0,1,3,0,4,4,0,0,5,0,8,9,1
12439,176133,e6wP3becPmfG6HGdByUW00ZFxRLgAmgY,5Gyp41oLVo7Gg7vF4vpmggWP5MU70QO6,5,3,1,0,1,0,2,0,7,1.0,1,0.0,0,1,0,1,3,0,0,2,0,2,5,1
12440,176146,p4yxCxiqzIMRoAwoOyGnN7P9RZxypnFm,5Gyp41oLVo7Gg7vF4vpmggWP5MU70QO6,2,0,0,0,0,0,2,0,2,0.2857142857142857,1,0.0,0,0,0,0,0,0,0,2,0,0,2,0
12441,176171,uLKNUudVJDfzgTZMOzwyuzGBp4DvN0Tz,5Gyp41oLVo7Gg7vF4vpmggWP5MU70QO6,1,0,0,0,0,0,1,0,1,0.14285714285714285,1,0.0,0,0,0,0,0,0,0,1,0,0,1,1
12442,176192,44tKc1mf7lNbOwyGoI3ynKY4VpqC9O0k,5Gyp41oLVo7Gg7vF4vpmggWP5MU70QO6,1,0,0,0,0,0,1,0,1,0.14285714285714285,1,0.0,0,0,0,0,0,0,0,1,0,0,1,1
12443,176203,76U6Fp7U8Q2ccJndjwoG11QEiRczX2X3,5Gyp41oLVo7Gg7vF4vpmggWP5MU70QO6,1,0,0,0,0,0,1,0,1,0.14285714285714285,1,0.0,0,0,0,0,0,0,0,1,0,0,1,1
12444,176212,dor8frMpeKd5G3cE04cmbXxbireX88re,5Gyp41oLVo7Gg7vF4vpmggWP5MU70QO6,1,0,0,0,0,0,1,0,1,0.14285714285714285,1,0.0,0,0,0,0,0,0,0,1,0,0,1,1
12445,176214,yMKOk0dVftHnVR1CEiO9scq4ARXi4xK4,5Gyp41oLVo7Gg7vF4vpmggWP5MU70QO6,7,3,2,0,2,0,2,0,9,1.2857142857142858,1,0.0,0,2,0,2,3,0,0,2,0,4,5,1
12446,176223,RVzC5vQBqN30AW6Su7sjAfdP0iWczm3N,5Gyp41oLVo7Gg7vF4vpmggWP5MU70QO6,9,5,4,0,3,0,1,0,13,1.8571428571428572,1,0.0,0,4,0,3,5,0,0,1,0,7,6,1
12447,176248,Mj17Hk7aRKjaZReAMwyd4FAY5ldQsDAX,5Gyp41oLVo7Gg7vF4vpmggWP5MU70QO6,2,0,0,0,0,0,3,0,3,0.42857142857142855,1,0.0,0,0,0,0,0,0,0,3,0,0,3,1
12448,176264,4KtLnsvXpD29nfiYTBpcCcSvsc0fe43F,5Gyp41oLVo7Gg7vF4vpmggWP5MU70QO6,14,15,5,7,2,4,7,2,42,6.0,1,0.0,3,5,2,2,12,4,5,7,2,12,30,0
12449,176305,aF8xf13frnCZYncJXqcZ1YYKorqDTRSa,5Gyp41oLVo7Gg7vF4vpmggWP5MU70QO6,6,3,1,0,1,2,6,0,13,1.8571428571428572,1,0.0,0,1,0,1,3,2,0,6,0,2,11,1
12450,176353,4bOUwTkieqMfvbCbKosegaSfDeZ15GKM,fbPkOYLVPtPgIt0MxizjfFJov3JbHyAi,1,0,0,0,0,0,1,0,1,0.14285714285714285,1,0.0,0,0,0,0,0,0,0,1,0,0,1,1
12451,176354,3dMiR0LoABiSpQX4JYFVOM3r1eOr65HJ,fbPkOYLVPtPgIt0MxizjfFJov3JbHyAi,5,3,1,0,1,0,2,0,7,1.0,1,0.0,0,1,0,1,3,0,0,2,0,2,5,1
12452,176356,LKippngJk3cGSHQFQuBifcn7F1qfi1gi,fbPkOYLVPtPgIt0MxizjfFJov3JbHyAi,5,2,1,0,1,0,2,0,6,0.8571428571428571,1,0.0,0,1,0,1,2,0,0,2,0,2,4,1
12453,176357,8fBfbIuoUTzFONbekOgtlFtpKC5U6cNy,fbPkOYLVPtPgIt0MxizjfFJov3JbHyAi,10,8,3,3,3,1,4,0,22,3.142857142857143,1,0.0,3,3,3,3,5,1,0,4,0,12,10,1
12454,176358,cRpYMDSjBvEWIbn0U0hppujot5LNLTzW,fbPkOYLVPtPgIt0MxizjfFJov3JbHyAi,1,0,0,0,0,0,1,0,1,0.14285714285714285,1,0.0,0,0,0,0,0,0,0,1,0,0,1,1
12455,176359,38evuz11qT1yopNFOWEFJXqo6AKQdprx,fbPkOYLVPtPgIt0MxizjfFJov3JbHyAi,2,0,0,0,0,0,2,0,2,0.2857142857142857,1,0.0,0,0,0,0,0,0,0,2,0,0,2,1
12456,176362,tvD1wy5qLV5qKtu0LjnfHhQiwEJLQsKc,fbPkOYLVPtPgIt0MxizjfFJov3JbHyAi,7,5,3,4,3,0,1,0,16,2.2857142857142856,1,0.0,1,3,4,3,4,0,0,1,0,11,5,1
12457,176363,XpETIOce5NnU4qKIbkLob1tMSekzlpRK,fbPkOYLVPtPgIt0MxizjfFJov3JbHyAi,1,0,0,0,0,0,1,0,1,0.14285714285714285,1,0.0,0,0,0,0,0,0,0,1,0,0,1,1
12458,176364,zCHrzoFCDvrZWbgn6xqNjq29YrwinxJ6,fbPkOYLVPtPgIt0MxizjfFJov3JbHyAi,1,0,0,0,0,0,1,0,1,0.14285714285714285,1,0.0,0,0,0,0,0,0,0,1,0,0,1,1
12459,176366,ffNDXW73vFMgnRNtFmP91F2Fk6GpIDWe,fbPkOYLVPtPgIt0MxizjfFJov3JbHyAi,1,0,0,0,0,0,1,0,1,0.14285714285714285,1,0.0,0,0,0,0,0,0,0,1,0,0,1,1
12460,176367,QY2qA0MFHIqq0CtvZf3SzdZ2ea7Q99KG,fbPkOYLVPtPgIt0MxizjfFJov3JbHyAi,9,3,2,0,2,1,4,1,13,1.8571428571428572,1,0.0,0,2,0,2,3,1,0,4,1,4,9,1
12461,176369,3T6lo0hNKqGF8AeLHQEHxxeYIjJqOuY5,fbPkOYLVPtPgIt0MxizjfFJov3JbHyAi,2,0,0,0,0,0,2,0,2,0.2857142857142857,1,0.0,0,0,0,0,0,0,0,2,0,0,2,1
12462,176371,TKArhe0MXX8UInue0tvcz8uoMFUDLTjv,fbPkOYLVPtPgIt0MxizjfFJov3JbHyAi,1,0,0,0,0,0,1,0,1,0.14285714285714285,1,0.0,0,0,0,0,0,0,0,1,0,0,1,1
12463,176377,BnytRM0DS11v1j8Y5GXtdZweLuyRzpWa,7GRhBDsirIGkRZBtSMEzNTyDr2JQm4xx,11,8,5,4,4,0,2,0,23,3.2857142857142856,1,0.0,2,5,3,4,6,0,1,2,0,14,9,1
12464,176382,V5AS4ngknDMHs5ddf49SxlAoYguZsiN3,7GRhBDsirIGkRZBtSMEzNTyDr2JQm4xx,3,2,0,0,0,0,1,0,3,0.42857142857142855,1,0.0,0,0,0,0,2,0,0,1,0,0,3,1
12465,176397,L1FTG9TM6RI5TBCTexQgshQhXhu2oZpJ,7GRhBDsirIGkRZBtSMEzNTyDr2JQm4xx,6,8,6,0,6,0,1,0,21,3.0,1,0.0,0,6,0,6,8,0,0,1,0,12,9,1
12466,176413,D0DS3PcqkWtMhWmrWYDI3H9xnPeFgKco,5X6FeZozNMgE2VRi3MJYjkkFK8SETtu2,6,4,3,0,2,0,2,0,11,1.5714285714285714,1,0.0,0,3,0,2,4,0,0,2,0,5,6,1
12467,176451,oKu6VLpnoojteApzRKKjWrPb4vBoBjWk,5X6FeZozNMgE2VRi3MJYjkkFK8SETtu2,1,0,0,0,0,0,1,0,1,0.14285714285714285,1,0.0,0,0,0,0,0,0,0,1,0,0,1,1
12468,176454,O3FQHm8T0e3Sm0WiQAK4kR4V6HIDFaZD,5X6FeZozNMgE2VRi3MJYjkkFK8SETtu2,5,3,2,0,2,0,2,0,9,1.2857142857142858,1,0.0,0,2,0,2,3,0,0,2,0,4,5,1
12469,176457,0w96VyuRH6QOKeIyQlnOR4AwsQ0QEuXu,5X6FeZozNMgE2VRi3MJYjkkFK8SETtu2,1,0,0,0,0,0,1,0,1,0.14285714285714285,1,0.0,0,0,0,0,0,0,0,1,0,0,1,1
12470,176468,rGRFKIkiXYdsTLVzdgfkfhoHp29YmFvI,7GRhBDsirIGkRZBtSMEzNTyDr2JQm4xx,1,0,0,0,0,0,1,0,1,0.14285714285714285,1,0.0,0,0,0,0,0,0,0,1,0,0,1,1
12471,176475,IfDHOpQPeanhI9RrYG5jJZhgxxW26HTd,5X6FeZozNMgE2VRi3MJYjkkFK8SETtu2,1,0,0,0,0,0,1,0,1,0.14285714285714285,1,0.0,0,0,0,0,0,0,0,1,0,0,1,0
12472,176515,NYt3HW4iIDKFfkoDHUmE2GfhEi6C8Rqu,7GRhBDsirIGkRZBtSMEzNTyDr2JQm4xx,8,12,6,0,1,4,3,0,26,3.7142857142857144,1,0.0,4,6,0,1,8,4,0,3,0,11,15,1
12473,176520,BGZaaH5HDVuGvqaegp5MyJblPEuJpcXP,7GRhBDsirIGkRZBtSMEzNTyDr2JQm4xx,1,0,0,0,0,0,1,0,1,0.14285714285714285,1,0.0,0,0,0,0,0,0,0,1,0,0,1,1
12474,176521,bwHNoPHxbyrlfAktOsYn5l9pphqY7rqI,7GRhBDsirIGkRZBtSMEzNTyDr2JQm4xx,1,0,0,0,0,0,1,0,1,0.14285714285714285,1,0.0,0,0,0,0,0,0,0,1,0,0,1,1
12475,176528,7HpnoaIGu4hhAe6wQLzGOmmP3DNYMvrt,7GRhBDsirIGkRZBtSMEzNTyDr2JQm4xx,4,2,0,0,0,0,2,0,4,0.5714285714285714,1,0.0,0,0,0,0,2,0,0,2,0,0,4,1
12476,176552,KjugBA6V5bkEA5fAIbJoGnSUlDhZoaIH,5X6FeZozNMgE2VRi3MJYjkkFK8SETtu2,5,4,1,0,0,0,5,0,10,1.4285714285714286,1,0.0,0,1,0,0,4,0,0,5,0,1,9,0
12477,176555,zFJuKZAKTq12e9QE2ZEqSrQuW0gQ7ZSR,bWdj2GDclj5ofokWjzoa5jAwMkxCykd6,11,34,14,48,5,10,12,0,123,17.571428571428573,1,0.0,12,14,46,5,22,10,2,12,0,77,46,1
12478,176561,XPil0z3F5cAc6rFPjolit1u4hGh3bLog,bWdj2GDclj5ofokWjzoa5jAwMkxCykd6,2,0,0,0,0,0,3,0,3,0.42857142857142855,1,0.0,0,0,0,0,0,0,0,3,0,0,3,1
12479,176562,QgWb5bq53lHXqabN0HBji70t8pNuQpJI,A3fsA9Zfv1X2fVEQhTw51lKENdNrEqT3,6,3,2,0,1,0,3,0,9,1.2857142857142858,1,0.0,0,2,0,1,3,0,0,3,0,3,6,1
12480,176576,1ZnERDT2WSNZGJeanMnjXX2EswCJEUwX,SpATywNh6bZuzm8s1ceuBUnMUAeoAHHw,6,7,3,0,2,0,5,0,17,2.4285714285714284,2,0.0,0,3,0,2,7,0,0,5,0,5,12,1
12481,176595,VhtnI0jXlmYjp8tocIt6NwYAhqIJcpfm,RXDvfPUBYFlVdlueBFbLW0mhhAyGEqpt,1,0,0,0,0,0,1,0,1,0.14285714285714285,1,0.0,0,0,0,0,0,0,0,1,0,0,1,1
12482,176625,NMToinRYtSSoVCXpJZRcRohg7dcw6Du0,SpATywNh6bZuzm8s1ceuBUnMUAeoAHHw,1,0,0,0,0,0,1,0,1,0.14285714285714285,1,0.0,0,0,0,0,0,0,0,1,0,0,1,1
12483,176635,TYUe9cujyrCsl9vgAyeTTK1SiwFBDVY7,A3fsA9Zfv1X2fVEQhTw51lKENdNrEqT3,2,0,0,0,0,0,2,0,2,0.2857142857142857,1,0.0,0,0,0,0,0,0,0,2,0,0,2,1
12484,176651,YqY5WPa8kwIoLBKGaVnXfSZOMvkSrEdU,5X6FeZozNMgE2VRi3MJYjkkFK8SETtu2,1,0,0,0,0,0,1,0,1,0.14285714285714285,1,0.0,0,0,0,0,0,0,0,1,0,0,1,1
12485,176657,KGNZfzsWKEpndUg4ZWkpY4ThWCsiKpiv,A3fsA9Zfv1X2fVEQhTw51lKENdNrEqT3,1,0,0,0,0,0,1,0,1,0.14285714285714285,1,0.0,0,0,0,0,0,0,0,1,0,0,1,1
12486,176705,MED58Yjp1Lb99iMEyvwZJoRdEHymCjSn,SpATywNh6bZuzm8s1ceuBUnMUAeoAHHw,9,5,1,0,1,3,11,1,22,3.142857142857143,1,0.0,0,1,0,1,5,3,0,11,1,2,20,1
12487,176706,RPNytg6jKosKSPSkg7bLhh3BAXDjaY9a,RXDvfPUBYFlVdlueBFbLW0mhhAyGEqpt,18,15,3,18,3,0,4,0,43,6.142857142857143,3,0.0,3,3,18,3,12,0,0,4,0,27,16,1
12488,176714,mP0oq4UFI55XwGbomuLjnKyaYZ9Irhl8,RXDvfPUBYFlVdlueBFbLW0mhhAyGEqpt,2,0,0,0,0,0,2,0,2,0.2857142857142857,2,0.0,0,0,0,0,0,0,0,2,0,0,2,1
12489,176735,44GafVKSjOefcGtCUMS1SAXmrzlFFSGG,A3fsA9Zfv1X2fVEQhTw51lKENdNrEqT3,8,6,0,0,0,1,4,0,11,1.5714285714285714,1,0.0,0,0,0,0,6,1,0,4,0,0,11,1
12490,176736,GHfo4pUmbP0HyeQVp8PPz8kn0kTFo6yb,SpATywNh6bZuzm8s1ceuBUnMUAeoAHHw,28,33,0,46,0,0,3,0,82,11.714285714285714,2,0.0,10,0,41,0,23,0,5,3,0,51,31,0
12491,176752,CLwGKZEkoE30u30h4sBCUDzwMF5kR7gp,5X6FeZozNMgE2VRi3MJYjkkFK8SETtu2,3,3,1,0,0,0,1,0,5,0.7142857142857143,1,0.0,0,1,0,0,3,0,0,1,0,1,4,0
12492,176753,nSViyQ7vSn8aF5YHjw7hmNhhRklO9laV,SpATywNh6bZuzm8s1ceuBUnMUAeoAHHw,5,2,1,0,1,0,3,0,7,1.0,1,0.0,0,1,0,1,2,0,0,3,0,2,5,1
12493,176757,1BR9RQvHYYkyWaPC2GRTHswQs8AyO4gg,SpATywNh6bZuzm8s1ceuBUnMUAeoAHHw,15,35,2,21,3,0,3,0,64,9.142857142857142,1,0.0,20,2,18,3,15,0,3,3,0,43,21,1
12494,176774,kvxGydllm6BLbdP0nm9jaxgMVk1FHTYp,SpATywNh6bZuzm8s1ceuBUnMUAeoAHHw,20,46,25,25,0,3,9,2,110,15.714285714285714,1,0.0,16,25,19,0,30,3,6,9,2,60,50,1
12495,176776,wvaRW3X5tOUHanl7PiOdxpXKHWAXL5Dm,SpATywNh6bZuzm8s1ceuBUnMUAeoAHHw,1,0,0,0,0,0,1,0,1,0.14285714285714285,1,0.0,0,0,0,0,0,0,0,1,0,0,1,1
12496,176794,irUhnQtLaQWO9Ilnw5LLg2nfVwuwwh1f,G8EPVSXsOYB5YQWZGiz1aVq5Pgr2GrQu,1,0,0,0,0,0,1,0,1,0.14285714285714285,1,0.0,0,0,0,0,0,0,0,1,0,0,1,1
12497,176822,BEwpQuUn0betGBYfWGax81LgeoTlg8LE,SpATywNh6bZuzm8s1ceuBUnMUAeoAHHw,26,24,2,27,2,5,6,1,67,9.571428571428571,2,0.0,7,2,24,2,17,5,3,6,1,35,32,0
12498,176823,frevGWOFyf2Wo6uQjpFNvZnyWeFbKP0E,A3fsA9Zfv1X2fVEQhTw51lKENdNrEqT3,8,9,0,6,0,0,3,0,18,2.5714285714285716,2,0.0,0,0,6,0,9,0,0,3,0,6,12,1
12499,176831,vt6yAFP86tVXKBFMjBeWFksicr6ADIhP,SpATywNh6bZuzm8s1ceuBUnMUAeoAHHw,5,2,1,0,1,0,2,0,6,0.8571428571428571,1,0.0,0,1,0,1,2,0,0,2,0,2,4,1
12500,176836,nfdmRSIeQ1UeHw7VkGM3TXlNpKXW3emB,bWdj2GDclj5ofokWjzoa5jAwMkxCykd6,1,0,0,0,0,0,1,0,1,0.14285714285714285,1,0.0,0,0,0,0,0,0,0,1,0,0,1,1
12501,176873,tD2t0ZHpAx0YjQwAL8UEB0neif6SIb4V,bWdj2GDclj5ofokWjzoa5jAwMkxCykd6,1,0,0,0,0,0,1,0,1,0.14285714285714285,1,0.0,0,0,0,0,0,0,0,1,0,0,1,1
12502,176877,tD2t0ZHpAx0YjQwAL8UEB0neif6SIb4V,A3fsA9Zfv1X2fVEQhTw51lKENdNrEqT3,1,0,0,0,0,0,1,0,1,0.14285714285714285,1,0.0,0,0,0,0,0,0,0,1,0,0,1,1
12503,176882,e6qJWnBH5Aakpza4HlA3Q0irc2hEFZ0M,G8EPVSXsOYB5YQWZGiz1aVq5Pgr2GrQu,1,0,0,0,0,0,1,0,1,0.14285714285714285,1,0.0,0,0,0,0,0,0,0,1,0,0,1,1
12504,176884,2bO6MisGrRWNEa1nUMHMWWTQVeKS23eS,SpATywNh6bZuzm8s1ceuBUnMUAeoAHHw,11,6,6,0,6,0,2,0,20,2.857142857142857,1,0.0,0,6,0,6,6,0,0,2,0,12,8,1
12505,176886,KTcmc9IfHm2rSJ5YQNSXr92mTVEV8NoQ,5X6FeZozNMgE2VRi3MJYjkkFK8SETtu2,7,13,0,0,3,0,2,0,18,2.5714285714285716,1,0.0,6,0,0,3,7,0,0,2,0,9,9,0
12506,176909,wjicnAF12JyAapuh15sdon1diUWswaFA,bWdj2GDclj5ofokWjzoa5jAwMkxCykd6,6,3,1,0,1,0,2,0,7,1.0,1,0.0,0,1,0,1,3,0,0,2,0,2,5,1
12507,176910,hlLJjac8psTxnrEYNcjoWRSyE9PLM0jF,A3fsA9Zfv1X2fVEQhTw51lKENdNrEqT3,6,3,2,0,2,0,2,0,9,1.2857142857142858,1,0.0,0,2,0,2,3,0,0,2,0,4,5,1
12508,176923,AMJBHnJeXp5B5SBQNlM30pAlrKlBFahS,G8EPVSXsOYB5YQWZGiz1aVq5Pgr2GrQu,6,5,1,0,0,0,1,0,7,1.0,1,0.0,0,1,0,0,5,0,0,1,0,1,6,1
12509,176941,YmECTGgjL6NRIrd1m4lXekfVt4GlrSQ1,bWdj2GDclj5ofokWjzoa5jAwMkxCykd6,10,14,7,4,5,10,6,1,47,6.714285714285714,2,0.0,1,7,3,5,13,10,1,6,1,16,31,1
12510,176947,xOtdHo3wrVhEHE7TFWr0saCeohN8PpCL,RXDvfPUBYFlVdlueBFbLW0mhhAyGEqpt,19,9,6,76,0,0,3,0,94,13.428571428571429,1,0.0,2,6,67,0,7,0,9,3,0,75,19,0
12511,176959,IxN0oMkJdKmNRarUB8mq0kSQRx8qnGax,bWdj2GDclj5ofokWjzoa5jAwMkxCykd6,3,0,0,0,0,0,3,0,3,0.42857142857142855,1,0.0,0,0,0,0,0,0,0,3,0,0,3,1
12512,177010,CxhwRDRCARhFka2Q3podETDsye29rlXb,SpATywNh6bZuzm8s1ceuBUnMUAeoAHHw,5,4,2,0,1,0,2,0,9,1.2857142857142858,1,0.0,0,2,0,1,4,0,0,2,0,3,6,1
12513,177060,Et66VbQRwkFnF42twZ8Z4ErFWQLehmwC,A3fsA9Zfv1X2fVEQhTw51lKENdNrEqT3,8,5,1,0,1,0,3,0,10,1.4285714285714286,2,0.0,0,1,0,1,5,0,0,3,0,2,8,0
12514,177101,2G9uV9MMhfw3z7a992GuBzgkXLp94apO,A3fsA9Zfv1X2fVEQhTw51lKENdNrEqT3,6,3,1,0,1,0,5,0,10,1.4285714285714286,1,0.0,0,1,0,1,3,0,0,5,0,2,8,1
12515,177105,niznzPsNcmf0qkvKVIABVzsBAFOWmMfr,A3fsA9Zfv1X2fVEQhTw51lKENdNrEqT3,6,6,0,0,0,0,6,0,12,1.7142857142857142,2,0.0,0,0,0,0,6,0,0,6,0,0,12,1
12516,177106,EPVEir3f8DxjouE65Q4kYI9YaQMxGE89,RXDvfPUBYFlVdlueBFbLW0mhhAyGEqpt,6,5,0,0,0,0,2,0,7,1.0,1,0.0,0,0,0,0,5,0,0,2,0,0,7,1
12517,177113,66JqxLLiEx06fBDzS4MuyYNc7nIpYGk9,A3fsA9Zfv1X2fVEQhTw51lKENdNrEqT3,54,47,34,56,20,0,5,0,162,23.142857142857142,4,0.0,1,34,50,20,46,0,6,5,0,105,57,0
12518,177123,cuPQwSytidcCUilblyO4K9ALDT0iH8XK,A3fsA9Zfv1X2fVEQhTw51lKENdNrEqT3,1,0,0,0,0,0,1,0,1,0.14285714285714285,1,0.0,0,0,0,0,0,0,0,1,0,0,1,1
12519,177138,6d8C8yee0ddJ6Jgl51ehsW37Gh3pz3CL,RXDvfPUBYFlVdlueBFbLW0mhhAyGEqpt,15,23,9,0,9,0,5,1,47,6.714285714285714,1,0.0,2,9,0,9,21,0,0,5,1,20,27,1
12520,177167,DkBEQyIekQixrRUA1DCrhgBXxcYJJXln,SpATywNh6bZuzm8s1ceuBUnMUAeoAHHw,1,0,0,0,0,0,1,0,1,0.14285714285714285,1,0.0,0,0,0,0,0,0,0,1,0,0,1,1
12521,177177,nURvxLXCCRcUx0rr21CCKt2pPqq3RcJ7,SpATywNh6bZuzm8s1ceuBUnMUAeoAHHw,6,5,1,0,1,0,2,0,9,1.2857142857142858,1,0.0,0,1,0,1,5,0,0,2,0,2,7,1
12522,177185,eT9OhUahWhAeZfHPEbxGN9qGHwvkkQvs,SpATywNh6bZuzm8s1ceuBUnMUAeoAHHw,1,0,0,0,0,0,1,0,1,0.14285714285714285,1,0.0,0,0,0,0,0,0,0,1,0,0,1,1
12523,177190,LfqjHStsZ12hVtRAj2u8KdIMPVFnabmD,bWdj2GDclj5ofokWjzoa5jAwMkxCykd6,1,0,0,0,0,0,1,0,1,0.14285714285714285,1,0.0,0,0,0,0,0,0,0,1,0,0,1,1
12524,177192,mBNdEgFmgGVvgyDWBgZluXCXQS1DNZxP,bWdj2GDclj5ofokWjzoa5jAwMkxCykd6,6,4,2,0,2,0,1,0,9,1.2857142857142858,1,0.0,0,2,0,2,4,0,0,1,0,4,5,1
12525,177210,xmv8WUz0fQb7fJNMHkcUN733RgAFZjFP,SpATywNh6bZuzm8s1ceuBUnMUAeoAHHw,5,5,1,0,1,0,2,0,9,1.2857142857142858,1,0.0,0,1,0,1,5,0,0,2,0,2,7,1
12526,177225,jGkFsr85Pqt6G74Ct0j5bqEqPLMt7wa3,bWdj2GDclj5ofokWjzoa5jAwMkxCykd6,2,0,0,0,0,0,2,0,2,0.2857142857142857,1,0.0,0,0,0,0,0,0,0,2,0,0,2,1
12527,177226,jGkFsr85Pqt6G74Ct0j5bqEqPLMt7wa3,A3fsA9Zfv1X2fVEQhTw51lKENdNrEqT3,2,0,0,0,0,0,2,0,2,0.2857142857142857,1,0.0,0,0,0,0,0,0,0,2,0,0,2,1
12528,177238,hCQXqI8iQlGgI9I7RIJmpkxpbOJGkTCt,RXDvfPUBYFlVdlueBFbLW0mhhAyGEqpt,14,10,8,12,6,0,5,0,41,5.857142857142857,1,0.0,1,8,12,6,9,0,0,5,0,27,14,1
12529,177266,QiYah6MaRTZX43IYRVARS0cRIO6IdBSv,bWdj2GDclj5ofokWjzoa5jAwMkxCykd6,2,0,0,0,0,0,2,0,2,0.2857142857142857,1,0.0,0,0,0,0,0,0,0,2,0,0,2,1
12530,177308,g1C9Sv2GzsuaWdnKXvZB1yWKiZN0Fg91,bWdj2GDclj5ofokWjzoa5jAwMkxCykd6,1,0,0,0,0,0,1,0,1,0.14285714285714285,1,0.0,0,0,0,0,0,0,0,1,0,0,1,1
12531,177320,qiPgVnk4J2KtMigrE44RvNt4xKpRJnr3,SpATywNh6bZuzm8s1ceuBUnMUAeoAHHw,1,0,0,0,0,0,1,0,1,0.14285714285714285,1,0.0,0,0,0,0,0,0,0,1,0,0,1,1
12532,177325,LchclclKlrYHOcXtmhi0Eqhs9daD9eJz,RXDvfPUBYFlVdlueBFbLW0mhhAyGEqpt,70,73,32,170,25,4,5,0,309,44.142857142857146,2,0.0,39,32,159,25,34,4,11,5,0,255,54,1
12533,177347,fGIeAB7IRJCHxzCo8u4GLaPKxQfHeCdi,bWdj2GDclj5ofokWjzoa5jAwMkxCykd6,19,52,24,14,13,0,5,0,108,15.428571428571429,3,0.0,8,24,13,13,44,0,1,5,0,58,50,1
12534,177367,nIvIddlMAmTQagaACOulbZ6PInxlyOy2,5X6FeZozNMgE2VRi3MJYjkkFK8SETtu2,10,11,4,8,3,0,2,0,28,4.0,1,0.0,5,4,7,3,6,0,1,2,0,19,9,1
12535,177377,9NDg9VwFVuCbATto5EGvC6PrvN5Y88Xw,bWdj2GDclj5ofokWjzoa5jAwMkxCykd6,1,0,0,0,0,0,1,0,1,0.14285714285714285,1,0.0,0,0,0,0,0,0,0,1,0,0,1,1
12536,177380,g9JwaoBhrenD3JLPIF4Rgp3VFIAz66kP,bWdj2GDclj5ofokWjzoa5jAwMkxCykd6,10,20,1,60,1,10,12,2,106,15.142857142857142,1,0.0,8,1,59,1,12,10,1,12,2,69,37,1
12537,177405,IOvPoNN8l7pPy4G3bKTENwwaE7wXUaKr,A3fsA9Zfv1X2fVEQhTw51lKENdNrEqT3,7,2,1,0,1,0,7,0,11,1.5714285714285714,1,0.0,0,1,0,1,2,0,0,7,0,2,9,1
12538,177430,zF9V63zn5gsiipqbdXutnSHDmKKLyPTo,SpATywNh6bZuzm8s1ceuBUnMUAeoAHHw,5,4,1,0,1,0,3,0,9,1.2857142857142858,1,0.0,1,1,0,1,3,0,0,3,0,3,6,1
12539,177432,J3Fq3KF0FVOYO5SL2II3p94rxzVjXgko,SpATywNh6bZuzm8s1ceuBUnMUAeoAHHw,6,1,1,0,1,0,3,0,6,0.8571428571428571,1,0.0,0,1,0,1,1,0,0,3,0,2,4,0
12540,177436,RVgC7pWiS5TIqo11u8gn0FiACXxbMvEV,SpATywNh6bZuzm8s1ceuBUnMUAeoAHHw,4,3,0,0,0,0,2,0,5,0.7142857142857143,1,0.0,0,0,0,0,3,0,0,2,0,0,5,1
12541,177442,SWQUdK85RnayLE3toQQorQRoqxtUEkUa,bWdj2GDclj5ofokWjzoa5jAwMkxCykd6,13,6,2,44,0,0,2,0,54,7.714285714285714,1,0.0,0,2,38,0,6,0,6,2,0,40,14,0
12542,177460,NXEwBXbU6vvce77sujWgRB6LivhFJvRb,A3fsA9Zfv1X2fVEQhTw51lKENdNrEqT3,9,8,4,0,3,0,3,0,18,2.5714285714285716,2,0.0,0,4,0,3,8,0,0,3,0,7,11,1
12543,177461,TLRNemgJ2qb9k6dqDLHmoeJOx0QEylHX,SpATywNh6bZuzm8s1ceuBUnMUAeoAHHw,11,8,5,0,3,5,6,1,28,4.0,1,0.0,1,5,0,3,7,5,0,6,1,9,19,1
12544,177475,kg6Avyi36lrn1xiUPv7mqR2okQaeNtUx,5X6FeZozNMgE2VRi3MJYjkkFK8SETtu2,7,5,2,0,3,2,3,0,15,2.142857142857143,1,0.0,2,2,0,3,3,2,0,3,0,7,8,1
12545,177497,6AH2bS5pfPPDGjFaKt7vgWNStmoXDf9t,RXDvfPUBYFlVdlueBFbLW0mhhAyGEqpt,8,4,1,0,1,7,7,0,20,2.857142857142857,1,0.0,0,1,0,1,4,7,0,7,0,2,18,1
12546,177501,K3eaSd5rYP9Gkimldqt40pigYQrGeLsH,bWdj2GDclj5ofokWjzoa5jAwMkxCykd6,10,10,5,14,3,0,4,0,36,5.142857142857143,2,0.0,2,5,13,3,8,0,1,4,0,23,13,1
12547,177522,UtuMMiTcYdEIPqLGUrTySvaHfGG20tSq,SpATywNh6bZuzm8s1ceuBUnMUAeoAHHw,5,2,1,0,1,0,2,0,6,0.8571428571428571,1,0.0,0,1,0,1,2,0,0,2,0,2,4,1
12548,177561,FmxPauZCcN5TsI90By7Uh5tN8Q2Qo10j,5X6FeZozNMgE2VRi3MJYjkkFK8SETtu2,1,0,0,0,0,0,1,0,1,0.14285714285714285,1,0.0,0,0,0,0,0,0,0,1,0,0,1,1
12549,177667,ipVvzWInHV8LAm6qVHoFaV0nnfOGT5ry,SpATywNh6bZuzm8s1ceuBUnMUAeoAHHw,1,0,0,0,0,0,1,0,1,0.14285714285714285,1,0.0,0,0,0,0,0,0,0,1,0,0,1,1
12550,177668,p54dVByd9epbS397rAmrAwTW19iwa3UI,bWdj2GDclj5ofokWjzoa5jAwMkxCykd6,15,12,1,40,4,1,11,1,70,10.0,2,0.0,7,1,35,4,5,1,5,11,1,47,23,1
12551,177691,A6oLHbyuoChPN0ROQ5fG10dHGRIiYTTe,SpATywNh6bZuzm8s1ceuBUnMUAeoAHHw,28,29,15,29,10,3,4,0,90,12.857142857142858,1,0.0,11,15,23,10,18,3,6,4,0,59,31,1
12552,177727,G4leME9fPSQLSwsbbKKP6ouczXxo1Wlw,SpATywNh6bZuzm8s1ceuBUnMUAeoAHHw,27,30,12,22,7,0,6,0,77,11.0,2,0.0,9,12,21,7,21,0,1,6,0,49,28,1
12553,177730,Mvi2iSl7G6NCzuzRtyT9FnCVUPePQVy1,bWdj2GDclj5ofokWjzoa5jAwMkxCykd6,9,18,6,34,5,0,4,0,67,9.571428571428571,1,0.0,9,6,33,5,9,0,1,4,0,53,14,1
12554,177736,3kQ25Y1n5ZQOWjLlVHwcdpzmvrmbPTL3,SpATywNh6bZuzm8s1ceuBUnMUAeoAHHw,14,13,0,0,0,0,4,0,17,2.4285714285714284,1,0.0,0,0,0,0,13,0,0,4,0,0,17,1
12555,177750,QjqGEc1MUmw3VEVWGhyD00LM60lNtKPh,SpATywNh6bZuzm8s1ceuBUnMUAeoAHHw,16,9,5,8,3,7,13,2,47,6.714285714285714,2,0.0,3,5,8,3,6,7,0,13,2,19,28,1
12556,177755,JHMFz2Gy459G1ldyhA75ALSO8YlPxA4n,A3fsA9Zfv1X2fVEQhTw51lKENdNrEqT3,6,5,2,0,1,0,3,0,11,1.5714285714285714,2,0.0,0,2,0,1,5,0,0,3,0,3,8,1
12557,177766,zmIcVKuNFZm39Xd0zSmSfRofuInASrOB,A3fsA9Zfv1X2fVEQhTw51lKENdNrEqT3,5,2,1,0,1,0,2,0,6,0.8571428571428571,1,0.0,0,1,0,1,2,0,0,2,0,2,4,1
12558,177770,AsCRvwtleeGS6D6WD7MD0zpcijqiUpJg,SpATywNh6bZuzm8s1ceuBUnMUAeoAHHw,1,0,0,0,0,0,1,0,1,0.14285714285714285,1,0.0,0,0,0,0,0,0,0,1,0,0,1,1
12559,177792,Xrjgmm5mgiySWho5SEzdacBLSLkDfygK,SpATywNh6bZuzm8s1ceuBUnMUAeoAHHw,19,9,8,0,7,0,4,0,28,4.0,1,0.0,0,8,0,7,9,0,0,4,0,15,13,1
12560,177799,Yyccad96I3hbgqqNLycAhyGOxNsdJzLL,SpATywNh6bZuzm8s1ceuBUnMUAeoAHHw,15,19,2,0,1,1,9,1,33,4.714285714285714,1,0.0,2,2,0,1,17,1,0,9,1,5,28,1
12561,177809,h1QswJ31uhxfyhfP3OhNVJBUvcTub6pW,bWdj2GDclj5ofokWjzoa5jAwMkxCykd6,2,0,0,0,0,0,2,0,2,0.2857142857142857,1,0.0,0,0,0,0,0,0,0,2,0,0,2,1
12562,177811,KVNNbfG6UQEmke4Oy3hBc7o3aqspqwkG,bWdj2GDclj5ofokWjzoa5jAwMkxCykd6,4,0,0,0,0,0,6,0,6,0.8571428571428571,1,0.0,0,0,0,0,0,0,0,6,0,0,6,1
12563,177817,1lCKn2N8CWNZFqkAXfsrQhctsw90ZkSX,bWdj2GDclj5ofokWjzoa5jAwMkxCykd6,5,2,1,0,1,0,3,0,7,1.0,1,0.0,0,1,0,1,2,0,0,3,0,2,5,1
12564,177822,IfuP3wsHPcoufqx0FyqFKUytwStvSPv8,G8EPVSXsOYB5YQWZGiz1aVq5Pgr2GrQu,8,5,1,0,1,0,2,0,9,1.2857142857142858,1,0.0,0,1,0,1,5,0,0,2,0,2,7,1
12565,177827,ryn67VWPQk6LcF6yj0ExcHQJuf0D8gOm,G8EPVSXsOYB5YQWZGiz1aVq5Pgr2GrQu,7,11,0,0,2,0,3,0,16,2.2857142857142856,1,0.0,8,0,0,2,3,0,0,3,0,10,6,1
12566,177866,Pk6H5V6IGPh6QxXblrwO7oI0RG2f9ujy,A3fsA9Zfv1X2fVEQhTw51lKENdNrEqT3,18,17,13,10,9,0,5,0,54,7.714285714285714,2,0.0,1,13,9,9,16,0,1,5,0,32,22,1
12567,177883,3KDcn3HvW3CpzWtc78PKWcm3CxgBERCi,SpATywNh6bZuzm8s1ceuBUnMUAeoAHHw,1,0,0,0,0,0,1,0,1,0.14285714285714285,1,0.0,0,0,0,0,0,0,0,1,0,0,1,1
12568,177898,qKod71hGHVj3I0edUan3ZmfswQIOaBhk,SpATywNh6bZuzm8s1ceuBUnMUAeoAHHw,4,2,0,0,0,0,2,0,4,0.5714285714285714,1,0.0,0,0,0,0,2,0,0,2,0,0,4,0
12569,177913,vMJQI9w07ZiISGIPIFnaaxiyY7O127F5,bWdj2GDclj5ofokWjzoa5jAwMkxCykd6,1,0,0,0,0,0,1,0,1,0.14285714285714285,1,0.0,0,0,0,0,0,0,0,1,0,0,1,1
12570,177917,0Rhh8KlMvGRxFbePsrW63o0GE8JJ4ZBr,A3fsA9Zfv1X2fVEQhTw51lKENdNrEqT3,4,0,0,0,0,0,5,0,5,0.7142857142857143,1,0.0,0,0,0,0,0,0,0,5,0,0,5,1
12571,177935,fCHhd4TOkyXDtd95SIvxpoNr5KiduXIc,bWdj2GDclj5ofokWjzoa5jAwMkxCykd6,7,3,2,0,2,0,2,0,9,1.2857142857142858,1,0.0,0,2,0,2,3,0,0,2,0,4,5,1
12572,177958,kvoUslzLG0mKlFKuSPgqASK2op5HSx76,A3fsA9Zfv1X2fVEQhTw51lKENdNrEqT3,6,5,2,0,1,0,2,0,10,1.4285714285714286,1,0.0,0,2,0,1,5,0,0,2,0,3,7,1
12573,177964,DHUv7XpIZcPp2QYGNmTXjhgg7Zq4BpJ7,bWdj2GDclj5ofokWjzoa5jAwMkxCykd6,1,0,0,0,0,0,1,0,1,0.14285714285714285,1,0.0,0,0,0,0,0,0,0,1,0,0,1,1
12574,177966,IuR34QWilyKtRzmb7qMgvf0gIZLKgowR,SpATywNh6bZuzm8s1ceuBUnMUAeoAHHw,1,0,0,0,0,0,1,0,1,0.14285714285714285,1,0.0,0,0,0,0,0,0,0,1,0,0,1,1
12575,177970,YeBJe2tNupEMDdAag9Wv20aFIU63DOgj,SpATywNh6bZuzm8s1ceuBUnMUAeoAHHw,1,0,0,0,0,0,1,0,1,0.14285714285714285,1,0.0,0,0,0,0,0,0,0,1,0,0,1,1
12576,178000,PhLYSq5B07iE4fjll2EKADOqnDhqPRc7,A3fsA9Zfv1X2fVEQhTw51lKENdNrEqT3,1,0,0,0,0,0,1,0,1,0.14285714285714285,1,0.0,0,0,0,0,0,0,0,1,0,0,1,1
12577,178016,IC7EvxrdI6aK6zztlqGy7t8EMIkvsLWH,SpATywNh6bZuzm8s1ceuBUnMUAeoAHHw,2,2,0,0,0,0,0,0,2,0.2857142857142857,1,0.0,0,0,0,0,2,0,0,0,0,0,2,1
12578,178022,LiD14ALXLddUqpdQnujGFxQiBSoJOZGF,A3fsA9Zfv1X2fVEQhTw51lKENdNrEqT3,3,3,1,0,0,0,1,0,5,0.7142857142857143,1,0.0,0,1,0,0,3,0,0,1,0,1,4,1
12579,178047,g5hqByjT71l7XQpoHooh42h6aYalEjyF,RXDvfPUBYFlVdlueBFbLW0mhhAyGEqpt,6,5,3,0,1,16,4,0,29,4.142857142857143,2,0.0,0,3,0,1,5,16,0,4,0,4,25,1
12580,178054,HyVNcqbXwwt4x7Lh0NDvZJuGvdEMSlMz,bWdj2GDclj5ofokWjzoa5jAwMkxCykd6,1,0,0,0,0,0,1,0,1,0.14285714285714285,1,0.0,0,0,0,0,0,0,0,1,0,0,1,1
12581,178056,xk56WEVJEAYlfTe18KDPHjwyCpm6eESo,RXDvfPUBYFlVdlueBFbLW0mhhAyGEqpt,4,0,0,0,0,2,5,1,8,1.1428571428571428,2,0.0,0,0,0,0,0,2,0,5,1,0,8,1
12582,178067,SM0peUZSWYQguXepyPBRDLnLmqFvDaRW,A3fsA9Zfv1X2fVEQhTw51lKENdNrEqT3,16,16,9,0,5,0,5,0,35,5.0,1,0.0,0,9,0,5,16,0,0,5,0,14,21,1
12583,178076,ctPyLd013hzE9dQTFFYRA7Z6fW1VhLt5,SpATywNh6bZuzm8s1ceuBUnMUAeoAHHw,11,14,4,10,2,0,1,0,31,4.428571428571429,1,0.0,9,4,10,2,5,0,0,1,0,25,6,1
12584,178096,YRvoydpc37Vpysmtw8O9rzowfgsZu7lO,bWdj2GDclj5ofokWjzoa5jAwMkxCykd6,3,4,0,0,0,0,1,0,5,0.7142857142857143,1,0.0,1,0,0,0,3,0,0,1,0,1,4,1
12585,178120,yiEYYQaKbyzpwJWElvWXAXdPO93zfPgh,A3fsA9Zfv1X2fVEQhTw51lKENdNrEqT3,1,0,0,0,0,0,1,0,1,0.14285714285714285,1,0.0,0,0,0,0,0,0,0,1,0,0,1,1
12586,178123,jpxpIqdWMtlxqJfj67lnudhyEHl6x8Bm,RXDvfPUBYFlVdlueBFbLW0mhhAyGEqpt,16,13,10,0,7,0,3,0,33,4.714285714285714,2,0.0,2,10,0,7,11,0,0,3,0,19,14,1
12587,178135,7vNqxUIgpaCj3NnoU9xg00b9Tp3tF5Ri,SpATywNh6bZuzm8s1ceuBUnMUAeoAHHw,9,8,4,0,3,1,5,1,22,3.142857142857143,3,0.0,0,4,0,3,8,1,0,5,1,7,15,1
12588,178140,m5gaSzexRDWD05xetdfM0AEyRBJhEUro,G8EPVSXsOYB5YQWZGiz1aVq5Pgr2GrQu,8,3,0,0,0,1,7,1,12,1.7142857142857142,1,0.0,0,0,0,0,3,1,0,7,1,0,12,1
12589,178152,oRBxd78DtsQ3mEkDyjGaQEGbdrTlmw6j,bWdj2GDclj5ofokWjzoa5jAwMkxCykd6,10,6,2,0,2,0,5,0,15,2.142857142857143,1,0.0,0,2,0,2,6,0,0,5,0,4,11,1
12590,178159,aXJa1zRW8xrdcYprvRlDR2amMkiONMef,SpATywNh6bZuzm8s1ceuBUnMUAeoAHHw,1,0,0,0,0,0,1,0,1,0.14285714285714285,1,0.0,0,0,0,0,0,0,0,1,0,0,1,1
12591,178161,PJ1wLAp2McpPLRMTf6gnqm4Wj7JimEv0,A3fsA9Zfv1X2fVEQhTw51lKENdNrEqT3,5,7,1,0,1,0,1,0,10,1.4285714285714286,1,0.0,0,1,0,1,7,0,0,1,0,2,8,1
12592,178164,dqE1PGrWExsbP4JkEoKdSn4p50FzqbEb,SpATywNh6bZuzm8s1ceuBUnMUAeoAHHw,8,75,41,0,25,7,13,0,161,23.0,1,0.0,6,41,0,25,69,7,0,13,0,72,89,1
12593,178177,bovRkt8OOEauRqwvmsqsFz6hCg8Axl1M,SpATywNh6bZuzm8s1ceuBUnMUAeoAHHw,1,0,0,0,0,0,1,0,1,0.14285714285714285,1,0.0,0,0,0,0,0,0,0,1,0,0,1,1
12594,178204,wMH9y8Ndp4UrZ98WukfHH3BPMXWwQMTj,A3fsA9Zfv1X2fVEQhTw51lKENdNrEqT3,8,6,4,0,1,0,3,0,14,2.0,1,0.0,0,4,0,1,6,0,0,3,0,5,9,1
12595,178241,TY4t65XwSRMNK0q3MPTxoH0jDDniCwnz,3VkHkmOtom3jM2wCu94xgzzu1d6Dn7or,17,34,9,18,8,10,3,0,82,11.714285714285714,1,0.0,12,9,17,8,22,10,1,3,0,46,36,1
12596,178247,pAK3JL9nOUE6ElEWOzQCcrLzC9DIz75y,3VkHkmOtom3jM2wCu94xgzzu1d6Dn7or,1,0,0,0,0,0,1,0,1,0.14285714285714285,1,0.0,0,0,0,0,0,0,0,1,0,0,1,1
12597,178296,GGDBEvjaACiSZQampqxQz2sgcfzT2xkK,3VkHkmOtom3jM2wCu94xgzzu1d6Dn7or,2,0,0,0,0,0,2,0,2,0.2857142857142857,1,0.0,0,0,0,0,0,0,0,2,0,0,2,1
12598,178312,WzbBhY7PPwDbKcr5cy3SQJUMexrza6T3,3VkHkmOtom3jM2wCu94xgzzu1d6Dn7or,18,26,10,19,12,0,2,0,69,9.857142857142858,1,0.0,15,10,15,12,11,0,4,2,0,52,17,0
12599,178326,fXzX29qCY75dHs5GbBNWch9q4sEll7tc,3VkHkmOtom3jM2wCu94xgzzu1d6Dn7or,1,0,0,0,0,0,1,0,1,0.14285714285714285,1,0.0,0,0,0,0,0,0,0,1,0,0,1,1
12600,178333,95Q9KIbaZc3PIrmPnrRNws7TPRZmIUn3,3VkHkmOtom3jM2wCu94xgzzu1d6Dn7or,5,18,0,0,0,0,6,0,24,3.4285714285714284,1,0.0,0,0,0,0,18,0,0,6,0,0,24,1
12601,178336,2jQIZm4r1ZdKRG6ONVUMJuxDKPQlwLnX,3VkHkmOtom3jM2wCu94xgzzu1d6Dn7or,18,9,7,0,8,0,2,0,26,3.7142857142857144,1,0.0,1,7,0,8,8,0,0,2,0,16,10,1
12602,178339,3YNDQ9HlzmkqaiTl4QusF9pDU1NGEW6Y,3VkHkmOtom3jM2wCu94xgzzu1d6Dn7or,5,3,1,0,1,0,4,0,9,1.2857142857142858,1,0.0,1,1,0,1,2,0,0,4,0,3,6,1
12603,178357,LenizO7WIZrXvyQ6XIzz5famelwMYXXi,3VkHkmOtom3jM2wCu94xgzzu1d6Dn7or,5,3,1,0,1,0,3,0,8,1.1428571428571428,1,0.0,0,1,0,1,3,0,0,3,0,2,6,1
12604,178387,gdwF9XR8Xpzo8gL6dV1NzSZ7vu4bXRLw,3VkHkmOtom3jM2wCu94xgzzu1d6Dn7or,1,0,0,0,0,0,2,0,2,0.2857142857142857,1,0.0,0,0,0,0,0,0,0,2,0,0,2,0
12605,178390,KcIgH6BTbf5UYqPK5e0rO1gbcEdYcouv,3VkHkmOtom3jM2wCu94xgzzu1d6Dn7or,11,15,0,0,0,2,5,0,22,3.142857142857143,1,0.0,0,0,0,0,15,2,0,5,0,0,22,1
12606,178405,qSdRUaRT6TLZlucPzeApIsYGcjbAWzoN,3VkHkmOtom3jM2wCu94xgzzu1d6Dn7or,1,0,0,0,0,0,1,0,1,0.14285714285714285,1,0.0,0,0,0,0,0,0,0,1,0,0,1,1
12607,178413,gmvkP36dUhO1IjRmv1lLf6yGGtsBjVXA,3VkHkmOtom3jM2wCu94xgzzu1d6Dn7or,2,0,0,0,0,0,4,0,4,0.5714285714285714,1,0.0,0,0,0,0,0,0,0,4,0,0,4,1
12608,178435,zXaIFCKxfdY9z9fVBcdJ9CKQhYz4fcsP,3VkHkmOtom3jM2wCu94xgzzu1d6Dn7or,4,2,1,0,1,0,1,0,5,0.7142857142857143,1,0.0,0,1,0,1,2,0,0,1,0,2,3,0
12609,178467,Do66WCKDNxgmYoj93CHEnWXTvirOCxw7,3VkHkmOtom3jM2wCu94xgzzu1d6Dn7or,1,0,0,0,0,0,1,0,1,0.14285714285714285,1,0.0,0,0,0,0,0,0,0,1,0,0,1,1
12610,178484,DRegbZtztbDzfFAIDX6e5PDqboL8isDw,3VkHkmOtom3jM2wCu94xgzzu1d6Dn7or,1,0,0,0,0,0,1,0,1,0.14285714285714285,1,0.0,0,0,0,0,0,0,0,1,0,0,1,1
12611,178553,yV4UETFEi3JBAhsQHPqkVkaRjz4EU8w3,3VkHkmOtom3jM2wCu94xgzzu1d6Dn7or,1,0,0,0,0,0,1,0,1,0.14285714285714285,1,0.0,0,0,0,0,0,0,0,1,0,0,1,1
12612,178592,9CsgDhj3d2ihI7xcZwIVEoQTTeVHShPp,3VkHkmOtom3jM2wCu94xgzzu1d6Dn7or,1,0,0,0,0,0,1,0,1,0.14285714285714285,1,0.0,0,0,0,0,0,0,0,1,0,0,1,1
12613,178603,WlS78rUQAxTgHFyIAu04YS47iktWxxPR,3VkHkmOtom3jM2wCu94xgzzu1d6Dn7or,2,0,0,0,0,0,2,0,2,0.2857142857142857,1,0.0,0,0,0,0,0,0,0,2,0,0,2,1
12614,178620,mdnioLDSZ1Gz7WvAWQRWotu1cuvELoUd,3VkHkmOtom3jM2wCu94xgzzu1d6Dn7or,11,21,13,0,9,0,6,0,49,7.0,5,0.0,2,13,0,9,19,0,0,6,0,24,25,0
12615,178625,movdjrYCfnJMfd9wvIPPthaZq1W8AtQy,3VkHkmOtom3jM2wCu94xgzzu1d6Dn7or,1,0,0,0,0,0,1,0,1,0.14285714285714285,1,0.0,0,0,0,0,0,0,0,1,0,0,1,1
12616,178626,q7moRFMHVwQpRKPFnrQikrPXmZ6umVEi,3VkHkmOtom3jM2wCu94xgzzu1d6Dn7or,11,11,4,0,4,6,16,3,44,6.285714285714286,2,0.0,5,4,0,4,6,6,0,16,3,13,31,1
12617,178687,AuQrdDkaOVNdwuE2sCqLolxJPeSXxcim,3VkHkmOtom3jM2wCu94xgzzu1d6Dn7or,8,9,3,4,4,1,4,0,25,3.5714285714285716,1,0.0,4,3,3,4,5,1,1,4,0,14,11,1
12618,178693,tvIvEXoeBhrp2nV048Q2FjnK3OqpjH6r,3VkHkmOtom3jM2wCu94xgzzu1d6Dn7or,1,0,0,0,0,0,1,0,1,0.14285714285714285,1,0.0,0,0,0,0,0,0,0,1,0,0,1,1
12619,178733,DFb88DJyixpbyPmZwbM8rx6Jbqu1swUQ,3VkHkmOtom3jM2wCu94xgzzu1d6Dn7or,4,2,1,0,1,0,2,0,6,0.8571428571428571,1,0.0,0,1,0,1,2,0,0,2,0,2,4,1
12620,178752,2SS1m6X4PtlYKEeYaD96IeTATcPtQRmJ,3VkHkmOtom3jM2wCu94xgzzu1d6Dn7or,1,0,0,0,0,0,1,0,1,0.14285714285714285,1,0.0,0,0,0,0,0,0,0,1,0,0,1,1
12621,178777,5Wr4gytl06JTPjH70zxfV5nKBu21xgtb,3VkHkmOtom3jM2wCu94xgzzu1d6Dn7or,29,99,19,30,19,39,14,1,221,31.571428571428573,2,0.0,72,19,25,19,27,39,5,14,1,135,86,1
12622,178789,gqmyrnWST1YHRFuHufOpa1zW5qVaZveS,3VkHkmOtom3jM2wCu94xgzzu1d6Dn7or,1,0,0,0,0,0,1,0,1,0.14285714285714285,1,0.0,0,0,0,0,0,0,0,1,0,0,1,1
12623,178861,Y1ppxEgbx61jNTLCoOABIFXnW04QUYST,3VkHkmOtom3jM2wCu94xgzzu1d6Dn7or,7,4,3,0,3,0,4,0,14,2.0,1,0.0,0,3,0,3,4,0,0,4,0,6,8,1
12624,178871,G9zWjPylIHl2UsOBER9GZ5Kwh5iK59rh,3VkHkmOtom3jM2wCu94xgzzu1d6Dn7or,40,34,23,0,23,1,3,0,84,12.0,1,0.0,2,23,0,23,32,1,0,3,0,48,36,1
12625,178897,MinoPdD8UGZsXLdMkNi0JxgJ1fpYTHgX,3VkHkmOtom3jM2wCu94xgzzu1d6Dn7or,2,0,0,0,0,0,2,0,2,0.2857142857142857,1,0.0,0,0,0,0,0,0,0,2,0,0,2,1
12626,178969,B3pRT25SRFSWSiOB5wDWOCSu3VaxYqAo,3VkHkmOtom3jM2wCu94xgzzu1d6Dn7or,7,8,2,0,3,0,4,0,17,2.4285714285714284,2,0.0,2,2,0,3,6,0,0,4,0,7,10,1
12627,178972,dcYgKBzujpMIqe60unjrhnmHIEGafOxK,3VkHkmOtom3jM2wCu94xgzzu1d6Dn7or,1,0,0,0,0,0,1,0,1,0.14285714285714285,1,0.0,0,0,0,0,0,0,0,1,0,0,1,1
12628,178982,Z73UcSKohCDSYTgmUbDDz1j8bHwE1Twa,3VkHkmOtom3jM2wCu94xgzzu1d6Dn7or,1,0,0,0,0,0,1,0,1,0.14285714285714285,1,0.0,0,0,0,0,0,0,0,1,0,0,1,1
12629,178998,g0SgNwFw2DuaWnZ19sobU7oBg0SxPT5e,3VkHkmOtom3jM2wCu94xgzzu1d6Dn7or,1,0,0,0,0,0,1,0,1,0.14285714285714285,1,0.0,0,0,0,0,0,0,0,1,0,0,1,1
12630,179013,Zl3AWoVuBFcgdahcnPxWebf3SDADcUWC,3VkHkmOtom3jM2wCu94xgzzu1d6Dn7or,9,4,3,0,3,0,2,0,12,1.7142857142857142,1,0.0,0,3,0,3,4,0,0,2,0,6,6,1
12631,179020,KPuBLXcUz8uTnNFSL9u93FtuErrVvFEB,3VkHkmOtom3jM2wCu94xgzzu1d6Dn7or,1,0,0,0,0,0,2,0,2,0.2857142857142857,1,0.0,0,0,0,0,0,0,0,2,0,0,2,1
12632,179027,YNtLVTxLwTR7I2LNaRCT43IyBwbXZEUC,3VkHkmOtom3jM2wCu94xgzzu1d6Dn7or,4,4,1,0,2,0,1,0,8,1.1428571428571428,1,0.0,2,1,0,2,2,0,0,1,0,5,3,1
12633,179054,onzvyrzddloP4Y462nOOhxYjnUaQBd7J,3VkHkmOtom3jM2wCu94xgzzu1d6Dn7or,1,0,0,0,0,0,1,0,1,0.14285714285714285,1,0.0,0,0,0,0,0,0,0,1,0,0,1,1
12634,179058,LBO8Ewmz7y2U43TK4TJihTIxUkT7Ho7i,SpATywNh6bZuzm8s1ceuBUnMUAeoAHHw,15,10,7,0,5,0,2,1,25,3.5714285714285716,1,0.0,2,7,0,5,8,0,0,2,1,14,11,1
12635,179064,ypmSniAoMQdaD8bVBqpv9lhEdTHkgicw,G8EPVSXsOYB5YQWZGiz1aVq5Pgr2GrQu,18,18,9,0,6,0,5,0,38,5.428571428571429,1,0.0,0,9,0,6,18,0,0,5,0,15,23,1
12636,179073,dY4JdXVvpIHPKR4Esa2rpHGx5DEmr1uS,SpATywNh6bZuzm8s1ceuBUnMUAeoAHHw,1,0,0,0,0,0,1,0,1,0.14285714285714285,1,0.0,0,0,0,0,0,0,0,1,0,0,1,1
12637,179118,5OSDqmARPywzyw7TNCUkjUu4ZhXmVumi,SpATywNh6bZuzm8s1ceuBUnMUAeoAHHw,16,11,4,52,0,0,2,0,69,9.857142857142858,1,0.0,6,4,43,0,5,0,9,2,0,53,16,1
12638,179132,w5KgLMMXp0mTj0PVIHIOHr2nxhzUfABT,SpATywNh6bZuzm8s1ceuBUnMUAeoAHHw,22,24,18,8,16,0,1,0,67,9.571428571428571,2,0.0,3,18,7,16,21,0,1,1,0,44,23,1
12639,179183,Gmz5iMjiwcyTx4KusyWM0rOecmUutZaf,5X6FeZozNMgE2VRi3MJYjkkFK8SETtu2,1,0,0,0,0,0,1,0,1,0.14285714285714285,1,0.0,0,0,0,0,0,0,0,1,0,0,1,1
12640,179204,rUqdqKrP6jEVFmWXIFav09cIY8KEIESp,SpATywNh6bZuzm8s1ceuBUnMUAeoAHHw,2,0,0,0,0,0,2,0,2,0.2857142857142857,1,0.0,0,0,0,0,0,0,0,2,0,0,2,1
12641,179209,R23hQIkxpjGDipcAUB8Dm9M15B8oN1UL,SpATywNh6bZuzm8s1ceuBUnMUAeoAHHw,8,5,3,0,2,0,4,0,14,2.0,2,0.0,0,3,0,2,5,0,0,4,0,5,9,1
12642,179211,R23hQIkxpjGDipcAUB8Dm9M15B8oN1UL,bWdj2GDclj5ofokWjzoa5jAwMkxCykd6,6,4,2,0,1,0,3,0,10,1.4285714285714286,2,0.0,0,2,0,1,4,0,0,3,0,3,7,0
12643,179212,R23hQIkxpjGDipcAUB8Dm9M15B8oN1UL,A3fsA9Zfv1X2fVEQhTw51lKENdNrEqT3,6,4,2,0,1,0,5,0,12,1.7142857142857142,4,0.0,0,2,0,1,4,0,0,5,0,3,9,0
12644,179231,hQH8EkY3K9ePEt9jn5ZdKTUudKlRBEnW,5X6FeZozNMgE2VRi3MJYjkkFK8SETtu2,7,9,1,0,1,0,4,0,15,2.142857142857143,1,0.0,0,1,0,1,9,0,0,4,0,2,13,0
12645,179236,phUbJgbIGGa7ctfmqKFL5A4ez8Y8gbBs,G8EPVSXsOYB5YQWZGiz1aVq5Pgr2GrQu,17,28,16,12,12,0,4,0,72,10.285714285714286,1,0.0,8,16,9,12,20,0,3,4,0,45,27,0
12646,179238,4iRTdFrWnotIGLB21xnhMmvH623uk9Hg,G8EPVSXsOYB5YQWZGiz1aVq5Pgr2GrQu,1,0,0,0,0,0,1,0,1,0.14285714285714285,1,0.0,0,0,0,0,0,0,0,1,0,0,1,1
12647,179254,scd3kJGQZMfO9m14NZd9uOrxe7XoIWpn,SpATywNh6bZuzm8s1ceuBUnMUAeoAHHw,20,19,11,22,3,1,10,0,66,9.428571428571429,3,0.0,6,11,19,3,13,1,3,10,0,39,27,0
12648,179269,4ML4Rs54jY3fM6KAvqncawhNmnqaKs8R,A3fsA9Zfv1X2fVEQhTw51lKENdNrEqT3,2,0,0,0,0,0,3,0,3,0.42857142857142855,1,0.0,0,0,0,0,0,0,0,3,0,0,3,1
12649,179297,fXMmjwDSkIUd9lGJ9H4HzqxK2pgc19EB,SpATywNh6bZuzm8s1ceuBUnMUAeoAHHw,5,2,1,0,1,0,2,0,6,0.8571428571428571,1,0.0,0,1,0,1,2,0,0,2,0,2,4,1
12650,179341,UxzzvgJEwkSNbVO46V5QcfFfzC8qCW9S,RXDvfPUBYFlVdlueBFbLW0mhhAyGEqpt,6,7,0,0,0,20,3,0,30,4.285714285714286,1,0.0,0,0,0,0,7,20,0,3,0,0,30,1
12651,179344,qEQGNCv0DTznAP1gMwDRVGTAjB8ymoH3,RXDvfPUBYFlVdlueBFbLW0mhhAyGEqpt,1,0,0,0,0,0,1,0,1,0.14285714285714285,1,0.0,0,0,0,0,0,0,0,1,0,0,1,0
12652,179348,RNNuxsM5xlYyyu9stwQmqEuw1Q1FUKuB,SpATywNh6bZuzm8s1ceuBUnMUAeoAHHw,2,0,0,0,0,0,2,0,2,0.2857142857142857,1,0.0,0,0,0,0,0,0,0,2,0,0,2,1
12653,179362,RNNuxsM5xlYyyu9stwQmqEuw1Q1FUKuB,A3fsA9Zfv1X2fVEQhTw51lKENdNrEqT3,2,0,0,0,0,0,4,0,4,0.5714285714285714,1,0.0,0,0,0,0,0,0,0,4,0,0,4,1
12654,179442,2B47LMmmv8eUBezceflRv3RF5vIZnhHm,SpATywNh6bZuzm8s1ceuBUnMUAeoAHHw,7,3,2,0,2,0,2,0,9,1.2857142857142858,1,0.0,0,2,0,2,3,0,0,2,0,4,5,1
12655,179463,ijCx69zLzcwindM6K7tyzp56xpGOIFVa,5X6FeZozNMgE2VRi3MJYjkkFK8SETtu2,1,0,0,0,0,0,2,0,2,0.2857142857142857,1,0.0,0,0,0,0,0,0,0,2,0,0,2,1
12656,179471,bFBipIvg3ynAbrvo3mXNRP6i8NWVQRYx,5X6FeZozNMgE2VRi3MJYjkkFK8SETtu2,1,0,0,0,0,0,1,0,1,0.14285714285714285,1,0.0,0,0,0,0,0,0,0,1,0,0,1,1
12657,179543,kjvNUIKnKel06xDJXlSvyzBwMUnrsU4r,SpATywNh6bZuzm8s1ceuBUnMUAeoAHHw,5,3,1,0,1,0,2,0,7,1.0,1,0.0,0,1,0,1,3,0,0,2,0,2,5,0
12658,179544,tWKTzoE9MrJMRUpo6ULAcb4uIpfbisw7,bWdj2GDclj5ofokWjzoa5jAwMkxCykd6,5,5,1,0,2,0,2,0,10,1.4285714285714286,1,0.0,3,1,0,2,2,0,0,2,0,6,4,1
12659,179568,hcWxPPFXJZEtM1yKNtZ1ZD1nYFNlYmMq,A3fsA9Zfv1X2fVEQhTw51lKENdNrEqT3,10,11,6,0,2,0,4,0,23,3.2857142857142856,3,0.0,0,6,0,2,11,0,0,4,0,8,15,1
12660,179573,dytCdr5a5mu9Lr4Kt80AVLD7WwBUELzE,5X6FeZozNMgE2VRi3MJYjkkFK8SETtu2,7,3,2,0,2,0,2,0,9,1.2857142857142858,1,0.0,0,2,0,2,3,0,0,2,0,4,5,1
12661,179588,Xi3RoGAOjHAkUXOmQAg8CMkVWfFCkb7n,A3fsA9Zfv1X2fVEQhTw51lKENdNrEqT3,1,0,0,0,0,0,1,0,1,0.14285714285714285,1,0.0,0,0,0,0,0,0,0,1,0,0,1,1
12662,179590,wzsW7csdv8zU4NLhCRJbm0sFHzlDcvr8,SpATywNh6bZuzm8s1ceuBUnMUAeoAHHw,1,0,0,0,0,0,1,0,1,0.14285714285714285,1,0.0,0,0,0,0,0,0,0,1,0,0,1,1
12663,179593,rin2tkCacWBK9y40n870snOw1zz1mc0B,RXDvfPUBYFlVdlueBFbLW0mhhAyGEqpt,10,15,1,0,2,0,2,0,20,2.857142857142857,1,0.0,2,1,0,2,13,0,0,2,0,5,15,1
12664,179597,ZS9S4XJPiV9wcpaOuoDes9YJua1kN5R2,bWdj2GDclj5ofokWjzoa5jAwMkxCykd6,7,4,1,0,1,0,4,1,11,1.5714285714285714,1,0.0,1,1,0,1,3,0,0,4,1,3,8,1
12665,179601,TGiJnSEfOlHtpx1NmAAE5E7Ka91RcY3D,A3fsA9Zfv1X2fVEQhTw51lKENdNrEqT3,1,0,0,0,0,0,1,0,1,0.14285714285714285,1,0.0,0,0,0,0,0,0,0,1,0,0,1,1
12666,179604,TGiJnSEfOlHtpx1NmAAE5E7Ka91RcY3D,SpATywNh6bZuzm8s1ceuBUnMUAeoAHHw,1,0,0,0,0,0,1,0,1,0.14285714285714285,1,0.0,0,0,0,0,0,0,0,1,0,0,1,1
12667,179620,KNNMSW3oLxGqEqv2czanNkhQgdUkOWgY,5X6FeZozNMgE2VRi3MJYjkkFK8SETtu2,1,0,0,0,0,0,1,0,1,0.14285714285714285,1,0.0,0,0,0,0,0,0,0,1,0,0,1,1
12668,179630,KNNMSW3oLxGqEqv2czanNkhQgdUkOWgY,G8EPVSXsOYB5YQWZGiz1aVq5Pgr2GrQu,5,6,2,0,1,0,2,0,11,1.5714285714285714,2,0.0,0,2,0,1,6,0,0,2,0,3,8,1
12669,179667,KT45H8qrJu79sTHkCPHSA9sUb3RNHJTY,A3fsA9Zfv1X2fVEQhTw51lKENdNrEqT3,1,0,0,0,0,0,1,0,1,0.14285714285714285,1,0.0,0,0,0,0,0,0,0,1,0,0,1,1
12670,179704,gHRMftxFMfKG8FHWISkllbscPcwviNm3,SpATywNh6bZuzm8s1ceuBUnMUAeoAHHw,2,0,0,0,0,0,4,0,4,0.5714285714285714,1,0.0,0,0,0,0,0,0,0,4,0,0,4,1
12671,179712,gHRMftxFMfKG8FHWISkllbscPcwviNm3,5X6FeZozNMgE2VRi3MJYjkkFK8SETtu2,2,0,0,0,0,0,2,0,2,0.2857142857142857,1,0.0,0,0,0,0,0,0,0,2,0,0,2,1
12672,179789,5IM8g7YMOYo5qH7Yu3x31T3JkVOH9iqe,bWdj2GDclj5ofokWjzoa5jAwMkxCykd6,5,3,1,4,1,0,2,0,11,1.5714285714285714,1,0.0,1,1,3,1,2,0,1,2,0,6,5,1
12673,179809,FrcNdFNfLYMOg5fdBzjs15qKbgtHEYZH,bWdj2GDclj5ofokWjzoa5jAwMkxCykd6,12,11,6,0,3,0,7,1,28,4.0,3,0.0,1,6,0,3,10,0,0,7,1,10,18,1
12674,179817,bMSiq9HxrbA3t78b0Doz2ZoPAzWxGeLd,SpATywNh6bZuzm8s1ceuBUnMUAeoAHHw,6,3,2,0,2,0,1,0,8,1.1428571428571428,1,0.0,0,2,0,2,3,0,0,1,0,4,4,1
12675,179833,4k7x6DcNdq1PRhbqFmfcKoI6JpPSJsyb,RXDvfPUBYFlVdlueBFbLW0mhhAyGEqpt,1,0,0,0,0,0,1,0,1,0.14285714285714285,1,0.0,0,0,0,0,0,0,0,1,0,0,1,1
12676,179837,nhm9yHarbp8XLLlD9eddGGK5srTsgarU,G8EPVSXsOYB5YQWZGiz1aVq5Pgr2GrQu,5,2,1,0,1,0,2,0,6,0.8571428571428571,1,0.0,0,1,0,1,2,0,0,2,0,2,4,1
12677,179860,SL3jxjEQk6v82n0aWfLP80T9svpvrAxv,A3fsA9Zfv1X2fVEQhTw51lKENdNrEqT3,7,3,2,0,2,0,2,0,9,1.2857142857142858,1,0.0,0,2,0,2,3,0,0,2,0,4,5,0
12678,179868,oCWJvRJFiv4PFQbuiqaN5xYpzbjSLgTp,5X6FeZozNMgE2VRi3MJYjkkFK8SETtu2,1,0,0,0,0,0,1,0,1,0.14285714285714285,1,0.0,0,0,0,0,0,0,0,1,0,0,1,1
12679,179873,o3O6sFZEm4uYUPzBaiRjRHoiv6fwyQLX,SpATywNh6bZuzm8s1ceuBUnMUAeoAHHw,1,0,0,0,0,0,1,0,1,0.14285714285714285,1,0.0,0,0,0,0,0,0,0,1,0,0,1,1
12680,179881,duZhJuYE4OhwtoOCCnEJC29StAlCNOa3,SpATywNh6bZuzm8s1ceuBUnMUAeoAHHw,2,0,0,0,0,0,2,0,2,0.2857142857142857,1,0.0,0,0,0,0,0,0,0,2,0,0,2,1
12681,179894,hPO4i6aLLS5ySVSpaJ1gi3UEL1wMdcjH,5X6FeZozNMgE2VRi3MJYjkkFK8SETtu2,1,0,0,0,0,0,1,0,1,0.14285714285714285,1,0.0,0,0,0,0,0,0,0,1,0,0,1,1
12682,179895,hPO4i6aLLS5ySVSpaJ1gi3UEL1wMdcjH,RXDvfPUBYFlVdlueBFbLW0mhhAyGEqpt,1,0,0,0,0,0,1,0,1,0.14285714285714285,1,0.0,0,0,0,0,0,0,0,1,0,0,1,1
12683,179951,DldKY1CwDXbGRaTjHVPFy7M2k54ir3Sa,SpATywNh6bZuzm8s1ceuBUnMUAeoAHHw,8,7,3,0,3,0,6,0,19,2.7142857142857144,1,0.0,0,3,0,3,7,0,0,6,0,6,13,1
12684,179969,nCZrnJjbpsSoXVwiEhCJqTYAOI3F94p9,A3fsA9Zfv1X2fVEQhTw51lKENdNrEqT3,10,6,4,0,4,0,1,0,15,2.142857142857143,2,0.0,0,4,0,4,6,0,0,1,0,8,7,1
12685,179979,bf8aEyd6FsvtZHaXW2U9ZnLIJNgziVh0,SpATywNh6bZuzm8s1ceuBUnMUAeoAHHw,6,8,0,0,0,0,2,0,10,1.4285714285714286,1,0.0,0,0,0,0,8,0,0,2,0,0,10,1
12686,179980,XD7r9EdkeFNawRwVnSFsvsZq5B2P09f1,SpATywNh6bZuzm8s1ceuBUnMUAeoAHHw,1,0,0,0,0,0,3,0,3,0.42857142857142855,1,0.0,0,0,0,0,0,0,0,3,0,0,3,1
12687,179990,jSMK0akNGSFm4KfOYXgrnzc6M6L4GOjs,bWdj2GDclj5ofokWjzoa5jAwMkxCykd6,7,2,0,0,0,1,6,1,10,1.4285714285714286,1,0.0,0,0,0,0,2,1,0,6,1,0,10,1
12688,180007,d61Mq2WOkbOPuslLwPbE2HIvs5VJCHXC,A3fsA9Zfv1X2fVEQhTw51lKENdNrEqT3,2,0,0,0,0,0,3,0,3,0.42857142857142855,2,0.0,0,0,0,0,0,0,0,3,0,0,3,1
12689,180020,9fZ9ajTU1tyQz56pupAA6Mj4GXhRGs70,RXDvfPUBYFlVdlueBFbLW0mhhAyGEqpt,1,0,0,0,0,0,1,0,1,0.14285714285714285,1,0.0,0,0,0,0,0,0,0,1,0,0,1,1
12690,180037,QHMb7P7jQNCBcOLFOpsx5OnkXdlEixMX,SpATywNh6bZuzm8s1ceuBUnMUAeoAHHw,6,4,2,0,1,0,4,0,11,1.5714285714285714,2,0.0,0,2,0,1,4,0,0,4,0,3,8,1
12691,180046,oj4B9Eiq2DhD93IZ9QqW6z1NcyEBJDg5,RXDvfPUBYFlVdlueBFbLW0mhhAyGEqpt,6,5,3,0,2,1,3,0,14,2.0,1,0.0,0,3,0,2,5,1,0,3,0,5,9,1
12692,180062,1v1hnAW2fjxDgMlfMAcBqTKOh6UMFrVl,5X6FeZozNMgE2VRi3MJYjkkFK8SETtu2,1,0,0,0,0,0,1,0,1,0.14285714285714285,1,0.0,0,0,0,0,0,0,0,1,0,0,1,1
12693,180063,7iiJKJH1gn2zCei1ljdqO2u1S02IW6Ni,5X6FeZozNMgE2VRi3MJYjkkFK8SETtu2,2,0,0,0,0,0,2,0,2,0.2857142857142857,1,0.0,0,0,0,0,0,0,0,2,0,0,2,1
12694,180085,faKL2n0gPoXoql4sSWDfZo6er3NptGIb,7GRhBDsirIGkRZBtSMEzNTyDr2JQm4xx,2,0,0,0,0,0,2,0,2,0.2857142857142857,1,0.0,0,0,0,0,0,0,0,2,0,0,2,1
12695,180112,tqvV2MwKeLemDHIUsPAVAoV4nZW7CEvr,7GRhBDsirIGkRZBtSMEzNTyDr2JQm4xx,22,18,12,15,10,0,3,0,58,8.285714285714286,1,0.0,4,12,15,10,14,0,0,3,0,41,17,1
12696,180113,gQlwXyK2UfJePDb32xo4quF0aS1cebFG,7GRhBDsirIGkRZBtSMEzNTyDr2JQm4xx,2,0,0,0,0,0,2,0,2,0.2857142857142857,1,0.0,0,0,0,0,0,0,0,2,0,0,2,1
12697,180204,Ie7mkAUCVVaLYxvosre748ADQJqirOJg,5X6FeZozNMgE2VRi3MJYjkkFK8SETtu2,7,4,1,0,1,0,2,0,8,1.1428571428571428,1,0.0,0,1,0,1,4,0,0,2,0,2,6,1
12698,180217,RtFjOHQ78yo3bQ6aRAVmoLevb4Ve3GxB,7GRhBDsirIGkRZBtSMEzNTyDr2JQm4xx,5,2,1,0,0,0,5,0,8,1.1428571428571428,1,0.0,0,1,0,0,2,0,0,5,0,1,7,1
12699,180225,5p1pugPSQA7ekfeoqop7HHA1WjATAX83,7GRhBDsirIGkRZBtSMEzNTyDr2JQm4xx,1,0,0,0,0,0,1,0,1,0.14285714285714285,1,0.0,0,0,0,0,0,0,0,1,0,0,1,1
12700,180244,A6zX6I2GfUhXHkfxx6hY7fkYNihUgWzR,7GRhBDsirIGkRZBtSMEzNTyDr2JQm4xx,1,0,0,0,0,0,1,0,1,0.14285714285714285,1,0.0,0,0,0,0,0,0,0,1,0,0,1,1
12701,180249,skO1w4xAP0rDa1qcY4cgOn68z6G9pTRm,5X6FeZozNMgE2VRi3MJYjkkFK8SETtu2,2,0,0,0,0,0,3,0,3,0.42857142857142855,1,0.0,0,0,0,0,0,0,0,3,0,0,3,1
12702,180261,AyhJARh0xhxObM9zhvUdDxlTCtu309eW,5X6FeZozNMgE2VRi3MJYjkkFK8SETtu2,4,2,1,0,1,0,1,0,5,0.7142857142857143,1,0.0,0,1,0,1,2,0,0,1,0,2,3,1
12703,180312,hYTVG5ANDBem3sg8QIDjen4BqqV0JGFL,7GRhBDsirIGkRZBtSMEzNTyDr2JQm4xx,1,0,0,0,0,0,1,0,1,0.14285714285714285,1,0.0,0,0,0,0,0,0,0,1,0,0,1,1
12704,180319,ocTIjxG8zBs0mQRpUtpuAKc7MDpzU7Sd,5X6FeZozNMgE2VRi3MJYjkkFK8SETtu2,5,4,2,0,1,0,1,0,8,1.1428571428571428,1,0.0,1,2,0,1,3,0,0,1,0,4,4,1
12705,180333,VdbwmsrhEaf1Ntx0Uu4hETHXAIfCfgPp,5Gyp41oLVo7Gg7vF4vpmggWP5MU70QO6,2,0,0,0,0,0,2,0,2,0.2857142857142857,1,0.0,0,0,0,0,0,0,0,2,0,0,2,1
12706,180346,Dzw21RObfNeqcKRhrcWOWYYLAAShj0W4,5Gyp41oLVo7Gg7vF4vpmggWP5MU70QO6,1,0,0,0,0,0,1,0,1,0.14285714285714285,1,0.0,0,0,0,0,0,0,0,1,0,0,1,1
12707,180360,se9ZVl8DNkiCW8i2nP0p3krrUcQqYC47,5Gyp41oLVo7Gg7vF4vpmggWP5MU70QO6,5,3,2,0,0,0,2,0,7,1.0,2,0.0,0,2,0,0,3,0,0,2,0,2,5,1
12708,180365,9QuW9ZLhtCdoIktgbqTL0ZL84tEvEWfk,5Gyp41oLVo7Gg7vF4vpmggWP5MU70QO6,5,2,2,0,2,0,2,0,8,1.1428571428571428,2,0.0,0,2,0,2,2,0,0,2,0,4,4,1
12709,180369,XXSXfhCw9mGganakCzSbMGrDeFQxXvty,5Gyp41oLVo7Gg7vF4vpmggWP5MU70QO6,4,4,2,0,0,1,1,0,8,1.1428571428571428,1,0.0,0,2,0,0,4,1,0,1,0,2,6,1
12710,180385,6kVQKwQyT547HfghY5j8ZYVsAOaPndJb,5Gyp41oLVo7Gg7vF4vpmggWP5MU70QO6,5,2,0,0,0,0,4,0,6,0.8571428571428571,1,0.0,0,0,0,0,2,0,0,4,0,0,6,1
12711,180404,zc3yobCT7g704IntVUdzizx4jyscourR,5Gyp41oLVo7Gg7vF4vpmggWP5MU70QO6,8,8,6,0,5,12,2,0,33,4.714285714285714,1,0.0,1,6,0,5,7,12,0,2,0,12,21,1
12712,180408,YTqFGKydGa9t3OpX1V9OLIPq0MJ9XJx3,5Gyp41oLVo7Gg7vF4vpmggWP5MU70QO6,11,10,6,3,3,0,2,0,24,3.4285714285714284,1,0.0,1,6,2,3,9,0,1,2,0,12,12,1
12713,180409,vpMPPz3PltCcHRnbpX25nnc9Umi2LOSS,5Gyp41oLVo7Gg7vF4vpmggWP5MU70QO6,15,13,7,6,4,9,4,6,49,7.0,1,0.0,3,7,4,4,10,9,2,4,6,18,31,1
12714,180422,6dc6EewVUNfgITT5R0ncyzJuV0RcJz2q,5Gyp41oLVo7Gg7vF4vpmggWP5MU70QO6,11,8,4,9,1,0,2,0,24,3.4285714285714284,1,0.0,3,4,6,1,5,0,3,2,0,14,10,1
12715,180428,hdCB9NYvijkht4G4yPpTVpMi2HQucz4x,5Gyp41oLVo7Gg7vF4vpmggWP5MU70QO6,5,2,1,0,1,0,2,0,6,0.8571428571428571,1,0.0,0,1,0,1,2,0,0,2,0,2,4,1
12716,180449,pm4QAvD55kGSf5JZpnTAByS2n0xgOUT4,5Gyp41oLVo7Gg7vF4vpmggWP5MU70QO6,12,8,5,0,4,1,4,0,22,3.142857142857143,2,0.0,1,5,0,4,7,1,0,4,0,10,12,1
12717,180457,dFabA08S2MisFGsUf420mmCXMOVQ9987,5Gyp41oLVo7Gg7vF4vpmggWP5MU70QO6,1,0,0,0,0,0,2,0,2,0.2857142857142857,1,0.0,0,0,0,0,0,0,0,2,0,0,2,1
12718,180465,v0j16a4LE6aPOzv0omm2uC56r3JNzrm2,5Gyp41oLVo7Gg7vF4vpmggWP5MU70QO6,7,3,1,0,2,0,2,0,8,1.1428571428571428,1,0.0,0,1,0,2,3,0,0,2,0,3,5,1
12719,180466,p04QzukP32kpPk8EGoBhDUGJJQqJUoNz,5Gyp41oLVo7Gg7vF4vpmggWP5MU70QO6,1,0,0,0,0,0,1,0,1,0.14285714285714285,1,0.0,0,0,0,0,0,0,0,1,0,0,1,1
12720,180470,kCpIxmgqcIr7LDiV8CMd5u1iUng7rZ5o,5Gyp41oLVo7Gg7vF4vpmggWP5MU70QO6,7,2,1,0,1,0,5,0,9,1.2857142857142858,1,0.0,0,1,0,1,2,0,0,5,0,2,7,1
12721,180471,vRDqP5xcXUHdZPGQ9k1Y2zmDGUpZ7MaA,5Gyp41oLVo7Gg7vF4vpmggWP5MU70QO6,3,3,0,0,0,0,1,0,4,0.5714285714285714,1,0.0,0,0,0,0,3,0,0,1,0,0,4,1
12722,180480,oISxv33lwptGFBahWRvD6klRjmHxu37p,5Gyp41oLVo7Gg7vF4vpmggWP5MU70QO6,6,1,1,0,0,1,7,1,11,1.5714285714285714,1,0.0,0,1,0,0,1,1,0,7,1,1,10,1
12723,180491,MdyAi5wz0BPn55uzdxK3YSomKT9HZ1dV,5Gyp41oLVo7Gg7vF4vpmggWP5MU70QO6,7,3,2,0,2,0,3,1,11,1.5714285714285714,1,0.0,0,2,0,2,3,0,0,3,1,4,7,1
12724,180501,2hb1nLylJ3pK33F1eNFi4G1Jg39Nh6nj,5Gyp41oLVo7Gg7vF4vpmggWP5MU70QO6,4,2,1,0,1,0,1,0,5,0.7142857142857143,1,0.0,0,1,0,1,2,0,0,1,0,2,3,1
12725,180525,Caf5ukME6sc80BSrYSlVzcSKAp8RAaQ2,5Gyp41oLVo7Gg7vF4vpmggWP5MU70QO6,3,0,0,0,0,0,4,0,4,0.5714285714285714,1,0.0,0,0,0,0,0,0,0,4,0,0,4,1
12726,180545,2fJnw6CwlD9kPbDbGOr5T9g4ChtEFbIV,5Gyp41oLVo7Gg7vF4vpmggWP5MU70QO6,10,5,3,6,2,0,2,0,18,2.5714285714285716,1,0.0,1,3,4,2,4,0,2,2,0,10,8,1
12727,180549,nNkPxgK73MqMApsYtxu6v9AnfWusfhDn,5Gyp41oLVo7Gg7vF4vpmggWP5MU70QO6,7,5,2,0,2,0,2,0,11,1.5714285714285714,1,0.0,0,2,0,2,5,0,0,2,0,4,7,1
12728,180573,AXjXLUPDRZg18lUnclQU86YQs1DGA11X,5Gyp41oLVo7Gg7vF4vpmggWP5MU70QO6,12,15,7,9,4,10,4,1,50,7.142857142857143,1,0.0,6,7,6,4,9,10,3,4,1,23,27,1
12729,180581,p8OxzMqwupG8Wxjqf7hR8Y85upVCYHhC,5Gyp41oLVo7Gg7vF4vpmggWP5MU70QO6,4,2,1,0,1,0,1,0,5,0.7142857142857143,1,0.0,0,1,0,1,2,0,0,1,0,2,3,1
12730,180615,qLscbApWydA7z1h7Ht7RN2UnF0mvGZpF,5Gyp41oLVo7Gg7vF4vpmggWP5MU70QO6,4,2,1,0,1,0,1,0,5,0.7142857142857143,1,0.0,0,1,0,1,2,0,0,1,0,2,3,1
12731,180616,EIaoEsmMCElUVPCCMKJTeZSwe5Tpb9nu,5Gyp41oLVo7Gg7vF4vpmggWP5MU70QO6,11,10,6,14,2,0,4,0,36,5.142857142857143,2,0.0,1,6,11,2,9,0,3,4,0,20,16,1
12732,180621,G4gv3psLUg6DraQbf90HcUcwjZl74koo,5Gyp41oLVo7Gg7vF4vpmggWP5MU70QO6,7,3,2,0,1,0,4,0,10,1.4285714285714286,1,0.0,0,2,0,1,3,0,0,4,0,3,7,1
12733,180623,O3hYI537zr7fPNSahntbmZkF0gMAGE4h,5Gyp41oLVo7Gg7vF4vpmggWP5MU70QO6,1,0,0,0,0,0,1,0,1,0.14285714285714285,1,0.0,0,0,0,0,0,0,0,1,0,0,1,1
12734,180625,bsalGAvHbAyi2zQkMdMuno7PqVBrE5qV,5Gyp41oLVo7Gg7vF4vpmggWP5MU70QO6,5,2,1,0,1,0,2,0,6,0.8571428571428571,1,0.0,0,1,0,1,2,0,0,2,0,2,4,1
12735,180627,2ZUUEzlqPIZRVja8Yw3ZMtVqM8WoUnTW,5Gyp41oLVo7Gg7vF4vpmggWP5MU70QO6,15,18,8,13,3,5,6,3,56,8.0,1,0.0,9,8,9,3,9,5,4,6,3,29,27,1
12736,180638,QFH4wolhcweAHadUiy5aIW0unRYxm1jI,5Gyp41oLVo7Gg7vF4vpmggWP5MU70QO6,4,2,1,0,0,0,2,0,5,0.7142857142857143,1,0.0,0,1,0,0,2,0,0,2,0,1,4,1
12737,180639,hqSRPxpI43WtMHTwEnMUolUcTbcIJWPD,5Gyp41oLVo7Gg7vF4vpmggWP5MU70QO6,13,15,7,16,0,0,4,0,42,6.0,1,0.0,5,7,11,0,10,0,5,4,0,23,19,1
12738,180666,OV8ydTO9DA2HDljMOebORxkzQvud47yg,5Gyp41oLVo7Gg7vF4vpmggWP5MU70QO6,7,3,2,0,1,3,4,0,13,1.8571428571428572,1,0.0,0,2,0,1,3,3,0,4,0,3,10,1
12739,180685,ZCzGn7UyXXjv72SOnujYeGTtd5gijp5N,5Gyp41oLVo7Gg7vF4vpmggWP5MU70QO6,9,7,2,9,1,3,3,1,26,3.7142857142857144,1,0.0,5,2,6,1,2,3,3,3,1,14,12,1
12740,180698,cmBGPhEo7zyHufHh12hBiHKxlPiadEZH,5Gyp41oLVo7Gg7vF4vpmggWP5MU70QO6,7,4,0,0,1,0,4,1,10,1.4285714285714286,1,0.0,0,0,0,1,4,0,0,4,1,1,9,0
12741,180716,WEqUhplW7x1SpLabVjNcI5M4HsCYjumg,5Gyp41oLVo7Gg7vF4vpmggWP5MU70QO6,4,5,2,0,0,0,1,0,8,1.1428571428571428,1,0.0,0,2,0,0,5,0,0,1,0,2,6,1
12742,180719,IcZ6i6v1x93Zo65F5bywQyN2mFUqZ0pV,5Gyp41oLVo7Gg7vF4vpmggWP5MU70QO6,2,0,0,0,0,6,1,0,7,1.0,1,0.0,0,0,0,0,0,6,0,1,0,0,7,1
12743,180723,XpCDhn34CsjM8KU9xQLESEPM4fYlChby,5Gyp41oLVo7Gg7vF4vpmggWP5MU70QO6,8,4,2,0,1,1,4,0,12,1.7142857142857142,1,0.0,0,2,0,1,4,1,0,4,0,3,9,1
12744,180741,iJ82QfZ5cjEE893M5bH0BgxBT4c25nXE,5Gyp41oLVo7Gg7vF4vpmggWP5MU70QO6,1,0,0,0,0,0,2,0,2,0.2857142857142857,2,0.0,0,0,0,0,0,0,0,2,0,0,2,1
12745,180744,TOybu3VTl57Gwz61jxLAAYZF2xYkGB5M,5Gyp41oLVo7Gg7vF4vpmggWP5MU70QO6,14,16,10,0,9,3,8,3,49,7.0,1,0.0,3,10,0,9,13,3,0,8,3,22,27,1
12746,180754,lDJqver3AFFUyXISNdqvZpmq6OeWVl0r,5Gyp41oLVo7Gg7vF4vpmggWP5MU70QO6,1,0,0,0,0,0,2,0,2,0.2857142857142857,1,0.0,0,0,0,0,0,0,0,2,0,0,2,1
12747,180759,YZvjSAhv73aSPxCkFsL6a9U6nSCuWb5C,5Gyp41oLVo7Gg7vF4vpmggWP5MU70QO6,5,2,1,0,1,0,2,0,6,0.8571428571428571,1,0.0,0,1,0,1,2,0,0,2,0,2,4,1
12748,180784,AsAtWFxD8bumrqIWR5awNAWKQt2RUSUJ,5Gyp41oLVo7Gg7vF4vpmggWP5MU70QO6,4,2,1,0,1,0,1,0,5,0.7142857142857143,1,0.0,0,1,0,1,2,0,0,1,0,2,3,1
12749,180789,Nt4mZsjfM4IZ7anEZxuZk7e6qxizotdE,5Gyp41oLVo7Gg7vF4vpmggWP5MU70QO6,21,34,27,14,7,1,2,0,85,12.142857142857142,2,0.0,2,27,9,7,32,1,5,2,0,45,40,1
12750,180821,ELsX3So3MEP4M02HSkl7LgWbVXNEckun,5Gyp41oLVo7Gg7vF4vpmggWP5MU70QO6,7,3,1,0,2,4,2,0,12,1.7142857142857142,1,0.0,0,1,0,2,3,4,0,2,0,3,9,1
12751,180824,t6VI3IanHtDke9IUrIN6nN2LpiVCDOFR,5Gyp41oLVo7Gg7vF4vpmggWP5MU70QO6,4,5,3,0,0,0,1,0,9,1.2857142857142858,1,0.0,0,3,0,0,5,0,0,1,0,3,6,1
12752,180843,0rbXUlrgFDVR0QpsFzdCtuKCZmFaVq4v,5Gyp41oLVo7Gg7vF4vpmggWP5MU70QO6,1,0,0,0,0,0,1,0,1,0.14285714285714285,1,0.0,0,0,0,0,0,0,0,1,0,0,1,1
12753,180854,5xDTEdGInGFTZn3PwlXNraXRYICzcVem,5Gyp41oLVo7Gg7vF4vpmggWP5MU70QO6,7,4,3,0,2,0,1,0,10,1.4285714285714286,1,0.0,0,3,0,2,4,0,0,1,0,5,5,1
12754,180864,NrFu06k2xTVsBcsU6J8BlqDNgeYTHuT3,5Gyp41oLVo7Gg7vF4vpmggWP5MU70QO6,5,1,1,0,1,0,3,0,6,0.8571428571428571,1,0.0,0,1,0,1,1,0,0,3,0,2,4,1
12755,180871,CNnvEGwKATmmBRimIHsh9gqRuWKpHbRS,5Gyp41oLVo7Gg7vF4vpmggWP5MU70QO6,6,3,1,0,1,0,3,0,8,1.1428571428571428,1,0.0,0,1,0,1,3,0,0,3,0,2,6,1
12756,180875,O1JCj9IRlzuPnXGSMFH3o6nPheXmI0dk,5Gyp41oLVo7Gg7vF4vpmggWP5MU70QO6,8,7,4,0,2,0,2,0,15,2.142857142857143,2,0.0,1,4,0,2,6,0,0,2,0,7,8,1
12757,180893,IZuOLlG7HUowwCKYPaGqcIFnzKRG5W4h,5Gyp41oLVo7Gg7vF4vpmggWP5MU70QO6,17,15,10,0,7,0,4,0,36,5.142857142857143,2,0.0,2,10,0,7,13,0,0,4,0,19,17,1
12758,180897,X2rYZmjNSta2MgyewfHiGDRqM0GJtlTs,5Gyp41oLVo7Gg7vF4vpmggWP5MU70QO6,14,10,5,21,3,0,2,0,41,5.857142857142857,1,0.0,4,5,13,3,6,0,8,2,0,25,16,1
12759,180916,r0hi0ZJd8UuUZLbhRuT99HexLH6eSRnQ,5Gyp41oLVo7Gg7vF4vpmggWP5MU70QO6,1,0,0,0,0,0,1,0,1,0.14285714285714285,1,0.0,0,0,0,0,0,0,0,1,0,0,1,1
12760,180920,fNnHBhGnywsG6LHW9M0Nx0qEbrvDjBO7,5Gyp41oLVo7Gg7vF4vpmggWP5MU70QO6,1,0,0,0,0,0,1,0,1,0.14285714285714285,1,0.0,0,0,0,0,0,0,0,1,0,0,1,1
12761,180925,NoYPpFxcK6tcx8jsBNJXYeJWPofFfMTW,5Gyp41oLVo7Gg7vF4vpmggWP5MU70QO6,4,3,1,0,0,0,2,0,6,0.8571428571428571,1,0.0,0,1,0,0,3,0,0,2,0,1,5,1
12762,180968,nVmPrup4WIX4cDkqM2yvhc3E0JOk5euN,5Gyp41oLVo7Gg7vF4vpmggWP5MU70QO6,14,26,8,8,8,47,10,14,121,17.285714285714285,2,0.0,11,8,6,8,15,47,2,10,14,33,88,1
12763,180974,BkjpawhkYLwXRm8TkP8sUAuZJZtPDlsW,5Gyp41oLVo7Gg7vF4vpmggWP5MU70QO6,7,3,2,0,2,0,3,0,10,1.4285714285714286,1,0.0,0,2,0,2,3,0,0,3,0,4,6,1
12764,180995,5ZSp0tU9aRE4uiUWHP8Ae2WfrW4oZyzA,5Gyp41oLVo7Gg7vF4vpmggWP5MU70QO6,6,4,2,0,1,0,2,0,9,1.2857142857142858,1,0.0,1,2,0,1,3,0,0,2,0,4,5,1
12765,181013,oVXEwzWOnz5Sf1Z310ZehdO5ZKy4uuD6,5Gyp41oLVo7Gg7vF4vpmggWP5MU70QO6,12,26,15,0,3,0,7,0,51,7.285714285714286,2,0.0,1,15,0,3,25,0,0,7,0,19,32,1
12766,181056,jaMIs7YXs87q8CsWLCKUUMpBiCYuq5u4,5Gyp41oLVo7Gg7vF4vpmggWP5MU70QO6,7,3,2,0,2,0,4,0,11,1.5714285714285714,1,0.0,0,2,0,2,3,0,0,4,0,4,7,1
12767,181066,2ZB75XaxDHECeG9sXD5ayYvXNr27JTjj,5Gyp41oLVo7Gg7vF4vpmggWP5MU70QO6,1,0,0,0,0,0,1,0,1,0.14285714285714285,1,0.0,0,0,0,0,0,0,0,1,0,0,1,1
12768,181110,5khGTvLU6yjmXaeHpWJGWa1iZGzL5YGz,5Gyp41oLVo7Gg7vF4vpmggWP5MU70QO6,19,34,24,0,10,0,4,0,72,10.285714285714286,1,0.0,2,24,0,10,32,0,0,4,0,36,36,1
12769,181111,J9Wf06bYC2mfaRnTcRT9MBC53a9bvAMe,5Gyp41oLVo7Gg7vF4vpmggWP5MU70QO6,12,14,10,0,3,0,4,0,31,4.428571428571429,1,0.0,2,10,0,3,12,0,0,4,0,15,16,1
12770,181125,nj0GeuvjREGyDQcup3h5G1wINhoiYYrm,5Gyp41oLVo7Gg7vF4vpmggWP5MU70QO6,9,3,2,0,2,2,5,0,14,2.0,1,0.0,0,2,0,2,3,2,0,5,0,4,10,1
12771,181130,uurBymt1lyDtglBoVIFUaumdRGJ7o8GH,5Gyp41oLVo7Gg7vF4vpmggWP5MU70QO6,7,2,1,0,1,5,7,2,18,2.5714285714285716,1,0.0,0,1,0,1,2,5,0,7,2,2,16,1
12772,181141,piQRkV9tfktADXclBB7xQYTpIWhw5NQu,5Gyp41oLVo7Gg7vF4vpmggWP5MU70QO6,10,11,8,0,2,0,2,0,23,3.2857142857142856,2,0.0,0,8,0,2,11,0,0,2,0,10,13,1
12773,181157,Q4IvbcNWdBPmlOeKoLaoLQatAn7Hl55o,5Gyp41oLVo7Gg7vF4vpmggWP5MU70QO6,12,7,6,0,2,0,3,0,18,2.5714285714285716,1,0.0,0,6,0,2,7,0,0,3,0,8,10,1
12774,181185,kvFxm6h3ndggPRl7hrJAQaZ5vmCMmjlt,5Gyp41oLVo7Gg7vF4vpmggWP5MU70QO6,5,2,0,0,1,0,2,1,6,0.8571428571428571,1,0.0,0,0,0,1,2,0,0,2,1,1,5,1
12775,181195,1zErz13s8fNQRVaEvkOtvw6bLhr23yB4,5Gyp41oLVo7Gg7vF4vpmggWP5MU70QO6,10,12,10,7,1,0,2,0,32,4.571428571428571,1,0.0,1,10,5,1,11,0,2,2,0,17,15,1
12776,181226,uT6DjukxZLvo9BEaU3ExjxzUc2OZ2h85,5Gyp41oLVo7Gg7vF4vpmggWP5MU70QO6,9,8,4,10,2,0,3,0,27,3.857142857142857,1,0.0,3,4,7,2,5,0,3,3,0,16,11,1
12777,181234,ppwn795jM3X8HLmfBGWlJ1RCSK9HLpNe,5Gyp41oLVo7Gg7vF4vpmggWP5MU70QO6,8,4,3,0,2,0,3,0,12,1.7142857142857142,1,0.0,0,3,0,2,4,0,0,3,0,5,7,1
12778,181239,YSDr4kp8xy1IJOjF6U6TmfojxhpzvfoE,5Gyp41oLVo7Gg7vF4vpmggWP5MU70QO6,8,3,2,0,2,1,5,2,15,2.142857142857143,1,0.0,0,2,0,2,3,1,0,5,2,4,11,1
12779,181258,bDOMCQV7nFdKo0pDqOPr3ECLpgkdBCSt,5Gyp41oLVo7Gg7vF4vpmggWP5MU70QO6,18,13,8,1,7,1,9,1,40,5.714285714285714,2,0.0,3,8,1,7,10,1,0,9,1,19,21,1
12780,181288,mDjnFW2H7nFisiWlxOrJTsR30uwjlL59,5Gyp41oLVo7Gg7vF4vpmggWP5MU70QO6,15,9,8,0,4,0,3,0,24,3.4285714285714284,1,0.0,0,8,0,4,9,0,0,3,0,12,12,1
12781,181300,u5ObOMoHUcvVsOQTGkiv0BRKKcn8v2w8,5Gyp41oLVo7Gg7vF4vpmggWP5MU70QO6,7,3,2,0,2,0,2,0,9,1.2857142857142858,1,0.0,0,2,0,2,3,0,0,2,0,4,5,1
12782,181416,6eFLenmSuEaK2yDqVHC9OonKyhwGkbDc,5Gyp41oLVo7Gg7vF4vpmggWP5MU70QO6,2,0,0,0,0,0,2,0,2,0.2857142857142857,1,0.0,0,0,0,0,0,0,0,2,0,0,2,1
12783,181433,ZgSCBb788XyHHe00tk3N5n3DNv5SRct9,5Gyp41oLVo7Gg7vF4vpmggWP5MU70QO6,6,6,0,0,0,0,2,0,8,1.1428571428571428,1,0.0,0,0,0,0,6,0,0,2,0,0,8,1
12784,181435,DQwc8pejbnheXq1m3QxoKvet1LFQ88Od,5Gyp41oLVo7Gg7vF4vpmggWP5MU70QO6,10,8,5,0,3,0,4,0,20,2.857142857142857,1,0.0,0,5,0,3,8,0,0,4,0,8,12,1
12785,181438,5LW4mjF9q34UvMTZjLS5Sqba8UzHsR4B,5Gyp41oLVo7Gg7vF4vpmggWP5MU70QO6,6,3,1,0,1,0,2,0,7,1.0,1,0.0,0,1,0,1,3,0,0,2,0,2,5,1
12786,181447,CHhRHW1xvsEWXIP2d0gkl8piD067lkvn,5Gyp41oLVo7Gg7vF4vpmggWP5MU70QO6,4,2,1,0,1,0,1,0,5,0.7142857142857143,1,0.0,0,1,0,1,2,0,0,1,0,2,3,1
12787,181466,1uHovACZmOb4Xg0f8FhkliZEuRitP24W,5Gyp41oLVo7Gg7vF4vpmggWP5MU70QO6,10,7,6,0,3,0,1,0,17,2.4285714285714284,1,0.0,0,6,0,3,7,0,0,1,0,9,8,1
12788,181467,aV4MH8Zz9KrPRpKW0wkxeTpdmDua621E,5Gyp41oLVo7Gg7vF4vpmggWP5MU70QO6,1,0,0,0,0,0,1,0,1,0.14285714285714285,1,0.0,0,0,0,0,0,0,0,1,0,0,1,1
12789,181569,HFlkUxGHWB77t9TiRXSaNCP8d3isxGAz,5Gyp41oLVo7Gg7vF4vpmggWP5MU70QO6,13,7,6,0,2,0,5,2,22,3.142857142857143,1,0.0,0,6,0,2,7,0,0,5,2,8,14,1
12790,181580,9DPHcUOWUV8IQnJfLjMYUBV9Ko2uH3w5,5Gyp41oLVo7Gg7vF4vpmggWP5MU70QO6,6,3,2,0,2,0,3,0,10,1.4285714285714286,1,0.0,0,2,0,2,3,0,0,3,0,4,6,1
12791,181584,iKVtXLZY6XC1Ozhvwt3XfCzLYHoRf4Le,5Gyp41oLVo7Gg7vF4vpmggWP5MU70QO6,6,1,1,0,1,0,3,0,6,0.8571428571428571,1,0.0,0,1,0,1,1,0,0,3,0,2,4,0
12792,181586,6qpmxN3N2yoZzMmasQOl4q0O494Ovdgi,5Gyp41oLVo7Gg7vF4vpmggWP5MU70QO6,1,0,0,0,0,0,1,0,1,0.14285714285714285,1,0.0,0,0,0,0,0,0,0,1,0,0,1,1
12793,181593,fwOgm19i9S3by4kH60ptT6BbQyrVR3WL,5Gyp41oLVo7Gg7vF4vpmggWP5MU70QO6,9,13,7,0,1,0,4,1,26,3.7142857142857144,1,0.0,0,7,0,1,13,0,0,4,1,8,18,1
12794,181612,mzwsSG8Ktfv1WZqjqew1AgaQEM1GX6IP,5Gyp41oLVo7Gg7vF4vpmggWP5MU70QO6,20,39,15,0,10,28,16,1,109,15.571428571428571,1,0.0,8,15,0,10,31,28,0,16,1,33,76,1
12795,181631,Nw5m8lebM1Lxi9RkpjTadGBacKl5bV7H,5Gyp41oLVo7Gg7vF4vpmggWP5MU70QO6,1,0,0,0,0,0,2,0,2,0.2857142857142857,1,0.0,0,0,0,0,0,0,0,2,0,0,2,1
12796,181647,LD6dgwMbAWHuMQHG0naXfcUBkMX3mcrC,5Gyp41oLVo7Gg7vF4vpmggWP5MU70QO6,8,6,4,16,0,0,3,0,29,4.142857142857143,1,0.0,1,4,8,0,5,0,8,3,0,13,16,1
12797,181666,cXxLX3weIMxSwYSoT8P8ZKKNMlGVjCNy,5Gyp41oLVo7Gg7vF4vpmggWP5MU70QO6,1,0,0,0,0,0,1,0,1,0.14285714285714285,1,0.0,0,0,0,0,0,0,0,1,0,0,1,1
12798,181705,O4qtZeWI5SwQrozkAvEbFYqe7vdk37bO,5Gyp41oLVo7Gg7vF4vpmggWP5MU70QO6,9,6,4,0,2,0,3,0,15,2.142857142857143,1,0.0,0,4,0,2,6,0,0,3,0,6,9,1
12799,181706,KPAskVsVbArHW91A7Qm73UM5PoCX0SEG,5Gyp41oLVo7Gg7vF4vpmggWP5MU70QO6,12,8,3,2,3,1,5,0,22,3.142857142857143,1,0.0,4,3,1,3,4,1,1,5,0,11,11,1
12800,181711,rlOA9rzwAqUsSQUxvWoyo9NkAlJS9jq0,5Gyp41oLVo7Gg7vF4vpmggWP5MU70QO6,7,3,1,0,1,1,4,0,10,1.4285714285714286,1,0.0,0,1,0,1,3,1,0,4,0,2,8,1
12801,181725,GyWTABuPpZEqO585EnNTIpM2B2faPYN3,5Gyp41oLVo7Gg7vF4vpmggWP5MU70QO6,4,3,2,0,2,0,1,0,8,1.1428571428571428,1,0.0,0,2,0,2,3,0,0,1,0,4,4,1
12802,181726,nZgoOk2D7MZGiXntucp8f1hhA6rT4Hgo,5Gyp41oLVo7Gg7vF4vpmggWP5MU70QO6,15,20,6,7,5,3,5,1,47,6.714285714285714,1,0.0,11,6,5,5,9,3,2,5,1,27,20,1
12803,181739,EonY9rxOz92zkguacFYNy9LDZUxPvKP6,5Gyp41oLVo7Gg7vF4vpmggWP5MU70QO6,9,6,4,3,2,0,2,0,17,2.4285714285714284,1,0.0,1,4,2,2,5,0,1,2,0,9,8,1
12804,181748,5BUswz1byqYFdKib2By2QrOXer7Jj6do,5Gyp41oLVo7Gg7vF4vpmggWP5MU70QO6,4,2,1,0,0,0,4,0,7,1.0,1,0.0,0,1,0,0,2,0,0,4,0,1,6,1
12805,181750,KGXFn1n0h5LwrdyZxyMenRRVTJ2x6Rjd,5Gyp41oLVo7Gg7vF4vpmggWP5MU70QO6,4,2,0,0,1,0,1,0,4,0.5714285714285714,1,0.0,0,0,0,1,2,0,0,1,0,1,3,1
12806,181762,NGkgB52eZIjL1l9fMcFvWPBwWPAe9rvH,5Gyp41oLVo7Gg7vF4vpmggWP5MU70QO6,7,6,4,0,1,0,2,0,13,1.8571428571428572,1,0.0,0,4,0,1,6,0,0,2,0,5,8,1
12807,181818,8uqydEYLMBuGG3VmuAAb8Fc8GUVVDVBb,5Gyp41oLVo7Gg7vF4vpmggWP5MU70QO6,7,3,2,0,2,0,2,0,9,1.2857142857142858,1,0.0,0,2,0,2,3,0,0,2,0,4,5,1
12808,181822,Ju2SQJE2BqRVGeDZMui7MZtceq6FlFez,5Gyp41oLVo7Gg7vF4vpmggWP5MU70QO6,6,1,1,0,1,0,3,0,6,0.8571428571428571,1,0.0,0,1,0,1,1,0,0,3,0,2,4,1
12809,181823,aDHCSq5YufHdEsMSuYYdrG98PaZ1BG7V,5Gyp41oLVo7Gg7vF4vpmggWP5MU70QO6,1,0,0,0,0,0,2,0,2,0.2857142857142857,1,0.0,0,0,0,0,0,0,0,2,0,0,2,1
12810,181832,F2CZ6Iyzsz2icKGcipaMSpZVmnUO4oC3,5Gyp41oLVo7Gg7vF4vpmggWP5MU70QO6,12,16,4,0,1,0,8,1,30,4.285714285714286,1,0.0,5,4,0,1,11,0,0,8,1,10,20,1
12811,181862,26Ci83ax9ggNzZ5zmbdpF3sLapFM1xLv,5Gyp41oLVo7Gg7vF4vpmggWP5MU70QO6,1,0,0,0,0,0,1,0,1,0.14285714285714285,1,0.0,0,0,0,0,0,0,0,1,0,0,1,1
12812,181868,CU3P6lJfWMkPlregl6AgalycBN1UXKCI,5Gyp41oLVo7Gg7vF4vpmggWP5MU70QO6,8,5,2,0,2,1,4,1,15,2.142857142857143,1,0.0,0,2,0,2,5,1,0,4,1,4,11,1
12813,181870,a1HLwBKYYR0WpSeS8QuvfBbxDgqGIB2F,5Gyp41oLVo7Gg7vF4vpmggWP5MU70QO6,1,0,0,0,0,0,2,0,2,0.2857142857142857,1,0.0,0,0,0,0,0,0,0,2,0,0,2,1
12814,181872,4Er7jyS82PpyIJ1GVZiHCRbQI0ysQvgx,5Gyp41oLVo7Gg7vF4vpmggWP5MU70QO6,14,17,8,6,2,19,11,2,65,9.285714285714286,1,0.0,7,8,4,2,10,19,2,11,2,21,44,1
12815,181878,mFn79ciJdfvDwevzTSoEVfLGV9PijzfL,5Gyp41oLVo7Gg7vF4vpmggWP5MU70QO6,4,2,1,0,1,0,1,0,5,0.7142857142857143,1,0.0,0,1,0,1,2,0,0,1,0,2,3,1
12816,181891,UnYWhkEUM28aufKl6iE422jz3645yuzl,5Gyp41oLVo7Gg7vF4vpmggWP5MU70QO6,1,0,0,0,0,0,1,0,1,0.14285714285714285,1,0.0,0,0,0,0,0,0,0,1,0,0,1,1
12817,181925,woOVTWY9QIEZxnUvH9kgVqMAANkeoDdW,5Gyp41oLVo7Gg7vF4vpmggWP5MU70QO6,1,0,0,0,0,0,1,0,1,0.14285714285714285,1,0.0,0,0,0,0,0,0,0,1,0,0,1,1
12818,181930,RdPbOoj1tSvRDq7tNhQTJcA4ojiLiLWa,5Gyp41oLVo7Gg7vF4vpmggWP5MU70QO6,13,21,9,9,7,0,2,0,48,6.857142857142857,2,0.0,5,9,6,7,16,0,3,2,0,27,21,1
12819,181944,paTMSyIYccWRvSekJsb5JXCiuZJwgllx,5Gyp41oLVo7Gg7vF4vpmggWP5MU70QO6,1,0,0,0,0,0,1,0,1,0.14285714285714285,1,0.0,0,0,0,0,0,0,0,1,0,0,1,1
12820,181951,zKuu0G4RnvAcXMNiMRIMiJEZsUKC7Le7,5Gyp41oLVo7Gg7vF4vpmggWP5MU70QO6,4,2,1,0,1,0,2,0,6,0.8571428571428571,1,0.0,0,1,0,1,2,0,0,2,0,2,4,1
12821,181968,HQ5tnzuUQ94xK6c7cghGoPyRlzEcu26K,5Gyp41oLVo7Gg7vF4vpmggWP5MU70QO6,7,3,2,0,2,0,3,0,10,1.4285714285714286,1,0.0,0,2,0,2,3,0,0,3,0,4,6,1
12822,181970,0pIqHSKuDCSg4zJWaYLKFpCLPhGoteyk,5Gyp41oLVo7Gg7vF4vpmggWP5MU70QO6,11,11,5,6,3,0,3,0,28,4.0,1,0.0,4,5,3,3,7,0,3,3,0,15,13,1
12823,181983,qvXX30e2GzSZOZjOYJYzckyY0LoUWSEL,5Gyp41oLVo7Gg7vF4vpmggWP5MU70QO6,9,8,2,0,2,1,5,1,19,2.7142857142857144,1,0.0,5,2,0,2,3,1,0,5,1,9,10,1
12824,181985,Doz9EqVz2rDPpnfDU5uayT06yOJEViYw,5Gyp41oLVo7Gg7vF4vpmggWP5MU70QO6,8,3,2,0,2,1,5,0,13,1.8571428571428572,1,0.0,0,2,0,2,3,1,0,5,0,4,9,1
12825,181988,KKt1JC1nzbMVlXS5edz6S15kzLg0gQOL,5Gyp41oLVo7Gg7vF4vpmggWP5MU70QO6,2,0,0,0,0,0,2,0,2,0.2857142857142857,1,0.0,0,0,0,0,0,0,0,2,0,0,2,1
12826,182031,gcBrw9IbRpVyrCuK81SDliRBWaiEwt3S,5Gyp41oLVo7Gg7vF4vpmggWP5MU70QO6,1,0,0,0,0,0,1,0,1,0.14285714285714285,1,0.0,0,0,0,0,0,0,0,1,0,0,1,1
12827,182039,Q9kdHcV1kbonm0KnIW9OSERwU5lfVZ8s,5Gyp41oLVo7Gg7vF4vpmggWP5MU70QO6,6,6,2,0,3,0,1,0,12,1.7142857142857142,1,0.0,1,2,0,3,5,0,0,1,0,6,6,1
12828,182050,VKQwP2UGxFr8cW02yW69JgEmp944MwNR,5Gyp41oLVo7Gg7vF4vpmggWP5MU70QO6,1,0,0,0,0,0,1,0,1,0.14285714285714285,1,0.0,0,0,0,0,0,0,0,1,0,0,1,1
12829,182070,1YSmilr2ajm5pFk4iAawwfB3mRapy4GR,5Gyp41oLVo7Gg7vF4vpmggWP5MU70QO6,4,4,2,0,2,0,1,0,9,1.2857142857142858,1,0.0,0,2,0,2,4,0,0,1,0,4,5,1
12830,182072,FfUXMT7mZqZTunyhx99wOtQUuUI4jlLj,5Gyp41oLVo7Gg7vF4vpmggWP5MU70QO6,7,5,2,0,4,0,1,0,12,1.7142857142857142,1,0.0,1,2,0,4,4,0,0,1,0,7,5,1
12831,182075,QVjEwhKJ4IaQVAen5cqn3R8peuziaXvN,5Gyp41oLVo7Gg7vF4vpmggWP5MU70QO6,4,2,0,0,0,0,2,0,4,0.5714285714285714,1,0.0,0,0,0,0,2,0,0,2,0,0,4,1
12832,182084,XZQ1LXoj3dsDPYD030v9JTWJcyoUhfK4,5Gyp41oLVo7Gg7vF4vpmggWP5MU70QO6,10,5,3,0,1,2,7,1,19,2.7142857142857144,2,0.0,0,3,0,1,5,2,0,7,1,4,15,1
12833,182088,w9Op2paOObvbeexRevdwj22JnTTWTNbu,5Gyp41oLVo7Gg7vF4vpmggWP5MU70QO6,10,5,4,0,2,0,5,1,17,2.4285714285714284,1,0.0,0,4,0,2,5,0,0,5,1,6,11,1
12834,182094,3URMlJ8WFfbFx3SvBMPqUCA5oJqCky66,5Gyp41oLVo7Gg7vF4vpmggWP5MU70QO6,8,6,4,4,1,0,1,0,16,2.2857142857142856,1,0.0,1,4,2,1,5,0,2,1,0,8,8,0
12835,182097,I7kDXvBJVlkmv06VEWaRnFxAqKlFNhUE,5Gyp41oLVo7Gg7vF4vpmggWP5MU70QO6,4,2,1,0,1,0,2,0,6,0.8571428571428571,1,0.0,0,1,0,1,2,0,0,2,0,2,4,1
12836,182110,74kxele4p3nZqMdSzyWOOH2cXxk0mF2n,fbPkOYLVPtPgIt0MxizjfFJov3JbHyAi,7,5,2,0,3,0,5,0,15,2.142857142857143,1,0.0,2,2,0,3,3,0,0,5,0,7,8,1
12837,182111,1RfSO2DiyVK1bsd1s7TaxenvqJaPeVpp,fbPkOYLVPtPgIt0MxizjfFJov3JbHyAi,5,2,1,0,1,0,3,0,7,1.0,1,0.0,0,1,0,1,2,0,0,3,0,2,5,1
12838,182114,FIhbLaUliLEAJsxsc7jKlH4XCeC9DPXv,fbPkOYLVPtPgIt0MxizjfFJov3JbHyAi,10,5,4,0,3,0,7,1,20,2.857142857142857,1,0.0,0,4,0,3,5,0,0,7,1,7,13,1
12839,182115,5O3cQgHyrDFUqJDA7J5HOtUVaVPsBSzt,fbPkOYLVPtPgIt0MxizjfFJov3JbHyAi,6,5,2,0,2,0,1,0,10,1.4285714285714286,1,0.0,0,2,0,2,5,0,0,1,0,4,6,1
12840,182117,17rg9STHXDHiRzS91SaQJyD9M8yu2605,fbPkOYLVPtPgIt0MxizjfFJov3JbHyAi,14,10,5,7,6,0,6,0,34,4.857142857142857,1,0.0,4,5,6,6,6,0,1,6,0,21,13,1
12841,182118,ytQygmlMNZc9yKIahmW7Nv1t8JgEizoV,fbPkOYLVPtPgIt0MxizjfFJov3JbHyAi,2,0,0,0,0,0,2,0,2,0.2857142857142857,1,0.0,0,0,0,0,0,0,0,2,0,0,2,1
12842,182124,sIANk8CDDpmYWYdg4Th4BflYvOf56CEK,fbPkOYLVPtPgIt0MxizjfFJov3JbHyAi,6,5,1,0,2,0,2,0,10,1.4285714285714286,1,0.0,2,1,0,2,3,0,0,2,0,5,5,1
12843,182125,aDT6m9laxK2gk5mLuphqqVgMaj2Iqzzo,fbPkOYLVPtPgIt0MxizjfFJov3JbHyAi,1,0,0,0,0,0,1,0,1,0.14285714285714285,1,0.0,0,0,0,0,0,0,0,1,0,0,1,1
12844,182128,FgihPmscVblrwMVdNFApI0UuOBmm5ZAb,fbPkOYLVPtPgIt0MxizjfFJov3JbHyAi,1,0,0,0,0,0,1,0,1,0.14285714285714285,1,0.0,0,0,0,0,0,0,0,1,0,0,1,1
12845,182134,NZSWYEaOe1aGzYbLbh5XgSdJLgnj2k8M,fbPkOYLVPtPgIt0MxizjfFJov3JbHyAi,7,3,2,0,2,0,10,0,17,2.4285714285714284,1,0.0,0,2,0,2,3,0,0,10,0,4,13,1
12846,182135,iejOj5OrmiAxzthyfxCU4HfOTTqB4wPz,fbPkOYLVPtPgIt0MxizjfFJov3JbHyAi,6,3,2,0,1,0,3,0,9,1.2857142857142858,1,0.0,0,2,0,1,3,0,0,3,0,3,6,1
12847,182138,QLWeBu2uxsDdky4Sdm2eq1MPlPyoR8PH,fbPkOYLVPtPgIt0MxizjfFJov3JbHyAi,2,0,0,0,0,0,8,0,8,1.1428571428571428,1,0.0,0,0,0,0,0,0,0,8,0,0,8,1
12848,182139,zlBC6rRu9jlWaXBFQagY5lGC2179zznK,fbPkOYLVPtPgIt0MxizjfFJov3JbHyAi,9,4,3,0,3,8,13,0,31,4.428571428571429,1,0.0,0,3,0,3,4,8,0,13,0,6,25,1
12849,182143,dX17jSABXDRMoXQfnDhuEq3sAW2GzYho,fbPkOYLVPtPgIt0MxizjfFJov3JbHyAi,6,1,1,0,1,0,5,0,8,1.1428571428571428,1,0.0,0,1,0,1,1,0,0,5,0,2,6,1
12850,182144,65phBvShfMs4BgpXceOfsAexAndxdKUb,fbPkOYLVPtPgIt0MxizjfFJov3JbHyAi,8,5,3,0,2,0,3,0,13,1.8571428571428572,1,0.0,0,3,0,2,5,0,0,3,0,5,8,1
12851,182145,s9ikAKfIHizdIit72lZmNDpOCL8RyNmr,fbPkOYLVPtPgIt0MxizjfFJov3JbHyAi,1,0,0,0,0,0,1,0,1,0.14285714285714285,1,0.0,0,0,0,0,0,0,0,1,0,0,1,1
12852,182146,je4a6LCViJiZST1Qe1r42SwknRjAiEHX,fbPkOYLVPtPgIt0MxizjfFJov3JbHyAi,9,6,4,0,3,2,7,0,22,3.142857142857143,1,0.0,0,4,0,3,6,2,0,7,0,7,15,1
12853,182147,w6ZOM4xdCTA9pBKt304kiLQIHLSshQf0,fbPkOYLVPtPgIt0MxizjfFJov3JbHyAi,9,4,3,0,3,0,5,0,15,2.142857142857143,1,0.0,0,3,0,3,4,0,0,5,0,6,9,1
12854,182152,eXbUPJJ8vgGBYCYeE2hEC0aNbKdSDbEs,fbPkOYLVPtPgIt0MxizjfFJov3JbHyAi,1,0,0,0,0,0,1,0,1,0.14285714285714285,1,0.0,0,0,0,0,0,0,0,1,0,0,1,1
12855,182154,0TrmohedmafnRfHAroMKgKRtGWbbpH4N,fbPkOYLVPtPgIt0MxizjfFJov3JbHyAi,2,0,0,0,0,0,6,0,6,0.8571428571428571,1,0.0,0,0,0,0,0,0,0,6,0,0,6,1
12856,182155,BoBgrmtQAbGEQdCkYjgMVVWzk508tw3x,fbPkOYLVPtPgIt0MxizjfFJov3JbHyAi,4,2,1,0,1,0,1,0,5,0.7142857142857143,1,0.0,0,1,0,1,2,0,0,1,0,2,3,1
12857,182156,DLmLcsmmZc2iMAWHNtxeaYm4TYub9M4W,fbPkOYLVPtPgIt0MxizjfFJov3JbHyAi,1,0,0,0,0,0,1,0,1,0.14285714285714285,1,0.0,0,0,0,0,0,0,0,1,0,0,1,1
12858,182159,ntaJKTMgiTQfD5Tbv9HcsBpNugCaYi0b,fbPkOYLVPtPgIt0MxizjfFJov3JbHyAi,1,0,0,0,0,0,2,0,2,0.2857142857142857,1,0.0,0,0,0,0,0,0,0,2,0,0,2,1
12859,182160,wKSiPD3ccCI47tDYWhx56Wd2BJP8ki2L,fbPkOYLVPtPgIt0MxizjfFJov3JbHyAi,9,7,3,0,3,5,4,1,23,3.2857142857142856,1,0.0,2,3,0,3,5,5,0,4,1,8,15,1
12860,182162,itIzAmwxr6fy2yhmRnAPbRxBE6DJmsTD,fbPkOYLVPtPgIt0MxizjfFJov3JbHyAi,23,27,14,17,15,0,2,0,75,10.714285714285714,1,0.0,12,14,14,15,15,0,3,2,0,55,20,1
12861,182194,csxsIreB4z2fEbPvSHNv03dBFq18io5H,3VkHkmOtom3jM2wCu94xgzzu1d6Dn7or,1,0,0,0,0,0,1,0,1,0.14285714285714285,1,0.0,0,0,0,0,0,0,0,1,0,0,1,1
12862,182195,0DzldTHKdoH90kklIAjpWyAEe6XDDjyM,3VkHkmOtom3jM2wCu94xgzzu1d6Dn7or,2,0,0,0,0,0,2,0,2,0.2857142857142857,1,0.0,0,0,0,0,0,0,0,2,0,0,2,1
12863,182198,fjRMOtvjigMsGnlSnPUPaprtvPnBtbuW,3VkHkmOtom3jM2wCu94xgzzu1d6Dn7or,9,13,3,0,4,6,9,1,36,5.142857142857143,1,0.0,3,3,0,4,10,6,0,9,1,10,26,1
12864,182205,bTczPD51Suiv53Xy2FmFzTweP9qA2PXP,3VkHkmOtom3jM2wCu94xgzzu1d6Dn7or,6,6,3,0,2,0,5,0,16,2.2857142857142856,1,0.0,0,3,0,2,6,0,0,5,0,5,11,1
12865,182209,fN5vmNHpVQShrSJGsQfUHVmKVlpKBGSR,3VkHkmOtom3jM2wCu94xgzzu1d6Dn7or,1,0,0,0,0,0,1,0,1,0.14285714285714285,1,0.0,0,0,0,0,0,0,0,1,0,0,1,1
12866,182220,kh2vzlwluJq9JmVuODuzJ0gIlWmSWoqB,3VkHkmOtom3jM2wCu94xgzzu1d6Dn7or,6,13,6,0,0,2,2,0,23,3.2857142857142856,1,0.0,0,6,0,0,13,2,0,2,0,6,17,1
12867,182227,cHLzyoSNKubGg47lLtnMJYW3dvB9xzcx,3VkHkmOtom3jM2wCu94xgzzu1d6Dn7or,7,5,2,0,1,2,7,0,17,2.4285714285714284,1,0.0,1,2,0,1,4,2,0,7,0,4,13,1
12868,182230,0IVbCZxyYgDvtApqm5aKQEhPY2ayA5sy,3VkHkmOtom3jM2wCu94xgzzu1d6Dn7or,5,2,0,0,0,1,5,0,8,1.1428571428571428,1,0.0,0,0,0,0,2,1,0,5,0,0,8,0
12869,182232,VfHC2SKhHbKGj4ZnO1yfFM7GCtKBBAcC,3VkHkmOtom3jM2wCu94xgzzu1d6Dn7or,1,0,0,0,0,0,2,0,2,0.2857142857142857,1,0.0,0,0,0,0,0,0,0,2,0,0,2,1
12870,182233,jwgcgdUXLu2gXFgpv8mLrXcrkYyNakoU,3VkHkmOtom3jM2wCu94xgzzu1d6Dn7or,6,0,0,0,0,3,8,2,13,1.8571428571428572,1,0.0,0,0,0,0,0,3,0,8,2,0,13,1
12871,182234,Ckbaflkb87MSikjOjkyAMqpueoAF2UNu,3VkHkmOtom3jM2wCu94xgzzu1d6Dn7or,6,3,2,0,2,0,1,0,8,1.1428571428571428,1,0.0,0,2,0,2,3,0,0,1,0,4,4,1
12872,182236,yWtKP7X5IakNbcOVZXYdks1Jj5UCg7ph,3VkHkmOtom3jM2wCu94xgzzu1d6Dn7or,7,2,1,0,1,0,6,2,12,1.7142857142857142,1,0.0,0,1,0,1,2,0,0,6,2,2,10,1
12873,182242,u6YQGD67yzQraOCkQvpFkxe73vsSHBNh,3VkHkmOtom3jM2wCu94xgzzu1d6Dn7or,1,0,0,0,0,0,2,0,2,0.2857142857142857,1,0.0,0,0,0,0,0,0,0,2,0,0,2,1
12874,182244,YwOmwhLK2jRByqckCXHjjfeOrEZhOyRH,3VkHkmOtom3jM2wCu94xgzzu1d6Dn7or,11,13,7,0,4,0,14,2,40,5.714285714285714,1,0.0,0,7,0,4,13,0,0,14,2,11,29,1
12875,182252,gok0oMg5xY1pC9HgrOtGpZy6NUwXLxlf,3VkHkmOtom3jM2wCu94xgzzu1d6Dn7or,4,0,0,0,0,0,4,0,4,0.5714285714285714,1,0.0,0,0,0,0,0,0,0,4,0,0,4,0
12876,182255,eWbah1mPfqGGn0g78J9fkAub7UxJt3bI,3VkHkmOtom3jM2wCu94xgzzu1d6Dn7or,5,2,1,0,1,0,3,0,7,1.0,1,0.0,0,1,0,1,2,0,0,3,0,2,5,1
12877,182258,P4QefYxxQlboHx5mmTzC7fQ3zDmvVItg,3VkHkmOtom3jM2wCu94xgzzu1d6Dn7or,9,15,1,0,2,0,8,1,27,3.857142857142857,1,0.0,2,1,0,2,13,0,0,8,1,5,22,1
12878,182261,QhGVkY0v83zB7Ydq0uVaVQ4ZFO6GOJw4,3VkHkmOtom3jM2wCu94xgzzu1d6Dn7or,2,0,0,0,0,0,4,0,4,0.5714285714285714,1,0.0,0,0,0,0,0,0,0,4,0,0,4,1
12879,182270,1BBLLCnuLnP5mi368OTjrHinvVTwPvbC,3VkHkmOtom3jM2wCu94xgzzu1d6Dn7or,4,2,1,0,1,0,1,0,5,0.7142857142857143,1,0.0,0,1,0,1,2,0,0,1,0,2,3,1
12880,182271,2fqSxqAVilSfIg4sQ6fD6J1JY6ZshTCe,3VkHkmOtom3jM2wCu94xgzzu1d6Dn7or,1,0,0,0,0,0,3,0,3,0.42857142857142855,1,0.0,0,0,0,0,0,0,0,3,0,0,3,1
12881,182276,JwpnWAbXqqokshNbyxBH2QHaOUPb8wrj,3VkHkmOtom3jM2wCu94xgzzu1d6Dn7or,8,4,3,0,3,0,1,0,11,1.5714285714285714,1,0.0,0,3,0,3,4,0,0,1,0,6,5,1
12882,182282,JuasymbBrE2UlWNEAFWaoRL2BZwC7SNr,3VkHkmOtom3jM2wCu94xgzzu1d6Dn7or,11,7,4,0,3,0,5,0,19,2.7142857142857144,1,0.0,0,4,0,3,7,0,0,5,0,7,12,1
12883,182283,EtDvowReST2EpXduL96uQJrkBnjRSfnj,3VkHkmOtom3jM2wCu94xgzzu1d6Dn7or,7,4,1,0,0,0,11,2,18,2.5714285714285716,1,0.0,0,1,0,0,4,0,0,11,2,1,17,1
12884,182288,e8fSlTZ73gVJQ2o5lZEoqxY5iG8EDdMh,3VkHkmOtom3jM2wCu94xgzzu1d6Dn7or,13,23,4,0,2,0,6,0,35,5.0,1,0.0,0,4,0,2,23,0,0,6,0,6,29,1
12885,182318,dVj05AozpSMnDp2rhv4XKLX2a6Zq0Qtw,SpATywNh6bZuzm8s1ceuBUnMUAeoAHHw,2,0,0,0,0,0,2,0,2,0.2857142857142857,1,0.0,0,0,0,0,0,0,0,2,0,0,2,1
12886,182332,ssNBIPbMZoiJEHlxM1JuEFEFm67Micu2,SpATywNh6bZuzm8s1ceuBUnMUAeoAHHw,6,2,0,0,0,4,14,6,26,3.7142857142857144,1,0.0,0,0,0,0,2,4,0,14,6,0,26,1
12887,182346,yuwVVMBtTYqYgFk8HBT2CeCSsbPznS4I,SpATywNh6bZuzm8s1ceuBUnMUAeoAHHw,6,8,1,0,1,4,6,0,20,2.857142857142857,2,0.0,0,1,0,1,8,4,0,6,0,2,18,1
12888,182375,L7M3Ksh9UBx3xOMl31gqtqz6gfclvqlN,SpATywNh6bZuzm8s1ceuBUnMUAeoAHHw,7,11,4,0,1,1,6,0,23,3.2857142857142856,3,0.0,0,4,0,1,11,1,0,6,0,5,18,1
12889,182376,QlyEMMfomXdFJCE0WvpazQe9ZaXY0FQw,SpATywNh6bZuzm8s1ceuBUnMUAeoAHHw,1,0,0,0,0,0,2,0,2,0.2857142857142857,1,0.0,0,0,0,0,0,0,0,2,0,0,2,1
12890,182379,JdJ1SwT93OWgPbpS5GdJzD3RLASaE4SR,RXDvfPUBYFlVdlueBFbLW0mhhAyGEqpt,22,14,10,44,7,0,1,0,76,10.857142857142858,1,0.0,3,10,40,7,11,0,4,1,0,60,16,1
12891,182384,ORzIK1DF1vIanXrZDWEgyHCiC4GvvfBc,SpATywNh6bZuzm8s1ceuBUnMUAeoAHHw,4,3,1,0,1,0,3,0,8,1.1428571428571428,1,0.0,0,1,0,1,3,0,0,3,0,2,6,1
12892,182391,UoSDdKW8bXtB0Kuj20V0r0Rw6UViB6yh,SpATywNh6bZuzm8s1ceuBUnMUAeoAHHw,5,1,0,0,0,2,7,1,11,1.5714285714285714,1,0.0,0,0,0,0,1,2,0,7,1,0,11,1
12893,182394,0f1EqzZzcXc3MSIWeoaoeCrrqcxrvxwo,bWdj2GDclj5ofokWjzoa5jAwMkxCykd6,2,0,0,0,0,0,2,0,2,0.2857142857142857,1,0.0,0,0,0,0,0,0,0,2,0,0,2,1
12894,182395,pvxjw4szSuluDWQ3DWPes9Mzs1MCvxjI,G8EPVSXsOYB5YQWZGiz1aVq5Pgr2GrQu,6,3,2,0,2,0,1,0,8,1.1428571428571428,1,0.0,0,2,0,2,3,0,0,1,0,4,4,1
12895,182399,vheHPiBs6HjJGbv3Snt0SQIKMYHc5UaU,SpATywNh6bZuzm8s1ceuBUnMUAeoAHHw,3,2,1,0,0,0,1,0,4,0.5714285714285714,1,0.0,0,1,0,0,2,0,0,1,0,1,3,1
12896,182402,UdmIlH1y5ROywT4Ry6jaou64JO5vWiAz,RXDvfPUBYFlVdlueBFbLW0mhhAyGEqpt,1,0,0,0,0,0,1,0,1,0.14285714285714285,1,0.0,0,0,0,0,0,0,0,1,0,0,1,1
12897,182403,ED2sXONkBYI0OZyQYOJ9ygAn9aUKK1Wk,SpATywNh6bZuzm8s1ceuBUnMUAeoAHHw,11,11,6,0,3,4,4,1,29,4.142857142857143,1,0.0,3,6,0,3,8,4,0,4,1,12,17,1
12898,182404,zfXJRVQB9jP4gtyolibVkLvC6I4sMq4Z,SpATywNh6bZuzm8s1ceuBUnMUAeoAHHw,13,9,7,0,3,1,6,1,27,3.857142857142857,1,0.0,0,7,0,3,9,1,0,6,1,10,17,1
12899,182416,Efp2zT9GZ53ahT7m5PosJWOFPjhn8JqA,SpATywNh6bZuzm8s1ceuBUnMUAeoAHHw,1,0,0,0,0,0,1,0,1,0.14285714285714285,1,0.0,0,0,0,0,0,0,0,1,0,0,1,1
12900,182417,4PtDSHhkS4yeMTirE5mvkBBwP3dmM9Qp,SpATywNh6bZuzm8s1ceuBUnMUAeoAHHw,9,8,1,8,0,0,1,0,18,2.5714285714285716,1,0.0,3,1,8,0,5,0,0,1,0,12,6,1
12901,182419,x22fjNSFy0R926MDZKZwS7I3gfP8Gm84,SpATywNh6bZuzm8s1ceuBUnMUAeoAHHw,7,3,2,0,2,0,4,0,11,1.5714285714285714,1,0.0,0,2,0,2,3,0,0,4,0,4,7,1
12902,182420,pYlHnfVkpsPzITBRcvdTXUYMyNXMgg3O,SpATywNh6bZuzm8s1ceuBUnMUAeoAHHw,1,0,0,0,0,0,1,0,1,0.14285714285714285,1,0.0,0,0,0,0,0,0,0,1,0,0,1,1
12903,182427,cZXuWsaeYW0DT1jWDe6bxRqc9qfzrr3C,SpATywNh6bZuzm8s1ceuBUnMUAeoAHHw,5,3,1,0,1,4,3,0,12,1.7142857142857142,1,0.0,0,1,0,1,3,4,0,3,0,2,10,1
12904,182430,3Gc9QM94u4cd0Dw8TEKRCkl8s35hHWXM,SpATywNh6bZuzm8s1ceuBUnMUAeoAHHw,9,4,3,0,3,0,2,0,12,1.7142857142857142,1,0.0,0,3,0,3,4,0,0,2,0,6,6,1
12905,182436,UvIGBO3KU0rWCndAPFCCP6wfS7NUy3B1,SpATywNh6bZuzm8s1ceuBUnMUAeoAHHw,2,0,0,0,0,0,3,0,3,0.42857142857142855,1,0.0,0,0,0,0,0,0,0,3,0,0,3,1
12906,182439,Ilz4MVKb2TGAxWTIiq19EE5elYfPlhdl,SpATywNh6bZuzm8s1ceuBUnMUAeoAHHw,9,6,4,0,3,0,5,0,18,2.5714285714285716,1,0.0,0,4,0,3,6,0,0,5,0,7,11,1
12907,182441,vaWLVKWyrsUzDV0qs20ZUq8M3VNW01Uk,RXDvfPUBYFlVdlueBFbLW0mhhAyGEqpt,1,0,0,0,0,0,1,0,1,0.14285714285714285,1,0.0,0,0,0,0,0,0,0,1,0,0,1,1
12908,182444,SPRinDndbzCEO5Ph1nH3gJGoP1uaeA7R,G8EPVSXsOYB5YQWZGiz1aVq5Pgr2GrQu,1,0,0,0,0,0,1,0,1,0.14285714285714285,1,0.0,0,0,0,0,0,0,0,1,0,0,1,1
12909,182445,Ww3MvCXkT8tDnrpdz1E1wBxJBjpXj1Rq,SpATywNh6bZuzm8s1ceuBUnMUAeoAHHw,5,2,1,0,1,0,2,0,6,0.8571428571428571,1,0.0,0,1,0,1,2,0,0,2,0,2,4,1
12910,182448,hFzrRa1GPtD5a7H30wae91F5SOZlRQO1,SpATywNh6bZuzm8s1ceuBUnMUAeoAHHw,9,8,1,0,0,2,6,1,18,2.5714285714285716,1,0.0,0,1,0,0,8,2,0,6,1,1,17,1
12911,182450,8NJMmSdWvECNT7Pwfk6FLAypMClX0z5v,SpATywNh6bZuzm8s1ceuBUnMUAeoAHHw,4,2,1,0,0,0,2,0,5,0.7142857142857143,1,0.0,0,1,0,0,2,0,0,2,0,1,4,1
12912,182453,8ZePp5sXciCV5oXPjTIQbWFxt1SxfcLl,SpATywNh6bZuzm8s1ceuBUnMUAeoAHHw,10,3,2,0,2,2,5,1,15,2.142857142857143,1,0.0,0,2,0,2,3,2,0,5,1,4,11,1
12913,182466,FYh1ETHUxyunx6o3SR9eAC4QbrxXPzoc,RXDvfPUBYFlVdlueBFbLW0mhhAyGEqpt,8,7,3,0,2,0,3,0,15,2.142857142857143,1,0.0,0,3,0,2,7,0,0,3,0,5,10,1
12914,182470,YITGGXKhxzNHdElox232lzcaZdJ61YFn,bWdj2GDclj5ofokWjzoa5jAwMkxCykd6,5,2,1,0,1,3,3,0,10,1.4285714285714286,1,0.0,0,1,0,1,2,3,0,3,0,2,8,1
12915,182472,BeFe1KokGOrbanlGLijG18LEqInxi9W4,RXDvfPUBYFlVdlueBFbLW0mhhAyGEqpt,1,0,0,0,0,0,1,0,1,0.14285714285714285,1,0.0,0,0,0,0,0,0,0,1,0,0,1,1
12916,182476,ryyeh5DB53zHNKeo2vkO5VPfDAHRLLxK,SpATywNh6bZuzm8s1ceuBUnMUAeoAHHw,5,4,0,0,0,0,2,0,6,0.8571428571428571,1,0.0,0,0,0,0,4,0,0,2,0,0,6,1
12917,182478,ywCBITW2Nk5KrEWUjIfEEyRW364OA7v3,SpATywNh6bZuzm8s1ceuBUnMUAeoAHHw,7,4,2,0,0,0,4,0,10,1.4285714285714286,1,0.0,0,2,0,0,4,0,0,4,0,2,8,1
12918,182483,Wm4boeiuAufaIeI7PkgbnseZNqzvwXoA,RXDvfPUBYFlVdlueBFbLW0mhhAyGEqpt,1,0,0,0,0,0,1,0,1,0.14285714285714285,1,0.0,0,0,0,0,0,0,0,1,0,0,1,1
12919,182484,nJFL4ZgVlk8vsvSCMEvmMvfyFCPNkQbb,bWdj2GDclj5ofokWjzoa5jAwMkxCykd6,2,0,0,0,0,0,2,0,2,0.2857142857142857,1,0.0,0,0,0,0,0,0,0,2,0,0,2,1
12920,182490,5kux74rVeqoEvbABYMpdIOO6ta3zLim7,bWdj2GDclj5ofokWjzoa5jAwMkxCykd6,3,2,1,0,0,0,1,0,4,0.5714285714285714,1,0.0,0,1,0,0,2,0,0,1,0,1,3,1
12921,182491,HxeyM7hnjqqrHkT4PVJnwDZtWwoxUMiy,RXDvfPUBYFlVdlueBFbLW0mhhAyGEqpt,1,0,0,0,0,0,1,0,1,0.14285714285714285,1,0.0,0,0,0,0,0,0,0,1,0,0,1,1
12922,182496,FWAi9SzUY3hC5pRVyJkleZ3oNtaFNi6V,SpATywNh6bZuzm8s1ceuBUnMUAeoAHHw,2,0,0,0,0,0,2,0,2,0.2857142857142857,1,0.0,0,0,0,0,0,0,0,2,0,0,2,1
12923,182497,zsHSwvXoubMUxhT2AYVzfcvRGMppEBUX,G8EPVSXsOYB5YQWZGiz1aVq5Pgr2GrQu,1,0,0,0,0,0,1,0,1,0.14285714285714285,1,0.0,0,0,0,0,0,0,0,1,0,0,1,1
12924,182499,9bY2ODFG0JcDRpzNxe1p1poGx2Xx1OUa,SpATywNh6bZuzm8s1ceuBUnMUAeoAHHw,6,6,0,0,0,0,4,0,10,1.4285714285714286,1,0.0,0,0,0,0,6,0,0,4,0,0,10,1
12925,182508,e3jS2U1BhNpArENK983B1rVL1JoqwREV,SpATywNh6bZuzm8s1ceuBUnMUAeoAHHw,8,6,3,0,3,0,1,0,13,1.8571428571428572,1,0.0,0,3,0,3,6,0,0,1,0,6,7,1
12926,182515,oElQ0NJpFnzZRtGV3YErd6rr4i8DxzbB,SpATywNh6bZuzm8s1ceuBUnMUAeoAHHw,6,4,2,0,1,0,2,0,9,1.2857142857142858,1,0.0,0,2,0,1,4,0,0,2,0,3,6,1
12927,182524,IKXwL3bDtlAxjRP4WWhZczJlcbIhG3ib,G8EPVSXsOYB5YQWZGiz1aVq5Pgr2GrQu,9,7,5,0,4,1,6,1,24,3.4285714285714284,1,0.0,0,5,0,4,7,1,0,6,1,9,15,1
12928,182527,QoLZveDbZCrcOypIzCYKhgphRVMR37f0,SpATywNh6bZuzm8s1ceuBUnMUAeoAHHw,7,11,5,0,3,0,5,0,24,3.4285714285714284,1,0.0,2,5,0,3,9,0,0,5,0,10,14,1
12929,182540,68zow3PIETzGkbgKSgGqp4cft1zzT0Wg,SpATywNh6bZuzm8s1ceuBUnMUAeoAHHw,15,29,13,18,5,23,11,0,99,14.142857142857142,2,0.0,6,13,15,5,23,23,3,11,0,39,60,1
12930,182548,1wTTPpSWNZRGQY72YsG9M4kDyp3wXVIX,SpATywNh6bZuzm8s1ceuBUnMUAeoAHHw,9,4,0,3,0,0,5,2,14,2.0,1,0.0,1,0,3,0,3,0,0,5,2,4,10,1
12931,182552,ykEW9evpDPHZbB36kn5ppyB9XHnMY2SE,bWdj2GDclj5ofokWjzoa5jAwMkxCykd6,4,2,1,0,0,0,2,0,5,0.7142857142857143,1,0.0,0,1,0,0,2,0,0,2,0,1,4,1
12932,182556,0dYUj8IzWWp9WKVei3srYo9Z7019GkyS,SpATywNh6bZuzm8s1ceuBUnMUAeoAHHw,6,2,1,0,1,0,3,0,7,1.0,1,0.0,0,1,0,1,2,0,0,3,0,2,5,1
12933,182565,BtOoPJiqJpi7FXEZFIq8NLvECwNXeaZ8,SpATywNh6bZuzm8s1ceuBUnMUAeoAHHw,6,1,1,0,1,0,3,0,6,0.8571428571428571,1,0.0,0,1,0,1,1,0,0,3,0,2,4,1
12934,182572,L3vH8w9MBmyNbE6zYIQcQAgtUd2AVGJ2,bWdj2GDclj5ofokWjzoa5jAwMkxCykd6,2,0,0,0,0,0,2,0,2,0.2857142857142857,1,0.0,0,0,0,0,0,0,0,2,0,0,2,1
12935,182574,9HtqmGFwW9nlaXQoPiq8Q0exBzv6okJA,SpATywNh6bZuzm8s1ceuBUnMUAeoAHHw,6,2,1,0,1,0,10,0,14,2.0,1,0.0,0,1,0,1,2,0,0,10,0,2,12,1
12936,182583,67xpG0g0SaNRrqSFMK3Slz5FQV4uaOHQ,SpATywNh6bZuzm8s1ceuBUnMUAeoAHHw,7,2,1,0,1,0,4,2,10,1.4285714285714286,1,0.0,0,1,0,1,2,0,0,4,2,2,8,1
12937,182590,AgVRfkL9ddoBcgWiMEqgB28oDseRQMfR,G8EPVSXsOYB5YQWZGiz1aVq5Pgr2GrQu,7,10,0,0,0,0,2,0,12,1.7142857142857142,1,0.0,1,0,0,0,9,0,0,2,0,1,11,1
12938,182592,o8FE9F7Hj949CAE87fPDQyCYZ9zgH4qv,SpATywNh6bZuzm8s1ceuBUnMUAeoAHHw,1,0,0,0,0,0,1,0,1,0.14285714285714285,1,0.0,0,0,0,0,0,0,0,1,0,0,1,1
12939,182593,MV8XdB3h6ePuBNN3BGaZCvIfimFFX0Mk,SpATywNh6bZuzm8s1ceuBUnMUAeoAHHw,1,0,0,0,0,0,1,0,1,0.14285714285714285,1,0.0,0,0,0,0,0,0,0,1,0,0,1,1
12940,182595,iQCW6W4nBE7M3nPE1JFW3uJTussgN79A,SpATywNh6bZuzm8s1ceuBUnMUAeoAHHw,7,2,1,0,1,0,5,1,10,1.4285714285714286,1,0.0,0,1,0,1,2,0,0,5,1,2,8,1
12941,182596,i1weaEaafaiWi31Ms4bwoF6JM4IRf714,G8EPVSXsOYB5YQWZGiz1aVq5Pgr2GrQu,14,27,11,20,7,0,2,0,67,9.571428571428571,1,0.0,14,11,11,7,13,0,9,2,0,43,24,1
12942,182599,C82stxYBdobab5s8FnzuMHxgMBwKu2tD,SpATywNh6bZuzm8s1ceuBUnMUAeoAHHw,3,2,0,0,0,0,2,0,4,0.5714285714285714,1,0.0,0,0,0,0,2,0,0,2,0,0,4,1
12943,182602,pC6FwYDHxh9swUa6nvJYcLLtE0AYC1Cg,bWdj2GDclj5ofokWjzoa5jAwMkxCykd6,1,0,0,0,0,0,1,0,1,0.14285714285714285,1,0.0,0,0,0,0,0,0,0,1,0,0,1,1
12944,182604,YYm9SLmjJQnTtFQLnNCxEK5OKVRWWeS9,SpATywNh6bZuzm8s1ceuBUnMUAeoAHHw,7,7,3,0,3,1,2,0,16,2.2857142857142856,1,0.0,0,3,0,3,7,1,0,2,0,6,10,1
12945,182610,VR4kpCHjSnr2YglEgcuTrivL0Gg47pGL,SpATywNh6bZuzm8s1ceuBUnMUAeoAHHw,13,15,7,18,5,0,2,0,47,6.714285714285714,1,0.0,6,7,15,5,9,0,3,2,0,33,14,1
12946,182611,WtbenHJvVPK6SiW3psJUnjqNlshJ00ku,SpATywNh6bZuzm8s1ceuBUnMUAeoAHHw,9,5,0,0,0,1,5,1,12,1.7142857142857142,1,0.0,0,0,0,0,5,1,0,5,1,0,12,1
12947,182614,UuSIoFbtQOfzMmWUxokidkbXgJFaHXwx,bWdj2GDclj5ofokWjzoa5jAwMkxCykd6,1,0,0,0,0,0,1,0,1,0.14285714285714285,1,0.0,0,0,0,0,0,0,0,1,0,0,1,1
12948,182623,Vqh7IxciNu3w4ryq9DwYRMQWb1h8f16V,G8EPVSXsOYB5YQWZGiz1aVq5Pgr2GrQu,11,13,7,0,4,19,5,0,48,6.857142857142857,1,0.0,0,7,0,4,13,19,0,5,0,11,37,1
12949,182626,1P2LChndrUiRCjj6mVB5w5hmLH8bp8jB,SpATywNh6bZuzm8s1ceuBUnMUAeoAHHw,7,6,1,0,1,0,3,0,11,1.5714285714285714,1,0.0,0,1,0,1,6,0,0,3,0,2,9,1
12950,182629,x5W7px1blVgXPSeduQeF8luvK0oCFfzJ,RXDvfPUBYFlVdlueBFbLW0mhhAyGEqpt,1,0,0,0,0,0,1,0,1,0.14285714285714285,1,0.0,0,0,0,0,0,0,0,1,0,0,1,1
12951,182633,XO0d4deCWOy3mmgL5fsAr1MAAwghPAkB,RXDvfPUBYFlVdlueBFbLW0mhhAyGEqpt,38,50,3,86,5,1,11,0,156,22.285714285714285,1,0.0,16,3,80,5,34,1,6,11,0,104,52,1
12952,182639,COhPD73W4lvIiazL2vbp3j5FVs5HQ601,SpATywNh6bZuzm8s1ceuBUnMUAeoAHHw,5,2,1,0,1,0,2,0,6,0.8571428571428571,1,0.0,0,1,0,1,2,0,0,2,0,2,4,1
12953,182640,2Wz9ixAR47Et860ivxArFAVvspY1IqDz,bWdj2GDclj5ofokWjzoa5jAwMkxCykd6,6,3,0,24,0,1,2,0,30,4.285714285714286,1,0.0,1,0,23,0,2,1,1,2,0,24,6,1
12954,182643,1IgVs7QdLHhnPG0jFRERCqu2Y9FlWiVF,G8EPVSXsOYB5YQWZGiz1aVq5Pgr2GrQu,3,0,0,0,0,3,2,0,5,0.7142857142857143,1,0.0,0,0,0,0,0,3,0,2,0,0,5,1
12955,182647,8P2IV2kWoU5ZCAhZNesFZXBCmVIcwHGV,SpATywNh6bZuzm8s1ceuBUnMUAeoAHHw,15,33,2,18,0,5,15,2,75,10.714285714285714,2,0.0,7,2,15,0,26,5,3,15,2,24,51,1
12956,182664,VHKy90msZ6s6PWErEswELl083Xh3kNC6,SpATywNh6bZuzm8s1ceuBUnMUAeoAHHw,10,7,1,14,1,9,5,0,37,5.285714285714286,2,0.0,2,1,13,1,5,9,1,5,0,17,20,1
12957,182669,PhL2ZyLw1V28vd4DfOVSi8FZIcPFQkVx,bWdj2GDclj5ofokWjzoa5jAwMkxCykd6,4,2,1,0,1,1,1,0,6,0.8571428571428571,1,0.0,0,1,0,1,2,1,0,1,0,2,4,1
12958,182671,GANbW2mfChK4bd2m73sodc3ItJtDn1ba,SpATywNh6bZuzm8s1ceuBUnMUAeoAHHw,4,0,0,0,0,0,3,1,4,0.5714285714285714,1,0.0,0,0,0,0,0,0,0,3,1,0,4,1
12959,182672,L8GepxGnZH9aQkkBlOp07iXjAUHLfNwr,SpATywNh6bZuzm8s1ceuBUnMUAeoAHHw,3,5,0,0,0,0,1,0,6,0.8571428571428571,1,0.0,2,0,0,0,3,0,0,1,0,2,4,1
12960,182675,XYKEbaRABcMuBHmMB2I3YkBepzCp0swB,bWdj2GDclj5ofokWjzoa5jAwMkxCykd6,5,14,2,0,1,0,4,0,21,3.0,2,0.0,2,2,0,1,12,0,0,4,0,5,16,1
12961,182696,GcJFzpyOdnnoWwg3V1INu4JCOvQXcJgJ,SpATywNh6bZuzm8s1ceuBUnMUAeoAHHw,1,0,0,0,0,0,1,0,1,0.14285714285714285,1,0.0,0,0,0,0,0,0,0,1,0,0,1,1
12962,182699,RAGQmaCMG2kfcGeGG7CgUDmUq1d4kIyn,G8EPVSXsOYB5YQWZGiz1aVq5Pgr2GrQu,2,0,0,0,0,0,4,0,4,0.5714285714285714,1,0.0,0,0,0,0,0,0,0,4,0,0,4,1
12963,182702,3QS27JowcKsai44171i1lf7TLJ6jrzZW,SpATywNh6bZuzm8s1ceuBUnMUAeoAHHw,6,5,2,0,1,0,2,0,10,1.4285714285714286,1,0.0,2,2,0,1,3,0,0,2,0,5,5,1
12964,182705,vgiQpvSAFn3WqqXXyEm42CrUfpctzUEX,SpATywNh6bZuzm8s1ceuBUnMUAeoAHHw,5,2,1,0,1,0,2,0,6,0.8571428571428571,1,0.0,0,1,0,1,2,0,0,2,0,2,4,1
12965,182714,SDvatKCgfdtv12UzJLxR0GYxgD4pUkgT,bWdj2GDclj5ofokWjzoa5jAwMkxCykd6,3,3,1,0,0,0,2,0,6,0.8571428571428571,1,0.0,0,1,0,0,3,0,0,2,0,1,5,1
12966,182718,e9IMJZnDOQwZUgVPoYAYW4meXQnaglvw,SpATywNh6bZuzm8s1ceuBUnMUAeoAHHw,10,2,2,0,2,0,8,3,17,2.4285714285714284,1,0.0,0,2,0,2,2,0,0,8,3,4,13,1
12967,182724,TV8zrBdNM1adKaAPI8D2c3PyvuLKkNEi,SpATywNh6bZuzm8s1ceuBUnMUAeoAHHw,8,2,1,0,1,3,7,1,15,2.142857142857143,1,0.0,0,1,0,1,2,3,0,7,1,2,13,1
12968,182742,YMU8P29wy18QfGxug1svcdE5aeLt8eef,SpATywNh6bZuzm8s1ceuBUnMUAeoAHHw,13,14,5,0,2,5,10,1,37,5.285714285714286,1,0.0,2,5,0,2,12,5,0,10,1,9,28,1
12969,182744,AXhSW785x6j50916e34SRK9faB9FqLBm,SpATywNh6bZuzm8s1ceuBUnMUAeoAHHw,2,0,0,0,0,0,2,0,2,0.2857142857142857,1,0.0,0,0,0,0,0,0,0,2,0,0,2,1
12970,182746,ADL0cXowUMs4wyiAOHKMOrtTHu5tmUqi,SpATywNh6bZuzm8s1ceuBUnMUAeoAHHw,5,5,3,0,2,0,2,0,12,1.7142857142857142,1,0.0,0,3,0,2,5,0,0,2,0,5,7,1
12971,182751,s4TEJX3ZSvr4kBLGdjg6CpTOCIceK5wi,SpATywNh6bZuzm8s1ceuBUnMUAeoAHHw,5,2,1,0,1,0,3,0,7,1.0,2,0.0,0,1,0,1,2,0,0,3,0,2,5,1
12972,182755,CwJSAfmXBIxjg0tYJaLcAWBrHja9U2kJ,SpATywNh6bZuzm8s1ceuBUnMUAeoAHHw,5,3,0,0,0,0,5,0,8,1.1428571428571428,1,0.0,0,0,0,0,3,0,0,5,0,0,8,1
12973,182766,ywNFtohqWrdbrhEW62rPnGjVYfzTZ181,SpATywNh6bZuzm8s1ceuBUnMUAeoAHHw,1,0,0,0,0,0,1,0,1,0.14285714285714285,1,0.0,0,0,0,0,0,0,0,1,0,0,1,1
12974,182768,wVdlJl1TkeMQ7fPs3s7SDiFZ9EQoXXFL,RXDvfPUBYFlVdlueBFbLW0mhhAyGEqpt,1,0,0,0,0,0,1,0,1,0.14285714285714285,1,0.0,0,0,0,0,0,0,0,1,0,0,1,1
12975,182781,myIIBocNFelldmuN47bMrRiORGKDSj7S,RXDvfPUBYFlVdlueBFbLW0mhhAyGEqpt,1,0,0,0,0,0,1,0,1,0.14285714285714285,1,0.0,0,0,0,0,0,0,0,1,0,0,1,1
12976,182783,H5XDLEjPVO5GyYRwYkINM9ORsYQG2YvW,SpATywNh6bZuzm8s1ceuBUnMUAeoAHHw,13,12,4,14,3,0,1,0,34,4.857142857142857,1,0.0,5,4,13,3,7,0,1,1,0,25,9,1
12977,182796,G1LkA451FC6E6IOfdWKqpy8y2lc8YSzz,SpATywNh6bZuzm8s1ceuBUnMUAeoAHHw,6,5,2,0,0,0,4,0,11,1.5714285714285714,1,0.0,0,2,0,0,5,0,0,4,0,2,9,1
12978,182815,JfAsemHlarA2F9Qw0stOCWfmH1qVmt8W,SpATywNh6bZuzm8s1ceuBUnMUAeoAHHw,1,0,0,0,0,0,1,0,1,0.14285714285714285,1,0.0,0,0,0,0,0,0,0,1,0,0,1,1
12979,182831,ZNcLOAJ2r3H5DqhbGk1CiPtwI7ixaCeK,RXDvfPUBYFlVdlueBFbLW0mhhAyGEqpt,5,7,4,0,1,0,4,0,16,2.2857142857142856,2,0.0,0,4,0,1,7,0,0,4,0,5,11,1
12980,182833,7cuOR7XN3OKWyCY4rmOlBcFyB6vgzoQs,bWdj2GDclj5ofokWjzoa5jAwMkxCykd6,9,13,3,34,3,0,4,0,57,8.142857142857142,1,0.0,5,3,33,3,8,0,1,4,0,44,13,1
12981,182849,2CWwtE86TUtrUhYms4GqpHHdjjzejIiw,RXDvfPUBYFlVdlueBFbLW0mhhAyGEqpt,10,9,0,0,0,0,1,0,10,1.4285714285714286,1,0.0,0,0,0,0,9,0,0,1,0,0,10,1
12982,182851,dJrIkntdHmFqt2nNdHl0WRj6RFfeHhWR,G8EPVSXsOYB5YQWZGiz1aVq5Pgr2GrQu,3,0,0,0,0,1,2,0,3,0.42857142857142855,1,0.0,0,0,0,0,0,1,0,2,0,0,3,1
12983,182860,foTg5qEPNfrsoDSNAhj65g7lMuh2VdSR,SpATywNh6bZuzm8s1ceuBUnMUAeoAHHw,1,0,0,0,0,0,1,0,1,0.14285714285714285,1,0.0,0,0,0,0,0,0,0,1,0,0,1,1
12984,182872,Klt9qoufCaIWdba44x7MkMWwmjaj9rrO,G8EPVSXsOYB5YQWZGiz1aVq5Pgr2GrQu,8,5,3,0,2,0,4,0,14,2.0,1,0.0,0,3,0,2,5,0,0,4,0,5,9,1
12985,182876,73K789g4e0jr9RbqLOh1RUOvDP0ZYtaO,SpATywNh6bZuzm8s1ceuBUnMUAeoAHHw,1,0,0,0,0,0,1,0,1,0.14285714285714285,1,0.0,0,0,0,0,0,0,0,1,0,0,1,1
12986,182884,q1zfV7JQnPHYBA4GkSf8RBmBmzIBSPXp,SpATywNh6bZuzm8s1ceuBUnMUAeoAHHw,1,0,0,0,0,0,2,0,2,0.2857142857142857,1,0.0,0,0,0,0,0,0,0,2,0,0,2,1
12987,182901,ROcCBAUDWCCmSmJWa8UkAc38NUTaJmvd,SpATywNh6bZuzm8s1ceuBUnMUAeoAHHw,7,7,6,0,4,0,1,0,18,2.5714285714285716,1,0.0,0,6,0,4,7,0,0,1,0,10,8,1
12988,182902,Gj3pHpaNgZrapEPZYhvbfuaS2aMS6tgO,SpATywNh6bZuzm8s1ceuBUnMUAeoAHHw,1,0,0,0,0,0,1,0,1,0.14285714285714285,1,0.0,0,0,0,0,0,0,0,1,0,0,1,1
12989,182909,kZLA3umCB77AeK17F9sH7z1Ojbpf7TLv,RXDvfPUBYFlVdlueBFbLW0mhhAyGEqpt,11,9,6,0,3,0,2,0,20,2.857142857142857,1,0.0,3,6,0,3,6,0,0,2,0,12,8,1
12990,182910,woTsCvW1lUQJlNZPTxvW6TWDeSBjlE3x,SpATywNh6bZuzm8s1ceuBUnMUAeoAHHw,15,45,2,21,2,4,7,1,82,11.714285714285714,1,0.0,32,2,16,2,13,4,5,7,1,52,30,1
12991,182923,7kYJ9SFEtYe6Heh67x8Vp6BF2X3NW60w,SpATywNh6bZuzm8s1ceuBUnMUAeoAHHw,5,2,1,0,0,0,5,0,8,1.1428571428571428,1,0.0,0,1,0,0,2,0,0,5,0,1,7,1
12992,182928,hOv5RKQK1RGRxpJJGcW0k2cA3RwQ8Rk5,SpATywNh6bZuzm8s1ceuBUnMUAeoAHHw,8,9,5,0,3,0,3,0,20,2.857142857142857,2,0.0,2,5,0,3,7,0,0,3,0,10,10,1
12993,182929,czJlHgmBYIN2fkWm8DMCxTMvIB7CPSjD,SpATywNh6bZuzm8s1ceuBUnMUAeoAHHw,1,0,0,0,0,0,1,0,1,0.14285714285714285,1,0.0,0,0,0,0,0,0,0,1,0,0,1,1
12994,182953,tmP3hiAxOmIcth7vkvpHKk2OIqOO5u37,bWdj2GDclj5ofokWjzoa5jAwMkxCykd6,4,5,1,0,0,0,1,0,7,1.0,1,0.0,0,1,0,0,5,0,0,1,0,1,6,1
12995,182959,4uRRd3ZIFdyKPTDLtcF8p2hJfez66l8b,bWdj2GDclj5ofokWjzoa5jAwMkxCykd6,4,2,1,0,1,0,1,0,5,0.7142857142857143,1,0.0,0,1,0,1,2,0,0,1,0,2,3,1
12996,182961,XNpvXjwLvaeOlYFUhwJmIuJfOHxWLTUx,SpATywNh6bZuzm8s1ceuBUnMUAeoAHHw,8,11,5,3,0,0,2,0,21,3.0,1,0.0,5,5,3,0,6,0,0,2,0,13,8,1
12997,182971,LslskpvRu2kdJKdLBrkhLUwON3Gy18Vo,bWdj2GDclj5ofokWjzoa5jAwMkxCykd6,10,3,2,12,2,0,3,0,22,3.142857142857143,1,0.0,1,2,12,2,2,0,0,3,0,17,5,0
12998,182975,TVBdP57RgHmXdzDOQxhhxrruZniECnNa,SpATywNh6bZuzm8s1ceuBUnMUAeoAHHw,10,11,7,0,3,10,10,2,43,6.142857142857143,2,0.0,0,7,0,3,11,10,0,10,2,10,33,1
12999,182978,WRGP3RiE3PgQD7N1Gw3XyQmMvgPUNX5x,SpATywNh6bZuzm8s1ceuBUnMUAeoAHHw,10,15,9,0,5,1,13,2,45,6.428571428571429,1,0.0,0,9,0,5,15,1,0,13,2,14,31,1
13000,182990,LHjZbHCdMckrMwOq7c5kO6EdbIUV0ZXr,SpATywNh6bZuzm8s1ceuBUnMUAeoAHHw,1,0,0,0,0,0,1,0,1,0.14285714285714285,1,0.0,0,0,0,0,0,0,0,1,0,0,1,1
13001,182992,p0pdpDYYJlDvrp00zDzLRGjYUqDxuGfa,SpATywNh6bZuzm8s1ceuBUnMUAeoAHHw,8,3,1,0,1,1,5,1,12,1.7142857142857142,1,0.0,0,1,0,1,3,1,0,5,1,2,10,1
13002,182994,64m0Q8jwm0bupg7LuUgGhNi3maBhbH3Y,SpATywNh6bZuzm8s1ceuBUnMUAeoAHHw,5,1,1,0,1,0,2,0,5,0.7142857142857143,1,0.0,0,1,0,1,1,0,0,2,0,2,3,1
13003,182998,aliLWjsmDZq4LP4uTi2kUntAc8WQqjiN,SpATywNh6bZuzm8s1ceuBUnMUAeoAHHw,6,3,2,0,2,0,1,0,8,1.1428571428571428,1,0.0,0,2,0,2,3,0,0,1,0,4,4,1
13004,183000,mjiGg0j06CInyeszEq1InPQHaMEdBBQC,SpATywNh6bZuzm8s1ceuBUnMUAeoAHHw,1,0,0,0,0,0,1,0,1,0.14285714285714285,1,0.0,0,0,0,0,0,0,0,1,0,0,1,1
13005,183015,Klt9qoufCaIWdba44x7MkMWwmjaj9rrO,RXDvfPUBYFlVdlueBFbLW0mhhAyGEqpt,5,2,1,0,1,0,2,0,6,0.8571428571428571,1,0.0,0,1,0,1,2,0,0,2,0,2,4,1
13006,183020,ktn21iQNCuR3oHHXVI0NrarzymknVPKy,bWdj2GDclj5ofokWjzoa5jAwMkxCykd6,14,17,6,60,3,0,4,0,90,12.857142857142858,1,0.0,4,6,59,3,13,0,1,4,0,72,18,1
13007,183023,iVDV62MoJzFeSGfSaOdA9lfvHL2Xprv8,bWdj2GDclj5ofokWjzoa5jAwMkxCykd6,1,0,0,0,0,0,1,0,1,0.14285714285714285,1,0.0,0,0,0,0,0,0,0,1,0,0,1,1
13008,183035,A23dnlnLlkfS4Hk14geJvIKVXuW282iT,SpATywNh6bZuzm8s1ceuBUnMUAeoAHHw,7,2,1,0,1,0,4,0,8,1.1428571428571428,1,0.0,0,1,0,1,2,0,0,4,0,2,6,1
13009,183046,wgSBRoX5zgs9VU58GuULiQecnpPq9Lqh,RXDvfPUBYFlVdlueBFbLW0mhhAyGEqpt,6,3,2,0,2,0,1,0,8,1.1428571428571428,1,0.0,0,2,0,2,3,0,0,1,0,4,4,1
13010,183051,rlQIqtgsDfEVihltHvVH3EnaOkFIJWY2,bWdj2GDclj5ofokWjzoa5jAwMkxCykd6,2,0,0,0,0,0,2,0,2,0.2857142857142857,1,0.0,0,0,0,0,0,0,0,2,0,0,2,1
13011,183053,lmeMhWa8hXVoeC6vmJbPTxkNCUltvvzl,bWdj2GDclj5ofokWjzoa5jAwMkxCykd6,1,0,0,0,0,0,1,0,1,0.14285714285714285,1,0.0,0,0,0,0,0,0,0,1,0,0,1,0
13012,183074,hDvxnDgro87cypkqHin6LwVYFrNPTTLE,RXDvfPUBYFlVdlueBFbLW0mhhAyGEqpt,11,5,3,0,2,0,8,1,19,2.7142857142857144,1,0.0,0,3,0,2,5,0,0,8,1,5,14,0
13013,183099,VerLbwiPxmF2ThOpDXTyChlnDHBPqkR9,SpATywNh6bZuzm8s1ceuBUnMUAeoAHHw,1,0,0,0,0,0,1,0,1,0.14285714285714285,1,0.0,0,0,0,0,0,0,0,1,0,0,1,1
13014,183102,Kl5tK7ooc00n8wf3ct9g9Ke76aOxJvfm,RXDvfPUBYFlVdlueBFbLW0mhhAyGEqpt,2,0,0,0,0,0,3,0,3,0.42857142857142855,1,0.0,0,0,0,0,0,0,0,3,0,0,3,1
13015,183108,jVeR6Ygg8woHLAlxijrDAiyFqfotJXuz,SpATywNh6bZuzm8s1ceuBUnMUAeoAHHw,1,0,0,0,0,0,1,0,1,0.14285714285714285,1,0.0,0,0,0,0,0,0,0,1,0,0,1,1
13016,183109,AildxiB1DfzGkzpFkUFcF6xLBoz939kN,SpATywNh6bZuzm8s1ceuBUnMUAeoAHHw,4,2,1,0,1,0,1,0,5,0.7142857142857143,1,0.0,0,1,0,1,2,0,0,1,0,2,3,1
13017,183115,lKZ6PIEzVkW9yjCyAe8hsmBYDIXs5abt,RXDvfPUBYFlVdlueBFbLW0mhhAyGEqpt,4,3,0,0,0,0,4,0,7,1.0,1,0.0,0,0,0,0,3,0,0,4,0,0,7,1
13018,183119,BoPqpHAIR2FQ1yjN5I6jPiYn67RLyUD3,bWdj2GDclj5ofokWjzoa5jAwMkxCykd6,1,0,0,0,0,0,2,0,2,0.2857142857142857,1,0.0,0,0,0,0,0,0,0,2,0,0,2,1
13019,183123,CkLUnVGhbMVv40VnwKxHWwmtgjnmo4A6,G8EPVSXsOYB5YQWZGiz1aVq5Pgr2GrQu,77,101,41,204,25,34,16,5,426,60.857142857142854,2,0.0,55,41,158,25,46,34,46,16,5,279,147,0
13020,183129,eOxm8XEI11Xs6eiBi1Nu5QzIagZXwEm9,RXDvfPUBYFlVdlueBFbLW0mhhAyGEqpt,12,13,8,0,1,8,2,0,32,4.571428571428571,1,0.0,4,8,0,1,9,8,0,2,0,13,19,0
13021,183130,w2Erm8d51TR8x1zaznDbwXn8kjSZE4Bu,G8EPVSXsOYB5YQWZGiz1aVq5Pgr2GrQu,8,8,5,0,3,0,8,0,24,3.4285714285714284,1,0.0,0,5,0,3,8,0,0,8,0,8,16,1
13022,183131,xWIW5AMIa14HXXQklcDbkiec2fixez0X,SpATywNh6bZuzm8s1ceuBUnMUAeoAHHw,2,0,0,0,0,0,2,0,2,0.2857142857142857,1,0.0,0,0,0,0,0,0,0,2,0,0,2,1
13023,183144,NFQYK3FjmQHQ82RJihsHHyxDsiLlEhiy,G8EPVSXsOYB5YQWZGiz1aVq5Pgr2GrQu,6,3,2,0,2,0,1,0,8,1.1428571428571428,1,0.0,0,2,0,2,3,0,0,1,0,4,4,1
13024,183150,RDDLwVBt5GubTYBjjqKExEAvJzlxgV07,G8EPVSXsOYB5YQWZGiz1aVq5Pgr2GrQu,4,2,1,0,1,0,1,0,5,0.7142857142857143,1,0.0,0,1,0,1,2,0,0,1,0,2,3,1
13025,183151,mXfwwTIVjHMqoVKAh2iEQbinKUCJHwTp,RXDvfPUBYFlVdlueBFbLW0mhhAyGEqpt,1,0,0,0,0,0,1,0,1,0.14285714285714285,1,0.0,0,0,0,0,0,0,0,1,0,0,1,1
13026,183153,meaga1KCWxPmzsqVBplIkGxQedzxaUD2,bWdj2GDclj5ofokWjzoa5jAwMkxCykd6,7,3,2,0,2,0,2,0,9,1.2857142857142858,1,0.0,0,2,0,2,3,0,0,2,0,4,5,1
13027,183156,BWYYcHsqCzhUpDFvLBDv5oyoAjPbY2ao,G8EPVSXsOYB5YQWZGiz1aVq5Pgr2GrQu,6,1,1,0,1,0,3,0,6,0.8571428571428571,1,0.0,0,1,0,1,1,0,0,3,0,2,4,1
13028,183166,1vUHALYrvSKjWqmr07cdKDwJ3ETsWONf,G8EPVSXsOYB5YQWZGiz1aVq5Pgr2GrQu,8,12,6,0,0,0,4,0,22,3.142857142857143,1,0.0,0,6,0,0,12,0,0,4,0,6,16,1
13029,183167,98I0uRRrxrvjOLcZ6vxnPf4VwE1fUSbw,SpATywNh6bZuzm8s1ceuBUnMUAeoAHHw,10,7,5,0,3,1,4,0,20,2.857142857142857,1,0.0,0,5,0,3,7,1,0,4,0,8,12,1
13030,183169,Ha83qom95SRdPZQ3GDUlHj6Txt7HaICx,RXDvfPUBYFlVdlueBFbLW0mhhAyGEqpt,5,1,0,0,0,0,3,1,5,0.7142857142857143,1,0.0,0,0,0,0,1,0,0,3,1,0,5,1
13031,183171,uWoWmi6BUckUwLrnQ5aAr8mNZ3FhCJCq,bWdj2GDclj5ofokWjzoa5jAwMkxCykd6,6,6,1,6,2,0,3,0,18,2.5714285714285716,1,0.0,4,1,6,2,2,0,0,3,0,13,5,1
13032,183175,uWoWmi6BUckUwLrnQ5aAr8mNZ3FhCJCq,SpATywNh6bZuzm8s1ceuBUnMUAeoAHHw,13,19,6,17,3,0,1,0,46,6.571428571428571,1,0.0,11,6,15,3,8,0,2,1,0,35,11,1
13033,183176,vmxFgUyErGGqygNyLIYogRrMCWwWAOsK,SpATywNh6bZuzm8s1ceuBUnMUAeoAHHw,3,0,0,0,0,0,2,1,3,0.42857142857142855,1,0.0,0,0,0,0,0,0,0,2,1,0,3,1
13034,183179,cBEtpnUSjx0dg8glJzii42d18FEs4ecN,bWdj2GDclj5ofokWjzoa5jAwMkxCykd6,4,2,1,0,1,0,1,0,5,0.7142857142857143,1,0.0,0,1,0,1,2,0,0,1,0,2,3,1
13035,183185,6UfIu5SKHPYfwZxBxJpGSqhLHKhbdsl0,RXDvfPUBYFlVdlueBFbLW0mhhAyGEqpt,6,4,3,0,0,0,3,0,10,1.4285714285714286,1,0.0,0,3,0,0,4,0,0,3,0,3,7,1
13036,183195,ZUG5m2QmH8RqkCO5a89mIgt4zubZUyS0,SpATywNh6bZuzm8s1ceuBUnMUAeoAHHw,6,0,0,0,0,6,6,1,13,1.8571428571428572,1,0.0,0,0,0,0,0,6,0,6,1,0,13,1
13037,183205,rtxwCWIEQDwTZ37mLeJaxSUkUCTNLEOP,SpATywNh6bZuzm8s1ceuBUnMUAeoAHHw,9,6,3,0,1,0,5,2,17,2.4285714285714284,1,0.0,0,3,0,1,6,0,0,5,2,4,13,1
13038,183228,EnOE2zcU3adIQka8zXE5uaDcwrIceQaF,SpATywNh6bZuzm8s1ceuBUnMUAeoAHHw,15,8,5,16,4,11,5,1,50,7.142857142857143,1,0.0,2,5,14,4,6,11,2,5,1,25,25,1
13039,183230,RYd1k9DojojPZwrkV3NjsTI5OdZnPV9W,bWdj2GDclj5ofokWjzoa5jAwMkxCykd6,6,12,0,0,1,0,4,0,17,2.4285714285714284,1,0.0,0,0,0,1,12,0,0,4,0,1,16,1
13040,183232,7RSTSE7CX0EZRW2RDRnKS7CJkHtK7gJx,SpATywNh6bZuzm8s1ceuBUnMUAeoAHHw,5,3,2,0,1,0,2,0,8,1.1428571428571428,1,0.0,0,2,0,1,3,0,0,2,0,3,5,1
13041,183236,DIfj5Ba2axfDE4LFDWqKjVBCgesW8XXW,bWdj2GDclj5ofokWjzoa5jAwMkxCykd6,1,0,0,0,0,0,2,0,2,0.2857142857142857,1,0.0,0,0,0,0,0,0,0,2,0,0,2,1
13042,183238,L44FpqBwTo2JSXh1jKpzwO4TUp5s63E0,SpATywNh6bZuzm8s1ceuBUnMUAeoAHHw,5,2,1,0,1,0,2,0,6,0.8571428571428571,1,0.0,0,1,0,1,2,0,0,2,0,2,4,1
13043,183250,zvOHbaUWjxRZ9zCYxYPMcUH4Ef5dE8Ae,SpATywNh6bZuzm8s1ceuBUnMUAeoAHHw,6,3,1,0,1,0,2,0,7,1.0,1,0.0,0,1,0,1,3,0,0,2,0,2,5,1
13044,183254,1EtDFoshTxvFPxLRYfA4KzHCN6a1sUab,RXDvfPUBYFlVdlueBFbLW0mhhAyGEqpt,8,8,5,0,2,2,2,0,19,2.7142857142857144,1,0.0,0,5,0,2,8,2,0,2,0,7,12,1
13045,183258,cwjdhzGq04zCTXyAv16dQv37UeRHYh5B,G8EPVSXsOYB5YQWZGiz1aVq5Pgr2GrQu,7,3,2,0,2,0,2,0,9,1.2857142857142858,2,0.0,0,2,0,2,3,0,0,2,0,4,5,1
13046,183260,5nq8zs9A2tdQgPir7vYvctaqXkR3aFiH,SpATywNh6bZuzm8s1ceuBUnMUAeoAHHw,12,17,2,15,1,0,5,0,40,5.714285714285714,1,0.0,6,2,13,1,11,0,2,5,0,22,18,1
13047,183265,QT9CjDkbeQDwB2YMvS9MmI6T8kS9zKHi,RXDvfPUBYFlVdlueBFbLW0mhhAyGEqpt,5,1,1,0,1,0,2,0,5,0.7142857142857143,1,0.0,0,1,0,1,1,0,0,2,0,2,3,1
13048,183267,9nmSiMdYrhU2xelQs2wN4VWDOzZHLs5V,G8EPVSXsOYB5YQWZGiz1aVq5Pgr2GrQu,1,0,0,0,0,0,1,0,1,0.14285714285714285,1,0.0,0,0,0,0,0,0,0,1,0,0,1,1
13049,183291,KA8RyaMJzO49U5Bg2GbjpW1mpD8UFvq1,bWdj2GDclj5ofokWjzoa5jAwMkxCykd6,1,0,0,0,0,0,1,0,1,0.14285714285714285,1,0.0,0,0,0,0,0,0,0,1,0,0,1,1
13050,183294,x0GEvwkvyx0g8nTyKguqj2gMY7vcYmyU,SpATywNh6bZuzm8s1ceuBUnMUAeoAHHw,6,3,1,0,1,0,2,0,7,1.0,1,0.0,0,1,0,1,3,0,0,2,0,2,5,1
13051,183297,11kDA8TSGRrd2fZeDsp1CDJVYBIctE55,RXDvfPUBYFlVdlueBFbLW0mhhAyGEqpt,6,6,4,0,1,0,1,0,12,1.7142857142857142,1,0.0,0,4,0,1,6,0,0,1,0,5,7,1
13052,183300,K6sgJjXLg94pFHcJsnQvREqPhcrsQGLq,SpATywNh6bZuzm8s1ceuBUnMUAeoAHHw,2,0,0,0,0,0,3,0,3,0.42857142857142855,1,0.0,0,0,0,0,0,0,0,3,0,0,3,1
13053,183306,uufXnXOfmStAymRAiMYAROVtj5hPlDvd,bWdj2GDclj5ofokWjzoa5jAwMkxCykd6,5,2,1,0,1,0,3,0,7,1.0,1,0.0,0,1,0,1,2,0,0,3,0,2,5,1
13054,183315,G77tKik9NyptRJFC9Rot5qsRZiF0D6mk,SpATywNh6bZuzm8s1ceuBUnMUAeoAHHw,6,6,3,0,2,0,2,0,13,1.8571428571428572,1,0.0,2,3,0,2,4,0,0,2,0,7,6,1
13055,183316,Dm8rUUBDQqhrTm6PWZMMnJPt5PSDMko0,G8EPVSXsOYB5YQWZGiz1aVq5Pgr2GrQu,3,2,0,0,0,1,2,0,5,0.7142857142857143,1,0.0,0,0,0,0,2,1,0,2,0,0,5,1
13056,183317,jTtPdqNIV0C6SwNZGMhf4DTx667U70VG,SpATywNh6bZuzm8s1ceuBUnMUAeoAHHw,12,21,0,18,0,13,5,2,59,8.428571428571429,1,0.0,4,0,15,0,17,13,3,5,2,19,40,1
13057,183319,olHirIGJLYzj8TwhRxe1Dm9DLgoQbNvO,SpATywNh6bZuzm8s1ceuBUnMUAeoAHHw,9,7,6,0,5,0,5,0,23,3.2857142857142856,1,0.0,0,6,0,5,7,0,0,5,0,11,12,1
13058,183340,0Vj24SN7QK68fxZGEj9b6pGHh8nTXfGG,bWdj2GDclj5ofokWjzoa5jAwMkxCykd6,1,0,0,0,0,0,1,0,1,0.14285714285714285,1,0.0,0,0,0,0,0,0,0,1,0,0,1,1
13059,183345,7QIKpGgitmD7tk807kQNY8RClDv3488Y,SpATywNh6bZuzm8s1ceuBUnMUAeoAHHw,5,2,1,0,1,1,2,1,8,1.1428571428571428,1,0.0,0,1,0,1,2,1,0,2,1,2,6,1
13060,183350,89IraAtUfhoGAQgzdMP1844g2s2iN4Ox,RXDvfPUBYFlVdlueBFbLW0mhhAyGEqpt,16,18,6,15,6,4,6,10,65,9.285714285714286,1,0.0,5,6,15,6,13,4,0,6,10,32,33,1
13061,183353,geebTbOsD2liuGCoIF7cu53Xft014LYQ,bWdj2GDclj5ofokWjzoa5jAwMkxCykd6,5,2,1,0,1,0,2,1,7,1.0,1,0.0,0,1,0,1,2,0,0,2,1,2,5,1
13062,183399,5e8eBFhY8m9197wxmtpeMKTT5Js0t5oX,SpATywNh6bZuzm8s1ceuBUnMUAeoAHHw,1,0,0,0,0,0,1,0,1,0.14285714285714285,1,0.0,0,0,0,0,0,0,0,1,0,0,1,1
13063,183400,dWLPd7W4XxJuKssPJAJlISLlvxj9YqGO,G8EPVSXsOYB5YQWZGiz1aVq5Pgr2GrQu,14,14,6,10,3,0,6,1,40,5.714285714285714,1,0.0,3,6,7,3,11,0,3,6,1,19,21,1
13064,183411,GO3MGrx4XteeFiOXpQf53F1doJGXYUJh,G8EPVSXsOYB5YQWZGiz1aVq5Pgr2GrQu,11,14,10,0,5,1,9,3,42,6.0,2,0.0,0,10,0,5,14,1,0,9,3,15,27,1
13065,183413,qvBe3rKX4kTO2XRpAwHefqsXVjGwcgVZ,SpATywNh6bZuzm8s1ceuBUnMUAeoAHHw,6,7,0,0,0,2,2,0,11,1.5714285714285714,1,0.0,3,0,0,0,4,2,0,2,0,3,8,1
13066,183416,orkcYdEVQqlH9SJjCRUiZ5P3bFy172XW,bWdj2GDclj5ofokWjzoa5jAwMkxCykd6,2,0,0,0,0,0,5,0,5,0.7142857142857143,2,0.0,0,0,0,0,0,0,0,5,0,0,5,1
13067,183434,OocLfrCOBb0PIIRDKMfTM554g3aeKj99,bWdj2GDclj5ofokWjzoa5jAwMkxCykd6,5,2,1,0,1,0,2,0,6,0.8571428571428571,1,0.0,0,1,0,1,2,0,0,2,0,2,4,1
13068,183441,AGnMVhenXKmXw34icDYbSubheSiHLlFC,bWdj2GDclj5ofokWjzoa5jAwMkxCykd6,1,0,0,0,0,0,1,0,1,0.14285714285714285,1,0.0,0,0,0,0,0,0,0,1,0,0,1,1
13069,183444,7OyOaefKbOX5xGdSnzdHd0CL6VXfEf8T,G8EPVSXsOYB5YQWZGiz1aVq5Pgr2GrQu,2,0,0,0,0,0,2,0,2,0.2857142857142857,1,0.0,0,0,0,0,0,0,0,2,0,0,2,1
13070,183447,IGdK3d2q4pwzeowbu1fnlncF2G0mIESt,SpATywNh6bZuzm8s1ceuBUnMUAeoAHHw,6,12,0,0,0,0,2,0,14,2.0,1,0.0,1,0,0,0,11,0,0,2,0,1,13,1
13071,183449,NhOj8NHtxbWRVl1n7CiUbpZQHLOfubek,RXDvfPUBYFlVdlueBFbLW0mhhAyGEqpt,13,16,2,0,1,21,12,1,53,7.571428571428571,1,0.0,0,2,0,1,16,21,0,12,1,3,50,1
13072,183460,zsosD9YlCDywhEUV3Vphbp3IXW8MeBYM,bWdj2GDclj5ofokWjzoa5jAwMkxCykd6,1,0,0,0,0,0,1,0,1,0.14285714285714285,1,0.0,0,0,0,0,0,0,0,1,0,0,1,1
13073,183476,069ftOw6ldZ1V3ipXwZemwIwoCreCmPS,G8EPVSXsOYB5YQWZGiz1aVq5Pgr2GrQu,16,15,5,36,3,0,1,0,60,8.571428571428571,1,0.0,9,5,27,3,6,0,9,1,0,44,16,1
13074,183481,zpoCbNcTK6iqE6Hm4JrK6lHIZV2VXvYX,SpATywNh6bZuzm8s1ceuBUnMUAeoAHHw,1,0,0,0,0,0,3,0,3,0.42857142857142855,1,0.0,0,0,0,0,0,0,0,3,0,0,3,1
13075,183488,kUJcgErkiF8AsEDKHMMLmp1H5MenUsXw,G8EPVSXsOYB5YQWZGiz1aVq5Pgr2GrQu,2,0,0,0,0,0,3,0,3,0.42857142857142855,1,0.0,0,0,0,0,0,0,0,3,0,0,3,1
13076,183500,fsFbJ8UrfADOZi56VOg1TSjQKQnG4WLk,RXDvfPUBYFlVdlueBFbLW0mhhAyGEqpt,8,5,0,0,0,0,3,0,8,1.1428571428571428,1,0.0,0,0,0,0,5,0,0,3,0,0,8,1
13077,183502,VtCUQBk0TlN0AJOAq0bEC4tTAH6HVrBA,SpATywNh6bZuzm8s1ceuBUnMUAeoAHHw,3,2,0,0,0,0,1,0,3,0.42857142857142855,1,0.0,0,0,0,0,2,0,0,1,0,0,3,1
13078,183514,f2GMLkjrqGdN19ysxF64zEiQj9fxR4cG,G8EPVSXsOYB5YQWZGiz1aVq5Pgr2GrQu,5,2,1,0,1,0,2,0,6,0.8571428571428571,1,0.0,0,1,0,1,2,0,0,2,0,2,4,1
13079,183527,66KnlNHw8D8zXFB0ktOwarKa6xDfCRsA,SpATywNh6bZuzm8s1ceuBUnMUAeoAHHw,2,0,0,0,0,0,2,0,2,0.2857142857142857,1,0.0,0,0,0,0,0,0,0,2,0,0,2,1
13080,183534,joi2hmNEoOCl0stUXbrsaehVDAdpUejn,SpATywNh6bZuzm8s1ceuBUnMUAeoAHHw,1,0,0,0,0,0,1,0,1,0.14285714285714285,1,0.0,0,0,0,0,0,0,0,1,0,0,1,1
13081,183537,GNsGzjFSidI9fBCvT9fI5F8kfuYTc1I2,RXDvfPUBYFlVdlueBFbLW0mhhAyGEqpt,13,16,9,0,3,0,7,1,36,5.142857142857143,2,0.0,2,9,0,3,14,0,0,7,1,14,22,0
13082,183541,gqy9Iq3u49oICISghrOoeZuPt4tAVyjr,SpATywNh6bZuzm8s1ceuBUnMUAeoAHHw,5,2,1,0,1,0,2,0,6,0.8571428571428571,1,0.0,0,1,0,1,2,0,0,2,0,2,4,1
13083,183543,RrZIh1Er4YeabEoYA6SJyDj40LWgHTn5,SpATywNh6bZuzm8s1ceuBUnMUAeoAHHw,6,2,0,0,0,0,5,0,7,1.0,1,0.0,0,0,0,0,2,0,0,5,0,0,7,1
13084,183549,oAjXymbDbd4Rt4XO0pdep7ez7kmoJtvA,bWdj2GDclj5ofokWjzoa5jAwMkxCykd6,2,0,0,0,0,0,2,0,2,0.2857142857142857,1,0.0,0,0,0,0,0,0,0,2,0,0,2,1
13085,183550,JaYbgvhgx43SysY9J8DaCR3IcdUzCcUf,bWdj2GDclj5ofokWjzoa5jAwMkxCykd6,4,4,1,0,0,0,2,0,7,1.0,2,0.0,0,1,0,0,4,0,0,2,0,1,6,1
13086,183552,tCPCenWlAqHKYLuxwQ692ECgp8ponIEe,SpATywNh6bZuzm8s1ceuBUnMUAeoAHHw,2,0,0,0,0,0,2,0,2,0.2857142857142857,1,0.0,0,0,0,0,0,0,0,2,0,0,2,1
13087,183560,539icBw2nmvBmBkzeMPm9mMNpWONyi1a,bWdj2GDclj5ofokWjzoa5jAwMkxCykd6,2,0,0,0,0,0,2,0,2,0.2857142857142857,1,0.0,0,0,0,0,0,0,0,2,0,0,2,1
13088,183569,iJJNhRwyvCNK6HRXY0B7B0PcxR090Rv4,SpATywNh6bZuzm8s1ceuBUnMUAeoAHHw,1,0,0,0,0,0,1,0,1,0.14285714285714285,1,0.0,0,0,0,0,0,0,0,1,0,0,1,1
13089,183570,mORy2uEWeq5FPaYREt08zxVhXzxOvG5x,SpATywNh6bZuzm8s1ceuBUnMUAeoAHHw,4,2,1,0,1,18,1,0,23,3.2857142857142856,1,0.0,0,1,0,1,2,18,0,1,0,2,21,1
13090,183579,hKd0tEZKHss60gUM0z43MBrDD3KnSpLX,SpATywNh6bZuzm8s1ceuBUnMUAeoAHHw,6,3,1,0,1,0,3,0,8,1.1428571428571428,1,0.0,0,1,0,1,3,0,0,3,0,2,6,1
13091,183585,bGVVh5mMYkn1gHW6CnpRuYzXwIcX6sC6,SpATywNh6bZuzm8s1ceuBUnMUAeoAHHw,6,1,1,0,1,1,3,1,8,1.1428571428571428,1,0.0,0,1,0,1,1,1,0,3,1,2,6,1
13092,183590,iwLRjFCEFjJtmNgQnRk4kXqxuLSCzbLr,SpATywNh6bZuzm8s1ceuBUnMUAeoAHHw,7,4,2,0,2,0,4,1,13,1.8571428571428572,1,0.0,1,2,0,2,3,0,0,4,1,5,8,1
13093,183603,yMScB1KMRz60XZtblJXZ7cOwpx8nYT9h,G8EPVSXsOYB5YQWZGiz1aVq5Pgr2GrQu,9,9,1,18,2,0,2,0,32,4.571428571428571,1,0.0,7,1,12,2,2,0,6,2,0,22,10,1
13094,183613,7jDyNmBRkEY6fNon9RWGerv8blE7YVJd,bWdj2GDclj5ofokWjzoa5jAwMkxCykd6,4,2,0,0,0,0,2,0,4,0.5714285714285714,1,0.0,0,0,0,0,2,0,0,2,0,0,4,1
13095,183614,x967IREOKVWVVneKjnOdD8ZruuMl1VE7,SpATywNh6bZuzm8s1ceuBUnMUAeoAHHw,9,21,9,0,7,0,3,0,40,5.714285714285714,1,0.0,1,9,0,7,20,0,0,3,0,17,23,1
13096,183624,Tfb5kzD9uzk4IFFKiGmgMSkZRj1tZ0K9,bWdj2GDclj5ofokWjzoa5jAwMkxCykd6,8,22,5,26,8,0,4,0,65,9.285714285714286,2,0.0,16,5,26,8,6,0,0,4,0,55,10,0
13097,183631,FbdmHwhDtQoDvNNbH5NO4UO0Yhp01nUq,SpATywNh6bZuzm8s1ceuBUnMUAeoAHHw,5,2,1,0,1,0,2,0,6,0.8571428571428571,1,0.0,0,1,0,1,2,0,0,2,0,2,4,1
13098,183634,R4jzs50fuf1JavV9xGEb7vRBguxW8cYa,SpATywNh6bZuzm8s1ceuBUnMUAeoAHHw,8,13,6,0,2,1,4,0,26,3.7142857142857144,1,0.0,0,6,0,2,13,1,0,4,0,8,18,1
13099,183641,CAXYMnI26CJKVZLm27KWhrQ5wZxlWBLx,SpATywNh6bZuzm8s1ceuBUnMUAeoAHHw,5,6,1,0,1,0,1,0,9,1.2857142857142858,1,0.0,0,1,0,1,6,0,0,1,0,2,7,1
13100,183645,rzux1UjWNNs1GqyksFiTFp3NDiKcqZIA,SpATywNh6bZuzm8s1ceuBUnMUAeoAHHw,5,2,1,0,1,0,2,0,6,0.8571428571428571,1,0.0,0,1,0,1,2,0,0,2,0,2,4,1
13101,183649,tHouYbJheFPQJDK2n6XJK9jRREGEheXi,G8EPVSXsOYB5YQWZGiz1aVq5Pgr2GrQu,36,43,12,44,10,2,6,1,118,16.857142857142858,1,0.0,25,12,29,10,18,2,15,6,1,76,42,1
13102,183651,QP3bOKPbx70fYEywL9MXgcXTnFgBdqPj,SpATywNh6bZuzm8s1ceuBUnMUAeoAHHw,6,3,1,0,1,0,3,0,8,1.1428571428571428,1,0.0,0,1,0,1,3,0,0,3,0,2,6,1
13103,183655,Mbj5txvZRTAvPuGny65LvJcTeJZzO2Xr,SpATywNh6bZuzm8s1ceuBUnMUAeoAHHw,5,4,3,0,1,0,1,0,9,1.2857142857142858,1,0.0,0,3,0,1,4,0,0,1,0,4,5,1
13104,183664,o19vb57bgfx9sNjmUMNmIakP5nctIJ3O,bWdj2GDclj5ofokWjzoa5jAwMkxCykd6,5,4,0,0,0,0,2,0,6,0.8571428571428571,1,0.0,0,0,0,0,4,0,0,2,0,0,6,1
13105,183675,cpH6ushFbRO23LBN96kMSHMHQ5CDuqWx,SpATywNh6bZuzm8s1ceuBUnMUAeoAHHw,10,8,4,0,3,0,2,0,17,2.4285714285714284,1,0.0,3,4,0,3,5,0,0,2,0,10,7,1
13106,183689,tVDSRebDM9kj4eZBXWEp0omzaKHFumrl,SpATywNh6bZuzm8s1ceuBUnMUAeoAHHw,4,2,1,0,1,0,1,0,5,0.7142857142857143,1,0.0,0,1,0,1,2,0,0,1,0,2,3,1
13107,183698,o19vb57bgfx9sNjmUMNmIakP5nctIJ3O,G8EPVSXsOYB5YQWZGiz1aVq5Pgr2GrQu,1,0,0,0,0,0,1,0,1,0.14285714285714285,1,0.0,0,0,0,0,0,0,0,1,0,0,1,1
13108,183699,qjQ6GiU7sehnY7qaKKajZBfA0GV2t1bA,SpATywNh6bZuzm8s1ceuBUnMUAeoAHHw,5,2,0,0,1,0,2,0,5,0.7142857142857143,1,0.0,0,0,0,1,2,0,0,2,0,1,4,1
13109,183716,2hMeaUc14fgUG8b3kgXxN1xDYogexPXy,bWdj2GDclj5ofokWjzoa5jAwMkxCykd6,5,9,0,0,1,0,1,0,11,1.5714285714285714,1,0.0,3,0,0,1,6,0,0,1,0,4,7,1
13110,183718,Lf0mThPYOrtlCzgRGBCVTPy1hiGUII8h,bWdj2GDclj5ofokWjzoa5jAwMkxCykd6,7,2,1,0,1,0,4,0,8,1.1428571428571428,1,0.0,0,1,0,1,2,0,0,4,0,2,6,1
13111,183726,hB6lALXH4sMaj6Hr4qOJgZbelF7wY5ML,SpATywNh6bZuzm8s1ceuBUnMUAeoAHHw,5,2,1,0,1,0,2,0,6,0.8571428571428571,1,0.0,0,1,0,1,2,0,0,2,0,2,4,1
13112,183734,bUWUvqWKJBmYgRNIoWQO6VIVyvpJs3GG,bWdj2GDclj5ofokWjzoa5jAwMkxCykd6,14,16,6,16,2,0,3,0,43,6.142857142857143,1,0.0,3,6,14,2,13,0,2,3,0,25,18,1
13113,183736,CJjWj5QSoyqJ23EMwHZtEX525JWA2E7K,SpATywNh6bZuzm8s1ceuBUnMUAeoAHHw,5,2,1,0,1,0,2,0,6,0.8571428571428571,1,0.0,0,1,0,1,2,0,0,2,0,2,4,1
13114,183737,EEKM5fD1OwESnar1FjU8hxj0L9tVWx44,RXDvfPUBYFlVdlueBFbLW0mhhAyGEqpt,10,9,1,0,1,5,2,0,18,2.5714285714285716,1,0.0,0,1,0,1,9,5,0,2,0,2,16,1
13115,183740,e1dzN81UKTvb4PNCErZLbC2uYa0wPNos,SpATywNh6bZuzm8s1ceuBUnMUAeoAHHw,6,5,2,0,2,0,1,0,10,1.4285714285714286,1,0.0,0,2,0,2,5,0,0,1,0,4,6,1
13116,183743,Tkxf1Z89UY3ofefoIUKYhYMqhRZ3ElpY,SpATywNh6bZuzm8s1ceuBUnMUAeoAHHw,1,0,0,0,0,0,1,0,1,0.14285714285714285,1,0.0,0,0,0,0,0,0,0,1,0,0,1,1
13117,183755,5UWxjYJaVNtau37O89p9sB7M5HwhMo3z,bWdj2GDclj5ofokWjzoa5jAwMkxCykd6,1,0,0,0,0,0,1,0,1,0.14285714285714285,1,0.0,0,0,0,0,0,0,0,1,0,0,1,1
13118,183759,NplT7OhnAZOp9hCAdGLFNwSMTc3LAhF2,G8EPVSXsOYB5YQWZGiz1aVq5Pgr2GrQu,23,32,6,38,4,0,2,0,82,11.714285714285714,1,0.0,23,6,23,4,9,0,15,2,0,56,26,1
13119,183766,bY2gh2mIojoS37RuKr0mq0gh4QBiW0z8,G8EPVSXsOYB5YQWZGiz1aVq5Pgr2GrQu,11,18,5,16,2,3,2,0,46,6.571428571428571,1,0.0,10,5,14,2,8,3,2,2,0,31,15,1
13120,183781,HL5HEUPq5k60nwiHmjiz48idVIW7iDWP,SpATywNh6bZuzm8s1ceuBUnMUAeoAHHw,5,2,1,0,1,0,2,0,6,0.8571428571428571,1,0.0,0,1,0,1,2,0,0,2,0,2,4,1
13121,183784,QzFNcWcdt9jKMCztuclgA8fbidhRkaqv,SpATywNh6bZuzm8s1ceuBUnMUAeoAHHw,7,6,0,0,0,0,13,1,20,2.857142857142857,1,0.0,0,0,0,0,6,0,0,13,1,0,20,1
13122,183796,MhvviuZNTmfoceElB9BVHo0GzJkIAz9b,G8EPVSXsOYB5YQWZGiz1aVq5Pgr2GrQu,7,6,2,0,2,0,1,0,11,1.5714285714285714,1,0.0,0,2,0,2,6,0,0,1,0,4,7,1
13123,183800,4T6e9tf501hupPEmmZRZG7Lv5vYmRX6i,SpATywNh6bZuzm8s1ceuBUnMUAeoAHHw,6,4,3,0,3,0,1,0,11,1.5714285714285714,1,0.0,0,3,0,3,4,0,0,1,0,6,5,1
13124,183802,4Y8z1fVuk8HPWGVOteuQwAFNrdo0CBpu,SpATywNh6bZuzm8s1ceuBUnMUAeoAHHw,1,0,0,0,0,0,2,0,2,0.2857142857142857,1,0.0,0,0,0,0,0,0,0,2,0,0,2,1
13125,183805,6Ysh3EXeoiNCd1uXxsjEQronkryNKRU5,RXDvfPUBYFlVdlueBFbLW0mhhAyGEqpt,1,0,0,0,0,0,1,0,1,0.14285714285714285,1,0.0,0,0,0,0,0,0,0,1,0,0,1,1
13126,183808,cLRv4oHsLxWfkE6gs4eN6fO5y0RK8Odw,G8EPVSXsOYB5YQWZGiz1aVq5Pgr2GrQu,6,4,2,0,1,0,4,0,11,1.5714285714285714,1,0.0,0,2,0,1,4,0,0,4,0,3,8,1
13127,183822,OuPUar7X5BJymhikUDnyE5tFiUVuL09j,bWdj2GDclj5ofokWjzoa5jAwMkxCykd6,4,2,1,0,1,0,1,0,5,0.7142857142857143,1,0.0,0,1,0,1,2,0,0,1,0,2,3,1
13128,183839,yzbVurZnZZ3LzSESEDTD8mBP09kqyBBh,G8EPVSXsOYB5YQWZGiz1aVq5Pgr2GrQu,5,2,1,0,0,0,4,0,7,1.0,1,0.0,0,1,0,0,2,0,0,4,0,1,6,1
13129,183842,e3vAZGPddv8GG7o51Df54H5d3GJcihRZ,G8EPVSXsOYB5YQWZGiz1aVq5Pgr2GrQu,5,2,1,0,1,0,2,0,6,0.8571428571428571,1,0.0,0,1,0,1,2,0,0,2,0,2,4,1
13130,183843,KqeR1ihSDa1Ej9nVqHYeUS5y6oETFEfM,bWdj2GDclj5ofokWjzoa5jAwMkxCykd6,4,2,0,0,1,0,1,0,4,0.5714285714285714,1,0.0,0,0,0,1,2,0,0,1,0,1,3,1
13131,183850,N9VYkIRf4aydaM9gnOlftZxNGDW8I3Zp,SpATywNh6bZuzm8s1ceuBUnMUAeoAHHw,5,6,3,0,1,1,3,0,14,2.0,3,0.0,0,3,0,1,6,1,0,3,0,4,10,1
13132,183851,ls613vLH6fBQyqRMeuiCg3ot5Tyb4DDz,RXDvfPUBYFlVdlueBFbLW0mhhAyGEqpt,1,0,0,0,0,0,1,0,1,0.14285714285714285,1,0.0,0,0,0,0,0,0,0,1,0,0,1,1
13133,183852,NyPL3YppErvC9cRYCzI4gxKdO7060UB2,SpATywNh6bZuzm8s1ceuBUnMUAeoAHHw,4,2,1,0,0,0,2,0,5,0.7142857142857143,1,0.0,0,1,0,0,2,0,0,2,0,1,4,1
13134,183854,3aJcxnpBDknIFELx5q7A1ed9nLB6csNj,bWdj2GDclj5ofokWjzoa5jAwMkxCykd6,3,3,0,0,0,0,1,0,4,0.5714285714285714,1,0.0,0,0,0,0,3,0,0,1,0,0,4,1
13135,183856,PN6HDAlC1c0mDwWmACSk2v8uGfyNjwaH,SpATywNh6bZuzm8s1ceuBUnMUAeoAHHw,5,1,1,0,1,0,2,0,5,0.7142857142857143,1,0.0,0,1,0,1,1,0,0,2,0,2,3,1
13136,183857,xaz3R9QEFJxcfadxPNec99QMlGTDEIiY,SpATywNh6bZuzm8s1ceuBUnMUAeoAHHw,16,20,6,24,5,7,5,1,68,9.714285714285714,1,0.0,12,6,21,5,8,7,3,5,1,44,24,1
13137,183870,56VZldyBA7sJdFNsW4uyCbKalKBMfJny,SpATywNh6bZuzm8s1ceuBUnMUAeoAHHw,5,3,0,0,0,0,4,0,7,1.0,1,0.0,0,0,0,0,3,0,0,4,0,0,7,1
13138,183872,KLhUlREKq0O2xglSDOcFfaFp54qACtHM,SpATywNh6bZuzm8s1ceuBUnMUAeoAHHw,1,0,0,0,0,0,1,0,1,0.14285714285714285,1,0.0,0,0,0,0,0,0,0,1,0,0,1,1
13139,183875,fgQYCS5dRFsryAHcjDowcgqd9vNhjm9J,SpATywNh6bZuzm8s1ceuBUnMUAeoAHHw,6,7,0,0,0,0,2,0,9,1.2857142857142858,1,0.0,0,0,0,0,7,0,0,2,0,0,9,1
13140,183886,jhJPaGwU7dqU4ZwAVfiDn0qBdh771kri,G8EPVSXsOYB5YQWZGiz1aVq5Pgr2GrQu,15,66,32,50,17,0,2,0,167,23.857142857142858,1,0.0,0,32,47,17,66,0,3,2,0,96,71,1
13141,183895,HdOvDLzexKNSAsc0DtnaPUszT8VuZf1r,SpATywNh6bZuzm8s1ceuBUnMUAeoAHHw,7,3,2,0,2,0,3,0,10,1.4285714285714286,1,0.0,0,2,0,2,3,0,0,3,0,4,6,1
13142,183899,BDTbCzD1BP0Zvh6WPG7fuO5jLB3vSWaq,SpATywNh6bZuzm8s1ceuBUnMUAeoAHHw,4,2,1,0,1,0,1,0,5,0.7142857142857143,1,0.0,0,1,0,1,2,0,0,1,0,2,3,1
13143,183909,hpKSHIi4bRo1DEIvbfvzcRke2iP1vwgF,RXDvfPUBYFlVdlueBFbLW0mhhAyGEqpt,5,6,4,0,1,0,2,0,13,1.8571428571428572,1,0.0,0,4,0,1,6,0,0,2,0,5,8,1
13144,183910,52QsTv4Uo7nj5fP154PK0QEBA8xMFRXc,G8EPVSXsOYB5YQWZGiz1aVq5Pgr2GrQu,10,15,1,10,1,0,3,0,30,4.285714285714286,2,0.0,9,1,7,1,6,0,3,3,0,18,12,1
13145,183919,5BY2554FQkXzWEII8U25cUr1TyLfBPj6,RXDvfPUBYFlVdlueBFbLW0mhhAyGEqpt,5,2,1,0,0,0,3,0,6,0.8571428571428571,1,0.0,0,1,0,0,2,0,0,3,0,1,5,1
13146,183923,2HllbOBswZcfya5rDzlXYMHVB93oWjxb,bWdj2GDclj5ofokWjzoa5jAwMkxCykd6,1,0,0,0,0,0,1,0,1,0.14285714285714285,1,0.0,0,0,0,0,0,0,0,1,0,0,1,1
13147,183926,DiwcwcqzaE6lFsZWpJEHbAW7aioGreHg,SpATywNh6bZuzm8s1ceuBUnMUAeoAHHw,8,3,2,0,2,0,4,0,11,1.5714285714285714,1,0.0,0,2,0,2,3,0,0,4,0,4,7,1
13148,183935,oFr2hzwQRg7T6VDIxFir4OUQxI2WAOox,SpATywNh6bZuzm8s1ceuBUnMUAeoAHHw,6,5,1,0,0,0,2,0,8,1.1428571428571428,1,0.0,0,1,0,0,5,0,0,2,0,1,7,1
13149,183947,3SCBHiEI4HvwPrOQDNTIAqp1rZOAx5IK,RXDvfPUBYFlVdlueBFbLW0mhhAyGEqpt,4,2,1,0,1,0,1,0,5,0.7142857142857143,1,0.0,0,1,0,1,2,0,0,1,0,2,3,1
13150,183950,9ihleSS6gtfYUO7B3tfCDZConGdOxWz6,SpATywNh6bZuzm8s1ceuBUnMUAeoAHHw,7,3,0,0,0,0,4,0,7,1.0,1,0.0,0,0,0,0,3,0,0,4,0,0,7,1
13151,183952,ojd6JmvYlEsNwy0j8rsyD9P7isML33mP,SpATywNh6bZuzm8s1ceuBUnMUAeoAHHw,7,3,2,0,2,0,3,0,10,1.4285714285714286,1,0.0,0,2,0,2,3,0,0,3,0,4,6,1
13152,183958,5cpP5I4qy02g5JK1VuduuXdg8Frcarq0,SpATywNh6bZuzm8s1ceuBUnMUAeoAHHw,5,2,1,0,1,0,3,0,7,1.0,1,0.0,0,1,0,1,2,0,0,3,0,2,5,1
13153,183969,xZnb7uXmxIWQ7sisovgxwTXG7X7Be4Tl,bWdj2GDclj5ofokWjzoa5jAwMkxCykd6,11,15,7,8,2,10,8,1,51,7.285714285714286,1,0.0,2,7,6,2,13,10,2,8,1,17,34,1
13154,183973,qQ4S9PtUViLcUYCg7MK0igZg7IO7I0HK,SpATywNh6bZuzm8s1ceuBUnMUAeoAHHw,4,3,0,0,0,0,2,0,5,0.7142857142857143,1,0.0,0,0,0,0,3,0,0,2,0,0,5,1
13155,183988,qgG4OU0HRuoi21bBKmy9fO5g8h7KcP6E,RXDvfPUBYFlVdlueBFbLW0mhhAyGEqpt,20,16,7,18,7,0,8,0,56,8.0,1,0.0,8,7,16,7,8,0,2,8,0,38,18,1
13156,183997,FZXhILo2dZIp84xBqa5ZKNF9O2Wx35MO,SpATywNh6bZuzm8s1ceuBUnMUAeoAHHw,2,0,0,0,0,0,2,0,2,0.2857142857142857,1,0.0,0,0,0,0,0,0,0,2,0,0,2,1
13157,184003,ZqhWTPWWREP1gJARqRhQXMYloraIQQwo,SpATywNh6bZuzm8s1ceuBUnMUAeoAHHw,5,5,3,0,0,0,2,0,10,1.4285714285714286,2,0.0,0,3,0,0,5,0,0,2,0,3,7,1
13158,184008,UJHNe0sYjldvLe2oh1mb1WNNcWhYLg5J,SpATywNh6bZuzm8s1ceuBUnMUAeoAHHw,1,0,0,0,0,0,1,0,1,0.14285714285714285,1,0.0,0,0,0,0,0,0,0,1,0,0,1,1
13159,184017,m4zdr76CpU472F6wsJffFbslI27LpI4g,bWdj2GDclj5ofokWjzoa5jAwMkxCykd6,4,2,1,0,1,0,5,0,9,1.2857142857142858,2,0.0,0,1,0,1,2,0,0,5,0,2,7,1
13160,184024,h774wdF6vIIcl50Js74gckwUtlv9SBGH,G8EPVSXsOYB5YQWZGiz1aVq5Pgr2GrQu,8,14,5,0,4,0,3,0,26,3.7142857142857144,1,0.0,6,5,0,4,8,0,0,3,0,15,11,1
13161,184025,rXd7sBSm51uTyzv9MhrGYApbktwAzsFy,SpATywNh6bZuzm8s1ceuBUnMUAeoAHHw,3,3,1,0,0,0,1,0,5,0.7142857142857143,1,0.0,0,1,0,0,3,0,0,1,0,1,4,1
13162,184027,iu7Na8oZcPlYaVeI8FJk9aKFI4xc19c4,G8EPVSXsOYB5YQWZGiz1aVq5Pgr2GrQu,4,0,0,0,0,1,3,0,4,0.5714285714285714,1,0.0,0,0,0,0,0,1,0,3,0,0,4,1
13163,184029,CrwOvQpdA842UJZ7DoCSM957jMvz9EeO,SpATywNh6bZuzm8s1ceuBUnMUAeoAHHw,6,3,2,0,2,0,1,0,8,1.1428571428571428,1,0.0,0,2,0,2,3,0,0,1,0,4,4,1
13164,184046,5kCR1wjWWz9eEHdizA4crFyxKTH4mIdl,SpATywNh6bZuzm8s1ceuBUnMUAeoAHHw,7,7,2,0,1,0,4,0,14,2.0,1,0.0,2,2,0,1,5,0,0,4,0,5,9,1
13165,184054,dcJH2SRBlozVvsUdEPFKC47IdUh8xpq7,SpATywNh6bZuzm8s1ceuBUnMUAeoAHHw,16,20,9,12,5,4,13,1,64,9.142857142857142,1,0.0,8,9,9,5,12,4,3,13,1,31,33,1
13166,184080,Q0ABMzqV4ZKePGWKS9YO1g6VONZhZLgg,RXDvfPUBYFlVdlueBFbLW0mhhAyGEqpt,13,12,6,25,0,0,2,0,45,6.428571428571429,2,0.0,4,6,21,0,8,0,4,2,0,31,14,0
13167,184093,NslicJCNMxB9cZhzoMFtRxmqPnqyw5Ii,RXDvfPUBYFlVdlueBFbLW0mhhAyGEqpt,5,2,1,0,1,0,2,0,6,0.8571428571428571,1,0.0,0,1,0,1,2,0,0,2,0,2,4,1
13168,184099,jb1WJE68F4yEoD652bth3JuHIrLPIvo8,SpATywNh6bZuzm8s1ceuBUnMUAeoAHHw,8,7,2,0,1,0,5,0,15,2.142857142857143,1,0.0,0,2,0,1,7,0,0,5,0,3,12,1
13169,184108,Jr0wwW2Pnso55z8kcFx2vv1KjdLnz1KD,bWdj2GDclj5ofokWjzoa5jAwMkxCykd6,2,0,0,0,0,0,2,0,2,0.2857142857142857,1,0.0,0,0,0,0,0,0,0,2,0,0,2,1
13170,184121,fqQqpuKLzyQIMrl6XKL3tfcygq4Er6K5,bWdj2GDclj5ofokWjzoa5jAwMkxCykd6,1,0,0,0,0,0,1,0,1,0.14285714285714285,1,0.0,0,0,0,0,0,0,0,1,0,0,1,1
13171,184128,vQs4K4jFbbnMTWF8mXp4DI5eKN8aBPM9,SpATywNh6bZuzm8s1ceuBUnMUAeoAHHw,9,6,3,0,2,0,4,1,16,2.2857142857142856,2,0.0,0,3,0,2,6,0,0,4,1,5,11,1
13172,184130,hHVyNQkfLcybgeO1W2xMmju5SBV0vBkh,SpATywNh6bZuzm8s1ceuBUnMUAeoAHHw,7,6,3,0,2,0,3,0,14,2.0,1,0.0,0,3,0,2,6,0,0,3,0,5,9,1
13173,184135,01vp16vMBdfdzNflK84lEgGXfBDKyb7S,bWdj2GDclj5ofokWjzoa5jAwMkxCykd6,8,6,4,0,2,0,5,0,17,2.4285714285714284,2,0.0,0,4,0,2,6,0,0,5,0,6,11,1
13174,184139,87SYGQjFYUtEWda0pG12bcNker0JGBy3,bWdj2GDclj5ofokWjzoa5jAwMkxCykd6,10,10,0,12,0,2,5,1,30,4.285714285714286,1,0.0,3,0,12,0,7,2,0,5,1,15,15,1
13175,184140,erOlfnGmmzlHYZTaWMuJdUpNjOjYMpjJ,G8EPVSXsOYB5YQWZGiz1aVq5Pgr2GrQu,16,15,15,0,0,0,3,0,33,4.714285714285714,1,0.0,0,15,0,0,15,0,0,3,0,15,18,1
13176,184141,rhwYpyX6KgM0VDKsxgisgjFhLGxmCQNh,SpATywNh6bZuzm8s1ceuBUnMUAeoAHHw,10,5,3,0,3,0,3,0,14,2.0,1,0.0,0,3,0,3,5,0,0,3,0,6,8,1
13177,184159,grKJZKhbDMTJWn0gJUYvmKRwIdpcuPd3,SpATywNh6bZuzm8s1ceuBUnMUAeoAHHw,1,0,0,0,0,0,1,0,1,0.14285714285714285,1,0.0,0,0,0,0,0,0,0,1,0,0,1,1
13178,184162,wrzzafNhG6GCvwxPDE3fRWCo6aRW8DwL,SpATywNh6bZuzm8s1ceuBUnMUAeoAHHw,7,3,2,0,2,0,3,0,10,1.4285714285714286,1,0.0,0,2,0,2,3,0,0,3,0,4,6,1
13179,184177,OOKe107tRCXEu4JY5tmAfF1YLRgWymlM,SpATywNh6bZuzm8s1ceuBUnMUAeoAHHw,7,2,1,0,1,0,4,1,9,1.2857142857142858,1,0.0,0,1,0,1,2,0,0,4,1,2,7,1
13180,184186,VVnP6JrqXx0kcUSjOpF3nGJjlaJ7pttn,RXDvfPUBYFlVdlueBFbLW0mhhAyGEqpt,6,3,2,0,2,4,2,0,13,1.8571428571428572,1,0.0,0,2,0,2,3,4,0,2,0,4,9,1
13181,184196,fz9iMau4c5Sc5pf7Ev3deQnz7r6jSD21,bWdj2GDclj5ofokWjzoa5jAwMkxCykd6,7,4,2,0,1,3,4,0,14,2.0,1,0.0,0,2,0,1,4,3,0,4,0,3,11,1
13182,184198,T5b4rlcXzzOiQabsmSU227C710oPv1q6,SpATywNh6bZuzm8s1ceuBUnMUAeoAHHw,1,0,0,0,0,0,1,0,1,0.14285714285714285,1,0.0,0,0,0,0,0,0,0,1,0,0,1,1
13183,184200,fgbY9PHcmr11G1IYkEJJMMaayPBzrdUL,bWdj2GDclj5ofokWjzoa5jAwMkxCykd6,1,0,0,0,0,0,1,0,1,0.14285714285714285,1,0.0,0,0,0,0,0,0,0,1,0,0,1,1
13184,184206,6YsryIPZKCMdT9rBoswcMetX0bA1SxAS,G8EPVSXsOYB5YQWZGiz1aVq5Pgr2GrQu,1,0,0,0,0,0,1,0,1,0.14285714285714285,1,0.0,0,0,0,0,0,0,0,1,0,0,1,1
13185,184214,dCqryZS5yEyDDbYzWpFyoRjFGlVzafA6,5Gyp41oLVo7Gg7vF4vpmggWP5MU70QO6,1,0,0,0,0,0,1,0,1,0.14285714285714285,1,0.0,0,0,0,0,0,0,0,1,0,0,1,1
13186,184230,YRDulTOgIWgR8cFwTAVhhuxX46WtWav7,5Gyp41oLVo7Gg7vF4vpmggWP5MU70QO6,1,0,0,0,0,0,1,0,1,0.14285714285714285,1,0.0,0,0,0,0,0,0,0,1,0,0,1,1
13187,184232,l4WlJO3Jpy27BdnSHSbIwrtjpEVcxPiy,5Gyp41oLVo7Gg7vF4vpmggWP5MU70QO6,1,0,0,0,0,0,1,0,1,0.14285714285714285,1,0.0,0,0,0,0,0,0,0,1,0,0,1,1
13188,184234,p0nAYIAgPKFrrLkwnZeKFQeORCcXOdHl,5Gyp41oLVo7Gg7vF4vpmggWP5MU70QO6,6,4,1,0,2,0,4,0,11,1.5714285714285714,1,0.0,3,1,0,2,1,0,0,4,0,6,5,0
13189,184237,Im8OZq4WKyr1B9dfjSkTtMelhAH9uWSr,5Gyp41oLVo7Gg7vF4vpmggWP5MU70QO6,1,0,0,0,0,0,1,0,1,0.14285714285714285,1,0.0,0,0,0,0,0,0,0,1,0,0,1,1
13190,184245,YWrHRbNreHJe5iW4BiuBi4YwZG4tk5wx,5Gyp41oLVo7Gg7vF4vpmggWP5MU70QO6,2,0,0,0,0,0,2,0,2,0.2857142857142857,1,0.0,0,0,0,0,0,0,0,2,0,0,2,1
13191,184249,walJZXHwF3doVDD3RPNhbAoeSNaLgA4Q,5Gyp41oLVo7Gg7vF4vpmggWP5MU70QO6,5,2,1,0,1,0,2,0,6,0.8571428571428571,1,0.0,0,1,0,1,2,0,0,2,0,2,4,1
13192,184250,OanBSNHIQYRj4Jp2lzBNtY4pt9ANozmk,5Gyp41oLVo7Gg7vF4vpmggWP5MU70QO6,1,0,0,0,0,0,1,0,1,0.14285714285714285,1,0.0,0,0,0,0,0,0,0,1,0,0,1,1
13193,184273,ryDHfI9VlxEuq9P95xmWnlvLcWdFOBP8,5Gyp41oLVo7Gg7vF4vpmggWP5MU70QO6,6,4,2,0,2,0,2,0,10,1.4285714285714286,1,0.0,0,2,0,2,4,0,0,2,0,4,6,1
13194,184278,ZgpGN88lumfbDP2hVF7RLkOIiFODCDmG,5Gyp41oLVo7Gg7vF4vpmggWP5MU70QO6,2,0,0,0,0,0,3,0,3,0.42857142857142855,1,0.0,0,0,0,0,0,0,0,3,0,0,3,1
13195,184295,EWfAZDd5nGbae5ofnAGOF6BMPZ0hsMJq,5Gyp41oLVo7Gg7vF4vpmggWP5MU70QO6,8,3,2,0,2,1,3,1,12,1.7142857142857142,1,0.0,0,2,0,2,3,1,0,3,1,4,8,1
13196,184296,8ibAJIwvLEy17ev0RSqd01LfNuuU9R2K,5Gyp41oLVo7Gg7vF4vpmggWP5MU70QO6,7,2,0,0,0,1,10,3,16,2.2857142857142856,1,0.0,0,0,0,0,2,1,0,10,3,0,16,1
13197,184301,UKkBInQa7yMHkp5JLcsLsu2Rm6Gu6A10,5Gyp41oLVo7Gg7vF4vpmggWP5MU70QO6,6,3,1,0,1,0,2,0,7,1.0,1,0.0,0,1,0,1,3,0,0,2,0,2,5,1
13198,184307,8DCbMujrfIKOkxYBkibXx1DGndULJunM,5Gyp41oLVo7Gg7vF4vpmggWP5MU70QO6,9,4,3,0,3,0,2,0,12,1.7142857142857142,1,0.0,0,3,0,3,4,0,0,2,0,6,6,1
13199,184316,q1KW22sJlHuJafxKSNMxbZpto7Ue0rxt,5Gyp41oLVo7Gg7vF4vpmggWP5MU70QO6,6,4,1,0,2,0,4,0,11,1.5714285714285714,2,0.0,1,1,0,2,3,0,0,4,0,4,7,1
13200,184319,QoKkWqCz9JSPf2G2l4XrJl2BfFSq9X9B,5Gyp41oLVo7Gg7vF4vpmggWP5MU70QO6,10,8,1,6,0,3,3,0,21,3.0,1,0.0,3,1,3,0,5,3,3,3,0,7,14,1
13201,184325,kw3mSAPGy3lSGYVAwXkjqmqc5eU6galb,5Gyp41oLVo7Gg7vF4vpmggWP5MU70QO6,8,2,2,0,2,0,3,0,9,1.2857142857142858,1,0.0,0,2,0,2,2,0,0,3,0,4,5,1
13202,184329,NmSXtLcHGAQSNZGaHvLyDA6YnNQ58Zgp,5Gyp41oLVo7Gg7vF4vpmggWP5MU70QO6,6,5,2,0,2,0,1,0,10,1.4285714285714286,1,0.0,0,2,0,2,5,0,0,1,0,4,6,1
13203,184335,Gmb2KsL7DF4Lrnaw4YolO7TYaAfk1p9f,5Gyp41oLVo7Gg7vF4vpmggWP5MU70QO6,5,2,1,0,1,0,2,0,6,0.8571428571428571,1,0.0,0,1,0,1,2,0,0,2,0,2,4,1
13204,184344,k1KgfoARLKPwBKFYb9gSMt5WKTItv1kf,5Gyp41oLVo7Gg7vF4vpmggWP5MU70QO6,1,0,0,0,0,0,1,0,1,0.14285714285714285,1,0.0,0,0,0,0,0,0,0,1,0,0,1,1
13205,184349,hQ8hWOlIxDaeW0eIxILffazvx4MDF3wh,5Gyp41oLVo7Gg7vF4vpmggWP5MU70QO6,11,7,5,0,3,0,5,0,20,2.857142857142857,1,0.0,0,5,0,3,7,0,0,5,0,8,12,1
13206,184365,SSGF4jRiMix13YJuADGKuMPfmpw8sSJ7,5Gyp41oLVo7Gg7vF4vpmggWP5MU70QO6,6,3,1,0,1,0,2,0,7,1.0,1,0.0,0,1,0,1,3,0,0,2,0,2,5,1
13207,184379,LAvAjJZzTQAVTvztETb4BVDPuM9nBGU0,5Gyp41oLVo7Gg7vF4vpmggWP5MU70QO6,5,2,1,0,1,0,3,0,7,1.0,2,0.0,0,1,0,1,2,0,0,3,0,2,5,1
13208,184387,Cn5P4KbozwRH67Dsuo8o4HEAMCURG2rp,5Gyp41oLVo7Gg7vF4vpmggWP5MU70QO6,7,1,1,0,1,1,7,1,12,1.7142857142857142,2,0.0,0,1,0,1,1,1,0,7,1,2,10,1
13209,184392,0oQAWSzD0k4f4Ywi9nSJ6FaMaY6F6i7R,5Gyp41oLVo7Gg7vF4vpmggWP5MU70QO6,8,4,3,0,2,0,2,0,11,1.5714285714285714,1,0.0,0,3,0,2,4,0,0,2,0,5,6,1
13210,184393,fbcZHP0ECdlDyz0JOOtSmEtQuMV1LPFH,5Gyp41oLVo7Gg7vF4vpmggWP5MU70QO6,17,22,9,2,5,0,5,0,43,6.142857142857143,1,0.0,1,9,1,5,21,0,1,5,0,16,27,1
13211,184395,IlqSSQgfWr44lC84b9J1DRytAl95LFXm,5Gyp41oLVo7Gg7vF4vpmggWP5MU70QO6,6,5,2,0,1,0,2,0,10,1.4285714285714286,1,0.0,0,2,0,1,5,0,0,2,0,3,7,1
13212,184397,t5GAapz2qu7QW3ZA52Mo1qG5gvWMLT4H,5Gyp41oLVo7Gg7vF4vpmggWP5MU70QO6,1,0,0,0,0,0,1,0,1,0.14285714285714285,1,0.0,0,0,0,0,0,0,0,1,0,0,1,0
13213,184402,tkxwTpjNIcKspgIQFJ1HEHtxSp5ThNsq,5Gyp41oLVo7Gg7vF4vpmggWP5MU70QO6,7,5,3,0,3,2,4,0,17,2.4285714285714284,1,0.0,0,3,0,3,5,2,0,4,0,6,11,1
13214,184412,iNLMSYCSok03nU0WcNw4JJFtx0ifAHYV,5Gyp41oLVo7Gg7vF4vpmggWP5MU70QO6,1,0,0,0,0,0,1,0,1,0.14285714285714285,1,0.0,0,0,0,0,0,0,0,1,0,0,1,1
13215,184430,8s81mHP6Lgrzs5sdzveYdMrxd3ZB96kc,3VkHkmOtom3jM2wCu94xgzzu1d6Dn7or,1,0,0,0,0,0,1,0,1,0.14285714285714285,1,0.0,0,0,0,0,0,0,0,1,0,0,1,1
13216,184516,DTsOT0NTIRutfokoKq4yB8bQe3U1fEsD,3VkHkmOtom3jM2wCu94xgzzu1d6Dn7or,1,0,0,0,0,0,2,0,2,0.2857142857142857,1,0.0,0,0,0,0,0,0,0,2,0,0,2,1
13217,184528,lw6h3s1CoSuypoW7FPPIbDq7fjqWqDdP,3VkHkmOtom3jM2wCu94xgzzu1d6Dn7or,7,2,1,0,1,0,5,1,10,1.4285714285714286,1,0.0,0,1,0,1,2,0,0,5,1,2,8,1
13218,184613,YJAiqoz1F4UNiXHedBcWRmbBhQHxGtrm,3VkHkmOtom3jM2wCu94xgzzu1d6Dn7or,7,4,0,0,0,2,6,1,13,1.8571428571428572,1,0.0,0,0,0,0,4,2,0,6,1,0,13,1
13219,184711,exoKDO0f3lmtTfq6L6YJCwhFZBgMaXfc,3VkHkmOtom3jM2wCu94xgzzu1d6Dn7or,1,0,0,0,0,0,1,0,1,0.14285714285714285,1,0.0,0,0,0,0,0,0,0,1,0,0,1,1
13220,184791,vYxMlW5ssFbn7RCYrcmg1cCFSeVOM9i4,3VkHkmOtom3jM2wCu94xgzzu1d6Dn7or,1,0,0,0,0,0,2,0,2,0.2857142857142857,1,0.0,0,0,0,0,0,0,0,2,0,0,2,0
13221,184793,pHfVmP0MtByC9SkdM1AzMOfjrOpx3mAn,3VkHkmOtom3jM2wCu94xgzzu1d6Dn7or,1,0,0,0,0,0,2,0,2,0.2857142857142857,1,0.0,0,0,0,0,0,0,0,2,0,0,2,1
13222,185695,GeBQuszwSQRCopSsB1wYZb4YBk7b0Cp6,SpATywNh6bZuzm8s1ceuBUnMUAeoAHHw,5,4,3,0,0,0,2,0,9,1.2857142857142858,1,0.0,0,3,0,0,4,0,0,2,0,3,6,1
13223,185708,XKXeDYTx8c3NYYfheBcuxoUZV0qXomPt,RXDvfPUBYFlVdlueBFbLW0mhhAyGEqpt,7,2,1,0,1,0,4,0,8,1.1428571428571428,1,0.0,0,1,0,1,2,0,0,4,0,2,6,1
13224,185744,Az4YfhTihzekQWxQtUyhZcCNXF1QoO5A,A3fsA9Zfv1X2fVEQhTw51lKENdNrEqT3,2,0,0,0,0,0,2,0,2,0.2857142857142857,1,0.0,0,0,0,0,0,0,0,2,0,0,2,1
13225,185750,sJThH3sI3ghUBWEkkF5jl318HrGCcG4Q,SpATywNh6bZuzm8s1ceuBUnMUAeoAHHw,8,14,0,10,0,0,6,0,30,4.285714285714286,1,0.0,11,0,9,0,3,0,1,6,0,20,10,1
13226,185765,EcTOYzny90oltpyqEhmLnMxAbahxVt33,A3fsA9Zfv1X2fVEQhTw51lKENdNrEqT3,16,8,7,0,6,6,4,1,32,4.571428571428571,2,0.0,0,7,0,6,8,6,0,4,1,13,19,1
13227,185777,VDLlgOqW7FFpT6uHqFXXlnnZR1JOz0x8,G8EPVSXsOYB5YQWZGiz1aVq5Pgr2GrQu,2,0,0,0,0,0,2,0,2,0.2857142857142857,1,0.0,0,0,0,0,0,0,0,2,0,0,2,1
13228,185787,pX5xieCfpPW4jfU74i0ayJdMShXi7ShL,A3fsA9Zfv1X2fVEQhTw51lKENdNrEqT3,2,0,0,0,0,0,2,0,2,0.2857142857142857,1,0.0,0,0,0,0,0,0,0,2,0,0,2,1
13229,185791,OLSxCkluLildKVrVnzRIsj47tt9tVHj9,SpATywNh6bZuzm8s1ceuBUnMUAeoAHHw,1,0,0,0,0,0,1,0,1,0.14285714285714285,1,0.0,0,0,0,0,0,0,0,1,0,0,1,1
13230,185804,YxKCslAege9DFmBzH0U7gCkLRow3CW1P,SpATywNh6bZuzm8s1ceuBUnMUAeoAHHw,9,9,7,0,6,0,1,0,23,3.2857142857142856,1,0.0,1,7,0,6,8,0,0,1,0,14,9,1
13231,185828,IlZMDuyHlB01hS9oHYhp77XsI0vMQkwN,bWdj2GDclj5ofokWjzoa5jAwMkxCykd6,7,9,2,0,1,0,5,0,17,2.4285714285714284,2,0.0,0,2,0,1,9,0,0,5,0,3,14,1
13232,185840,9UxAqNYuBtvS2ppV37y5D8wZyoNAl3Em,bWdj2GDclj5ofokWjzoa5jAwMkxCykd6,9,22,7,0,6,0,7,12,54,7.714285714285714,1,0.0,7,7,0,6,15,0,0,7,12,20,34,1
13233,185842,gQqEJZs7B37MmzRexP5otRszUHd2KLYy,SpATywNh6bZuzm8s1ceuBUnMUAeoAHHw,27,22,15,20,8,0,3,0,68,9.714285714285714,2,0.0,4,15,18,8,18,0,2,3,0,45,23,1
13234,185845,nSUHoNpp8PQSdMavNp5bhwMOhBRAUKca,bWdj2GDclj5ofokWjzoa5jAwMkxCykd6,1,0,0,0,0,0,1,0,1,0.14285714285714285,1,0.0,0,0,0,0,0,0,0,1,0,0,1,1
13235,185855,mIK1AsuZnsKqFebwZwvDET5yr9oF0NY2,bWdj2GDclj5ofokWjzoa5jAwMkxCykd6,1,0,0,0,0,0,1,0,1,0.14285714285714285,1,0.0,0,0,0,0,0,0,0,1,0,0,1,1
13236,185864,eQeAZJfAlQDBFNhBayGkUGtYxXtMJqJ1,SpATywNh6bZuzm8s1ceuBUnMUAeoAHHw,11,6,5,0,3,0,6,0,20,2.857142857142857,1,0.0,0,5,0,3,6,0,0,6,0,8,12,1
13237,185868,KZ6GY3fLdtMBq5t6dJwyKZUQ4aE5PB3r,SpATywNh6bZuzm8s1ceuBUnMUAeoAHHw,11,16,1,18,0,0,5,0,40,5.714285714285714,1,0.0,10,1,17,0,6,0,1,5,0,28,12,1
13238,185871,TOGjSTNLmP1U3WLV68xOjR9qYmcLTX2F,bWdj2GDclj5ofokWjzoa5jAwMkxCykd6,4,2,1,0,1,0,1,0,5,0.7142857142857143,1,0.0,0,1,0,1,2,0,0,1,0,2,3,1
13239,185874,U6w2qwGH0WBMPRrilbl2Pu4q8r7wV2i5,RXDvfPUBYFlVdlueBFbLW0mhhAyGEqpt,4,2,1,0,1,0,2,0,6,0.8571428571428571,1,0.0,0,1,0,1,2,0,0,2,0,2,4,0
13240,185878,BCr2GOpOyeEKOuzlRV7PJCL1CEnRyr6Q,A3fsA9Zfv1X2fVEQhTw51lKENdNrEqT3,1,0,0,0,0,0,1,0,1,0.14285714285714285,1,0.0,0,0,0,0,0,0,0,1,0,0,1,1
13241,185900,mP0oq4UFI55XwGbomuLjnKyaYZ9Irhl8,SpATywNh6bZuzm8s1ceuBUnMUAeoAHHw,1,0,0,0,0,0,1,0,1,0.14285714285714285,1,0.0,0,0,0,0,0,0,0,1,0,0,1,1
13242,185906,3RLcNHh9pobwm6kdbgPM3yL4oOSbkTV7,bWdj2GDclj5ofokWjzoa5jAwMkxCykd6,11,8,3,12,2,1,10,3,39,5.571428571428571,1,0.0,1,3,11,2,7,1,1,10,3,17,22,1
13243,185913,JNo2rLqKe6aBGDwGzu8tXd13uOC5tEnq,A3fsA9Zfv1X2fVEQhTw51lKENdNrEqT3,11,8,7,0,0,0,7,0,22,3.142857142857143,1,0.0,0,7,0,0,8,0,0,7,0,7,15,0
13244,185916,AZzjcou5vNOE04RAMAJi2EeLUqqymRTr,SpATywNh6bZuzm8s1ceuBUnMUAeoAHHw,5,2,1,0,1,0,2,0,6,0.8571428571428571,1,0.0,0,1,0,1,2,0,0,2,0,2,4,1
13245,185958,brnRegHqgNF4oAtC7Z92Gvb6wNpNm0iX,SpATywNh6bZuzm8s1ceuBUnMUAeoAHHw,5,2,1,0,1,1,2,0,7,1.0,1,0.0,0,1,0,1,2,1,0,2,0,2,5,1
13246,185973,xpLT6AJby37iITmsTgKzOCviwStat3HT,RXDvfPUBYFlVdlueBFbLW0mhhAyGEqpt,23,38,26,42,16,0,7,0,129,18.428571428571427,3,0.0,3,26,36,16,35,0,6,7,0,81,48,1
13247,186015,IZAsMmFtzA3Z4w092UEvwBTSkmDLpELL,bWdj2GDclj5ofokWjzoa5jAwMkxCykd6,1,0,0,0,0,0,1,0,1,0.14285714285714285,1,0.0,0,0,0,0,0,0,0,1,0,0,1,1
13248,186026,CQWretzMoQOL7mDTUjZusG4cd4L6wPQK,G8EPVSXsOYB5YQWZGiz1aVq5Pgr2GrQu,8,7,5,0,4,0,3,0,19,2.7142857142857144,2,0.0,0,5,0,4,7,0,0,3,0,9,10,1
13249,186031,OrXQ89uxDLDCGqiuZJDaLKhVuW8wRjFm,SpATywNh6bZuzm8s1ceuBUnMUAeoAHHw,1,0,0,0,0,0,1,0,1,0.14285714285714285,1,0.0,0,0,0,0,0,0,0,1,0,0,1,1
13250,186032,q8cwoymgEO62c2PjNUcCMU666aFjaHHf,RXDvfPUBYFlVdlueBFbLW0mhhAyGEqpt,9,4,3,0,3,0,2,0,12,1.7142857142857142,1,0.0,0,3,0,3,4,0,0,2,0,6,6,0
13251,186036,3CK0J1tusVtSvx6F6S9RQr6rj3f2luQC,A3fsA9Zfv1X2fVEQhTw51lKENdNrEqT3,4,1,0,0,0,0,5,0,6,0.8571428571428571,2,0.0,0,0,0,0,1,0,0,5,0,0,6,1
13252,186037,l2J6DNpa2tfvVIbHf48MlgRXXDizR7ZU,RXDvfPUBYFlVdlueBFbLW0mhhAyGEqpt,21,21,2,26,1,0,1,0,51,7.285714285714286,1,0.0,4,2,24,1,17,0,2,1,0,31,20,1
13253,186043,pwdsR2guw7jGBDVAdaksGODr7uJoy6bJ,SpATywNh6bZuzm8s1ceuBUnMUAeoAHHw,1,0,0,0,0,0,1,0,1,0.14285714285714285,1,0.0,0,0,0,0,0,0,0,1,0,0,1,1
13254,186051,pwdsR2guw7jGBDVAdaksGODr7uJoy6bJ,bWdj2GDclj5ofokWjzoa5jAwMkxCykd6,1,0,0,0,0,0,1,0,1,0.14285714285714285,1,0.0,0,0,0,0,0,0,0,1,0,0,1,1
13255,186083,vbZxM4TDv9mGZl0HuTBLAdzQ0iLXNnWT,SpATywNh6bZuzm8s1ceuBUnMUAeoAHHw,7,4,2,0,2,0,2,0,10,1.4285714285714286,2,0.0,0,2,0,2,4,0,0,2,0,4,6,1
13256,186122,tzFDwEYPmJ3KvE5ftnVNKM2NcL054uAX,G8EPVSXsOYB5YQWZGiz1aVq5Pgr2GrQu,6,3,1,0,0,1,4,1,10,1.4285714285714286,1,0.0,0,1,0,0,3,1,0,4,1,1,9,1
13257,186142,JozaCp1AeR7tr4bIEFDuRD5emwNjHpcL,SpATywNh6bZuzm8s1ceuBUnMUAeoAHHw,7,4,0,0,0,10,3,0,17,2.4285714285714284,1,0.0,0,0,0,0,4,10,0,3,0,0,17,1
13258,186154,UY0l6TfHASkV3r4lAYBX1Kuh54Mk5Xfi,RXDvfPUBYFlVdlueBFbLW0mhhAyGEqpt,23,33,2,28,5,0,4,0,72,10.285714285714286,2,0.0,10,2,25,5,23,0,3,4,0,42,30,1
13259,186155,Xl8Tem8G8sPah3KAWnbWgv7GNqLZqPFw,RXDvfPUBYFlVdlueBFbLW0mhhAyGEqpt,1,0,0,0,0,0,1,0,1,0.14285714285714285,1,0.0,0,0,0,0,0,0,0,1,0,0,1,1
13260,186156,ujpnoFj9Sccm69HUxcPfoVG6MkkjyaiE,G8EPVSXsOYB5YQWZGiz1aVq5Pgr2GrQu,10,4,1,0,1,14,10,1,31,4.428571428571429,2,0.0,0,1,0,1,4,14,0,10,1,2,29,0
13261,186158,gHhm2qXabgimtxCoVqwGNu3GtN0RfHoU,G8EPVSXsOYB5YQWZGiz1aVq5Pgr2GrQu,6,2,1,0,1,0,4,0,8,1.1428571428571428,1,0.0,0,1,0,1,2,0,0,4,0,2,6,1
13262,186170,3ULN82Jhvo9A1lCK71PqFv86yozEWjuj,SpATywNh6bZuzm8s1ceuBUnMUAeoAHHw,10,8,5,0,3,0,2,0,18,2.5714285714285716,1,0.0,0,5,0,3,8,0,0,2,0,8,10,1
13263,186194,kQWd08MJREYjLYHoBUU4DknlUSMQ7cCV,SpATywNh6bZuzm8s1ceuBUnMUAeoAHHw,6,4,2,0,2,3,2,0,13,1.8571428571428572,1,0.0,0,2,0,2,4,3,0,2,0,4,9,1
13264,186196,POFpLFsQBaugY3YnnocJIKLsXXkLzRDf,SpATywNh6bZuzm8s1ceuBUnMUAeoAHHw,1,0,0,0,0,0,1,0,1,0.14285714285714285,1,0.0,0,0,0,0,0,0,0,1,0,0,1,1
13265,186198,v6v1hayEEXofBruMyo9TZ2ggXeu5UD3T,A3fsA9Zfv1X2fVEQhTw51lKENdNrEqT3,5,3,1,0,1,0,3,0,8,1.1428571428571428,1,0.0,0,1,0,1,3,0,0,3,0,2,6,1
13266,186211,Zc1PnahT9ISh4c9DBr5jGFkTq2VN1Ayy,G8EPVSXsOYB5YQWZGiz1aVq5Pgr2GrQu,11,14,8,10,3,2,1,0,38,5.428571428571429,1,0.0,5,8,7,3,9,2,3,1,0,23,15,1
13267,186222,vlarE7zCdES78rsfbZ9s0PTdwVr1rAk4,bWdj2GDclj5ofokWjzoa5jAwMkxCykd6,3,3,0,0,0,0,1,0,4,0.5714285714285714,1,0.0,0,0,0,0,3,0,0,1,0,0,4,1
13268,186224,MSWIy7wC5VROeIgPqQIhPQ6v5vOa7TXY,G8EPVSXsOYB5YQWZGiz1aVq5Pgr2GrQu,6,0,0,0,0,1,13,3,17,2.4285714285714284,1,0.0,0,0,0,0,0,1,0,13,3,0,17,1
13269,186246,UY0l6TfHASkV3r4lAYBX1Kuh54Mk5Xfi,A3fsA9Zfv1X2fVEQhTw51lKENdNrEqT3,35,32,1,62,1,0,14,5,115,16.428571428571427,2,0.0,7,1,56,1,25,0,6,14,5,65,50,1
13270,186252,6HmdNYWkOfKPcsSkwkqnh7uY2Gqe1cX7,SpATywNh6bZuzm8s1ceuBUnMUAeoAHHw,5,4,3,0,3,0,2,0,12,1.7142857142857142,2,0.0,0,3,0,3,4,0,0,2,0,6,6,1
13271,186255,vbQsfStPUAntkNJPXL2TWQHB0509Qjr7,A3fsA9Zfv1X2fVEQhTw51lKENdNrEqT3,3,0,0,0,0,0,4,0,4,0.5714285714285714,1,0.0,0,0,0,0,0,0,0,4,0,0,4,1
13272,186266,dehhpoRrM4rg7t676Y7qCiumWRV2WOzS,SpATywNh6bZuzm8s1ceuBUnMUAeoAHHw,1,0,0,0,0,0,1,0,1,0.14285714285714285,1,0.0,0,0,0,0,0,0,0,1,0,0,1,1
13273,186271,XAjd05OrffFBimg6dLsDVkG5Gjsx6XlT,A3fsA9Zfv1X2fVEQhTw51lKENdNrEqT3,1,0,0,0,0,0,1,0,1,0.14285714285714285,1,0.0,0,0,0,0,0,0,0,1,0,0,1,1
13274,186289,rkWpVW2n5cp9IeLZVRLQUrt1dID41LRY,SpATywNh6bZuzm8s1ceuBUnMUAeoAHHw,7,10,6,0,3,0,1,0,20,2.857142857142857,1,0.0,3,6,0,3,7,0,0,1,0,12,8,1
13275,186292,tWw75YIFgGadaRnkyPeGlfSVpk3ysa4L,A3fsA9Zfv1X2fVEQhTw51lKENdNrEqT3,5,3,1,0,1,0,1,0,6,0.8571428571428571,1,0.0,0,1,0,1,3,0,0,1,0,2,4,1
13276,186318,OSHDYiz33FI0tkAswcTI5uxK5gdfibj6,A3fsA9Zfv1X2fVEQhTw51lKENdNrEqT3,3,0,0,0,0,0,3,0,3,0.42857142857142855,1,0.0,0,0,0,0,0,0,0,3,0,0,3,1
13277,186319,8UDPY0GORYpQM3S1dtt5YkG0CDkJUfAi,SpATywNh6bZuzm8s1ceuBUnMUAeoAHHw,8,7,5,0,2,0,2,0,16,2.2857142857142856,1,0.0,0,5,0,2,7,0,0,2,0,7,9,1
13278,186332,SdUI7MFv1cY1lGHTqsLRYstBYRI0xIIR,SpATywNh6bZuzm8s1ceuBUnMUAeoAHHw,13,10,0,18,0,0,5,2,35,5.0,1,0.0,2,0,15,0,8,0,3,5,2,17,18,1
13279,186359,GMzSpgZQ6jzVsfHn8W8i83JsYNxnP00b,RXDvfPUBYFlVdlueBFbLW0mhhAyGEqpt,4,2,1,0,1,0,1,0,5,0.7142857142857143,1,0.0,0,1,0,1,2,0,0,1,0,2,3,1
13280,186375,uQzrox8H38SjXEhLoth5A55QRUWPEK46,G8EPVSXsOYB5YQWZGiz1aVq5Pgr2GrQu,7,4,1,0,1,0,3,0,9,1.2857142857142858,1,0.0,0,1,0,1,4,0,0,3,0,2,7,1
13281,186378,4lhCwJo7yYXKFlssNpVO8DZHuYKFBvLp,A3fsA9Zfv1X2fVEQhTw51lKENdNrEqT3,7,3,2,0,2,6,3,0,16,2.2857142857142856,1,0.0,0,2,0,2,3,6,0,3,0,4,12,1
13282,186398,59oEIRULxWLaLldaaHbqaw4nucIn93k4,G8EPVSXsOYB5YQWZGiz1aVq5Pgr2GrQu,5,2,1,0,1,0,2,0,6,0.8571428571428571,1,0.0,0,1,0,1,2,0,0,2,0,2,4,1
13283,186433,KZqJQBCdtksPSQ3TutEdK8fy0LKI4eut,RXDvfPUBYFlVdlueBFbLW0mhhAyGEqpt,1,0,0,0,0,0,1,0,1,0.14285714285714285,1,0.0,0,0,0,0,0,0,0,1,0,0,1,1
13284,186446,bIezVonf0N1LpjwByS1ltzDSkDe7OlG8,SpATywNh6bZuzm8s1ceuBUnMUAeoAHHw,12,19,10,0,3,1,9,2,44,6.285714285714286,1,0.0,0,10,0,3,19,1,0,9,2,13,31,1
13285,186457,LjhFDdYhdfVWWRFvrc4aNHUi5SD6clAR,bWdj2GDclj5ofokWjzoa5jAwMkxCykd6,4,2,1,0,1,0,1,0,5,0.7142857142857143,1,0.0,0,1,0,1,2,0,0,1,0,2,3,1
13286,186461,qIinMseAcQ8q8AFqNGAlgGp8FqmURvdC,bWdj2GDclj5ofokWjzoa5jAwMkxCykd6,6,3,0,0,0,0,4,0,7,1.0,1,0.0,0,0,0,0,3,0,0,4,0,0,7,1
13287,186471,T7YlTqIDVTZFYEYihxD1Zij5IkDsmVZP,SpATywNh6bZuzm8s1ceuBUnMUAeoAHHw,5,6,3,0,1,0,1,0,11,1.5714285714285714,1,0.0,2,3,0,1,4,0,0,1,0,6,5,1
13288,186475,qsPGhZXTxPpaTY2qxQgCzRxNrBA26TIJ,A3fsA9Zfv1X2fVEQhTw51lKENdNrEqT3,3,1,0,0,0,0,4,0,5,0.7142857142857143,1,0.0,0,0,0,0,1,0,0,4,0,0,5,1
13289,186479,FtIGPSLlLHlXJuNP4CbCwrQzSedZBL0g,SpATywNh6bZuzm8s1ceuBUnMUAeoAHHw,9,9,5,0,3,0,2,0,19,2.7142857142857144,1,0.0,3,5,0,3,6,0,0,2,0,11,8,1
13290,186490,V7rVXKT1jqsQDinfnUz1gk0ep5LdnCQz,SpATywNh6bZuzm8s1ceuBUnMUAeoAHHw,8,2,1,0,1,1,5,1,11,1.5714285714285714,1,0.0,0,1,0,1,2,1,0,5,1,2,9,1
13291,186493,htua1xywlnpsMMY7EJSOsurL86GI912X,bWdj2GDclj5ofokWjzoa5jAwMkxCykd6,3,3,1,0,0,0,1,0,5,0.7142857142857143,1,0.0,0,1,0,0,3,0,0,1,0,1,4,1
13292,186521,4BrXOKatej2Wdv61aLL3SraA7e0yYTLh,SpATywNh6bZuzm8s1ceuBUnMUAeoAHHw,2,0,0,0,0,0,2,0,2,0.2857142857142857,1,0.0,0,0,0,0,0,0,0,2,0,0,2,1
13293,186524,5pfeeYLWSB4wCSWnPZbrmiSBS3yXgMsk,SpATywNh6bZuzm8s1ceuBUnMUAeoAHHw,5,4,0,0,0,0,3,0,7,1.0,1,0.0,0,0,0,0,4,0,0,3,0,0,7,1
13294,186543,bJDihmOTOP8tzchQo3EmXDlLmnZksGMI,SpATywNh6bZuzm8s1ceuBUnMUAeoAHHw,1,0,0,0,0,0,1,0,1,0.14285714285714285,1,0.0,0,0,0,0,0,0,0,1,0,0,1,1
13295,186551,ITnBh4AcTaOdkBvoDVqj5ARkv2J54QTG,SpATywNh6bZuzm8s1ceuBUnMUAeoAHHw,7,2,1,0,1,0,6,1,11,1.5714285714285714,1,0.0,0,1,0,1,2,0,0,6,1,2,9,1
13296,186556,VIptmPegATK5qvvl8OyUabYRGHZdqxvU,SpATywNh6bZuzm8s1ceuBUnMUAeoAHHw,9,4,2,0,2,0,4,1,13,1.8571428571428572,1,0.0,1,2,0,2,3,0,0,4,1,5,8,1
13297,186563,itb7buqF5mtGNemnlGyYA2pmGWssLWjE,SpATywNh6bZuzm8s1ceuBUnMUAeoAHHw,10,6,4,0,3,0,3,0,16,2.2857142857142856,2,0.0,0,4,0,3,6,0,0,3,0,7,9,1
13298,186570,QZIRHdwFgibI2SBehTrmLAZxED1F4JL7,A3fsA9Zfv1X2fVEQhTw51lKENdNrEqT3,14,15,7,0,7,0,1,0,30,4.285714285714286,1,0.0,0,7,0,7,15,0,0,1,0,14,16,1
13299,186572,MYsCU1zkMrWxPhV1b7wSL5LZIo1zGyhU,SpATywNh6bZuzm8s1ceuBUnMUAeoAHHw,1,0,0,0,0,0,1,0,1,0.14285714285714285,1,0.0,0,0,0,0,0,0,0,1,0,0,1,1
13300,186585,4GCFGR3S6zyUaFCN0ANuEVdNqsmLUl3s,SpATywNh6bZuzm8s1ceuBUnMUAeoAHHw,14,43,2,16,0,17,25,3,106,15.142857142857142,2,0.0,14,2,14,0,29,17,2,25,3,30,76,1
13301,186591,ZUogtQULz2GfCq4cni0kVmwpD4O6JuwY,SpATywNh6bZuzm8s1ceuBUnMUAeoAHHw,8,6,1,6,0,0,2,0,15,2.142857142857143,1,0.0,1,1,5,0,5,0,1,2,0,7,8,1
13302,186592,UDgUCnq3QLzgpXlB51yXFWzxVoQqQtdJ,G8EPVSXsOYB5YQWZGiz1aVq5Pgr2GrQu,29,18,15,0,10,0,9,3,55,7.857142857142857,1,0.0,0,15,0,10,18,0,0,9,3,25,30,0
13303,186593,dFhW5phJnKOqlVjNkJknZ8QVATFpUOzD,bWdj2GDclj5ofokWjzoa5jAwMkxCykd6,2,0,0,0,0,0,3,0,3,0.42857142857142855,1,0.0,0,0,0,0,0,0,0,3,0,0,3,1
13304,186596,KZqJQBCdtksPSQ3TutEdK8fy0LKI4eut,bWdj2GDclj5ofokWjzoa5jAwMkxCykd6,1,0,0,0,0,0,1,0,1,0.14285714285714285,1,0.0,0,0,0,0,0,0,0,1,0,0,1,1
13305,186597,KZqJQBCdtksPSQ3TutEdK8fy0LKI4eut,A3fsA9Zfv1X2fVEQhTw51lKENdNrEqT3,1,0,0,0,0,0,1,0,1,0.14285714285714285,1,0.0,0,0,0,0,0,0,0,1,0,0,1,1
13306,186600,RCImAeGNpwksr5OoLexzhMJb9tVjxo1e,SpATywNh6bZuzm8s1ceuBUnMUAeoAHHw,1,0,0,0,0,0,1,0,1,0.14285714285714285,1,0.0,0,0,0,0,0,0,0,1,0,0,1,1
13307,186602,vavfgCcT5IuD68jWJDk0XbOVSfTIDT0M,G8EPVSXsOYB5YQWZGiz1aVq5Pgr2GrQu,7,11,0,0,0,0,6,1,18,2.5714285714285716,1,0.0,0,0,0,0,11,0,0,6,1,0,18,1
13308,186610,BOiGxHn3raRj9eGIKlFjQQHhXEBtSDbh,SpATywNh6bZuzm8s1ceuBUnMUAeoAHHw,2,0,0,0,0,0,2,0,2,0.2857142857142857,1,0.0,0,0,0,0,0,0,0,2,0,0,2,1
13309,186623,OyDMa8JOXSYbsE31qL3fL6emrgq0mwJU,SpATywNh6bZuzm8s1ceuBUnMUAeoAHHw,1,0,0,0,0,0,1,0,1,0.14285714285714285,1,0.0,0,0,0,0,0,0,0,1,0,0,1,1
13310,186635,MZdlzL4gO74etRlgkUDa9eGtQZo9ovTN,SpATywNh6bZuzm8s1ceuBUnMUAeoAHHw,1,0,0,0,0,0,1,0,1,0.14285714285714285,1,0.0,0,0,0,0,0,0,0,1,0,0,1,1
13311,186644,Rv6gVo5TL2yRLbTriDaWEPebl1P4Qs2d,A3fsA9Zfv1X2fVEQhTw51lKENdNrEqT3,1,0,0,0,0,0,1,0,1,0.14285714285714285,1,0.0,0,0,0,0,0,0,0,1,0,0,1,1
13312,186646,EXWNkRXjkZOc8AsQnQXXGYq4K74jND3i,SpATywNh6bZuzm8s1ceuBUnMUAeoAHHw,5,2,1,0,1,0,2,0,6,0.8571428571428571,1,0.0,0,1,0,1,2,0,0,2,0,2,4,1
13313,186650,Rv6gVo5TL2yRLbTriDaWEPebl1P4Qs2d,bWdj2GDclj5ofokWjzoa5jAwMkxCykd6,16,23,9,124,9,0,2,0,167,23.857142857142858,1,0.0,12,9,119,9,11,0,5,2,0,149,18,1
13314,186657,cEMxPdpNr0sg7WlHPqAdbLiWdfHH1ZVi,RXDvfPUBYFlVdlueBFbLW0mhhAyGEqpt,8,5,4,0,2,0,1,0,12,1.7142857142857142,1,0.0,0,4,0,2,5,0,0,1,0,6,6,1
13315,186663,w67bG97cTw7otOM2uWqK71mG1zCn2Z71,RXDvfPUBYFlVdlueBFbLW0mhhAyGEqpt,6,2,1,0,1,0,3,0,7,1.0,1,0.0,1,1,0,1,1,0,0,3,0,3,4,1
13316,186685,NkVQGteS9t3nbfagAzHcxD3mnVkb9mPC,A3fsA9Zfv1X2fVEQhTw51lKENdNrEqT3,35,28,21,64,12,0,7,0,132,18.857142857142858,2,0.0,3,21,56,12,25,0,8,7,0,92,40,1
13317,186707,mnhLxfC9FQKYouYyd3LS1enEfHJfDKsX,G8EPVSXsOYB5YQWZGiz1aVq5Pgr2GrQu,17,18,1,0,1,1,6,0,27,3.857142857142857,2,0.0,0,1,0,1,18,1,0,6,0,2,25,0
13318,186721,XO4yOVP7eCwBTi6pYIgtRmMh0ft7YdHb,bWdj2GDclj5ofokWjzoa5jAwMkxCykd6,6,4,0,0,0,2,8,0,14,2.0,1,0.0,0,0,0,0,4,2,0,8,0,0,14,1
13319,186759,hHVyNQkfLcybgeO1W2xMmju5SBV0vBkh,A3fsA9Zfv1X2fVEQhTw51lKENdNrEqT3,3,2,0,0,0,0,1,0,3,0.42857142857142855,1,0.0,0,0,0,0,2,0,0,1,0,0,3,1
13320,186789,zaUwSB02aOgiyf49lPt6UjZNYDYC7fjT,A3fsA9Zfv1X2fVEQhTw51lKENdNrEqT3,4,2,0,0,0,0,3,0,5,0.7142857142857143,1,0.0,0,0,0,0,2,0,0,3,0,0,5,1
13321,186792,eREFizdpriB0dfyYOU7lPptHy7Cm4d3g,SpATywNh6bZuzm8s1ceuBUnMUAeoAHHw,4,2,0,0,0,0,2,0,4,0.5714285714285714,1,0.0,0,0,0,0,2,0,0,2,0,0,4,1
13322,186797,Eh8pkmowXyhtJAd3Rq2bSawvaaJrouRd,RXDvfPUBYFlVdlueBFbLW0mhhAyGEqpt,6,5,2,0,1,0,4,0,12,1.7142857142857142,2,0.0,0,2,0,1,5,0,0,4,0,3,9,1
13323,186819,vAnLr8TMB4xrFCa1bt8zTG1qXKp0tpM2,SpATywNh6bZuzm8s1ceuBUnMUAeoAHHw,8,2,2,0,1,0,8,0,13,1.8571428571428572,1,0.0,0,2,0,1,2,0,0,8,0,3,10,1
13324,186845,rztgByxlqb0NHiCkVNMSLs4z23c2EnGy,SpATywNh6bZuzm8s1ceuBUnMUAeoAHHw,6,3,2,0,2,0,1,0,8,1.1428571428571428,1,0.0,0,2,0,2,3,0,0,1,0,4,4,1
13325,186852,h8UWLevhpVfEbcVzC3XxVtErwnEzlHV5,RXDvfPUBYFlVdlueBFbLW0mhhAyGEqpt,1,0,0,0,0,0,3,0,3,0.42857142857142855,2,0.0,0,0,0,0,0,0,0,3,0,0,3,0
13326,186879,f5d2qvzqNcWdC1ycnE8TG7hK2snW07TA,SpATywNh6bZuzm8s1ceuBUnMUAeoAHHw,6,8,5,0,4,0,7,0,24,3.4285714285714284,2,0.0,0,5,0,4,8,0,0,7,0,9,15,1
13327,186886,1Che5WZp8JOnI2bMKJvtmSYY66gIbE1b,SpATywNh6bZuzm8s1ceuBUnMUAeoAHHw,8,6,0,0,0,0,3,0,9,1.2857142857142858,1,0.0,0,0,0,0,6,0,0,3,0,0,9,1
13328,186916,n8LY1ToQ2P6PD0SRP8PZWwJUYWAdiNKb,3VkHkmOtom3jM2wCu94xgzzu1d6Dn7or,1,0,0,0,0,0,1,0,1,0.14285714285714285,1,0.0,0,0,0,0,0,0,0,1,0,0,1,1
13329,186946,IUpvJjgbl643UyF8wULi6B9PKWsV1bsS,3VkHkmOtom3jM2wCu94xgzzu1d6Dn7or,1,0,0,0,0,0,1,0,1,0.14285714285714285,1,0.0,0,0,0,0,0,0,0,1,0,0,1,1
13330,186948,Y3GsHv1t2an649bMll1LdxvN2SIICjxG,3VkHkmOtom3jM2wCu94xgzzu1d6Dn7or,1,0,0,0,0,0,1,0,1,0.14285714285714285,1,0.0,0,0,0,0,0,0,0,1,0,0,1,1
13331,186952,u0TAxOeMDUcz4HYUXhtuwFdKGuCQJPP6,3VkHkmOtom3jM2wCu94xgzzu1d6Dn7or,5,7,3,0,3,0,2,0,15,2.142857142857143,2,0.0,2,3,0,3,5,0,0,2,0,8,7,1
13332,186956,cMYfCr1GMHTzG7ZiciGrwM5l2A1AGHh9,3VkHkmOtom3jM2wCu94xgzzu1d6Dn7or,1,0,0,0,0,0,1,0,1,0.14285714285714285,1,0.0,0,0,0,0,0,0,0,1,0,0,1,1
13333,186959,lhe0217AMihRJNo4Bspb4FRLARjvGGyQ,3VkHkmOtom3jM2wCu94xgzzu1d6Dn7or,1,0,0,0,0,0,1,0,1,0.14285714285714285,1,0.0,0,0,0,0,0,0,0,1,0,0,1,1
13334,187005,FHIf7MUGEVUr0CqbuDIIiBw1QO6ZVxVj,3VkHkmOtom3jM2wCu94xgzzu1d6Dn7or,1,0,0,0,0,0,1,0,1,0.14285714285714285,1,0.0,0,0,0,0,0,0,0,1,0,0,1,1
13335,187018,Znmmp6V6FvAQ161tQ3t8Ufq1JqeABV0W,3VkHkmOtom3jM2wCu94xgzzu1d6Dn7or,1,0,0,0,0,0,1,0,1,0.14285714285714285,1,0.0,0,0,0,0,0,0,0,1,0,0,1,1
13336,187036,r235FEYMvkwQSN0TLkhdWY41ThJsKZPI,3VkHkmOtom3jM2wCu94xgzzu1d6Dn7or,13,12,4,0,4,0,9,0,29,4.142857142857143,1,0.0,0,4,0,4,12,0,0,9,0,8,21,1
13337,187037,UOOcBtVsAebNsOt57VwKXO1YgfAVMWii,3VkHkmOtom3jM2wCu94xgzzu1d6Dn7or,7,4,2,0,1,0,6,0,13,1.8571428571428572,1,0.0,0,2,0,1,4,0,0,6,0,3,10,1
13338,187070,36E8EgprLSCZHQtlY5yjvPm97JUh2cfX,3VkHkmOtom3jM2wCu94xgzzu1d6Dn7or,1,0,0,0,0,0,1,0,1,0.14285714285714285,1,0.0,0,0,0,0,0,0,0,1,0,0,1,1
13339,187075,uBzcfb44icLfh2f5mW4iYyj6hSWSmS38,3VkHkmOtom3jM2wCu94xgzzu1d6Dn7or,9,15,6,0,5,2,15,4,47,6.714285714285714,2,0.0,5,6,0,5,10,2,0,15,4,16,31,1
13340,187090,s89uavZ3km9aogxJ45C1gOIn37jOvzBC,fbPkOYLVPtPgIt0MxizjfFJov3JbHyAi,9,8,4,0,3,0,3,0,18,2.5714285714285716,1,0.0,0,4,0,3,8,0,0,3,0,7,11,1
13341,187093,TlbmE7XsXOxA9LAHMAGK9zsRJszf1Jcd,fbPkOYLVPtPgIt0MxizjfFJov3JbHyAi,18,23,18,0,1,1,3,0,46,6.571428571428571,1,0.0,4,18,0,1,19,1,0,3,0,23,23,1
13342,187096,nW9f9CiPiXdcUNUj5HdltqeG1yplsOpj,fbPkOYLVPtPgIt0MxizjfFJov3JbHyAi,1,0,0,0,0,0,1,0,1,0.14285714285714285,1,0.0,0,0,0,0,0,0,0,1,0,0,1,1
13343,187097,FVIxcL3KNPZgRk3VAWTB53BK2VJRJoNW,fbPkOYLVPtPgIt0MxizjfFJov3JbHyAi,8,5,1,8,1,0,2,0,17,2.4285714285714284,1,0.0,1,1,6,1,4,0,2,2,0,9,8,1
13344,187099,kXSl6jg4QHUvxsqBcAJXHeR9Ubl1gwbF,fbPkOYLVPtPgIt0MxizjfFJov3JbHyAi,1,0,0,0,0,0,1,0,1,0.14285714285714285,1,0.0,0,0,0,0,0,0,0,1,0,0,1,1
13345,187101,FlAkKX6ow9SvOzk0dTWPWgnX5766zY29,fbPkOYLVPtPgIt0MxizjfFJov3JbHyAi,1,0,0,0,0,0,1,0,1,0.14285714285714285,1,0.0,0,0,0,0,0,0,0,1,0,0,1,1
13346,187102,e40FG7MgJJlfB40dPeqwApGpeo4I5srR,fbPkOYLVPtPgIt0MxizjfFJov3JbHyAi,8,7,3,0,2,0,2,0,14,2.0,1,0.0,0,3,0,2,7,0,0,2,0,5,9,1
13347,187105,9DE0a3KJcJqzkMoD4VYpnCDg9cCk5hV4,fbPkOYLVPtPgIt0MxizjfFJov3JbHyAi,2,0,0,0,0,0,2,0,2,0.2857142857142857,1,0.0,0,0,0,0,0,0,0,2,0,0,2,1
13348,187107,rG7M6TKyUFqXw8w8ui7NRfruQr8bRWFG,fbPkOYLVPtPgIt0MxizjfFJov3JbHyAi,5,2,1,0,1,0,2,0,6,0.8571428571428571,1,0.0,0,1,0,1,2,0,0,2,0,2,4,1
13349,187111,5Pwkqnt6BX10vyfbMPXwyyxMRo64zs7g,fbPkOYLVPtPgIt0MxizjfFJov3JbHyAi,1,0,0,0,0,0,1,0,1,0.14285714285714285,1,0.0,0,0,0,0,0,0,0,1,0,0,1,1
13350,187115,4XcgNL1U2xG3iw9wdTEeH4HKfjTMhScM,fbPkOYLVPtPgIt0MxizjfFJov3JbHyAi,6,3,2,0,2,0,1,0,8,1.1428571428571428,1,0.0,0,2,0,2,3,0,0,1,0,4,4,1
13351,187230,hyOYv4rmSRnv16UkVW9gdxwUgBZxYdhv,5Gyp41oLVo7Gg7vF4vpmggWP5MU70QO6,8,5,4,0,4,0,1,0,14,2.0,1,0.0,0,4,0,4,5,0,0,1,0,8,6,1
13352,187260,vzQWE9ulRkQ7hUrO1Cw0UEGI4ALwL8Jg,5Gyp41oLVo7Gg7vF4vpmggWP5MU70QO6,5,4,3,0,2,0,2,0,11,1.5714285714285714,1,0.0,0,3,0,2,4,0,0,2,0,5,6,1
13353,187263,VoWsW4btdFhDkZDVEDrYE0OgkSDO7WLH,5Gyp41oLVo7Gg7vF4vpmggWP5MU70QO6,11,18,5,7,5,0,5,0,40,5.714285714285714,1,0.0,13,5,4,5,5,0,3,5,0,27,13,1
13354,187281,tI0Ei8jknXkjHOveohv83xyWyLEH72Bz,5Gyp41oLVo7Gg7vF4vpmggWP5MU70QO6,1,0,0,0,0,0,1,0,1,0.14285714285714285,1,0.0,0,0,0,0,0,0,0,1,0,0,1,1
13355,187292,PHXAtnilhkAfYARsAg1caWvqdybDG9wd,5Gyp41oLVo7Gg7vF4vpmggWP5MU70QO6,1,0,0,0,0,0,1,0,1,0.14285714285714285,1,0.0,0,0,0,0,0,0,0,1,0,0,1,1
13356,187293,y6skA61OxQXi41KVikPwH48hFkcuo8s0,5Gyp41oLVo7Gg7vF4vpmggWP5MU70QO6,2,0,0,0,0,1,1,0,2,0.2857142857142857,1,0.0,0,0,0,0,0,1,0,1,0,0,2,1
13357,187296,rtpXqjUa2W2r0HFNo4cTJ57QxTOXAUvW,5Gyp41oLVo7Gg7vF4vpmggWP5MU70QO6,6,7,0,0,0,0,2,0,9,1.2857142857142858,1,0.0,0,0,0,0,7,0,0,2,0,0,9,1
13358,187298,X7FeDRCspdh7NOzhLrJrdldfEZBgFA5Q,5Gyp41oLVo7Gg7vF4vpmggWP5MU70QO6,2,0,0,0,0,0,3,0,3,0.42857142857142855,1,0.0,0,0,0,0,0,0,0,3,0,0,3,1
13359,187320,DUrwR1Re5QIiLZZaDVxG0FXYJXyscHgC,5Gyp41oLVo7Gg7vF4vpmggWP5MU70QO6,1,0,0,0,0,0,2,0,2,0.2857142857142857,1,0.0,0,0,0,0,0,0,0,2,0,0,2,1
13360,187327,031MrYvOJqNjV16O5cUmmCo9dFy2kyYH,5Gyp41oLVo7Gg7vF4vpmggWP5MU70QO6,5,2,1,0,1,0,3,0,7,1.0,2,0.0,0,1,0,1,2,0,0,3,0,2,5,1
13361,187346,X8WCNt6loaLNoumdckfUSubkNRieo8NK,5Gyp41oLVo7Gg7vF4vpmggWP5MU70QO6,10,7,3,8,2,0,2,0,22,3.142857142857143,1,0.0,3,3,5,2,4,0,3,2,0,13,9,1
13362,187368,PehE9hSoHmU2qayrquECF2Z72j2CCoBa,5Gyp41oLVo7Gg7vF4vpmggWP5MU70QO6,11,6,3,6,3,0,2,0,20,2.857142857142857,1,0.0,2,3,4,3,4,0,2,2,0,12,8,1
13363,187402,1uOPQAhAVE7yRowaAKEn61VPIsM6sMCc,5Gyp41oLVo7Gg7vF4vpmggWP5MU70QO6,1,0,0,0,0,0,1,0,1,0.14285714285714285,1,0.0,0,0,0,0,0,0,0,1,0,0,1,1
13364,187436,XJpybRSv6nblPDjgevLWB1Ktkzr6kyjz,5Gyp41oLVo7Gg7vF4vpmggWP5MU70QO6,7,3,2,0,2,0,3,0,10,1.4285714285714286,1,0.0,0,2,0,2,3,0,0,3,0,4,6,0
13365,187461,kHMfLm6GLGyN2t8DdFTcaIg1JDY9sN2O,5Gyp41oLVo7Gg7vF4vpmggWP5MU70QO6,4,2,1,0,1,0,1,0,5,0.7142857142857143,1,0.0,0,1,0,1,2,0,0,1,0,2,3,1
13366,187531,bNDMI0LSeZpYXzR656IEJ9nN2Bo4tKbR,5Gyp41oLVo7Gg7vF4vpmggWP5MU70QO6,7,4,2,0,2,0,2,0,10,1.4285714285714286,1,0.0,1,2,0,2,3,0,0,2,0,5,5,1
13367,187539,ZzaZO5citAcoeYBQ4xnco2bMgq0deP0c,5Gyp41oLVo7Gg7vF4vpmggWP5MU70QO6,6,3,2,0,2,0,2,0,9,1.2857142857142858,1,0.0,0,2,0,2,3,0,0,2,0,4,5,1
13368,187559,UvSwBvBH1lyOipF4wGbdNVoeT8lJP5aY,5Gyp41oLVo7Gg7vF4vpmggWP5MU70QO6,8,6,4,0,5,0,3,0,18,2.5714285714285716,1,0.0,1,4,0,5,5,0,0,3,0,10,8,1
13369,187588,rOtdN0YIXzc9Q3VhwhOR72jeW5lVoqLk,5Gyp41oLVo7Gg7vF4vpmggWP5MU70QO6,1,0,0,0,0,0,1,0,1,0.14285714285714285,1,0.0,0,0,0,0,0,0,0,1,0,0,1,1
13370,187634,oVtSGZ3Qh0AOmlaUwqXBN2XqCeY3aZXg,5Gyp41oLVo7Gg7vF4vpmggWP5MU70QO6,8,5,2,2,2,0,1,0,12,1.7142857142857142,1,0.0,1,2,1,2,4,0,1,1,0,6,6,1
13371,187642,hBqYoPWGXo4KdSE3ypv2nDXmsYrpwKgj,5Gyp41oLVo7Gg7vF4vpmggWP5MU70QO6,1,0,0,0,0,0,1,0,1,0.14285714285714285,1,0.0,0,0,0,0,0,0,0,1,0,0,1,1
13372,187646,8TnzjeqjtzBIk5Ql7fkT5COqEK4SmduG,5Gyp41oLVo7Gg7vF4vpmggWP5MU70QO6,5,2,1,0,1,0,2,0,6,0.8571428571428571,1,0.0,0,1,0,1,2,0,0,2,0,2,4,1
13373,187666,gEQJ3UM0yClKwkCWvNfY56DY3nmyC9PH,5Gyp41oLVo7Gg7vF4vpmggWP5MU70QO6,1,0,0,0,0,0,1,0,1,0.14285714285714285,1,0.0,0,0,0,0,0,0,0,1,0,0,1,1
13374,187685,4YD7ENfnhFTRFL7ILKgGgEPnhlw4hbFM,5Gyp41oLVo7Gg7vF4vpmggWP5MU70QO6,16,21,8,8,7,0,2,0,46,6.571428571428571,1,0.0,9,8,5,7,12,0,3,2,0,29,17,1
13375,187743,dDNJlkechDaI59ozHemH2ci9sMXgZuGy,5Gyp41oLVo7Gg7vF4vpmggWP5MU70QO6,1,0,0,0,0,0,1,0,1,0.14285714285714285,1,0.0,0,0,0,0,0,0,0,1,0,0,1,1
13376,187778,TFGsSi9KLgFMzGuAkbmIBjdVI0bCDL1L,5Gyp41oLVo7Gg7vF4vpmggWP5MU70QO6,9,13,4,2,1,0,2,0,22,3.142857142857143,1,0.0,2,4,1,1,11,0,1,2,0,8,14,1
13377,187792,LfsAkbTX7fJr35wgA2mTq5FGmS91YLIg,5Gyp41oLVo7Gg7vF4vpmggWP5MU70QO6,1,0,0,0,0,0,1,0,1,0.14285714285714285,1,0.0,0,0,0,0,0,0,0,1,0,0,1,1
13378,187795,clbUGnOQsN7CuaV7idGJ2LVbYN3t8qC3,5Gyp41oLVo7Gg7vF4vpmggWP5MU70QO6,1,0,0,0,0,0,1,0,1,0.14285714285714285,1,0.0,0,0,0,0,0,0,0,1,0,0,1,0
13379,187811,svIGNMVQDEQItjiVEcEkS0o4Jv6ND7Cf,5Gyp41oLVo7Gg7vF4vpmggWP5MU70QO6,10,10,5,0,5,1,5,1,27,3.857142857142857,1,0.0,0,5,0,5,10,1,0,5,1,10,17,1
13380,187844,RgHRxvakRmUixgorlOGDqgR6MDRVkg1a,5Gyp41oLVo7Gg7vF4vpmggWP5MU70QO6,6,6,2,0,1,0,3,0,12,1.7142857142857142,1,0.0,0,2,0,1,6,0,0,3,0,3,9,1
13381,187857,0wd79ct9K0tXadEnPdbTVwaGgB8OZiGG,5Gyp41oLVo7Gg7vF4vpmggWP5MU70QO6,4,2,1,0,1,0,2,0,6,0.8571428571428571,1,0.0,0,1,0,1,2,0,0,2,0,2,4,1
13382,187904,CXsyB1ZLXRIghLjiAkglC0ZPywZoViBf,5Gyp41oLVo7Gg7vF4vpmggWP5MU70QO6,16,19,13,0,4,6,13,1,56,8.0,1,0.0,2,13,0,4,17,6,0,13,1,19,37,1
13383,187926,1zhWSkL1LgbM9Ql0JYjCdksX2L8b6ju3,5Gyp41oLVo7Gg7vF4vpmggWP5MU70QO6,1,0,0,0,0,0,1,0,1,0.14285714285714285,1,0.0,0,0,0,0,0,0,0,1,0,0,1,1
13384,187932,FwweMXtSQjX7f97OVLsz3BQNG8M83X1n,5Gyp41oLVo7Gg7vF4vpmggWP5MU70QO6,5,2,1,0,1,0,2,0,6,0.8571428571428571,1,0.0,0,1,0,1,2,0,0,2,0,2,4,1
13385,187949,sb7hNSICYIB8DwdqmDVZhADtdsUmB6A8,5Gyp41oLVo7Gg7vF4vpmggWP5MU70QO6,4,2,1,0,1,0,2,0,6,0.8571428571428571,1,0.0,0,1,0,1,2,0,0,2,0,2,4,1
13386,187957,rkTpZfWEwpYaYW4DQ2jc028n8OL8yZxV,5Gyp41oLVo7Gg7vF4vpmggWP5MU70QO6,2,0,0,0,0,0,2,0,2,0.2857142857142857,1,0.0,0,0,0,0,0,0,0,2,0,0,2,1
13387,187974,jEi13xq4MqrYBERiBNsPcCHETD8jUjLz,5Gyp41oLVo7Gg7vF4vpmggWP5MU70QO6,12,8,6,0,3,0,4,0,21,3.0,1,0.0,0,6,0,3,8,0,0,4,0,9,12,1
13388,188034,EZ3Ou5LoxQTuPntDejOm1oOPtMjZiZw9,5Gyp41oLVo7Gg7vF4vpmggWP5MU70QO6,1,0,0,0,0,0,1,0,1,0.14285714285714285,1,0.0,0,0,0,0,0,0,0,1,0,0,1,1
13389,188042,LLPFOetEZAXeG8yuEAYd66ngAGbEUiF6,5Gyp41oLVo7Gg7vF4vpmggWP5MU70QO6,1,0,0,0,0,0,1,0,1,0.14285714285714285,1,0.0,0,0,0,0,0,0,0,1,0,0,1,1
13390,188057,OVHybOodwAI8dJTggwddA43nUNgwwGTK,5Gyp41oLVo7Gg7vF4vpmggWP5MU70QO6,15,13,8,0,5,0,1,0,27,3.857142857142857,1,0.0,4,8,0,5,9,0,0,1,0,17,10,1
13391,188059,LdFBcSrOERy4lkOWuGPkFS72yiaKyYyW,5Gyp41oLVo7Gg7vF4vpmggWP5MU70QO6,5,2,0,0,1,0,2,0,5,0.7142857142857143,1,0.0,0,0,0,1,2,0,0,2,0,1,4,1
13392,188066,eI5x3pfKI3nJIhgLZUUaCzO9j8tp1lJj,5Gyp41oLVo7Gg7vF4vpmggWP5MU70QO6,5,2,1,0,1,0,2,0,6,0.8571428571428571,1,0.0,0,1,0,1,2,0,0,2,0,2,4,1
13393,188079,vigCNwN0hx9Veb8D37LCQqqHmlPvVayo,5Gyp41oLVo7Gg7vF4vpmggWP5MU70QO6,14,16,9,9,4,0,3,0,41,5.857142857142857,1,0.0,4,9,6,4,12,0,3,3,0,23,18,1
13394,188082,jG3lTvAWrNAXi6KwS9dxU6MbGOx8WqRE,5Gyp41oLVo7Gg7vF4vpmggWP5MU70QO6,6,3,2,0,2,0,1,0,8,1.1428571428571428,1,0.0,0,2,0,2,3,0,0,1,0,4,4,1
13395,188096,w8S7oPNGWahl5gDDyBTLSciA1VA7haw4,A3fsA9Zfv1X2fVEQhTw51lKENdNrEqT3,19,17,11,0,8,0,2,0,38,5.428571428571429,1,0.0,3,11,0,8,14,0,0,2,0,22,16,1
13396,188103,O8GYzagsTrclNZXR3HZD1CBdMlg7RUB6,SpATywNh6bZuzm8s1ceuBUnMUAeoAHHw,4,2,0,0,0,0,2,0,4,0.5714285714285714,1,0.0,0,0,0,0,2,0,0,2,0,0,4,1
13397,188113,Q8i7XHeUD92Ae2WeCoNsZYF9vQYf3HPz,SpATywNh6bZuzm8s1ceuBUnMUAeoAHHw,1,0,0,0,0,0,1,0,1,0.14285714285714285,1,0.0,0,0,0,0,0,0,0,1,0,0,1,1
13398,188129,bA4tnPZD0UU4XAL3OkL7nUjtkAzbgj9d,SpATywNh6bZuzm8s1ceuBUnMUAeoAHHw,13,26,11,0,6,0,3,0,46,6.571428571428571,1,0.0,7,11,0,6,19,0,0,3,0,24,22,1
13399,188157,2hMeaUc14fgUG8b3kgXxN1xDYogexPXy,A3fsA9Zfv1X2fVEQhTw51lKENdNrEqT3,8,5,4,0,3,0,1,0,13,1.8571428571428572,1,0.0,0,4,0,3,5,0,0,1,0,7,6,1
13400,188168,Q2xVgvnqNYVNG5kOgvnpJvY9QuBN0RbG,bWdj2GDclj5ofokWjzoa5jAwMkxCykd6,6,3,1,0,1,0,2,0,7,1.0,1,0.0,0,1,0,1,3,0,0,2,0,2,5,1
13401,188176,wwrhZcbbsWF5UNfVZIIcfrs0NelO6L0J,bWdj2GDclj5ofokWjzoa5jAwMkxCykd6,5,2,1,0,1,0,2,0,6,0.8571428571428571,1,0.0,0,1,0,1,2,0,0,2,0,2,4,1
13402,188188,Vhmq36VBivLuLEONnhTEAZGyc0lOW8HG,SpATywNh6bZuzm8s1ceuBUnMUAeoAHHw,1,0,0,0,0,0,1,0,1,0.14285714285714285,1,0.0,0,0,0,0,0,0,0,1,0,0,1,1
13403,188191,K6d2j7PmZmtKVENKrnd412mUvCD6G0Iq,A3fsA9Zfv1X2fVEQhTw51lKENdNrEqT3,36,21,10,52,8,0,9,1,101,14.428571428571429,1,0.0,3,10,47,8,18,0,5,9,1,68,33,1
13404,188218,ycZck16llBAZloBk10bwfMcnaMnaXQWK,RXDvfPUBYFlVdlueBFbLW0mhhAyGEqpt,6,5,0,0,0,0,5,0,10,1.4285714285714286,1,0.0,0,0,0,0,5,0,0,5,0,0,10,1
13405,188241,UQu58ECfm706pzTxKdZuMBkLVofX5BYJ,bWdj2GDclj5ofokWjzoa5jAwMkxCykd6,7,3,2,0,2,0,2,0,9,1.2857142857142858,1,0.0,0,2,0,2,3,0,0,2,0,4,5,1
13406,188249,55wiWWDY37Jvz4XRR5WZBukpONx2E6zf,bWdj2GDclj5ofokWjzoa5jAwMkxCykd6,5,5,3,0,2,0,2,0,12,1.7142857142857142,1,0.0,0,3,0,2,5,0,0,2,0,5,7,1
13407,188256,QycCZ3StVS9Q0gqdzH8YDRcbrA6KQPic,SpATywNh6bZuzm8s1ceuBUnMUAeoAHHw,22,35,11,15,6,0,2,0,69,9.857142857142858,1,0.0,21,11,15,6,14,0,0,2,0,53,16,1
13408,188301,CwrmTUMTRx5M6yQJpPEbrBRyJawjn4Ps,SpATywNh6bZuzm8s1ceuBUnMUAeoAHHw,1,0,0,0,0,0,1,0,1,0.14285714285714285,1,0.0,0,0,0,0,0,0,0,1,0,0,1,1
13409,188323,08FXiN9E2j1PM7CMfj415B4erdhymv4G,SpATywNh6bZuzm8s1ceuBUnMUAeoAHHw,9,2,2,0,2,0,7,1,14,2.0,1,0.0,0,2,0,2,2,0,0,7,1,4,10,1
13410,188332,WxVM9kOqNmenlQy1YKMo3yVYKYKkewCz,bWdj2GDclj5ofokWjzoa5jAwMkxCykd6,1,0,0,0,0,0,1,0,1,0.14285714285714285,1,0.0,0,0,0,0,0,0,0,1,0,0,1,1
13411,188338,7xGbu9oc4JWGY9fgiUO3Qqm473RvS2PB,SpATywNh6bZuzm8s1ceuBUnMUAeoAHHw,7,3,2,0,2,0,2,0,9,1.2857142857142858,1,0.0,0,2,0,2,3,0,0,2,0,4,5,1
13412,188348,4ly9tFjgsKJLiMP1XUHFz2i27nHiXdvU,A3fsA9Zfv1X2fVEQhTw51lKENdNrEqT3,8,3,2,0,0,5,6,1,17,2.4285714285714284,1,0.0,0,2,0,0,3,5,0,6,1,2,15,1
13413,188374,U30BvMtyZpL38NHSSIWCu0FHJgAKw4Fr,A3fsA9Zfv1X2fVEQhTw51lKENdNrEqT3,2,0,0,0,0,0,3,0,3,0.42857142857142855,1,0.0,0,0,0,0,0,0,0,3,0,0,3,0
13414,188386,q3NLZCkaVgPCeFUby9MsDXbo2vYw2wOB,SpATywNh6bZuzm8s1ceuBUnMUAeoAHHw,1,0,0,0,0,0,1,0,1,0.14285714285714285,1,0.0,0,0,0,0,0,0,0,1,0,0,1,1
13415,188415,GAKCidUQ8hdeh0WMwEYlK9cUZXNPRN5R,RXDvfPUBYFlVdlueBFbLW0mhhAyGEqpt,1,0,0,0,0,0,1,0,1,0.14285714285714285,1,0.0,0,0,0,0,0,0,0,1,0,0,1,1
13416,188427,btK3RdfuvWrDzNhOkrOpUgTbQUI2vrLY,SpATywNh6bZuzm8s1ceuBUnMUAeoAHHw,6,7,1,0,1,0,1,0,10,1.4285714285714286,1,0.0,3,1,0,1,4,0,0,1,0,5,5,1
13417,188446,3tkincdjsTSFt3awGPKGfVv9zR1YRwuC,SpATywNh6bZuzm8s1ceuBUnMUAeoAHHw,1,0,0,0,0,0,1,0,1,0.14285714285714285,1,0.0,0,0,0,0,0,0,0,1,0,0,1,1
13418,188447,DUw85TcNpxyZaZKIM1HlHxvgtSm7uwxY,G8EPVSXsOYB5YQWZGiz1aVq5Pgr2GrQu,5,2,1,0,1,0,2,0,6,0.8571428571428571,1,0.0,0,1,0,1,2,0,0,2,0,2,4,0
13419,188458,jFwDcIl1Tm6UHlfb8PtOob6kZkOEjdQr,RXDvfPUBYFlVdlueBFbLW0mhhAyGEqpt,1,0,0,0,0,0,1,0,1,0.14285714285714285,1,0.0,0,0,0,0,0,0,0,1,0,0,1,1
13420,188461,blQKCpClzsxilnQtKRruTVl5WFjEiUZ7,SpATywNh6bZuzm8s1ceuBUnMUAeoAHHw,5,4,3,0,2,0,1,0,10,1.4285714285714286,1,0.0,0,3,0,2,4,0,0,1,0,5,5,1
13421,188475,Onp8u1IlkiXCdEq7Tg9xltw0KEKQAxrs,SpATywNh6bZuzm8s1ceuBUnMUAeoAHHw,6,3,2,0,2,0,1,0,8,1.1428571428571428,1,0.0,0,2,0,2,3,0,0,1,0,4,4,1
13422,188481,gkv9GP4XDvDQ4me5aOnbcgCOOilwq0mr,SpATywNh6bZuzm8s1ceuBUnMUAeoAHHw,1,0,0,0,0,0,1,0,1,0.14285714285714285,1,0.0,0,0,0,0,0,0,0,1,0,0,1,1
13423,188487,yQM2e0pQ43tZ4WbvgNqCdUjXo9r9zUpY,bWdj2GDclj5ofokWjzoa5jAwMkxCykd6,1,0,0,0,0,0,1,0,1,0.14285714285714285,1,0.0,0,0,0,0,0,0,0,1,0,0,1,1
13424,188509,NhmfopX2bIkd9yTnVyho2Qq41VTy8NFx,SpATywNh6bZuzm8s1ceuBUnMUAeoAHHw,6,1,1,0,1,0,3,0,6,0.8571428571428571,1,0.0,0,1,0,1,1,0,0,3,0,2,4,1
13425,188511,g6p03sN0Mi0uDRMoaBI65emUrtGFnpP4,RXDvfPUBYFlVdlueBFbLW0mhhAyGEqpt,20,13,9,14,7,0,7,1,51,7.285714285714286,1,0.0,2,9,14,7,11,0,0,7,1,32,19,1
13426,188522,VZRd1DrilkNeD7Ya8MVZCNtIczH3eEMz,G8EPVSXsOYB5YQWZGiz1aVq5Pgr2GrQu,21,42,24,26,6,0,15,1,114,16.285714285714285,2,0.0,9,24,17,6,33,0,9,15,1,56,58,1
13427,188544,wiVLWKqdbOlotFq1ag8KwC6Hw3JbpdNh,SpATywNh6bZuzm8s1ceuBUnMUAeoAHHw,6,3,1,0,1,0,2,0,7,1.0,1,0.0,0,1,0,1,3,0,0,2,0,2,5,1
13428,188555,uo8XRoO08TmpTH4gap159tNYVx3xop3U,G8EPVSXsOYB5YQWZGiz1aVq5Pgr2GrQu,1,0,0,0,0,0,1,0,1,0.14285714285714285,1,0.0,0,0,0,0,0,0,0,1,0,0,1,1
13429,188558,xqboiFlp42vyY93nDStsbVWBCL5sgIRH,A3fsA9Zfv1X2fVEQhTw51lKENdNrEqT3,24,23,1,16,1,0,7,0,48,6.857142857142857,1,0.0,0,1,13,1,23,0,3,7,0,15,33,1
13430,188561,6mdM8AvYlfditnue2TYJQLFDiBvxSUej,G8EPVSXsOYB5YQWZGiz1aVq5Pgr2GrQu,7,3,0,0,0,0,4,0,7,1.0,1,0.0,0,0,0,0,3,0,0,4,0,0,7,1
13431,188563,SiYxfRymwR9ZXmdv7LpkIYvuHNblUn46,bWdj2GDclj5ofokWjzoa5jAwMkxCykd6,2,0,0,0,0,0,2,0,2,0.2857142857142857,1,0.0,0,0,0,0,0,0,0,2,0,0,2,1
13432,188568,SiYxfRymwR9ZXmdv7LpkIYvuHNblUn46,RXDvfPUBYFlVdlueBFbLW0mhhAyGEqpt,1,0,0,0,0,0,1,0,1,0.14285714285714285,1,0.0,0,0,0,0,0,0,0,1,0,0,1,1
13433,188587,giGUAF5TXBP4oix75tUgV16Pg3alJM4Y,SpATywNh6bZuzm8s1ceuBUnMUAeoAHHw,1,0,0,0,0,0,1,0,1,0.14285714285714285,1,0.0,0,0,0,0,0,0,0,1,0,0,1,1
13434,188602,faupOzOQrYnrhUP3CZcXERH5hL8Q3xd2,bWdj2GDclj5ofokWjzoa5jAwMkxCykd6,8,6,2,32,1,3,3,0,47,6.714285714285714,2,0.0,1,2,31,1,5,3,1,3,0,35,12,1
13435,188639,sKKYS1ogqmOcjeYfYtZMxdkgoIt3cEVK,SpATywNh6bZuzm8s1ceuBUnMUAeoAHHw,18,15,7,0,7,0,4,0,33,4.714285714285714,1,0.0,0,7,0,7,15,0,0,4,0,14,19,1
13436,188667,aTM8g4rbVmgmqSlbdFoile3z2S6Tt4FV,3VkHkmOtom3jM2wCu94xgzzu1d6Dn7or,1,0,0,0,0,0,1,0,1,0.14285714285714285,1,0.0,0,0,0,0,0,0,0,1,0,0,1,1
13437,188678,sH2wlo6XXe7iJmjEIjVMN0eUnM6tyJrb,3VkHkmOtom3jM2wCu94xgzzu1d6Dn7or,4,2,1,0,1,0,1,0,5,0.7142857142857143,1,0.0,0,1,0,1,2,0,0,1,0,2,3,1
13438,188679,xMj985YGbnpmmaLLf9WHP3PHD8Af4HUa,3VkHkmOtom3jM2wCu94xgzzu1d6Dn7or,1,0,0,0,0,0,1,0,1,0.14285714285714285,1,0.0,0,0,0,0,0,0,0,1,0,0,1,1
13439,188689,ZlP72meXD3MdCpVYscW7cYVXmtXePojB,3VkHkmOtom3jM2wCu94xgzzu1d6Dn7or,4,2,0,0,0,0,2,0,4,0.5714285714285714,1,0.0,0,0,0,0,2,0,0,2,0,0,4,1
13440,188691,L5NduWAYcxynKXLIOf08sDGftk9wzQ6a,3VkHkmOtom3jM2wCu94xgzzu1d6Dn7or,7,7,4,0,2,0,3,0,16,2.2857142857142856,1,0.0,0,4,0,2,7,0,0,3,0,6,10,1
13441,188695,9O96GqJH5wK5Lu00wbAHcbR9RNQjfzP1,3VkHkmOtom3jM2wCu94xgzzu1d6Dn7or,7,2,1,0,1,1,4,0,9,1.2857142857142858,1,0.0,0,1,0,1,2,1,0,4,0,2,7,1
13442,188698,rjraeIoacuZJEw35Q8asy1sJ9D9vEPiU,3VkHkmOtom3jM2wCu94xgzzu1d6Dn7or,6,3,2,0,2,0,1,0,8,1.1428571428571428,1,0.0,0,2,0,2,3,0,0,1,0,4,4,1
13443,188710,splT3XbfuNvWu28Dz9nWIGEpMd1DYNNo,3VkHkmOtom3jM2wCu94xgzzu1d6Dn7or,1,0,0,0,0,0,1,0,1,0.14285714285714285,1,0.0,0,0,0,0,0,0,0,1,0,0,1,1
13444,188714,bRgauaxPr4eJDwen7ojFfhAEKTnn9yFa,3VkHkmOtom3jM2wCu94xgzzu1d6Dn7or,1,0,0,0,0,0,1,0,1,0.14285714285714285,1,0.0,0,0,0,0,0,0,0,1,0,0,1,1
13445,188719,Zcbku4ieBV7AjIPd5zWNQcljOJs6g3Xk,3VkHkmOtom3jM2wCu94xgzzu1d6Dn7or,4,2,0,0,0,0,2,0,4,0.5714285714285714,1,0.0,0,0,0,0,2,0,0,2,0,0,4,1
13446,188720,7mVnYRjKjtjH4lCP8tpUYIXKOYP4l6H9,3VkHkmOtom3jM2wCu94xgzzu1d6Dn7or,1,0,0,0,0,0,1,0,1,0.14285714285714285,1,0.0,0,0,0,0,0,0,0,1,0,0,1,1
13447,188726,rZc2RAebLP79KgIUARgq5IMQoQmvVjH0,3VkHkmOtom3jM2wCu94xgzzu1d6Dn7or,4,2,1,0,1,1,2,0,7,1.0,1,0.0,0,1,0,1,2,1,0,2,0,2,5,1
13448,188727,Rzuj7A1RYOdarZSozArynV32jCljcZEN,3VkHkmOtom3jM2wCu94xgzzu1d6Dn7or,1,0,0,0,0,0,2,0,2,0.2857142857142857,1,0.0,0,0,0,0,0,0,0,2,0,0,2,1
13449,188732,vBjMYxwVlP5OYa8uYuqiCgpy75HFIP5o,3VkHkmOtom3jM2wCu94xgzzu1d6Dn7or,1,0,0,0,0,0,1,0,1,0.14285714285714285,1,0.0,0,0,0,0,0,0,0,1,0,0,1,1
13450,188739,yWB3oqN8VRbhir0dM7XZbbGBMnznKciY,3VkHkmOtom3jM2wCu94xgzzu1d6Dn7or,5,2,1,0,1,0,3,0,7,1.0,2,0.0,0,1,0,1,2,0,0,3,0,2,5,1
13451,188744,RNarHXCsXWnc05ZCkRAoQLrCNIb9VXi5,3VkHkmOtom3jM2wCu94xgzzu1d6Dn7or,4,0,0,0,0,1,4,0,5,0.7142857142857143,1,0.0,0,0,0,0,0,1,0,4,0,0,5,1
13452,188745,RoQbop3klQZPIZTg1SEfKkCL3LxQQhrV,3VkHkmOtom3jM2wCu94xgzzu1d6Dn7or,6,1,1,0,1,0,5,0,8,1.1428571428571428,1,0.0,0,1,0,1,1,0,0,5,0,2,6,1
13453,188749,b1pOJDRxchXRoHUP49kKgMPNUJQLDSFZ,3VkHkmOtom3jM2wCu94xgzzu1d6Dn7or,10,6,4,0,3,0,3,0,16,2.2857142857142856,2,0.0,0,4,0,3,6,0,0,3,0,7,9,1
13454,188751,5tnLlHsyI6MqxnioivKTlNYEDjp4V4vl,3VkHkmOtom3jM2wCu94xgzzu1d6Dn7or,1,0,0,0,0,0,1,0,1,0.14285714285714285,1,0.0,0,0,0,0,0,0,0,1,0,0,1,1
13455,188752,LjklIQUhoK4K00yUFAEC0freV6RrtxfR,3VkHkmOtom3jM2wCu94xgzzu1d6Dn7or,1,0,0,0,0,0,1,0,1,0.14285714285714285,1,0.0,0,0,0,0,0,0,0,1,0,0,1,1
13456,188754,AWPvoaf0NtkyVV1p6r7SYTG5Gvv7rGNT,3VkHkmOtom3jM2wCu94xgzzu1d6Dn7or,1,0,0,0,0,0,1,0,1,0.14285714285714285,1,0.0,0,0,0,0,0,0,0,1,0,0,1,1
13457,188755,darIhG4UCSePcsT0dEJiHgaBq3otU8BD,3VkHkmOtom3jM2wCu94xgzzu1d6Dn7or,10,9,4,0,4,0,4,0,21,3.0,1,0.0,0,4,0,4,9,0,0,4,0,8,13,1
13458,188757,ulwzTcDf885NzrQCnoAeOKukwcIYM706,3VkHkmOtom3jM2wCu94xgzzu1d6Dn7or,1,0,0,0,0,0,2,0,2,0.2857142857142857,1,0.0,0,0,0,0,0,0,0,2,0,0,2,1
13459,188764,d29SpTzCOUSFg4yoYIxugcDveKRHlP4X,3VkHkmOtom3jM2wCu94xgzzu1d6Dn7or,1,0,0,0,0,0,2,0,2,0.2857142857142857,1,0.0,0,0,0,0,0,0,0,2,0,0,2,1
13460,188770,OOIu03NBEHePUSUIFa86FGFP5M136EAn,3VkHkmOtom3jM2wCu94xgzzu1d6Dn7or,4,2,1,0,1,0,1,0,5,0.7142857142857143,1,0.0,0,1,0,1,2,0,0,1,0,2,3,1
13461,188775,F8qH9FhQxX1wyTqzz3NU6nn0vfU0Riaf,3VkHkmOtom3jM2wCu94xgzzu1d6Dn7or,1,0,0,0,0,0,2,0,2,0.2857142857142857,1,0.0,0,0,0,0,0,0,0,2,0,0,2,0
13462,188777,y29CZe6BOX13f7fC7kXCzau5XL3ikH2J,3VkHkmOtom3jM2wCu94xgzzu1d6Dn7or,7,13,3,4,2,1,3,0,26,3.7142857142857144,1,0.0,5,3,3,2,8,1,1,3,0,13,13,1
13463,188778,xouPBfvCRjC5qv0HhQUKHIvhiPXfSbC9,3VkHkmOtom3jM2wCu94xgzzu1d6Dn7or,1,0,0,0,0,0,1,0,1,0.14285714285714285,1,0.0,0,0,0,0,0,0,0,1,0,0,1,1
13464,188787,UReFV1njNbexHxuOzGA2haECZtOzrAcs,3VkHkmOtom3jM2wCu94xgzzu1d6Dn7or,1,0,0,0,0,0,3,0,3,0.42857142857142855,1,0.0,0,0,0,0,0,0,0,3,0,0,3,1
13465,188792,m9kIF4xaVs2jU90mPDi3ysOgcd3rSMnE,3VkHkmOtom3jM2wCu94xgzzu1d6Dn7or,5,2,1,0,0,1,4,1,9,1.2857142857142858,1,0.0,0,1,0,0,2,1,0,4,1,1,8,1
13466,188793,rqoTUvotmiNzdNCmRA9XS33Bbc1NhTY9,3VkHkmOtom3jM2wCu94xgzzu1d6Dn7or,1,0,0,0,0,0,1,0,1,0.14285714285714285,1,0.0,0,0,0,0,0,0,0,1,0,0,1,1
13467,188799,yiJGRK3xKyZBczA9ZbC1g2ylL4nqHGee,3VkHkmOtom3jM2wCu94xgzzu1d6Dn7or,1,0,0,0,0,0,1,0,1,0.14285714285714285,1,0.0,0,0,0,0,0,0,0,1,0,0,1,1
13468,188807,l3nwiPsYiJl8Jihg077VE2FevaMxVbbu,3VkHkmOtom3jM2wCu94xgzzu1d6Dn7or,1,0,0,0,0,0,2,0,2,0.2857142857142857,1,0.0,0,0,0,0,0,0,0,2,0,0,2,0
13469,188840,td7Rsvww2Tt0cH9lZ6XoML9gQC1cSfIX,3VkHkmOtom3jM2wCu94xgzzu1d6Dn7or,1,0,0,0,0,0,1,0,1,0.14285714285714285,1,0.0,0,0,0,0,0,0,0,1,0,0,1,1
13470,188851,rcYKJ5kjivcqXxXUOJfTfslXTxt2wfkn,3VkHkmOtom3jM2wCu94xgzzu1d6Dn7or,4,2,1,0,0,0,3,0,6,0.8571428571428571,1,0.0,0,1,0,0,2,0,0,3,0,1,5,1
13471,188853,wtio4JmjBMuVClIbchDARr9kyIJKAWEa,3VkHkmOtom3jM2wCu94xgzzu1d6Dn7or,7,5,3,0,2,0,10,0,20,2.857142857142857,2,0.0,0,3,0,2,5,0,0,10,0,5,15,1
13472,188858,mH61okzOj3nEQ6Gv9aNpPBLjVL70RpBn,3VkHkmOtom3jM2wCu94xgzzu1d6Dn7or,1,0,0,0,0,0,1,0,1,0.14285714285714285,1,0.0,0,0,0,0,0,0,0,1,0,0,1,1
13473,188865,vp1rSNrizZff7tUEd2ybQWgYnsShgQzv,3VkHkmOtom3jM2wCu94xgzzu1d6Dn7or,7,2,1,0,1,0,8,2,14,2.0,1,0.0,0,1,0,1,2,0,0,8,2,2,12,1
13474,188869,qBJ5PlbiZTWOtW6qGRSzRxvflmQBdjbb,3VkHkmOtom3jM2wCu94xgzzu1d6Dn7or,1,0,0,0,0,0,1,0,1,0.14285714285714285,1,0.0,0,0,0,0,0,0,0,1,0,0,1,1
13475,188870,dAqrHPlMsXnPrglFnOZUeJrfWBb2qFZV,3VkHkmOtom3jM2wCu94xgzzu1d6Dn7or,1,0,0,0,0,0,1,0,1,0.14285714285714285,1,0.0,0,0,0,0,0,0,0,1,0,0,1,1
13476,188874,DJynUihFAWLqwBwk0pennAA3avYVlCnF,3VkHkmOtom3jM2wCu94xgzzu1d6Dn7or,5,0,0,0,0,1,5,1,7,1.0,1,0.0,0,0,0,0,0,1,0,5,1,0,7,1
13477,188879,BBWLa1LZvewDO9YK0u9Z0B5T3bzbyiLf,3VkHkmOtom3jM2wCu94xgzzu1d6Dn7or,1,0,0,0,0,0,1,0,1,0.14285714285714285,1,0.0,0,0,0,0,0,0,0,1,0,0,1,1
13478,188888,bj0WQuo9k1NIQkZ0EsnldydphhQRtUU6,3VkHkmOtom3jM2wCu94xgzzu1d6Dn7or,1,0,0,0,0,0,1,0,1,0.14285714285714285,1,0.0,0,0,0,0,0,0,0,1,0,0,1,1
13479,188892,YChfYjTEUmhFkScAd2qetCpOX19sz6WE,3VkHkmOtom3jM2wCu94xgzzu1d6Dn7or,4,2,0,0,1,0,1,0,4,0.5714285714285714,1,0.0,0,0,0,1,2,0,0,1,0,1,3,1
13480,188893,uErAtHHsF7lUzMfmcWuYTMcknda2v0F3,3VkHkmOtom3jM2wCu94xgzzu1d6Dn7or,4,2,0,0,0,0,2,0,4,0.5714285714285714,1,0.0,0,0,0,0,2,0,0,2,0,0,4,1
13481,188894,UygsTzsH7LWIOF2Htqvd4hLBNuIWqzyo,3VkHkmOtom3jM2wCu94xgzzu1d6Dn7or,7,13,3,0,0,0,8,4,28,4.0,1,0.0,0,3,0,0,13,0,0,8,4,3,25,1
13482,188895,aHOEE3Y86XSWbE1tAyDbE6Omr8cU9YfA,3VkHkmOtom3jM2wCu94xgzzu1d6Dn7or,1,0,0,0,0,0,1,0,1,0.14285714285714285,1,0.0,0,0,0,0,0,0,0,1,0,0,1,1
13483,188897,nZHDVGR2taFZ428UJIwMv53Rp94HbGnD,3VkHkmOtom3jM2wCu94xgzzu1d6Dn7or,9,5,3,0,2,4,10,1,25,3.5714285714285716,1,0.0,0,3,0,2,5,4,0,10,1,5,20,1
13484,188901,sq1wms76ewmJJMe5ABai2PQvpDuHzEFV,3VkHkmOtom3jM2wCu94xgzzu1d6Dn7or,5,4,1,0,1,0,1,0,7,1.0,1,0.0,0,1,0,1,4,0,0,1,0,2,5,1
13485,188902,U7T3zMiIGD6CAu6Tho01ck6PNG7rHFeb,3VkHkmOtom3jM2wCu94xgzzu1d6Dn7or,6,2,1,0,1,0,5,0,9,1.2857142857142858,1,0.0,0,1,0,1,2,0,0,5,0,2,7,1
13486,188903,GX8WUrDq59F3CPnzbsGBWLnaNb0wRVvg,3VkHkmOtom3jM2wCu94xgzzu1d6Dn7or,1,0,0,0,0,0,1,0,1,0.14285714285714285,1,0.0,0,0,0,0,0,0,0,1,0,0,1,1
13487,188909,C6CV9306M5utMUkPKkFqON6CMK7fT8vu,3VkHkmOtom3jM2wCu94xgzzu1d6Dn7or,5,2,1,0,1,0,2,0,6,0.8571428571428571,1,0.0,0,1,0,1,2,0,0,2,0,2,4,1
13488,188912,HqnHXfcoPap10Q0R8W8VaOhOdgU9xtH8,3VkHkmOtom3jM2wCu94xgzzu1d6Dn7or,10,43,11,0,0,6,12,0,72,10.285714285714286,1,0.0,12,11,0,0,31,6,0,12,0,23,49,1
13489,188915,2LmcdGGyubwVGXWuy0QUZiM05pluo5Uu,A3fsA9Zfv1X2fVEQhTw51lKENdNrEqT3,6,3,1,0,1,0,2,0,7,1.0,1,0.0,0,1,0,1,3,0,0,2,0,2,5,1
13490,188928,TJJeYBVqqJqVT0UpmMwKMknr7rLf2JfH,SpATywNh6bZuzm8s1ceuBUnMUAeoAHHw,4,2,0,0,0,0,2,0,4,0.5714285714285714,1,0.0,0,0,0,0,2,0,0,2,0,0,4,0
13491,188939,fwigvr5rkdA8owdUaAWu3mvJTkQAe70u,SpATywNh6bZuzm8s1ceuBUnMUAeoAHHw,27,34,14,21,7,2,7,1,86,12.285714285714286,1,0.0,19,14,18,7,15,2,3,7,1,58,28,1
13492,188952,tuXkXzLKLtIRrgeepCbs4ws8aCl66h43,7GRhBDsirIGkRZBtSMEzNTyDr2JQm4xx,34,119,36,50,30,53,17,1,306,43.714285714285715,1,0.0,69,36,39,30,50,53,11,17,1,174,132,1
13493,188956,LkRJ16T8XCnnHBkhkeRcewOdTN84VrPQ,SpATywNh6bZuzm8s1ceuBUnMUAeoAHHw,24,26,18,7,12,1,9,1,74,10.571428571428571,2,0.0,0,18,6,12,26,1,1,9,1,36,38,1
13494,188957,UcAhBIdVZpMELDlnTcMm9mzDJ1F9Jhg3,7GRhBDsirIGkRZBtSMEzNTyDr2JQm4xx,1,0,0,0,0,0,1,0,1,0.14285714285714285,1,0.0,0,0,0,0,0,0,0,1,0,0,1,1
13495,188958,tkdlCe7V8Pa5PG46xexcM5NKFN2Osmho,SpATywNh6bZuzm8s1ceuBUnMUAeoAHHw,1,0,0,0,0,0,1,0,1,0.14285714285714285,1,0.0,0,0,0,0,0,0,0,1,0,0,1,1
13496,188980,b9SN0Via9Qc1lw25HlIBgqllvaoVGqZR,7GRhBDsirIGkRZBtSMEzNTyDr2JQm4xx,1,0,0,0,0,0,1,0,1,0.14285714285714285,1,0.0,0,0,0,0,0,0,0,1,0,0,1,1
13497,188982,a6vqrMhHKzyWidqZtHap3qGcKb3WEBch,5X6FeZozNMgE2VRi3MJYjkkFK8SETtu2,4,2,0,0,0,0,2,0,4,0.5714285714285714,1,0.0,0,0,0,0,2,0,0,2,0,0,4,1
13498,188988,ljmWZCzWPqv1RXsn1q2wpsQtrnA1zct2,7GRhBDsirIGkRZBtSMEzNTyDr2JQm4xx,6,3,2,0,2,0,1,0,8,1.1428571428571428,1,0.0,0,2,0,2,3,0,0,1,0,4,4,1
13499,188998,kGchkvQPmF7DV3eBhLNc2GVWP2dYDeVK,7GRhBDsirIGkRZBtSMEzNTyDr2JQm4xx,4,2,1,0,1,0,1,0,5,0.7142857142857143,1,0.0,0,1,0,1,2,0,0,1,0,2,3,1
13500,189006,fOtwdZktYnpxoylqFRzXhWQ4IRQZkjMB,7GRhBDsirIGkRZBtSMEzNTyDr2JQm4xx,5,7,2,0,1,0,1,0,11,1.5714285714285714,1,0.0,0,2,0,1,7,0,0,1,0,3,8,1
13501,189008,6sr5fFi7rfC2NnnMJfyjbVZzoXpjJRhH,7GRhBDsirIGkRZBtSMEzNTyDr2JQm4xx,4,1,1,0,0,3,3,0,8,1.1428571428571428,1,0.0,0,1,0,0,1,3,0,3,0,1,7,1
13502,189014,k8okMXrxZcPMYpHTLdFHYiE4mVlekvm7,G8EPVSXsOYB5YQWZGiz1aVq5Pgr2GrQu,1,0,0,0,0,0,1,0,1,0.14285714285714285,1,0.0,0,0,0,0,0,0,0,1,0,0,1,1
13503,189026,T2tyjiaDe9s4tWUugE6FZTShWofnfMqo,A3fsA9Zfv1X2fVEQhTw51lKENdNrEqT3,6,5,0,0,0,0,3,0,8,1.1428571428571428,1,0.0,0,0,0,0,5,0,0,3,0,0,8,1
13504,189027,Tb3iSIl4j6IIWQqGXGjvVBDqMgnRJLyl,7GRhBDsirIGkRZBtSMEzNTyDr2JQm4xx,5,7,1,0,2,0,1,0,11,1.5714285714285714,1,0.0,3,1,0,2,4,0,0,1,0,6,5,1
13505,189029,UcAhBIdVZpMELDlnTcMm9mzDJ1F9Jhg3,bWdj2GDclj5ofokWjzoa5jAwMkxCykd6,1,0,0,0,0,0,1,0,1,0.14285714285714285,1,0.0,0,0,0,0,0,0,0,1,0,0,1,1
13506,189031,EFGFzlNARADgFL4TG0kEwOZD1FUUWtee,SpATywNh6bZuzm8s1ceuBUnMUAeoAHHw,2,0,0,0,0,0,2,0,2,0.2857142857142857,1,0.0,0,0,0,0,0,0,0,2,0,0,2,1
13507,189035,JxaxaQTFSPBMnjiqX4WWqfIhdnR1vwXm,A3fsA9Zfv1X2fVEQhTw51lKENdNrEqT3,2,0,0,0,0,0,2,0,2,0.2857142857142857,1,0.0,0,0,0,0,0,0,0,2,0,0,2,1
13508,189055,orwxChSuq5ic7EHtUR6sECjEFNRwZzJm,A3fsA9Zfv1X2fVEQhTw51lKENdNrEqT3,5,4,1,0,0,2,3,0,10,1.4285714285714286,1,0.0,0,1,0,0,4,2,0,3,0,1,9,1
13509,189098,YX2r5oewraL6wIQ6yI9Js4hkHPlQTVjj,7GRhBDsirIGkRZBtSMEzNTyDr2JQm4xx,9,2,1,0,1,1,7,1,13,1.8571428571428572,1,0.0,0,1,0,1,2,1,0,7,1,2,11,1
13510,189100,Cm9j8BFZp2zEHVq9X01HroWeJ3dkpIrl,A3fsA9Zfv1X2fVEQhTw51lKENdNrEqT3,7,4,1,0,1,0,2,0,8,1.1428571428571428,1,0.0,0,1,0,1,4,0,0,2,0,2,6,1
13511,189101,ArELmgPEmECqFMy1ajmS1kJdFsdtRbNE,SpATywNh6bZuzm8s1ceuBUnMUAeoAHHw,15,14,8,0,6,0,1,0,29,4.142857142857143,1,0.0,5,8,0,6,9,0,0,1,0,19,10,0
13512,189104,NumNFW5RaIHDi6n0KLy5Cf1kLDxHgZZ0,G8EPVSXsOYB5YQWZGiz1aVq5Pgr2GrQu,11,9,2,0,1,0,5,1,18,2.5714285714285716,2,0.0,0,2,0,1,9,0,0,5,1,3,15,1
13513,189107,krtZQqbvUpNsJjcNARYP8JsIRTz2QIeg,7GRhBDsirIGkRZBtSMEzNTyDr2JQm4xx,8,5,2,0,0,3,7,1,18,2.5714285714285716,1,0.0,0,2,0,0,5,3,0,7,1,2,16,1
13514,189109,ejIJpZTu0P4rcWcZmBKl6OiURGceVpiA,7GRhBDsirIGkRZBtSMEzNTyDr2JQm4xx,1,0,0,0,0,0,1,0,1,0.14285714285714285,1,0.0,0,0,0,0,0,0,0,1,0,0,1,1
13515,189110,sYKWdML3lybCcfZ8QzVXzUviXjVArLUH,7GRhBDsirIGkRZBtSMEzNTyDr2JQm4xx,2,0,0,0,0,0,2,0,2,0.2857142857142857,1,0.0,0,0,0,0,0,0,0,2,0,0,2,1
13516,189128,2wo3X72grgQzEbc3L58KSbNxJ33Bf4SU,7GRhBDsirIGkRZBtSMEzNTyDr2JQm4xx,4,2,1,0,1,0,1,0,5,0.7142857142857143,1,0.0,0,1,0,1,2,0,0,1,0,2,3,1
13517,189136,zNtPMkFrc8ewnZZhVeVhVYVOPd8vhwG9,7GRhBDsirIGkRZBtSMEzNTyDr2JQm4xx,13,15,3,34,1,10,6,0,69,9.857142857142858,1,0.0,8,3,26,1,7,10,8,6,0,38,31,1
13518,189144,eC4StSuQwImpW962lXYQQlRlP4Dxmsjm,5X6FeZozNMgE2VRi3MJYjkkFK8SETtu2,2,0,0,0,0,0,2,0,2,0.2857142857142857,1,0.0,0,0,0,0,0,0,0,2,0,0,2,1
13519,189162,o1LtNqe9OsdaahKJ5pz4qvaOsnGwGQzD,7GRhBDsirIGkRZBtSMEzNTyDr2JQm4xx,1,0,0,0,0,0,1,0,1,0.14285714285714285,1,0.0,0,0,0,0,0,0,0,1,0,0,1,1
13520,189166,LielUY2CViAshyTPFVeBFjcM9c8YHKw6,A3fsA9Zfv1X2fVEQhTw51lKENdNrEqT3,1,0,0,0,0,0,1,0,1,0.14285714285714285,1,0.0,0,0,0,0,0,0,0,1,0,0,1,1
13521,189176,Vve0UwhmiGWZN8bT2t4sC82sMWi2ZyY8,bWdj2GDclj5ofokWjzoa5jAwMkxCykd6,1,0,0,0,0,0,1,0,1,0.14285714285714285,1,0.0,0,0,0,0,0,0,0,1,0,0,1,1
13522,189203,ae9f7NnRGKtEuH4u37koNvJrDj4cou5c,7GRhBDsirIGkRZBtSMEzNTyDr2JQm4xx,13,24,0,0,3,0,9,0,36,5.142857142857143,1,0.0,10,0,0,3,14,0,0,9,0,13,23,1
13523,189204,eqcIPqJ4kM9TX6g3B8LCR2xTH3GBiOV4,bWdj2GDclj5ofokWjzoa5jAwMkxCykd6,10,21,2,0,3,1,8,0,35,5.0,1,0.0,7,2,0,3,14,1,0,8,0,12,23,0
13524,189221,8BLT2rbjNDvBkr2B6AQHpQ2yNooLf1CU,SpATywNh6bZuzm8s1ceuBUnMUAeoAHHw,21,44,24,29,0,5,6,1,109,15.571428571428571,2,0.0,12,24,25,0,32,5,4,6,1,61,48,1
13525,189224,V1EykxyqrSjJS8SrSU1L9A5qCk92mw9z,SpATywNh6bZuzm8s1ceuBUnMUAeoAHHw,1,0,0,0,0,0,1,0,1,0.14285714285714285,1,0.0,0,0,0,0,0,0,0,1,0,0,1,1
13526,189240,wtLaiBBHm4ZyQYh1Opif8R3gnmb4Cvts,SpATywNh6bZuzm8s1ceuBUnMUAeoAHHw,4,2,0,0,0,0,3,0,5,0.7142857142857143,1,0.0,0,0,0,0,2,0,0,3,0,0,5,1
13527,189248,VdLJh4DfNZNkgOb0QpZj77Lyif7Ai4W9,RXDvfPUBYFlVdlueBFbLW0mhhAyGEqpt,11,5,3,0,2,4,7,2,23,3.2857142857142856,1,0.0,0,3,0,2,5,4,0,7,2,5,18,1
13528,189261,0gEKH5fAOErqWMh035fBnqeaSHHzAI1h,SpATywNh6bZuzm8s1ceuBUnMUAeoAHHw,10,13,1,0,1,0,2,0,17,2.4285714285714284,1,0.0,0,1,0,1,13,0,0,2,0,2,15,1
13529,189296,6F27RWjto0oD6ZIVyhnSCbWEW4VbK6IA,SpATywNh6bZuzm8s1ceuBUnMUAeoAHHw,3,2,0,0,0,0,2,0,4,0.5714285714285714,1,0.0,0,0,0,0,2,0,0,2,0,0,4,1
13530,189307,WUH5fKgyK0ITY5YtWCIxwze8XvwwESM5,SpATywNh6bZuzm8s1ceuBUnMUAeoAHHw,1,0,0,0,0,0,1,0,1,0.14285714285714285,1,0.0,0,0,0,0,0,0,0,1,0,0,1,0
13531,189314,4D9TO74zb0mHkwi6G9vwCLqeflT8BNm5,A3fsA9Zfv1X2fVEQhTw51lKENdNrEqT3,2,0,0,0,0,0,2,0,2,0.2857142857142857,1,0.0,0,0,0,0,0,0,0,2,0,0,2,1
13532,189315,S17aPL792XOLE6jr4NEbeenFmW9zR5X6,G8EPVSXsOYB5YQWZGiz1aVq5Pgr2GrQu,5,5,1,0,2,0,2,0,10,1.4285714285714286,1,0.0,2,1,0,2,3,0,0,2,0,5,5,1
13533,189324,RHO2J6AKDheXb2vKjeepgmCGgMG6BTYE,7GRhBDsirIGkRZBtSMEzNTyDr2JQm4xx,5,4,1,0,2,0,2,0,9,1.2857142857142858,1,0.0,2,1,0,2,2,0,0,2,0,5,4,1
13534,189344,YWw2gZwiDNwUjZ7f1BeLAIZfUbRw3PAN,SpATywNh6bZuzm8s1ceuBUnMUAeoAHHw,1,0,0,0,0,0,1,0,1,0.14285714285714285,1,0.0,0,0,0,0,0,0,0,1,0,0,1,1
13535,189353,iNXUknYcsccIKS8GgjuItiXxtSErv2BI,7GRhBDsirIGkRZBtSMEzNTyDr2JQm4xx,1,0,0,0,0,0,1,0,1,0.14285714285714285,1,0.0,0,0,0,0,0,0,0,1,0,0,1,1
13536,189355,iNXUknYcsccIKS8GgjuItiXxtSErv2BI,5X6FeZozNMgE2VRi3MJYjkkFK8SETtu2,5,2,1,0,1,0,3,0,7,1.0,1,0.0,0,1,0,1,2,0,0,3,0,2,5,1
13537,189359,lezsrBjf0N9oe6E8V7oxUkPkJAqZJMFU,SpATywNh6bZuzm8s1ceuBUnMUAeoAHHw,29,41,15,51,8,18,3,0,136,19.428571428571427,1,0.0,23,15,44,8,18,18,7,3,0,90,46,1
13538,189392,qxH8TzH3Qy4v2W6mNWhfk8EgD86MOhcy,5X6FeZozNMgE2VRi3MJYjkkFK8SETtu2,6,16,6,0,5,0,1,0,28,4.0,1,0.0,9,6,0,5,7,0,0,1,0,20,8,0
13539,189395,aJzfntQTIfp35A305talVl9pd4o3Uf8u,7GRhBDsirIGkRZBtSMEzNTyDr2JQm4xx,1,0,0,0,0,0,1,0,1,0.14285714285714285,1,0.0,0,0,0,0,0,0,0,1,0,0,1,1
13540,189411,pSOYMJsNqMeLYStOpMCnSgntzZEejN1H,SpATywNh6bZuzm8s1ceuBUnMUAeoAHHw,5,2,1,0,1,0,3,0,7,1.0,1,0.0,0,1,0,1,2,0,0,3,0,2,5,1
13541,189414,Fs7AuQHyElzq194Dj7MYCCNmslBhiNQY,SpATywNh6bZuzm8s1ceuBUnMUAeoAHHw,12,8,4,3,3,0,2,0,20,2.857142857142857,1,0.0,3,4,3,3,5,0,0,2,0,13,7,1
13542,189417,WhcQ2FUhqplSbWBB55CQvv33YcQFAk48,SpATywNh6bZuzm8s1ceuBUnMUAeoAHHw,7,4,2,0,2,0,2,0,10,1.4285714285714286,1,0.0,0,2,0,2,4,0,0,2,0,4,6,1
13543,189423,XE68NKSR0NgsUmxAP8OC135kqBLzzb9D,7GRhBDsirIGkRZBtSMEzNTyDr2JQm4xx,5,3,2,0,2,0,2,0,9,1.2857142857142858,1,0.0,0,2,0,2,3,0,0,2,0,4,5,1
13544,189426,6F1lKjGTd159lFhX2roWh19Brj0u4Zbh,A3fsA9Zfv1X2fVEQhTw51lKENdNrEqT3,1,0,0,0,0,0,1,0,1,0.14285714285714285,1,0.0,0,0,0,0,0,0,0,1,0,0,1,1
13545,189428,zWECTl7pig27m6EXN2th2ITKXEX5E7bm,RXDvfPUBYFlVdlueBFbLW0mhhAyGEqpt,1,0,0,0,0,0,1,0,1,0.14285714285714285,1,0.0,0,0,0,0,0,0,0,1,0,0,1,1
13546,189429,UqksMVZ1lLvn2u7s6dT9SU5OFeNJnaAy,7GRhBDsirIGkRZBtSMEzNTyDr2JQm4xx,5,3,1,0,1,0,4,0,9,1.2857142857142858,1,0.0,0,1,0,1,3,0,0,4,0,2,7,1
13547,189463,8YAsQsQu6K1gQ9X3j9OO3pg6TTWyhygc,7GRhBDsirIGkRZBtSMEzNTyDr2JQm4xx,5,3,1,0,1,0,2,0,7,1.0,1,0.0,0,1,0,1,3,0,0,2,0,2,5,1
13548,189469,zQBqlqVriI6RZpOMpudm8qiUGV6Qrl0L,SpATywNh6bZuzm8s1ceuBUnMUAeoAHHw,1,0,0,0,0,0,1,0,1,0.14285714285714285,1,0.0,0,0,0,0,0,0,0,1,0,0,1,1
13549,189483,XSd0vlKD52NpLLSqBdFFlVoviwsj4dHQ,SpATywNh6bZuzm8s1ceuBUnMUAeoAHHw,9,12,2,0,3,1,2,0,20,2.857142857142857,2,0.0,4,2,0,3,8,1,0,2,0,9,11,1
13550,189495,5O6gO2IHLbVMXXDwdapXEnrWY7rrDpQl,7GRhBDsirIGkRZBtSMEzNTyDr2JQm4xx,1,0,0,0,0,0,1,0,1,0.14285714285714285,1,0.0,0,0,0,0,0,0,0,1,0,0,1,1
13551,189513,W44EUSPSAj1fZWLor5hD25joUoQF1Axq,A3fsA9Zfv1X2fVEQhTw51lKENdNrEqT3,12,8,2,0,2,2,9,1,24,3.4285714285714284,2,0.0,0,2,0,2,8,2,0,9,1,4,20,1
13552,189517,9RPQjNQK3P9Ja7ZwojZIq3WA9I1ozBKB,SpATywNh6bZuzm8s1ceuBUnMUAeoAHHw,13,20,4,13,3,0,2,0,42,6.0,1,0.0,4,4,11,3,16,0,2,2,0,22,20,1
13553,189535,Xv0DoRVy2WPaq7NGSTl3PflvzGmHzjVJ,A3fsA9Zfv1X2fVEQhTw51lKENdNrEqT3,1,0,0,0,0,0,1,0,1,0.14285714285714285,1,0.0,0,0,0,0,0,0,0,1,0,0,1,1
13554,189554,7ZT5u11YEDTZhD4NZDPzOcLz6uLhq9Bd,7GRhBDsirIGkRZBtSMEzNTyDr2JQm4xx,1,0,0,0,0,0,1,0,1,0.14285714285714285,1,0.0,0,0,0,0,0,0,0,1,0,0,1,1
13555,189564,0ARaDpddi8AQoUPzaSyC1U7MaF3V9mc5,SpATywNh6bZuzm8s1ceuBUnMUAeoAHHw,2,0,0,0,0,0,2,0,2,0.2857142857142857,1,0.0,0,0,0,0,0,0,0,2,0,0,2,1
13556,189566,UIWPjpONY8VKQTSxeNrHquVi8SXHJ9tU,7GRhBDsirIGkRZBtSMEzNTyDr2JQm4xx,16,20,8,0,6,0,1,0,35,5.0,1,0.0,0,8,0,6,20,0,0,1,0,14,21,1
13557,189570,BRlaUe6oMRYCNox0BajKnWHes3A3ujyM,A3fsA9Zfv1X2fVEQhTw51lKENdNrEqT3,8,7,1,0,0,0,5,0,13,1.8571428571428572,2,0.0,0,1,0,0,7,0,0,5,0,1,12,1
13558,189578,R1bxWlGh7IgBDoLkIUXA6O3TLQlfheKE,A3fsA9Zfv1X2fVEQhTw51lKENdNrEqT3,11,4,3,0,3,2,7,1,20,2.857142857142857,1,0.0,0,3,0,3,4,2,0,7,1,6,14,1
13559,189581,aU6SEeOgxLKetBRDwfHMDunWavvfr54M,bWdj2GDclj5ofokWjzoa5jAwMkxCykd6,1,0,0,0,0,0,1,0,1,0.14285714285714285,1,0.0,0,0,0,0,0,0,0,1,0,0,1,1
13560,189589,LeXQg2ZWiiKYpRH0t3zM93yLIzACb2NU,bWdj2GDclj5ofokWjzoa5jAwMkxCykd6,5,2,1,0,1,0,2,0,6,0.8571428571428571,1,0.0,0,1,0,1,2,0,0,2,0,2,4,1
13561,189597,0vAWgNGUpLVRA2RW70tZzBBxiCN36t8Y,7GRhBDsirIGkRZBtSMEzNTyDr2JQm4xx,8,4,3,0,3,0,1,0,11,1.5714285714285714,1,0.0,0,3,0,3,4,0,0,1,0,6,5,1
13562,189604,w5CgC7bTQWAEvwLpFNtMT9iZ9U07da4R,SpATywNh6bZuzm8s1ceuBUnMUAeoAHHw,2,0,0,0,0,0,2,0,2,0.2857142857142857,1,0.0,0,0,0,0,0,0,0,2,0,0,2,1
13563,189616,iemTWWDkC6AhVJDU5o3Oh9sLScAldw3C,bWdj2GDclj5ofokWjzoa5jAwMkxCykd6,1,0,0,0,0,0,1,0,1,0.14285714285714285,1,0.0,0,0,0,0,0,0,0,1,0,0,1,1
13564,189634,vosSqm6sHHL9cDsr1jZBTefbeiLRlWcO,A3fsA9Zfv1X2fVEQhTw51lKENdNrEqT3,5,2,1,0,1,0,2,0,6,0.8571428571428571,1,0.0,0,1,0,1,2,0,0,2,0,2,4,1
13565,189636,JBk9P3H9SpNENMmKz8O8B3au3Kj5XKWF,7GRhBDsirIGkRZBtSMEzNTyDr2JQm4xx,1,0,0,0,0,0,1,0,1,0.14285714285714285,1,0.0,0,0,0,0,0,0,0,1,0,0,1,1
13566,189637,GDIp2MOPceIb6QfEayZpWsXwU7IpnE1m,SpATywNh6bZuzm8s1ceuBUnMUAeoAHHw,4,2,0,0,0,0,2,0,4,0.5714285714285714,1,0.0,0,0,0,0,2,0,0,2,0,0,4,1
13567,189639,5qPjBVti4pvxDDFGs1UFTjnAG1OLcLcB,A3fsA9Zfv1X2fVEQhTw51lKENdNrEqT3,10,5,3,0,3,0,2,0,13,1.8571428571428572,1,0.0,0,3,0,3,5,0,0,2,0,6,7,1
13568,189647,0a9LRwLYq2zam4NcdU9Yh5C7IQvHBC1m,A3fsA9Zfv1X2fVEQhTw51lKENdNrEqT3,1,0,0,0,0,0,2,0,2,0.2857142857142857,2,0.0,0,0,0,0,0,0,0,2,0,0,2,1
13569,189662,AykjJday1wTguij5gx88Emm7vsRmhjsn,7GRhBDsirIGkRZBtSMEzNTyDr2JQm4xx,1,0,0,0,0,0,1,0,1,0.14285714285714285,1,0.0,0,0,0,0,0,0,0,1,0,0,1,1
13570,189697,3qxjUYnIYNKewMm8FEnsaaY7IZkJWvME,5X6FeZozNMgE2VRi3MJYjkkFK8SETtu2,1,0,0,0,0,0,1,0,1,0.14285714285714285,1,0.0,0,0,0,0,0,0,0,1,0,0,1,1
13571,189702,OyEvoRilpzFxIY7Xkwhpuz3t7yWiHYAD,7GRhBDsirIGkRZBtSMEzNTyDr2JQm4xx,1,0,0,0,0,0,1,0,1,0.14285714285714285,1,0.0,0,0,0,0,0,0,0,1,0,0,1,1
13572,189703,QI8v3mXYSOMc3klfons1psjYNmKqRAVM,A3fsA9Zfv1X2fVEQhTw51lKENdNrEqT3,2,0,0,0,0,0,4,0,4,0.5714285714285714,1,0.0,0,0,0,0,0,0,0,4,0,0,4,1
13573,189708,aK3nMtEDxGhnhy1C4yOyjUdvZihlJeoh,A3fsA9Zfv1X2fVEQhTw51lKENdNrEqT3,1,0,0,0,0,0,1,0,1,0.14285714285714285,1,0.0,0,0,0,0,0,0,0,1,0,0,1,1
13574,189712,T6EWQ7jVP89JlHzj41KN1gEtGYevpSQM,5X6FeZozNMgE2VRi3MJYjkkFK8SETtu2,1,0,0,0,0,0,1,0,1,0.14285714285714285,1,0.0,0,0,0,0,0,0,0,1,0,0,1,1
13575,189742,XtbEYUqZcMVM0EiUYCXC2IEORNMWz2mD,7GRhBDsirIGkRZBtSMEzNTyDr2JQm4xx,1,0,0,0,0,0,1,0,1,0.14285714285714285,1,0.0,0,0,0,0,0,0,0,1,0,0,1,1
13576,189767,ZkfFwyK1OgVihBxVb6PuDCZttx0mY0GH,A3fsA9Zfv1X2fVEQhTw51lKENdNrEqT3,1,0,0,0,0,0,1,0,1,0.14285714285714285,1,0.0,0,0,0,0,0,0,0,1,0,0,1,1
13577,189777,i8UchDPQpO6cT8iNPbZCYc4wYFSv7DDx,A3fsA9Zfv1X2fVEQhTw51lKENdNrEqT3,9,6,3,0,4,0,7,0,20,2.857142857142857,1,0.0,0,3,0,4,6,0,0,7,0,7,13,0
13578,189788,DFDnEvNaTkvfy3RohV4MJVwGUkEZrUrx,7GRhBDsirIGkRZBtSMEzNTyDr2JQm4xx,2,0,0,0,0,0,2,0,2,0.2857142857142857,1,0.0,0,0,0,0,0,0,0,2,0,0,2,1
13579,189797,yKVUx6ByOYe4vvSVP89s2ieWg1LfovnR,A3fsA9Zfv1X2fVEQhTw51lKENdNrEqT3,2,0,0,0,0,0,2,0,2,0.2857142857142857,1,0.0,0,0,0,0,0,0,0,2,0,0,2,1
13580,189809,h3uJUtBmEvmKgQr2Q8BC6FJ5GRugm894,A3fsA9Zfv1X2fVEQhTw51lKENdNrEqT3,24,4,2,72,0,4,9,0,91,13.0,1,0.0,2,2,59,0,2,4,13,9,0,63,28,1
13581,189814,SbMax8GBkfTumaOTkpcv6oaDlJ6SvOgc,A3fsA9Zfv1X2fVEQhTw51lKENdNrEqT3,71,76,38,0,32,0,1,0,147,21.0,1,0.0,5,38,0,32,71,0,0,1,0,75,72,1
13582,189818,Y65j88wkyz5DKML6XOG6DUVrzLQhWfST,7GRhBDsirIGkRZBtSMEzNTyDr2JQm4xx,1,0,0,0,0,0,1,0,1,0.14285714285714285,1,0.0,0,0,0,0,0,0,0,1,0,0,1,1
13583,189830,cfto4CbYTItqNRa3py5uJG0bkzsfzUco,7GRhBDsirIGkRZBtSMEzNTyDr2JQm4xx,1,0,0,0,0,0,1,0,1,0.14285714285714285,1,0.0,0,0,0,0,0,0,0,1,0,0,1,1
13584,189869,mG2HKIW4KvK5MNtCekVvEvxXHT51PCPq,7GRhBDsirIGkRZBtSMEzNTyDr2JQm4xx,6,3,1,0,1,0,2,0,7,1.0,1,0.0,0,1,0,1,3,0,0,2,0,2,5,1
13585,189870,BSHxCHMWX8I6UW8kFOVjbPaWq5D6kjuy,5X6FeZozNMgE2VRi3MJYjkkFK8SETtu2,18,33,0,22,11,0,1,0,67,9.571428571428571,1,0.0,25,0,17,11,8,0,5,1,0,53,14,1
13586,189885,EuByZSROH9lLZ2dnd4GXxahw8RdkgjTd,A3fsA9Zfv1X2fVEQhTw51lKENdNrEqT3,14,8,6,0,5,0,4,0,23,3.2857142857142856,1,0.0,0,6,0,5,8,0,0,4,0,11,12,1
13587,189905,H7bZ54NuzkB5Nw5q0ZI1nld9qDoHNngL,A3fsA9Zfv1X2fVEQhTw51lKENdNrEqT3,1,0,0,0,0,0,1,0,1,0.14285714285714285,1,0.0,0,0,0,0,0,0,0,1,0,0,1,1
13588,189945,AgRvWbkxdNzxJRN0PXihkXLvLsb4uQIe,A3fsA9Zfv1X2fVEQhTw51lKENdNrEqT3,1,0,0,0,0,0,2,0,2,0.2857142857142857,1,0.0,0,0,0,0,0,0,0,2,0,0,2,1
13589,189998,m7QOSCdmTCzPuCv2XL75peqogyn8U25P,A3fsA9Zfv1X2fVEQhTw51lKENdNrEqT3,1,0,0,0,0,0,1,0,1,0.14285714285714285,1,0.0,0,0,0,0,0,0,0,1,0,0,1,1
13590,190011,flCkd2hO7iQUUhaB3sp4v9WlXmzkKaLL,7GRhBDsirIGkRZBtSMEzNTyDr2JQm4xx,4,2,1,0,0,6,2,0,11,1.5714285714285714,1,0.0,0,1,0,0,2,6,0,2,0,1,10,1
13591,190038,d5ntYWn3uMz5PPmk3AvSW9B6md5cTatS,5X6FeZozNMgE2VRi3MJYjkkFK8SETtu2,1,0,0,0,0,0,4,0,4,0.5714285714285714,1,0.0,0,0,0,0,0,0,0,4,0,0,4,1
13592,190060,tMNGYXIFQLxoZULQtNFAcBIfN5Bk8aTB,A3fsA9Zfv1X2fVEQhTw51lKENdNrEqT3,6,3,1,0,1,0,2,0,7,1.0,1,0.0,0,1,0,1,3,0,0,2,0,2,5,1
13593,190081,iNidvGpmnGwj0TQ5PtdizeiguG8bztuW,7GRhBDsirIGkRZBtSMEzNTyDr2JQm4xx,10,10,6,0,5,0,3,0,24,3.4285714285714284,1,0.0,0,6,0,5,10,0,0,3,0,11,13,1
13594,190087,PihvdfGGc52TsY4zSIdQS0pOxHIYaXwm,5X6FeZozNMgE2VRi3MJYjkkFK8SETtu2,4,2,0,0,0,0,2,0,4,0.5714285714285714,1,0.0,0,0,0,0,2,0,0,2,0,0,4,1
13595,190088,3SVVs5mG0aNsXrE6M2lNU1XqYm152qHm,7GRhBDsirIGkRZBtSMEzNTyDr2JQm4xx,3,2,1,0,0,0,1,0,4,0.5714285714285714,1,0.0,0,1,0,0,2,0,0,1,0,1,3,1
13596,190110,BohRHH2vBIgnEZGZjM3WnHwJbVFmITRG,7GRhBDsirIGkRZBtSMEzNTyDr2JQm4xx,1,0,0,0,0,0,1,0,1,0.14285714285714285,1,0.0,0,0,0,0,0,0,0,1,0,0,1,1
13597,190111,SBDjqcJAy98nKfERlylEgYbif3PemxS8,A3fsA9Zfv1X2fVEQhTw51lKENdNrEqT3,7,4,1,0,1,0,2,0,8,1.1428571428571428,1,0.0,0,1,0,1,4,0,0,2,0,2,6,1
13598,190162,0D6hqHK4bxIFi4VUAoCI5xw3MhWFUe8Q,5X6FeZozNMgE2VRi3MJYjkkFK8SETtu2,1,0,0,0,0,0,1,0,1,0.14285714285714285,1,0.0,0,0,0,0,0,0,0,1,0,0,1,1
13599,190169,FaHW93yZCBwugzWZBbJAJZvMZt2lRMiJ,7GRhBDsirIGkRZBtSMEzNTyDr2JQm4xx,6,3,0,0,0,0,4,1,8,1.1428571428571428,1,0.0,1,0,0,0,2,0,0,4,1,1,7,1
13600,190190,p7LK5YIYyaPhnePVXdi7X5HGSzcJjL2r,7GRhBDsirIGkRZBtSMEzNTyDr2JQm4xx,1,0,0,0,0,0,1,0,1,0.14285714285714285,1,0.0,0,0,0,0,0,0,0,1,0,0,1,0
13601,190234,snhKj7MALyM2LCqV5sSwFpjNBeCB9QMT,7GRhBDsirIGkRZBtSMEzNTyDr2JQm4xx,4,1,0,0,1,0,2,0,4,0.5714285714285714,1,0.0,0,0,0,1,1,0,0,2,0,1,3,1
13602,190254,AA7aVbrpQJ2zUau6VJLFiC8rutvLHi1m,A3fsA9Zfv1X2fVEQhTw51lKENdNrEqT3,13,20,9,0,0,0,3,0,32,4.571428571428571,2,0.0,0,9,0,0,20,0,0,3,0,9,23,1
13603,190260,FPU0FjwogBJWUFzSjAMeAixgRBEtWUQi,3VkHkmOtom3jM2wCu94xgzzu1d6Dn7or,1,0,0,0,0,0,1,0,1,0.14285714285714285,1,0.0,0,0,0,0,0,0,0,1,0,0,1,1
13604,190269,y1EuJtYnpVYfd8F8xgK5tkHJLKj7p6FS,3VkHkmOtom3jM2wCu94xgzzu1d6Dn7or,7,2,1,0,0,1,5,1,10,1.4285714285714286,1,0.0,0,1,0,0,2,1,0,5,1,1,9,1
13605,190302,iRYbwr9W1H6DYIBL51n44HsYl060IwS1,3VkHkmOtom3jM2wCu94xgzzu1d6Dn7or,1,0,0,0,0,0,2,0,2,0.2857142857142857,1,0.0,0,0,0,0,0,0,0,2,0,0,2,1
13606,190312,RJKpx6tNa7aoTd7Dq5omUo61ITI2lGfj,3VkHkmOtom3jM2wCu94xgzzu1d6Dn7or,2,0,0,0,0,0,2,0,2,0.2857142857142857,1,0.0,0,0,0,0,0,0,0,2,0,0,2,1
13607,190314,iHg8Id8i74Y8JXzsZVVzjwPwX7H1Yl2W,3VkHkmOtom3jM2wCu94xgzzu1d6Dn7or,5,6,3,0,2,0,2,0,13,1.8571428571428572,2,0.0,0,3,0,2,6,0,0,2,0,5,8,1
13608,190318,6v60lWWjEmdiDD5aePepNjhBVO7dpc3H,3VkHkmOtom3jM2wCu94xgzzu1d6Dn7or,1,0,0,0,0,0,1,0,1,0.14285714285714285,1,0.0,0,0,0,0,0,0,0,1,0,0,1,1
13609,190338,9nRMm1PA3GIKd2fFGQBMEaDBV01scEDf,3VkHkmOtom3jM2wCu94xgzzu1d6Dn7or,19,15,12,2,6,1,4,2,42,6.0,1,0.0,1,12,2,6,14,1,0,4,2,21,21,1
13610,190348,fh7ZqgEvblupIZ9gbXHWPWPg5ZbZYMBJ,3VkHkmOtom3jM2wCu94xgzzu1d6Dn7or,1,0,0,0,0,0,1,0,1,0.14285714285714285,1,0.0,0,0,0,0,0,0,0,1,0,0,1,1
13611,190351,tVCyYdomAGfUjkZNKBHMqBkEaPWuCBi2,3VkHkmOtom3jM2wCu94xgzzu1d6Dn7or,1,0,0,0,0,0,1,0,1,0.14285714285714285,1,0.0,0,0,0,0,0,0,0,1,0,0,1,1
13612,190375,YGxQDme0yci5ICjRYEy6Me4N0nnZ0g9H,3VkHkmOtom3jM2wCu94xgzzu1d6Dn7or,1,0,0,0,0,0,2,0,2,0.2857142857142857,1,0.0,0,0,0,0,0,0,0,2,0,0,2,1
13613,190385,H5zUL9xfz1fEoOcbR4FmFtG01oFL0kN2,3VkHkmOtom3jM2wCu94xgzzu1d6Dn7or,4,2,1,0,0,0,2,0,5,0.7142857142857143,1,0.0,0,1,0,0,2,0,0,2,0,1,4,1
13614,190390,ett4RSqrxzIV8EYuhd1Xe4BYirxYbVDx,3VkHkmOtom3jM2wCu94xgzzu1d6Dn7or,1,0,0,0,0,0,1,0,1,0.14285714285714285,1,0.0,0,0,0,0,0,0,0,1,0,0,1,1
13615,190396,pwfdkJeIkLiqUQGNzUx1pEX5wP825mQj,3VkHkmOtom3jM2wCu94xgzzu1d6Dn7or,6,2,1,0,1,0,3,0,7,1.0,1,0.0,0,1,0,1,2,0,0,3,0,2,5,1
13616,190422,QhYcOEapN0nrffEwA6S7jQzZwToRePP8,3VkHkmOtom3jM2wCu94xgzzu1d6Dn7or,1,0,0,0,0,0,1,0,1,0.14285714285714285,1,0.0,0,0,0,0,0,0,0,1,0,0,1,1
13617,190442,zEaDEiE5fac9Y3NT8JaitlDl9a7ILbFn,3VkHkmOtom3jM2wCu94xgzzu1d6Dn7or,2,0,0,0,0,0,2,0,2,0.2857142857142857,1,0.0,0,0,0,0,0,0,0,2,0,0,2,0
13618,190476,cRTomtLEROB1eaNXB5ZOtN4GQZr71pEL,3VkHkmOtom3jM2wCu94xgzzu1d6Dn7or,1,0,0,0,0,0,1,0,1,0.14285714285714285,1,0.0,0,0,0,0,0,0,0,1,0,0,1,1
13619,190494,1rPI5jPhWfm6V8JZPzv2QRjwb8MNdqfD,3VkHkmOtom3jM2wCu94xgzzu1d6Dn7or,5,5,1,0,1,0,2,0,9,1.2857142857142858,1,0.0,3,1,0,1,2,0,0,2,0,5,4,1
13620,190495,Sf3D8cErqs9DUAq0Pdl9EdinO2VNyspc,3VkHkmOtom3jM2wCu94xgzzu1d6Dn7or,6,2,1,0,1,0,7,0,11,1.5714285714285714,1,0.0,0,1,0,1,2,0,0,7,0,2,9,1
13621,190506,5VWGQewJqmIYi1Ik1BTl5hZ5SDvaKZYy,3VkHkmOtom3jM2wCu94xgzzu1d6Dn7or,2,0,0,0,0,0,2,0,2,0.2857142857142857,1,0.0,0,0,0,0,0,0,0,2,0,0,2,1
13622,190515,CcHGoKJpqBRdD4QQg44nMVlMI2t2Fpdm,3VkHkmOtom3jM2wCu94xgzzu1d6Dn7or,10,6,3,0,3,6,6,1,25,3.5714285714285716,1,0.0,0,3,0,3,6,6,0,6,1,6,19,1
13623,190553,lBQWW3wz0MqhTNb2ZYkj36Re3eW068si,3VkHkmOtom3jM2wCu94xgzzu1d6Dn7or,1,0,0,0,0,0,1,0,1,0.14285714285714285,1,0.0,0,0,0,0,0,0,0,1,0,0,1,1
13624,190575,LmecgoK4LtwGlXVk4sMRxfP8aYkIhIm1,3VkHkmOtom3jM2wCu94xgzzu1d6Dn7or,5,2,1,0,1,0,2,0,6,0.8571428571428571,2,0.0,0,1,0,1,2,0,0,2,0,2,4,1
13625,190613,7cqhc9pbFpFjRpzwiG6jM1Uoeo0Yvjlm,3VkHkmOtom3jM2wCu94xgzzu1d6Dn7or,1,0,0,0,0,0,1,0,1,0.14285714285714285,1,0.0,0,0,0,0,0,0,0,1,0,0,1,1
13626,190627,KZVYUX0K5z0mdYc6KiQ6PojuarFpgkXq,3VkHkmOtom3jM2wCu94xgzzu1d6Dn7or,1,0,0,0,0,0,1,0,1,0.14285714285714285,1,0.0,0,0,0,0,0,0,0,1,0,0,1,1
13627,190646,i3sXJ1o3wIKSeiueKBCqui2G08946p1M,3VkHkmOtom3jM2wCu94xgzzu1d6Dn7or,1,0,0,0,0,0,1,0,1,0.14285714285714285,1,0.0,0,0,0,0,0,0,0,1,0,0,1,0
13628,190667,FbSHedxpIyx1zxNDmX3MtyNonypZQZwK,3VkHkmOtom3jM2wCu94xgzzu1d6Dn7or,1,0,0,0,0,0,1,0,1,0.14285714285714285,1,0.0,0,0,0,0,0,0,0,1,0,0,1,1
13629,190694,9rioKXPzXXz4G8DVkVea9icy6ke5RJAY,3VkHkmOtom3jM2wCu94xgzzu1d6Dn7or,1,0,0,0,0,0,1,0,1,0.14285714285714285,1,0.0,0,0,0,0,0,0,0,1,0,0,1,1
13630,190706,n0ANfyYsFaoG5WIUnaVoMaXuxxDLkEbk,3VkHkmOtom3jM2wCu94xgzzu1d6Dn7or,1,0,0,0,0,0,1,0,1,0.14285714285714285,1,0.0,0,0,0,0,0,0,0,1,0,0,1,1
13631,190717,bKF5MosBqVKnYq47osSfpVQVg6H93E3y,SpATywNh6bZuzm8s1ceuBUnMUAeoAHHw,11,6,4,0,3,7,10,3,33,4.714285714285714,1,0.0,0,4,0,3,6,7,0,10,3,7,26,0
13632,190734,clv7wTDLUGVcdBnHuGK5igxvVYbUFhfO,A3fsA9Zfv1X2fVEQhTw51lKENdNrEqT3,1,0,0,0,0,0,1,0,1,0.14285714285714285,1,0.0,0,0,0,0,0,0,0,1,0,0,1,1
13633,190737,SqKmRlxZATrsBxFcgKwGzFSyWis0fRul,SpATywNh6bZuzm8s1ceuBUnMUAeoAHHw,12,8,5,0,3,2,6,1,25,3.5714285714285716,1,0.0,2,5,0,3,6,2,0,6,1,10,15,1
13634,190739,FFNnY7di7du4c5wFNDNV6nMH5bqqpuVS,G8EPVSXsOYB5YQWZGiz1aVq5Pgr2GrQu,16,5,5,28,3,1,4,0,46,6.571428571428571,1,0.0,0,5,24,3,5,1,4,4,0,32,14,1
13635,190747,cTeA1f2AYHCTzaLCFeSZpEjefvjGhNJD,G8EPVSXsOYB5YQWZGiz1aVq5Pgr2GrQu,8,8,3,0,2,0,2,0,15,2.142857142857143,1,0.0,3,3,0,2,5,0,0,2,0,8,7,1
13636,190756,wIcAqiIkhVke6PQk1FQ10LQjFUOa268K,bWdj2GDclj5ofokWjzoa5jAwMkxCykd6,1,0,0,0,0,0,1,0,1,0.14285714285714285,1,0.0,0,0,0,0,0,0,0,1,0,0,1,1
13637,190767,ErHRXoQE3PAKpLvIUT0gh504hJR8YxvQ,SpATywNh6bZuzm8s1ceuBUnMUAeoAHHw,1,0,0,0,0,0,1,0,1,0.14285714285714285,1,0.0,0,0,0,0,0,0,0,1,0,0,1,1
13638,190769,FZEwaAUaiR6zemazrUHMMvDLCgHez3sb,A3fsA9Zfv1X2fVEQhTw51lKENdNrEqT3,1,0,0,0,0,0,2,0,2,0.2857142857142857,1,0.0,0,0,0,0,0,0,0,2,0,0,2,1
13639,190774,xClBQDVnnmCO9u08LGuvxGj9xJyOTeqG,SpATywNh6bZuzm8s1ceuBUnMUAeoAHHw,6,3,1,0,1,0,2,0,7,1.0,1,0.0,0,1,0,1,3,0,0,2,0,2,5,1
13640,190775,uf9uxJ0q9fqnk8v2mIZk18f6DfpdKvW8,bWdj2GDclj5ofokWjzoa5jAwMkxCykd6,9,13,5,44,5,0,5,1,73,10.428571428571429,1,0.0,4,5,42,5,9,0,2,5,1,56,17,1
13641,190781,WgwvOVLxVR0cLBIPFfdMgIZsyrXu2dEM,RXDvfPUBYFlVdlueBFbLW0mhhAyGEqpt,10,6,1,0,1,1,11,7,27,3.857142857142857,1,0.0,0,1,0,1,6,1,0,11,7,2,25,1
13642,190794,jImHfNEIObE674KdIbKVj7cCJ4ufqzHJ,A3fsA9Zfv1X2fVEQhTw51lKENdNrEqT3,1,0,0,0,0,0,1,0,1,0.14285714285714285,1,0.0,0,0,0,0,0,0,0,1,0,0,1,1
13643,190795,cHDpTfio4QPhERzYfGBXzFYjVYPP50Cv,SpATywNh6bZuzm8s1ceuBUnMUAeoAHHw,7,5,3,0,2,0,4,0,14,2.0,1,0.0,0,3,0,2,5,0,0,4,0,5,9,1
13644,190797,pHifOW1icP08PuJhI8vGjqOw0aKfYcAe,bWdj2GDclj5ofokWjzoa5jAwMkxCykd6,15,11,6,60,4,6,8,1,96,13.714285714285714,1,0.0,2,6,53,4,9,6,7,8,1,65,31,1
13645,190807,UuSIoFbtQOfzMmWUxokidkbXgJFaHXwx,A3fsA9Zfv1X2fVEQhTw51lKENdNrEqT3,1,0,0,0,0,0,1,0,1,0.14285714285714285,1,0.0,0,0,0,0,0,0,0,1,0,0,1,0
13646,190808,wU9dwS3WWOQY9ZgttcIaOxUTFKpzQrwI,bWdj2GDclj5ofokWjzoa5jAwMkxCykd6,1,0,0,0,0,0,1,0,1,0.14285714285714285,1,0.0,0,0,0,0,0,0,0,1,0,0,1,0
13647,190809,hHLItJoAM7XEkMep3WUdcTboIWoYySm9,SpATywNh6bZuzm8s1ceuBUnMUAeoAHHw,7,5,0,0,0,4,6,1,16,2.2857142857142856,1,0.0,0,0,0,0,5,4,0,6,1,0,16,1
13648,190815,xnAaa3WYxuN7DFkNBugIG5RWGpSS1yS8,bWdj2GDclj5ofokWjzoa5jAwMkxCykd6,1,0,0,0,0,0,1,0,1,0.14285714285714285,1,0.0,0,0,0,0,0,0,0,1,0,0,1,1
13649,190818,uDXojcZmAjRrYpbHg6OiLrdKtE8isYPI,G8EPVSXsOYB5YQWZGiz1aVq5Pgr2GrQu,1,0,0,0,0,0,1,0,1,0.14285714285714285,1,0.0,0,0,0,0,0,0,0,1,0,0,1,1
13650,190822,8pF3cyLxq0AckySwkuwDRCVUkL6fkRLY,SpATywNh6bZuzm8s1ceuBUnMUAeoAHHw,6,2,0,0,0,0,9,0,11,1.5714285714285714,1,0.0,0,0,0,0,2,0,0,9,0,0,11,1
13651,190826,5ae8aSisBHmEo0mgVwdFagGGHfcfDsIo,G8EPVSXsOYB5YQWZGiz1aVq5Pgr2GrQu,1,0,0,0,0,0,1,0,1,0.14285714285714285,1,0.0,0,0,0,0,0,0,0,1,0,0,1,1
13652,190834,PUW0i4IuafllkJEtV0GCqmTDeLHkDmH3,SpATywNh6bZuzm8s1ceuBUnMUAeoAHHw,1,0,0,0,0,0,1,0,1,0.14285714285714285,1,0.0,0,0,0,0,0,0,0,1,0,0,1,1
13653,190852,5FKNtYsTkByroijTHxSZ2wThgqvXV2F5,SpATywNh6bZuzm8s1ceuBUnMUAeoAHHw,4,2,1,0,1,0,1,0,5,0.7142857142857143,1,0.0,0,1,0,1,2,0,0,1,0,2,3,1
13654,190861,HkcPmWCSdk3INCYsquWGQGZKijdTCD0w,A3fsA9Zfv1X2fVEQhTw51lKENdNrEqT3,1,0,0,0,0,0,1,0,1,0.14285714285714285,1,0.0,0,0,0,0,0,0,0,1,0,0,1,1
13655,190883,NtWIu4J0HPOWOANC7ZYns4tsHx1TBJoi,bWdj2GDclj5ofokWjzoa5jAwMkxCykd6,1,0,0,0,0,0,1,0,1,0.14285714285714285,1,0.0,0,0,0,0,0,0,0,1,0,0,1,1
13656,190889,9Yh9BGNzlB70iEC7VABYNXfepXjXz9Ik,RXDvfPUBYFlVdlueBFbLW0mhhAyGEqpt,1,0,0,0,0,0,1,0,1,0.14285714285714285,1,0.0,0,0,0,0,0,0,0,1,0,0,1,1
13657,190895,RJe7xu782OWYH4oamOQryIYQy1schp1L,SpATywNh6bZuzm8s1ceuBUnMUAeoAHHw,14,29,12,16,0,7,6,1,71,10.142857142857142,1,0.0,6,12,14,0,23,7,2,6,1,32,39,1
13658,190903,x71DJUx1l6jseHCehLwk4aITn2PbPyqZ,SpATywNh6bZuzm8s1ceuBUnMUAeoAHHw,5,2,1,0,1,0,2,0,6,0.8571428571428571,1,0.0,0,1,0,1,2,0,0,2,0,2,4,1
13659,190904,vyEmNT9CTTZs1s1eotM7mTmxUqBkMZB7,A3fsA9Zfv1X2fVEQhTw51lKENdNrEqT3,1,0,0,0,0,0,1,0,1,0.14285714285714285,1,0.0,0,0,0,0,0,0,0,1,0,0,1,1
13660,190917,KK8c9Dmj5I63bhg4LxlQHTWu5jCGLVNt,G8EPVSXsOYB5YQWZGiz1aVq5Pgr2GrQu,1,0,0,0,0,0,1,0,1,0.14285714285714285,1,0.0,0,0,0,0,0,0,0,1,0,0,1,1
13661,190947,ok4VFpKhZuAEe6hS0zrBXKoNseBmFZze,SpATywNh6bZuzm8s1ceuBUnMUAeoAHHw,14,22,2,25,0,2,9,1,61,8.714285714285714,2,0.0,4,2,22,0,18,2,3,9,1,28,33,1
13662,190954,WsLtEmeFmoC69MkLWoUcJ9ig36NGyKM9,SpATywNh6bZuzm8s1ceuBUnMUAeoAHHw,6,3,1,0,1,0,2,0,7,1.0,1,0.0,0,1,0,1,3,0,0,2,0,2,5,1
13663,190958,2xUoAPKuvFamkqgtuAisQsHAYFznYGmc,RXDvfPUBYFlVdlueBFbLW0mhhAyGEqpt,21,22,5,31,10,0,4,0,72,10.285714285714286,2,0.0,15,5,28,10,7,0,3,4,0,58,14,0
13664,190967,FENPBJBmeLAdvUkUsPg7akiTSdA52zTP,SpATywNh6bZuzm8s1ceuBUnMUAeoAHHw,7,6,2,0,1,0,3,0,12,1.7142857142857142,1,0.0,1,2,0,1,5,0,0,3,0,4,8,1
13665,190972,iACYFngARHwRlBD1uz8Bwi5b1szxFkra,SpATywNh6bZuzm8s1ceuBUnMUAeoAHHw,8,29,1,0,1,0,5,0,36,5.142857142857143,1,0.0,2,1,0,1,27,0,0,5,0,4,32,1
13666,190977,oaoj9be4jW2Hot8wYgYrzLRvB0RU4KYy,bWdj2GDclj5ofokWjzoa5jAwMkxCykd6,3,2,1,0,0,0,1,0,4,0.5714285714285714,1,0.0,0,1,0,0,2,0,0,1,0,1,3,1
13667,190991,M7fcRt21bsAgtvsrrzEizQkpE9mFW4i5,G8EPVSXsOYB5YQWZGiz1aVq5Pgr2GrQu,1,0,0,0,0,0,2,0,2,0.2857142857142857,1,0.0,0,0,0,0,0,0,0,2,0,0,2,1
13668,191001,nT8w17cJcdO2lsrz7cGSY123lCPnSOcs,SpATywNh6bZuzm8s1ceuBUnMUAeoAHHw,11,11,0,19,0,2,5,2,39,5.571428571428571,1,0.0,4,0,17,0,7,2,2,5,2,21,18,1
13669,191008,HQaEPrkmOsZZRI0w0Zd2GpWW5QsOPUNb,RXDvfPUBYFlVdlueBFbLW0mhhAyGEqpt,7,7,1,0,1,0,5,0,14,2.0,1,0.0,0,1,0,1,7,0,0,5,0,2,12,1
13670,191076,kLjseYEqrk7qJRpdsFaZefvj0uwqDQlm,SpATywNh6bZuzm8s1ceuBUnMUAeoAHHw,1,0,0,0,0,0,1,0,1,0.14285714285714285,1,0.0,0,0,0,0,0,0,0,1,0,0,1,1
13671,191092,arrrU4WiLIpECIetBxOM4AIL8R5yPrJI,SpATywNh6bZuzm8s1ceuBUnMUAeoAHHw,3,0,0,0,0,0,3,0,3,0.42857142857142855,1,0.0,0,0,0,0,0,0,0,3,0,0,3,1
13672,191108,geEAXwfPbJ0MhEZG0COad1UptHNAilTd,A3fsA9Zfv1X2fVEQhTw51lKENdNrEqT3,1,0,0,0,0,0,1,0,1,0.14285714285714285,1,0.0,0,0,0,0,0,0,0,1,0,0,1,1
13673,191177,cd5GtUhUnzyOzoyRaUudZZpk7s0Fqqr1,SpATywNh6bZuzm8s1ceuBUnMUAeoAHHw,2,0,0,0,0,0,2,0,2,0.2857142857142857,1,0.0,0,0,0,0,0,0,0,2,0,0,2,1
13674,191193,5isrCsGh9CKWlpcsbDYSNSmskNZ5RJjk,A3fsA9Zfv1X2fVEQhTw51lKENdNrEqT3,1,0,0,0,0,0,1,0,1,0.14285714285714285,1,0.0,0,0,0,0,0,0,0,1,0,0,1,1
13675,191204,p8HUn53OHQxlBbPvpqicSSSkhMnoLuUk,SpATywNh6bZuzm8s1ceuBUnMUAeoAHHw,1,0,0,0,0,0,1,0,1,0.14285714285714285,1,0.0,0,0,0,0,0,0,0,1,0,0,1,1
13676,191228,kMzMJEHy7fAHiNUZU0um3I2BsPC7gMll,RXDvfPUBYFlVdlueBFbLW0mhhAyGEqpt,1,0,0,0,0,0,1,0,1,0.14285714285714285,1,0.0,0,0,0,0,0,0,0,1,0,0,1,1
13677,191255,2WxDTXrRtDNHrqbb0X9iRKeiD9MDTDVK,SpATywNh6bZuzm8s1ceuBUnMUAeoAHHw,9,25,9,0,0,1,7,0,42,6.0,1,0.0,12,9,0,0,13,1,0,7,0,21,21,1
13678,191284,WgQR6nrfyl7yDpgHC595JSoog2R9VhVs,A3fsA9Zfv1X2fVEQhTw51lKENdNrEqT3,1,0,0,0,0,0,1,0,1,0.14285714285714285,1,0.0,0,0,0,0,0,0,0,1,0,0,1,1
13679,191309,V2MW5TTOl8erA9KB40i6ShoB0MXn3LUC,SpATywNh6bZuzm8s1ceuBUnMUAeoAHHw,5,2,1,0,1,0,4,0,8,1.1428571428571428,1,0.0,0,1,0,1,2,0,0,4,0,2,6,1
13680,191314,GRgjzx7VHY5z0cMezCfvrpSTKqpE3kNZ,SpATywNh6bZuzm8s1ceuBUnMUAeoAHHw,6,5,2,0,2,0,1,0,10,1.4285714285714286,1,0.0,0,2,0,2,5,0,0,1,0,4,6,1
13681,191320,SFvWBN0LUhWN6O8eK5tB1YryzhojhfkD,SpATywNh6bZuzm8s1ceuBUnMUAeoAHHw,1,0,0,0,0,0,1,0,1,0.14285714285714285,1,0.0,0,0,0,0,0,0,0,1,0,0,1,1
13682,191334,iwS4gRr8dUdengK5x37B93sG4oePIfDx,SpATywNh6bZuzm8s1ceuBUnMUAeoAHHw,1,0,0,0,0,0,1,0,1,0.14285714285714285,1,0.0,0,0,0,0,0,0,0,1,0,0,1,1
13683,191346,p6TgFJdLQMaMzbR16kycIPcRPnBj3paK,bWdj2GDclj5ofokWjzoa5jAwMkxCykd6,4,5,1,0,0,0,3,0,9,1.2857142857142858,1,0.0,0,1,0,0,5,0,0,3,0,1,8,1
13684,191365,v0iISMadlSfH1jVtRvOUuiYm96jA1BgF,SpATywNh6bZuzm8s1ceuBUnMUAeoAHHw,3,2,0,0,0,0,1,0,3,0.42857142857142855,1,0.0,0,0,0,0,2,0,0,1,0,0,3,1
13685,191390,T6EWQ7jVP89JlHzj41KN1gEtGYevpSQM,RXDvfPUBYFlVdlueBFbLW0mhhAyGEqpt,1,0,0,0,0,0,1,0,1,0.14285714285714285,1,0.0,0,0,0,0,0,0,0,1,0,0,1,1
13686,191396,kFbAoBQLoBy3cufqfKmpAxdN84jZuyGv,SpATywNh6bZuzm8s1ceuBUnMUAeoAHHw,1,0,0,0,0,0,1,0,1,0.14285714285714285,1,0.0,0,0,0,0,0,0,0,1,0,0,1,1
13687,191399,RknKWTR2QlcaofxNlEIJO86tIh9EMpGt,SpATywNh6bZuzm8s1ceuBUnMUAeoAHHw,6,8,3,0,2,0,2,0,15,2.142857142857143,1,0.0,0,3,0,2,8,0,0,2,0,5,10,1
13688,191400,oB66Su2y0fKCmlftIiys81THD7pT5Kwq,SpATywNh6bZuzm8s1ceuBUnMUAeoAHHw,3,2,0,0,0,0,2,0,4,0.5714285714285714,1,0.0,0,0,0,0,2,0,0,2,0,0,4,1
13689,191418,cBqC4wQ0uum34JxjmDvje145C1HEdpV7,A3fsA9Zfv1X2fVEQhTw51lKENdNrEqT3,1,0,0,0,0,0,1,0,1,0.14285714285714285,1,0.0,0,0,0,0,0,0,0,1,0,0,1,1
13690,191426,if3F5GyFS3tLy1wJ6MlpPAYmdoRWmS4a,G8EPVSXsOYB5YQWZGiz1aVq5Pgr2GrQu,15,9,8,24,6,0,2,0,49,7.0,1,0.0,0,8,19,6,9,0,5,2,0,33,16,1
13691,191428,0g874SF3SMbHGyq5A3NVcdw5ZagrIMLX,A3fsA9Zfv1X2fVEQhTw51lKENdNrEqT3,1,0,0,0,0,0,1,0,1,0.14285714285714285,1,0.0,0,0,0,0,0,0,0,1,0,0,1,1
13692,191439,7k95jHpTPudDL0r9ern1lqZsX7khTblO,SpATywNh6bZuzm8s1ceuBUnMUAeoAHHw,10,3,2,0,2,4,8,2,21,3.0,1,0.0,0,2,0,2,3,4,0,8,2,4,17,1
13693,191470,WmysxkCsgnQj3BaPOZ0U0HkLBTddwtEo,RXDvfPUBYFlVdlueBFbLW0mhhAyGEqpt,18,8,4,15,3,8,10,4,52,7.428571428571429,1,0.0,3,4,15,3,5,8,0,10,4,25,27,1
13694,191474,URsMDmBXxCzQPD8yy0pnaAiUOwpb4Aof,G8EPVSXsOYB5YQWZGiz1aVq5Pgr2GrQu,1,0,0,0,0,0,1,0,1,0.14285714285714285,1,0.0,0,0,0,0,0,0,0,1,0,0,1,1
13695,191485,XFJ68m78eqRR6RTXtGyyLhWYKyJpG8am,SpATywNh6bZuzm8s1ceuBUnMUAeoAHHw,13,20,7,28,3,3,6,0,67,9.571428571428571,1,0.0,7,7,24,3,13,3,4,6,0,41,26,1
13696,191503,wuaIkUodYTr49NZ7BbMPsEdpO0t0C8Nt,bWdj2GDclj5ofokWjzoa5jAwMkxCykd6,1,0,0,0,0,0,1,0,1,0.14285714285714285,1,0.0,0,0,0,0,0,0,0,1,0,0,1,0
13697,191513,8Hc0b25bgfH6lNfQjbdydA9Vr0ij1wAo,RXDvfPUBYFlVdlueBFbLW0mhhAyGEqpt,6,3,2,0,1,0,2,0,8,1.1428571428571428,1,0.0,0,2,0,1,3,0,0,2,0,3,5,1
13698,191520,aQZ3ue6sZAjGbF4xHc1nd423AeIpShr7,SpATywNh6bZuzm8s1ceuBUnMUAeoAHHw,6,1,1,0,0,7,7,2,18,2.5714285714285716,1,0.0,0,1,0,0,1,7,0,7,2,1,17,1
13699,191555,xJg5Rk4cV40ktI4XCqJwerPySa8KdDum,SpATywNh6bZuzm8s1ceuBUnMUAeoAHHw,4,2,0,0,0,0,5,0,7,1.0,1,0.0,0,0,0,0,2,0,0,5,0,0,7,1
13700,191557,H7bZ54NuzkB5Nw5q0ZI1nld9qDoHNngL,RXDvfPUBYFlVdlueBFbLW0mhhAyGEqpt,7,3,2,0,2,0,2,0,9,1.2857142857142858,1,0.0,0,2,0,2,3,0,0,2,0,4,5,0
13701,191558,bxybXAkYqJdxWDLSPlh74sjGoIJub8gI,A3fsA9Zfv1X2fVEQhTw51lKENdNrEqT3,1,0,0,0,0,0,1,0,1,0.14285714285714285,1,0.0,0,0,0,0,0,0,0,1,0,0,1,1
13702,191566,dPo2apv0Dzwh69Z1mYMogRvND7Zqb5Dp,SpATywNh6bZuzm8s1ceuBUnMUAeoAHHw,1,0,0,0,0,0,1,0,1,0.14285714285714285,1,0.0,0,0,0,0,0,0,0,1,0,0,1,1
13703,191595,6VqcRtEStIFn65gZeMiEFRDlkNKCPpuX,SpATywNh6bZuzm8s1ceuBUnMUAeoAHHw,1,0,0,0,0,0,1,0,1,0.14285714285714285,1,0.0,0,0,0,0,0,0,0,1,0,0,1,1
13704,191600,6hpnm3HPpj7kwmlYcJCdnCjcQP3bgA8P,SpATywNh6bZuzm8s1ceuBUnMUAeoAHHw,1,0,0,0,0,0,1,0,1,0.14285714285714285,1,0.0,0,0,0,0,0,0,0,1,0,0,1,1
13705,191609,VRZ45dbdEaezkrEYnjvv0A7uj4TRC509,RXDvfPUBYFlVdlueBFbLW0mhhAyGEqpt,1,0,0,0,0,0,2,0,2,0.2857142857142857,1,0.0,0,0,0,0,0,0,0,2,0,0,2,1
13706,191619,WlHV3frRLxQmTIY14HccRXj4N1zg8F2y,A3fsA9Zfv1X2fVEQhTw51lKENdNrEqT3,1,0,0,0,0,0,1,0,1,0.14285714285714285,1,0.0,0,0,0,0,0,0,0,1,0,0,1,1
13707,191625,WlHV3frRLxQmTIY14HccRXj4N1zg8F2y,SpATywNh6bZuzm8s1ceuBUnMUAeoAHHw,1,0,0,0,0,0,1,0,1,0.14285714285714285,1,0.0,0,0,0,0,0,0,0,1,0,0,1,1
13708,191629,XdXU1POVy8aDaqRsnREruSsMPvgxWetA,A3fsA9Zfv1X2fVEQhTw51lKENdNrEqT3,1,0,0,0,0,0,1,0,1,0.14285714285714285,1,0.0,0,0,0,0,0,0,0,1,0,0,1,0
13709,191655,p04QzukP32kpPk8EGoBhDUGJJQqJUoNz,G8EPVSXsOYB5YQWZGiz1aVq5Pgr2GrQu,1,0,0,0,0,0,2,0,2,0.2857142857142857,1,0.0,0,0,0,0,0,0,0,2,0,0,2,1
13710,191678,vWQfaR79jDjjXdq7DWLb4Yep3Hqk0KZU,SpATywNh6bZuzm8s1ceuBUnMUAeoAHHw,1,0,0,0,0,0,1,0,1,0.14285714285714285,1,0.0,0,0,0,0,0,0,0,1,0,0,1,1
13711,191692,KNNMSW3oLxGqEqv2czanNkhQgdUkOWgY,RXDvfPUBYFlVdlueBFbLW0mhhAyGEqpt,7,6,4,0,1,0,2,0,13,1.8571428571428572,1,0.0,0,4,0,1,6,0,0,2,0,5,8,0
13712,191725,OnbafhawH0rPSL0N5ij1JID10mYyXSki,RXDvfPUBYFlVdlueBFbLW0mhhAyGEqpt,15,23,1,14,1,1,4,0,44,6.285714285714286,1,0.0,3,1,12,1,20,1,2,4,0,17,27,1
13713,191729,N7U6b4ydC4LyBj5GQ1EeCbwlZ2DqZbJ6,bWdj2GDclj5ofokWjzoa5jAwMkxCykd6,5,4,1,0,1,0,4,0,10,1.4285714285714286,1,0.0,0,1,0,1,4,0,0,4,0,2,8,1
13714,191733,dZqFLbQhzRGv0XrnoR6Btyn7eZPLWNcs,G8EPVSXsOYB5YQWZGiz1aVq5Pgr2GrQu,5,3,1,0,1,0,1,0,6,0.8571428571428571,1,0.0,0,1,0,1,3,0,0,1,0,2,4,1
13715,191735,qwG1GCNkwhgE1heJRoYjfA2CYeRyFFBD,SpATywNh6bZuzm8s1ceuBUnMUAeoAHHw,5,2,1,0,1,0,2,0,6,0.8571428571428571,1,0.0,0,1,0,1,2,0,0,2,0,2,4,1
13716,191740,0A6FjHxqeczBpR079Zm0ynsuWpteOCkO,A3fsA9Zfv1X2fVEQhTw51lKENdNrEqT3,1,0,0,0,0,0,1,0,1,0.14285714285714285,1,0.0,0,0,0,0,0,0,0,1,0,0,1,1
13717,191744,ifBHT3U3Q2vZ9dQs2fpRYsiXqMAEWHBB,SpATywNh6bZuzm8s1ceuBUnMUAeoAHHw,1,0,0,0,0,0,1,0,1,0.14285714285714285,1,0.0,0,0,0,0,0,0,0,1,0,0,1,1
13718,191751,inFcOljKYTbAioEZelr7FOpytUh6Wwwm,A3fsA9Zfv1X2fVEQhTw51lKENdNrEqT3,1,0,0,0,0,0,2,0,2,0.2857142857142857,1,0.0,0,0,0,0,0,0,0,2,0,0,2,1
13719,191755,BgRqBvDqiEwBpSmGhgFl2BztVgNMTQzO,SpATywNh6bZuzm8s1ceuBUnMUAeoAHHw,5,5,1,2,0,0,1,0,9,1.2857142857142858,1,0.0,1,1,2,0,4,0,0,1,0,4,5,1
13720,191758,RpI9z3V0AgaYDbaVWpv7K8qBLot9xbZ1,SpATywNh6bZuzm8s1ceuBUnMUAeoAHHw,2,0,0,0,0,2,1,0,3,0.42857142857142855,1,0.0,0,0,0,0,0,2,0,1,0,0,3,1
13721,191784,yPgZKtTbqfPKTL2LU9Q3PsQCk4gWnK9n,bWdj2GDclj5ofokWjzoa5jAwMkxCykd6,2,0,0,0,0,0,2,0,2,0.2857142857142857,1,0.0,0,0,0,0,0,0,0,2,0,0,2,1
13722,191792,kmiB7WIX79F3dncKlftv8WHURaepCY2a,G8EPVSXsOYB5YQWZGiz1aVq5Pgr2GrQu,5,3,1,0,1,0,1,0,6,0.8571428571428571,1,0.0,0,1,0,1,3,0,0,1,0,2,4,1
13723,191795,I4TQ7Q1utfRs4sHagyenl8ox4pkFBHHE,bWdj2GDclj5ofokWjzoa5jAwMkxCykd6,2,0,0,0,0,0,2,0,2,0.2857142857142857,1,0.0,0,0,0,0,0,0,0,2,0,0,2,1
13724,191796,HsUrz2Tvq8sRzoPDsx1zZZFVKu21a9Fj,bWdj2GDclj5ofokWjzoa5jAwMkxCykd6,1,0,0,0,0,0,1,0,1,0.14285714285714285,1,0.0,0,0,0,0,0,0,0,1,0,0,1,1
13725,191809,RkMMgfrDoCy0k6xciXBqfQqum2o9XEow,A3fsA9Zfv1X2fVEQhTw51lKENdNrEqT3,1,0,0,0,0,0,1,0,1,0.14285714285714285,1,0.0,0,0,0,0,0,0,0,1,0,0,1,1
13726,191820,GPXoKOYBnmTprrhcUmupBdNFpJRyodal,G8EPVSXsOYB5YQWZGiz1aVq5Pgr2GrQu,8,7,2,0,2,0,4,0,15,2.142857142857143,1,0.0,4,2,0,2,3,0,0,4,0,8,7,1
13727,191826,apfvYM10NU1k5W582bvs0kUbUD2jx0Pf,SpATywNh6bZuzm8s1ceuBUnMUAeoAHHw,1,0,0,0,0,0,2,0,2,0.2857142857142857,1,0.0,0,0,0,0,0,0,0,2,0,0,2,1
13728,191827,hMmMWG2mCSPmBVJCfg0hTnXWgrWTXDtT,bWdj2GDclj5ofokWjzoa5jAwMkxCykd6,1,0,0,0,0,0,1,0,1,0.14285714285714285,1,0.0,0,0,0,0,0,0,0,1,0,0,1,1
13729,191837,Fq5B003Bt4YEeqhrth8SMHf096RbzYAO,SpATywNh6bZuzm8s1ceuBUnMUAeoAHHw,16,16,4,16,3,0,6,1,46,6.571428571428571,1,0.0,11,4,14,3,5,0,2,6,1,32,14,1
13730,191840,bR8wdPBdFHSsMQ5cBBQOeSecEHoEdU3R,SpATywNh6bZuzm8s1ceuBUnMUAeoAHHw,1,0,0,0,0,0,1,0,1,0.14285714285714285,1,0.0,0,0,0,0,0,0,0,1,0,0,1,1
13731,191850,eRPwUTqaIsUryY9jPBGa7k7RWRZnrrvU,A3fsA9Zfv1X2fVEQhTw51lKENdNrEqT3,1,0,0,0,0,0,1,0,1,0.14285714285714285,1,0.0,0,0,0,0,0,0,0,1,0,0,1,1
13732,191861,AdLAJ2czvUY9AyeUk5B4rn58TrqeeWxO,RXDvfPUBYFlVdlueBFbLW0mhhAyGEqpt,1,0,0,0,0,0,1,0,1,0.14285714285714285,1,0.0,0,0,0,0,0,0,0,1,0,0,1,1
13733,191865,XVfEU97madT1zlAJ4ceeVrr8RhA7IGa2,SpATywNh6bZuzm8s1ceuBUnMUAeoAHHw,5,3,1,0,1,0,1,0,6,0.8571428571428571,1,0.0,0,1,0,1,3,0,0,1,0,2,4,1
13734,191889,kvp7nv1Fk7hbG5ZfWGkJtc8xaumUx9u9,bWdj2GDclj5ofokWjzoa5jAwMkxCykd6,5,6,1,0,2,0,2,0,11,1.5714285714285714,1,0.0,2,1,0,2,4,0,0,2,0,5,6,1
13735,191891,lej2dE7o05DOz003uw82zCNwZA2EHApG,SpATywNh6bZuzm8s1ceuBUnMUAeoAHHw,6,0,0,0,0,1,12,1,14,2.0,1,0.0,0,0,0,0,0,1,0,12,1,0,14,1
13736,191926,3h1FKqVdnDmZ3yTfOEvfGnfVX1CtMfQe,SpATywNh6bZuzm8s1ceuBUnMUAeoAHHw,4,2,1,0,1,0,1,0,5,0.7142857142857143,1,0.0,0,1,0,1,2,0,0,1,0,2,3,1
13737,191941,P7vHBcOeIbOXFo3TPWP2lDcTM83EhGeU,bWdj2GDclj5ofokWjzoa5jAwMkxCykd6,1,0,0,0,0,0,4,0,4,0.5714285714285714,1,0.0,0,0,0,0,0,0,0,4,0,0,4,1
13738,191955,BoMnQ757r2rWyLplEG42Z5wOai4BClQl,SpATywNh6bZuzm8s1ceuBUnMUAeoAHHw,5,2,1,0,1,0,2,0,6,0.8571428571428571,1,0.0,0,1,0,1,2,0,0,2,0,2,4,1
13739,191956,Rb4RoMnOmkTH16vQxR6FJxXkteFqMsSl,SpATywNh6bZuzm8s1ceuBUnMUAeoAHHw,5,2,1,0,1,0,3,0,7,1.0,1,0.0,0,1,0,1,2,0,0,3,0,2,5,1
13740,191985,IN6qMq7COdhsPUWIeIwbfkPbP9c7KKGp,A3fsA9Zfv1X2fVEQhTw51lKENdNrEqT3,1,0,0,0,0,0,1,0,1,0.14285714285714285,1,0.0,0,0,0,0,0,0,0,1,0,0,1,1
13741,191989,WFLWEfQrQsuFMQB4h1DfinKxHOxaJgRw,SpATywNh6bZuzm8s1ceuBUnMUAeoAHHw,1,0,0,0,0,0,1,0,1,0.14285714285714285,1,0.0,0,0,0,0,0,0,0,1,0,0,1,1
13742,192026,Efh1AOucFRD20ZMCFA52VPOCblceahzE,SpATywNh6bZuzm8s1ceuBUnMUAeoAHHw,13,25,12,23,7,0,4,0,71,10.142857142857142,1,0.0,10,12,19,7,15,0,4,4,0,48,23,1
13743,192041,XMT1fxCKn20PfgVrzu92ZEp8ge6Hh1C8,SpATywNh6bZuzm8s1ceuBUnMUAeoAHHw,1,0,0,0,0,0,2,0,2,0.2857142857142857,1,0.0,0,0,0,0,0,0,0,2,0,0,2,1
13744,192045,dMRYTOUYlQ9p1SCjA1w6Lggb6GRAcl7F,SpATywNh6bZuzm8s1ceuBUnMUAeoAHHw,1,0,0,0,0,0,2,0,2,0.2857142857142857,1,0.0,0,0,0,0,0,0,0,2,0,0,2,1
13745,192054,AFTEQHbalt54u0CSOEb5Gff5gtuUeG8b,SpATywNh6bZuzm8s1ceuBUnMUAeoAHHw,6,2,1,0,1,0,3,0,7,1.0,1,0.0,0,1,0,1,2,0,0,3,0,2,5,1
13746,192061,uTVTksRdwbB07oR2uLGlNMnBpRxCQAXg,SpATywNh6bZuzm8s1ceuBUnMUAeoAHHw,3,5,1,0,0,0,1,0,7,1.0,1,0.0,0,1,0,0,5,0,0,1,0,1,6,1
13747,192077,vsDIa2pTzMsANsuFnkRlfs0CNdNFRShO,A3fsA9Zfv1X2fVEQhTw51lKENdNrEqT3,1,0,0,0,0,0,1,0,1,0.14285714285714285,1,0.0,0,0,0,0,0,0,0,1,0,0,1,1
13748,192094,1JKF7DnCOdaXTBELvpKByyY2uKECcREV,A3fsA9Zfv1X2fVEQhTw51lKENdNrEqT3,1,0,0,0,0,0,1,0,1,0.14285714285714285,1,0.0,0,0,0,0,0,0,0,1,0,0,1,1
13749,192104,Dk2p6h1MYjykCuVHQMak8GN098n0FvGH,SpATywNh6bZuzm8s1ceuBUnMUAeoAHHw,10,13,3,10,0,2,3,0,31,4.428571428571429,1,0.0,2,3,8,0,11,2,2,3,0,13,18,1
13750,192115,ROeS4r0zXNXDfvEicSssoPyhkNCzHO0O,SpATywNh6bZuzm8s1ceuBUnMUAeoAHHw,6,3,2,0,2,0,5,0,12,1.7142857142857142,1,0.0,0,2,0,2,3,0,0,5,0,4,8,1
13751,192133,ItSWWp12ZmgzUSMzIbnzpzxw5V6GCE6O,SpATywNh6bZuzm8s1ceuBUnMUAeoAHHw,8,2,1,0,1,2,4,2,12,1.7142857142857142,1,0.0,0,1,0,1,2,2,0,4,2,2,10,1
13752,192137,VYiSBPiiJFjQtdS8d7Gp4hibwyjeIeC0,G8EPVSXsOYB5YQWZGiz1aVq5Pgr2GrQu,9,2,0,0,0,1,14,2,19,2.7142857142857144,1,0.0,0,0,0,0,2,1,0,14,2,0,19,1
13753,192146,luNGlNTmJ26UVXohAPNf4yZNgIUDcpxK,G8EPVSXsOYB5YQWZGiz1aVq5Pgr2GrQu,1,0,0,0,0,0,1,0,1,0.14285714285714285,1,0.0,0,0,0,0,0,0,0,1,0,0,1,1
13754,192154,D0xF5k3pRFZOFsh7BuEa1nD61TTGPmxo,SpATywNh6bZuzm8s1ceuBUnMUAeoAHHw,6,4,2,0,1,2,4,0,13,1.8571428571428572,2,0.0,0,2,0,1,4,2,0,4,0,3,10,1
13755,192163,12jrpDfrACe14hfSyU7dlcaDb6lV0AX7,SpATywNh6bZuzm8s1ceuBUnMUAeoAHHw,6,3,1,0,1,0,2,0,7,1.0,1,0.0,0,1,0,1,3,0,0,2,0,2,5,1
13756,192173,ezgBG4pn9egd5PGuIQdeghPmBuYsQq9O,bWdj2GDclj5ofokWjzoa5jAwMkxCykd6,2,0,0,0,0,0,3,0,3,0.42857142857142855,1,0.0,0,0,0,0,0,0,0,3,0,0,3,1
13757,192174,gdWcAsoLOdR54U3HxoDgKlKnKUBV7xCX,G8EPVSXsOYB5YQWZGiz1aVq5Pgr2GrQu,5,7,2,0,2,0,2,0,13,1.8571428571428572,1,0.0,2,2,0,2,5,0,0,2,0,6,7,1
13758,192180,3bqYNHEttQnrSXCOjNHPi8cuvQEsNCSU,SpATywNh6bZuzm8s1ceuBUnMUAeoAHHw,16,17,9,17,7,4,6,1,61,8.714285714285714,2,0.0,4,9,14,7,13,4,3,6,1,34,27,1
13759,192182,Zn2WcWGw1Iq8LSMueWFynbJxp3D9ATzp,bWdj2GDclj5ofokWjzoa5jAwMkxCykd6,6,3,2,0,2,0,1,0,8,1.1428571428571428,1,0.0,0,2,0,2,3,0,0,1,0,4,4,1
13760,192202,4WRiJt7yDLRdAnLXyL07imUb9PD066er,G8EPVSXsOYB5YQWZGiz1aVq5Pgr2GrQu,10,3,2,0,2,0,8,2,17,2.4285714285714284,2,0.0,0,2,0,2,3,0,0,8,2,4,13,1
13761,192212,FCG6YWuKaaz2zD1Uj2uT7JnTQhXHO8IA,SpATywNh6bZuzm8s1ceuBUnMUAeoAHHw,7,12,1,0,1,0,3,0,17,2.4285714285714284,1,0.0,0,1,0,1,12,0,0,3,0,2,15,1
13762,192235,fB1Ln4rTpVlSNSwZArMTX9xX5MOVzyer,SpATywNh6bZuzm8s1ceuBUnMUAeoAHHw,7,3,2,0,2,0,3,0,10,1.4285714285714286,1,0.0,0,2,0,2,3,0,0,3,0,4,6,1
13763,192244,43uMTKmmKD0ZGUfjI6gHffJ1F3eBB7HV,SpATywNh6bZuzm8s1ceuBUnMUAeoAHHw,12,10,5,11,3,0,2,0,31,4.428571428571429,1,0.0,3,5,10,3,7,0,1,2,0,21,10,1
13764,192255,NqQoXS07qNtJAkIAmOpEhw2wLcRnmrrU,SpATywNh6bZuzm8s1ceuBUnMUAeoAHHw,4,3,1,0,0,0,1,0,5,0.7142857142857143,1,0.0,0,1,0,0,3,0,0,1,0,1,4,1
13765,192264,WnUfGeFilK9N1GtlbmsLVr7aEjsrhuHu,SpATywNh6bZuzm8s1ceuBUnMUAeoAHHw,5,3,1,0,1,0,2,0,7,1.0,1,0.0,0,1,0,1,3,0,0,2,0,2,5,1
13766,192277,MExPU9M982R5ikM7jDJpvEjyfJ2HFRXK,G8EPVSXsOYB5YQWZGiz1aVq5Pgr2GrQu,1,0,0,0,0,0,2,0,2,0.2857142857142857,1,0.0,0,0,0,0,0,0,0,2,0,0,2,1
13767,192288,8ZHyO9qRnMfYwp3tP7QulKpzu10sbQSr,A3fsA9Zfv1X2fVEQhTw51lKENdNrEqT3,1,0,0,0,0,0,1,0,1,0.14285714285714285,1,0.0,0,0,0,0,0,0,0,1,0,0,1,1
13768,192289,a7ccLvSmzFTDxQ153X5LPl9qw8dtjwJS,bWdj2GDclj5ofokWjzoa5jAwMkxCykd6,1,0,0,0,0,0,1,0,1,0.14285714285714285,1,0.0,0,0,0,0,0,0,0,1,0,0,1,1
13769,192291,u5ObOMoHUcvVsOQTGkiv0BRKKcn8v2w8,SpATywNh6bZuzm8s1ceuBUnMUAeoAHHw,5,5,4,0,2,0,1,0,12,1.7142857142857142,1,0.0,0,4,0,2,5,0,0,1,0,6,6,1
13770,192315,eGRaiLXqwboqQlaTTQYr1FB1cM61jV4I,A3fsA9Zfv1X2fVEQhTw51lKENdNrEqT3,1,0,0,0,0,0,1,0,1,0.14285714285714285,1,0.0,0,0,0,0,0,0,0,1,0,0,1,1
13771,192324,cHLNWYCLO1WUu673oiGBHY06ztWWlBMP,bWdj2GDclj5ofokWjzoa5jAwMkxCykd6,1,0,0,0,0,0,1,0,1,0.14285714285714285,1,0.0,0,0,0,0,0,0,0,1,0,0,1,1
13772,192327,ZW8MI4gpXd8J54W8a3uuPTjmv3mJCgoT,G8EPVSXsOYB5YQWZGiz1aVq5Pgr2GrQu,2,0,0,0,0,0,2,0,2,0.2857142857142857,1,0.0,0,0,0,0,0,0,0,2,0,0,2,1
13773,192367,cBgZxnbCWuxd2FofXugFoDh4OfmFe8dT,bWdj2GDclj5ofokWjzoa5jAwMkxCykd6,5,2,1,0,1,0,2,0,6,0.8571428571428571,1,0.0,0,1,0,1,2,0,0,2,0,2,4,1
13774,192372,shnL5ct8qob4HtqjYuzsqQN09ccan9RZ,bWdj2GDclj5ofokWjzoa5jAwMkxCykd6,4,5,1,0,2,0,4,0,12,1.7142857142857142,1,0.0,2,1,0,2,3,0,0,4,0,5,7,1
13775,192374,ooAUGXFOFAguQ9s1QlStBjM610gDeFBk,A3fsA9Zfv1X2fVEQhTw51lKENdNrEqT3,1,0,0,0,0,0,1,0,1,0.14285714285714285,1,0.0,0,0,0,0,0,0,0,1,0,0,1,1
13776,192378,0Tg2flbTUdD7fODqYIfpiJiK0IDdFiOP,G8EPVSXsOYB5YQWZGiz1aVq5Pgr2GrQu,7,6,1,0,0,0,9,2,18,2.5714285714285716,1,0.0,0,1,0,0,6,0,0,9,2,1,17,1
13777,192390,xWEkYGAfNptAwZnPYzVBCVMgcZk3qKaB,SpATywNh6bZuzm8s1ceuBUnMUAeoAHHw,9,15,0,0,0,0,4,0,19,2.7142857142857144,2,0.0,1,0,0,0,14,0,0,4,0,1,18,0
13778,192412,31BGhLl5fMPdcRk1AZsl6rdwMvdi9CfF,SpATywNh6bZuzm8s1ceuBUnMUAeoAHHw,7,6,5,0,5,0,2,0,18,2.5714285714285716,1,0.0,0,5,0,5,6,0,0,2,0,10,8,1
13779,192416,2aLPbnt4moA8gfuPTpLKAlOHQIQiYuAh,SpATywNh6bZuzm8s1ceuBUnMUAeoAHHw,9,4,3,0,3,0,2,0,12,1.7142857142857142,1,0.0,0,3,0,3,4,0,0,2,0,6,6,1
13780,192423,6ZFGnTjh94PbXkR7sbTLWokikXbcLQlV,SpATywNh6bZuzm8s1ceuBUnMUAeoAHHw,1,0,0,0,0,0,1,0,1,0.14285714285714285,1,0.0,0,0,0,0,0,0,0,1,0,0,1,1
13781,192429,9LhQI6E10btWpLjiUrRwj3MG72TIQ74Y,SpATywNh6bZuzm8s1ceuBUnMUAeoAHHw,7,2,0,0,0,1,5,2,10,1.4285714285714286,1,0.0,0,0,0,0,2,1,0,5,2,0,10,1
13782,192436,xHQ7Ypd5S1OzYjBAcoZTGl29nW3kI889,SpATywNh6bZuzm8s1ceuBUnMUAeoAHHw,9,15,9,0,4,4,7,1,40,5.714285714285714,1,0.0,2,9,0,4,13,4,0,7,1,15,25,1
13783,192454,2o2Mu0kizqtKfAG0EeAIvXT3SodGLvCM,A3fsA9Zfv1X2fVEQhTw51lKENdNrEqT3,1,0,0,0,0,0,2,0,2,0.2857142857142857,1,0.0,0,0,0,0,0,0,0,2,0,0,2,1
13784,192457,2o2Mu0kizqtKfAG0EeAIvXT3SodGLvCM,bWdj2GDclj5ofokWjzoa5jAwMkxCykd6,1,0,0,0,0,0,1,0,1,0.14285714285714285,1,0.0,0,0,0,0,0,0,0,1,0,0,1,1
13785,192458,3h1zqwMTeQWdhoWHPgvllPWyD6P0qFtr,A3fsA9Zfv1X2fVEQhTw51lKENdNrEqT3,2,0,0,0,0,0,2,0,2,0.2857142857142857,2,0.0,0,0,0,0,0,0,0,2,0,0,2,1
13786,192612,db5WgqPhrbqgj9ILL28Zz7dJymWXcTmf,5Gyp41oLVo7Gg7vF4vpmggWP5MU70QO6,6,4,2,0,3,0,1,0,10,1.4285714285714286,1,0.0,1,2,0,3,3,0,0,1,0,6,4,1
13787,192634,DLUoSYMNxFQ2JZq5aNI4WnqKHEvAL4iR,5Gyp41oLVo7Gg7vF4vpmggWP5MU70QO6,7,3,2,0,2,0,2,0,9,1.2857142857142858,1,0.0,0,2,0,2,3,0,0,2,0,4,5,1
13788,192673,n4M3KtYoeVmBGwZqRhMtailPtqxiFNvM,5Gyp41oLVo7Gg7vF4vpmggWP5MU70QO6,5,2,1,0,1,0,3,0,7,1.0,1,0.0,0,1,0,1,2,0,0,3,0,2,5,0
13789,192690,xUPmWxTSsgICosGfzeoEXWep7y1BlUbF,5Gyp41oLVo7Gg7vF4vpmggWP5MU70QO6,1,0,0,0,0,0,1,0,1,0.14285714285714285,1,0.0,0,0,0,0,0,0,0,1,0,0,1,1
13790,192711,WII37BmFoYIjNgFNtCbYIDPeE9zOv47P,5Gyp41oLVo7Gg7vF4vpmggWP5MU70QO6,6,3,1,0,1,0,2,0,7,1.0,1,0.0,0,1,0,1,3,0,0,2,0,2,5,1
13791,192720,sV8Z2WoHSkq80AVgpDh4TBiipVVqEZ0U,5Gyp41oLVo7Gg7vF4vpmggWP5MU70QO6,10,6,3,0,2,2,6,1,20,2.857142857142857,1,0.0,2,3,0,2,4,2,0,6,1,7,13,0
13792,192748,6VNnJJ4TaCdKjrqjqfj7OP1FN8TgmlZx,5Gyp41oLVo7Gg7vF4vpmggWP5MU70QO6,6,5,1,0,2,0,2,0,10,1.4285714285714286,1,0.0,2,1,0,2,3,0,0,2,0,5,5,1
13793,192769,fsmpK8LD6WXenVxwQRsdTaVF7iZvaL2a,5Gyp41oLVo7Gg7vF4vpmggWP5MU70QO6,1,0,0,0,0,0,1,0,1,0.14285714285714285,1,0.0,0,0,0,0,0,0,0,1,0,0,1,1
13794,192775,h7zakr8SYSWro2uSacwrnlrgLZRsJAp8,5Gyp41oLVo7Gg7vF4vpmggWP5MU70QO6,1,0,0,0,0,0,1,0,1,0.14285714285714285,1,0.0,0,0,0,0,0,0,0,1,0,0,1,1
13795,192776,evrdwGhLAFWdgr0Clw2EFTM91w358eNP,5Gyp41oLVo7Gg7vF4vpmggWP5MU70QO6,1,0,0,0,0,0,1,0,1,0.14285714285714285,1,0.0,0,0,0,0,0,0,0,1,0,0,1,1
13796,192787,0bUXSF08LRKDrVerYGdbNNCRev5JedUi,5Gyp41oLVo7Gg7vF4vpmggWP5MU70QO6,12,7,5,0,4,1,4,0,21,3.0,1,0.0,0,5,0,4,7,1,0,4,0,9,12,1
13797,192792,irKkgWRUKv49jC7s6aHyZzH6m4GOBvj9,5Gyp41oLVo7Gg7vF4vpmggWP5MU70QO6,8,3,2,0,1,3,5,1,15,2.142857142857143,1,0.0,0,2,0,1,3,3,0,5,1,3,12,1
13798,192795,Qr56xJpKpx3PDtASRPf6XQoHmcGp3CKT,5Gyp41oLVo7Gg7vF4vpmggWP5MU70QO6,1,0,0,0,0,0,1,0,1,0.14285714285714285,1,0.0,0,0,0,0,0,0,0,1,0,0,1,1
13799,192798,7TbPOgQeqKxGhL5FETq1KXoyVDxkmhqf,5Gyp41oLVo7Gg7vF4vpmggWP5MU70QO6,9,10,1,0,0,0,6,1,18,2.5714285714285716,1,0.0,0,1,0,0,10,0,0,6,1,1,17,1
13800,192829,zqttlX0xeafyYu24Jt1h1c3dNmT1HiFC,5Gyp41oLVo7Gg7vF4vpmggWP5MU70QO6,2,0,0,0,0,0,2,0,2,0.2857142857142857,1,0.0,0,0,0,0,0,0,0,2,0,0,2,1
13801,192833,Hck0wChL86T7abzSrVcQpZ8hTWtosfXi,5Gyp41oLVo7Gg7vF4vpmggWP5MU70QO6,9,8,5,2,3,0,2,0,20,2.857142857142857,1,0.0,2,5,1,3,6,0,1,2,0,11,9,1
13802,192840,yrQAfD3ZnjZwlSwqGP3wxDAQpIia9vdY,5Gyp41oLVo7Gg7vF4vpmggWP5MU70QO6,4,2,1,0,1,0,2,0,6,0.8571428571428571,1,0.0,0,1,0,1,2,0,0,2,0,2,4,1
13803,192845,uNfKRPlxZfk1Bc9EZEEUlymSMEcLJL9L,5Gyp41oLVo7Gg7vF4vpmggWP5MU70QO6,4,2,1,0,0,0,2,0,5,0.7142857142857143,1,0.0,0,1,0,0,2,0,0,2,0,1,4,1
13804,192867,oeoxZo8En0mbPMY65RbcLH1DMoOBjdc7,5Gyp41oLVo7Gg7vF4vpmggWP5MU70QO6,9,17,4,0,4,0,2,0,27,3.857142857142857,1,0.0,0,4,0,4,17,0,0,2,0,8,19,1
13805,192887,SjjWcqrMCT8lboQ8wTyc2EHHc8C5Iiu7,5Gyp41oLVo7Gg7vF4vpmggWP5MU70QO6,2,0,0,0,0,0,2,0,2,0.2857142857142857,1,0.0,0,0,0,0,0,0,0,2,0,0,2,1
13806,192888,Mui53ZJj4fcTfsQUEi2bGhqknX4URISh,5Gyp41oLVo7Gg7vF4vpmggWP5MU70QO6,1,0,0,0,0,0,1,0,1,0.14285714285714285,1,0.0,0,0,0,0,0,0,0,1,0,0,1,1
13807,192897,idXOfa0UbHb2LgeTVNs25uJI6fFlL5At,5Gyp41oLVo7Gg7vF4vpmggWP5MU70QO6,2,0,0,0,0,0,2,0,2,0.2857142857142857,1,0.0,0,0,0,0,0,0,0,2,0,0,2,1
13808,192911,OfhCijoP0ZzvUzP2bFEF0mClPkmO92rU,5Gyp41oLVo7Gg7vF4vpmggWP5MU70QO6,7,3,2,0,2,0,2,0,9,1.2857142857142858,1,0.0,0,2,0,2,3,0,0,2,0,4,5,1
13809,192937,ujMqpxku4NSt0Wfta8V9ix1DgUcSpA6x,5Gyp41oLVo7Gg7vF4vpmggWP5MU70QO6,1,0,0,0,0,0,2,0,2,0.2857142857142857,1,0.0,0,0,0,0,0,0,0,2,0,0,2,1
13810,192948,IA3DXrRHbGqcPE8YntwXU3NYDZWBtMkD,5Gyp41oLVo7Gg7vF4vpmggWP5MU70QO6,2,0,0,0,0,0,2,0,2,0.2857142857142857,1,0.0,0,0,0,0,0,0,0,2,0,0,2,0
13811,192950,3U6KXt42y6FXXGo0GSzuDgsIRbrKRXyc,5Gyp41oLVo7Gg7vF4vpmggWP5MU70QO6,1,0,0,0,0,0,1,0,1,0.14285714285714285,1,0.0,0,0,0,0,0,0,0,1,0,0,1,1
13812,192962,p6mKHr5aRUQ8rsAM1ROUYWdXYBjQ7P7e,5Gyp41oLVo7Gg7vF4vpmggWP5MU70QO6,8,10,2,0,2,0,1,0,15,2.142857142857143,1,0.0,0,2,0,2,10,0,0,1,0,4,11,1
13813,192975,PIsLLpnsV9nrkg4TDwm54OVXzabsrTGs,5Gyp41oLVo7Gg7vF4vpmggWP5MU70QO6,5,2,1,0,0,0,3,1,7,1.0,1,0.0,0,1,0,0,2,0,0,3,1,1,6,1
13814,193009,SaCuUEx4yVWy7KEZ7c1LumXyYr79w4Rm,5Gyp41oLVo7Gg7vF4vpmggWP5MU70QO6,10,7,3,0,2,0,10,1,23,3.2857142857142856,1,0.0,1,3,0,2,6,0,0,10,1,6,17,1
13815,193391,Nj4h6U82iZbXhwqv4yzJTbTvwrq7ssZF,7GRhBDsirIGkRZBtSMEzNTyDr2JQm4xx,1,0,0,0,0,0,1,0,1,0.14285714285714285,1,0.0,0,0,0,0,0,0,0,1,0,0,1,1
13816,193411,5n7LHcPXoY0VQSveRQkdV1m8S1A4dqOZ,7GRhBDsirIGkRZBtSMEzNTyDr2JQm4xx,1,0,0,0,0,0,1,0,1,0.14285714285714285,1,0.0,0,0,0,0,0,0,0,1,0,0,1,1
13817,193413,RyJBTIZudHI18CHfqwWV9lrFHUkffvwx,7GRhBDsirIGkRZBtSMEzNTyDr2JQm4xx,6,2,1,0,1,0,3,0,7,1.0,1,0.0,0,1,0,1,2,0,0,3,0,2,5,0
13818,193418,SVf0SC9Fgx76juSVltwPFVkOfd5kIODF,7GRhBDsirIGkRZBtSMEzNTyDr2JQm4xx,2,0,0,0,0,0,2,0,2,0.2857142857142857,1,0.0,0,0,0,0,0,0,0,2,0,0,2,1
13819,193425,fp5rkOav6sQ2B0u2StsAV5mj6jUgMf4H,7GRhBDsirIGkRZBtSMEzNTyDr2JQm4xx,15,18,8,0,5,0,10,0,41,5.857142857142857,2,0.0,7,8,0,5,11,0,0,10,0,20,21,1
13820,193432,qtMwEGTQkwmsGD2BFQVyNlbYllHBhi9y,7GRhBDsirIGkRZBtSMEzNTyDr2JQm4xx,10,7,1,0,1,0,2,0,11,1.5714285714285714,1,0.0,0,1,0,1,7,0,0,2,0,2,9,1
13821,193439,HhFzRGJNOKJeEtotgjejPm9oQpRfjChn,7GRhBDsirIGkRZBtSMEzNTyDr2JQm4xx,1,0,0,0,0,0,2,0,2,0.2857142857142857,1,0.0,0,0,0,0,0,0,0,2,0,0,2,1
13822,193442,cZuRrLbkJ49uRRQDd7INWq8WLolfeTSw,7GRhBDsirIGkRZBtSMEzNTyDr2JQm4xx,1,0,0,0,0,0,1,0,1,0.14285714285714285,1,0.0,0,0,0,0,0,0,0,1,0,0,1,1
13823,193451,OUhmXCQX6q2wXNYlJfg8VMHiBpb32Qjg,7GRhBDsirIGkRZBtSMEzNTyDr2JQm4xx,8,10,3,0,3,0,2,0,18,2.5714285714285716,1,0.0,0,3,0,3,10,0,0,2,0,6,12,0
13824,193461,9GrY3tpi0hw7X0WFc7jJ7GdKfBSQDQX0,A3fsA9Zfv1X2fVEQhTw51lKENdNrEqT3,14,12,10,0,2,0,1,0,25,3.5714285714285716,1,0.0,0,10,0,2,12,0,0,1,0,12,13,1
13825,193529,Q3zkClKdiEJIkoKspwBuSNOwYXuxalAX,SpATywNh6bZuzm8s1ceuBUnMUAeoAHHw,7,5,3,0,3,0,2,0,13,1.8571428571428572,1,0.0,0,3,0,3,5,0,0,2,0,6,7,0
13826,193546,ut2Z39AHP6ZT6QUG6LjRTh7eJLhOH9rE,SpATywNh6bZuzm8s1ceuBUnMUAeoAHHw,1,0,0,0,0,0,1,0,1,0.14285714285714285,1,0.0,0,0,0,0,0,0,0,1,0,0,1,1
13827,193547,tomN9mWyg9iwVzF8UU8hmvw3PQ3xuR0k,G8EPVSXsOYB5YQWZGiz1aVq5Pgr2GrQu,5,5,0,0,0,0,1,0,6,0.8571428571428571,1,0.0,0,0,0,0,5,0,0,1,0,0,6,1
13828,193558,E5gNyf8gzkIFqEMMzFfX1babw0jRMtve,SpATywNh6bZuzm8s1ceuBUnMUAeoAHHw,1,0,0,0,0,0,1,0,1,0.14285714285714285,1,0.0,0,0,0,0,0,0,0,1,0,0,1,1
13829,193621,KHdvxdy2R5AbDwK3ZeYjgr8BjoNdfk08,SpATywNh6bZuzm8s1ceuBUnMUAeoAHHw,18,40,11,28,7,0,2,0,88,12.571428571428571,1,0.0,28,11,24,7,12,0,4,2,0,70,18,1
13830,193648,0lEKKJq7wgGTJZ13dxv0HcjHfYwzJrxA,5X6FeZozNMgE2VRi3MJYjkkFK8SETtu2,1,0,0,0,0,0,1,0,1,0.14285714285714285,1,0.0,0,0,0,0,0,0,0,1,0,0,1,1
13831,193662,VgqneuQZQ3AncdWCqb9v0uAbatLD1T8K,SpATywNh6bZuzm8s1ceuBUnMUAeoAHHw,3,0,0,0,0,1,4,0,5,0.7142857142857143,1,0.0,0,0,0,0,0,1,0,4,0,0,5,1
13832,193670,DQNJ5C68L0zW9SqNuKPhfxZqhIFSYAAT,SpATywNh6bZuzm8s1ceuBUnMUAeoAHHw,7,1,1,0,1,1,4,1,9,1.2857142857142858,1,0.0,0,1,0,1,1,1,0,4,1,2,7,1
13833,193674,cNh6wy7Ir03u71mDLbzarbbzMgepTdGC,A3fsA9Zfv1X2fVEQhTw51lKENdNrEqT3,7,12,4,0,2,0,7,0,25,3.5714285714285716,1,0.0,0,4,0,2,12,0,0,7,0,6,19,1
13834,193692,VwBmQMjyoGFc84WCvHOjmFbeW8jbYRgl,bWdj2GDclj5ofokWjzoa5jAwMkxCykd6,1,0,0,0,0,0,1,0,1,0.14285714285714285,1,0.0,0,0,0,0,0,0,0,1,0,0,1,1
13835,193710,mS4pmtwcndXVt9jKYDUH076p6bBZMe2Y,5X6FeZozNMgE2VRi3MJYjkkFK8SETtu2,5,2,1,0,1,0,2,0,6,0.8571428571428571,1,0.0,0,1,0,1,2,0,0,2,0,2,4,1
13836,193711,kEyzl5U0qNnr42pVaGkY13nZ2IWHqrcn,A3fsA9Zfv1X2fVEQhTw51lKENdNrEqT3,8,11,2,0,0,0,6,0,19,2.7142857142857144,1,0.0,0,2,0,0,11,0,0,6,0,2,17,1
13837,193740,QZU7ovSo60LPfLhEkMZQvJSmegKjwMYj,bWdj2GDclj5ofokWjzoa5jAwMkxCykd6,1,0,0,0,0,0,1,0,1,0.14285714285714285,1,0.0,0,0,0,0,0,0,0,1,0,0,1,1
13838,193755,nKyehpqCzFKe7AQ0H2jeEWUcUDLPIpGO,SpATywNh6bZuzm8s1ceuBUnMUAeoAHHw,5,4,2,0,1,0,2,0,9,1.2857142857142858,2,0.0,0,2,0,1,4,0,0,2,0,3,6,1
13839,193779,sxaa8Ea6Lo6kUM7O8EMurbYXKbm0hujM,A3fsA9Zfv1X2fVEQhTw51lKENdNrEqT3,4,2,1,0,0,0,2,0,5,0.7142857142857143,1,0.0,0,1,0,0,2,0,0,2,0,1,4,1
13840,193823,3vhCoT2dzeVdCpmcedhNzxK4VNLZ2l0r,A3fsA9Zfv1X2fVEQhTw51lKENdNrEqT3,2,0,0,0,0,0,2,0,2,0.2857142857142857,1,0.0,0,0,0,0,0,0,0,2,0,0,2,0
13841,193837,FMDDO6Y1UiugRDKpi0pVbHvW0zsQHjbn,A3fsA9Zfv1X2fVEQhTw51lKENdNrEqT3,1,0,0,0,0,0,2,0,2,0.2857142857142857,1,0.0,0,0,0,0,0,0,0,2,0,0,2,1
13842,193841,dfFEAUBIaQMqykMKdgVE6J8eiY6sOxye,SpATywNh6bZuzm8s1ceuBUnMUAeoAHHw,1,0,0,0,0,0,1,0,1,0.14285714285714285,1,0.0,0,0,0,0,0,0,0,1,0,0,1,1
13843,193849,hnA8kwZbTriWwmx5JyNt7w45L87YwoEF,G8EPVSXsOYB5YQWZGiz1aVq5Pgr2GrQu,6,3,1,0,1,1,2,0,8,1.1428571428571428,1,0.0,0,1,0,1,3,1,0,2,0,2,6,1
13844,193855,DC8hVUW5lzy6OHDhVmFS5qTdzgQgs5yo,G8EPVSXsOYB5YQWZGiz1aVq5Pgr2GrQu,10,5,4,0,3,0,2,0,14,2.0,1,0.0,0,4,0,3,5,0,0,2,0,7,7,1
13845,193873,aax9J1adQbt26SqiuCHMyd0MidU5QFDr,SpATywNh6bZuzm8s1ceuBUnMUAeoAHHw,18,20,8,20,3,2,9,1,63,9.0,1,0.0,5,8,16,3,15,2,4,9,1,32,31,1
13846,193875,XDysHi7lmceIm5Mq9k6RvheRnsYOet1p,SpATywNh6bZuzm8s1ceuBUnMUAeoAHHw,7,10,3,0,3,0,3,0,19,2.7142857142857144,1,0.0,0,3,0,3,10,0,0,3,0,6,13,1
13847,193876,t1OYI1zdmZ8QFHlNczrmBq9UprH9pvCH,SpATywNh6bZuzm8s1ceuBUnMUAeoAHHw,4,2,1,0,1,0,1,0,5,0.7142857142857143,1,0.0,0,1,0,1,2,0,0,1,0,2,3,1
13848,193886,glhFN9pJVRx23uQGYu0vpxeXZDAwQ2Ta,bWdj2GDclj5ofokWjzoa5jAwMkxCykd6,3,2,1,0,0,0,2,0,5,0.7142857142857143,1,0.0,0,1,0,0,2,0,0,2,0,1,4,1
13849,193898,CzuKHquS2mEQaelvyNFMdu8Hprmbh3VI,A3fsA9Zfv1X2fVEQhTw51lKENdNrEqT3,14,6,6,0,6,0,3,0,21,3.0,1,0.0,0,6,0,6,6,0,0,3,0,12,9,1
13850,193901,Qp3BNNi2PRh8N3k7qOPk9z3KeApis9gf,RXDvfPUBYFlVdlueBFbLW0mhhAyGEqpt,1,0,0,0,0,0,1,0,1,0.14285714285714285,1,0.0,0,0,0,0,0,0,0,1,0,0,1,1
13851,193923,TXo0CCOBoSUl3sGr1fGqVDX7GLiPHTPL,SpATywNh6bZuzm8s1ceuBUnMUAeoAHHw,13,27,8,0,4,0,1,0,40,5.714285714285714,1,0.0,0,8,0,4,27,0,0,1,0,12,28,1
13852,193971,B9OrY2GCm2nBIEwFkCzWGpeUovQjjQhl,SpATywNh6bZuzm8s1ceuBUnMUAeoAHHw,6,3,1,0,1,0,2,0,7,1.0,1,0.0,0,1,0,1,3,0,0,2,0,2,5,1
13853,193976,MdokNqUjzmrixfK2dFiZvz1LZ7rVu7Cj,SpATywNh6bZuzm8s1ceuBUnMUAeoAHHw,4,2,0,0,0,0,2,0,4,0.5714285714285714,1,0.0,0,0,0,0,2,0,0,2,0,0,4,1
13854,193989,kTjP7AQblBZanJKF3X14Zgingjm852XK,A3fsA9Zfv1X2fVEQhTw51lKENdNrEqT3,24,4,2,42,0,1,6,1,56,8.0,1,0.0,2,2,41,0,2,1,1,6,1,45,11,1
13855,194009,QnyEBvmb3eYd1kNyaAYx0F6xZuTb2DX9,SpATywNh6bZuzm8s1ceuBUnMUAeoAHHw,3,2,0,0,0,0,1,0,3,0.42857142857142855,1,0.0,0,0,0,0,2,0,0,1,0,0,3,1
13856,194016,0Gb2L45v3CzxlKP5WG7b6lBKOfgBuWF4,bWdj2GDclj5ofokWjzoa5jAwMkxCykd6,1,0,0,0,0,0,1,0,1,0.14285714285714285,1,0.0,0,0,0,0,0,0,0,1,0,0,1,1
13857,194049,mpIXHW5sILjjHOwn1u3NkBPJs6lkxDFU,A3fsA9Zfv1X2fVEQhTw51lKENdNrEqT3,1,0,0,0,0,0,1,0,1,0.14285714285714285,1,0.0,0,0,0,0,0,0,0,1,0,0,1,1
13858,194057,UasrjB6Lz57MSXiyP9hy734A5ulOXRm3,SpATywNh6bZuzm8s1ceuBUnMUAeoAHHw,8,2,2,0,2,0,6,0,12,1.7142857142857142,1,0.0,0,2,0,2,2,0,0,6,0,4,8,1
13859,194058,UasrjB6Lz57MSXiyP9hy734A5ulOXRm3,5X6FeZozNMgE2VRi3MJYjkkFK8SETtu2,6,1,1,0,1,0,3,0,6,0.8571428571428571,1,0.0,0,1,0,1,1,0,0,3,0,2,4,1
13860,194064,RGBg5OBpyocoeZ6vgulRvdHAe4GhCDz5,RXDvfPUBYFlVdlueBFbLW0mhhAyGEqpt,1,0,0,0,0,0,1,0,1,0.14285714285714285,1,0.0,0,0,0,0,0,0,0,1,0,0,1,1
13861,194069,RGBg5OBpyocoeZ6vgulRvdHAe4GhCDz5,5X6FeZozNMgE2VRi3MJYjkkFK8SETtu2,1,0,0,0,0,0,1,0,1,0.14285714285714285,1,0.0,0,0,0,0,0,0,0,1,0,0,1,1
13862,194106,RbyWsDK4wdT2As4ssmcjxiIXfIRi33se,RXDvfPUBYFlVdlueBFbLW0mhhAyGEqpt,1,0,0,0,0,0,1,0,1,0.14285714285714285,1,0.0,0,0,0,0,0,0,0,1,0,0,1,1
13863,194111,RbyWsDK4wdT2As4ssmcjxiIXfIRi33se,SpATywNh6bZuzm8s1ceuBUnMUAeoAHHw,1,0,0,0,0,0,1,0,1,0.14285714285714285,1,0.0,0,0,0,0,0,0,0,1,0,0,1,1
13864,194122,Jag1EXQWfAuTRiCgcVLyhRRkdOL9RtSD,SpATywNh6bZuzm8s1ceuBUnMUAeoAHHw,5,2,1,0,1,0,2,0,6,0.8571428571428571,1,0.0,0,1,0,1,2,0,0,2,0,2,4,1
13865,194139,r0yAsNzYkqEPYi6zNhQfzuueDjmcyFRr,5X6FeZozNMgE2VRi3MJYjkkFK8SETtu2,1,0,0,0,0,0,1,0,1,0.14285714285714285,1,0.0,0,0,0,0,0,0,0,1,0,0,1,1
13866,194149,r3BpteKZps4orgYHVV47mEy8Bf1f88sS,SpATywNh6bZuzm8s1ceuBUnMUAeoAHHw,1,0,0,0,0,0,1,0,1,0.14285714285714285,1,0.0,0,0,0,0,0,0,0,1,0,0,1,1
13867,194153,5jJlZ63WvPN0vjGcWOkJ1QjGnKioIAQM,5X6FeZozNMgE2VRi3MJYjkkFK8SETtu2,3,3,0,0,0,0,1,0,4,0.5714285714285714,1,0.0,0,0,0,0,3,0,0,1,0,0,4,1
13868,194174,aPhG1FOMABaf6t82UGQZl3EdavvBRVEM,SpATywNh6bZuzm8s1ceuBUnMUAeoAHHw,8,5,3,0,2,0,4,0,14,2.0,1,0.0,0,3,0,2,5,0,0,4,0,5,9,1
13869,194202,BRI1NrrNzUCAkotknDhVlhYBChSBuaKT,A3fsA9Zfv1X2fVEQhTw51lKENdNrEqT3,5,2,1,0,1,0,5,0,9,1.2857142857142858,1,0.0,0,1,0,1,2,0,0,5,0,2,7,1
13870,194229,Utp3WJ8WUPD5DMyG8PNbE11goCMql2Z7,A3fsA9Zfv1X2fVEQhTw51lKENdNrEqT3,1,0,0,0,0,0,1,0,1,0.14285714285714285,1,0.0,0,0,0,0,0,0,0,1,0,0,1,1
13871,194249,pYpEHiiN5hrwCDFMKyLxLiOaj9mHQ7GD,SpATywNh6bZuzm8s1ceuBUnMUAeoAHHw,10,25,10,0,6,0,7,0,48,6.857142857142857,2,0.0,0,10,0,6,25,0,0,7,0,16,32,1
13872,194264,FLurI80IK98XkIDWszFSc1I4xJfHkDui,SpATywNh6bZuzm8s1ceuBUnMUAeoAHHw,12,9,4,22,2,0,3,0,40,5.714285714285714,1,0.0,2,4,18,2,7,0,4,3,0,26,14,1
13873,194271,KZl7dzvypdUdUZeB27FsOKIroCh34ZqE,A3fsA9Zfv1X2fVEQhTw51lKENdNrEqT3,1,0,0,0,0,0,1,0,1,0.14285714285714285,1,0.0,0,0,0,0,0,0,0,1,0,0,1,1
13874,194287,MAiX9Mv3NnsExv5ROawUklmLMW7Nn262,SpATywNh6bZuzm8s1ceuBUnMUAeoAHHw,15,11,9,17,6,0,8,0,51,7.285714285714286,1,0.0,2,9,14,6,9,0,3,8,0,31,20,1
13875,194317,90AfsCq5UXzZCbixYNCLPLgYyR0EOdy8,G8EPVSXsOYB5YQWZGiz1aVq5Pgr2GrQu,2,0,0,0,0,0,2,0,2,0.2857142857142857,1,0.0,0,0,0,0,0,0,0,2,0,0,2,0
13876,194320,DJXmR0KXC00UhtfnxnB0CPGhSlDcn5wL,A3fsA9Zfv1X2fVEQhTw51lKENdNrEqT3,1,0,0,0,0,0,1,0,1,0.14285714285714285,1,0.0,0,0,0,0,0,0,0,1,0,0,1,1
13877,194324,n2VuZ0fqJlR2ojRwATHr8Dfs9pdWlC2O,A3fsA9Zfv1X2fVEQhTw51lKENdNrEqT3,2,0,0,0,0,0,2,0,2,0.2857142857142857,1,0.0,0,0,0,0,0,0,0,2,0,0,2,1
13878,194327,M1VqvJkrHwdSwkXPdddYGz81xvnLA8HS,SpATywNh6bZuzm8s1ceuBUnMUAeoAHHw,1,0,0,0,0,0,1,0,1,0.14285714285714285,1,0.0,0,0,0,0,0,0,0,1,0,0,1,1
13879,194336,QrSRvY8A0BnQzetj7Na9CGZYc5c4hg6D,SpATywNh6bZuzm8s1ceuBUnMUAeoAHHw,1,0,0,0,0,0,1,0,1,0.14285714285714285,1,0.0,0,0,0,0,0,0,0,1,0,0,1,1
13880,194343,v3fCRqF4yjcmyXUAihELSrQ7bgYySQHE,SpATywNh6bZuzm8s1ceuBUnMUAeoAHHw,1,0,0,0,0,0,1,0,1,0.14285714285714285,1,0.0,0,0,0,0,0,0,0,1,0,0,1,0
13881,194362,NSeMeg6h5JDvAoSbt1mktNuQe2nQivm2,5X6FeZozNMgE2VRi3MJYjkkFK8SETtu2,26,18,6,30,3,0,3,0,60,8.571428571428571,1,0.0,9,6,29,3,9,0,1,3,0,47,13,1
13882,194366,MxupZhGQSwq1Hs7FHVKBBW3oeB56xups,SpATywNh6bZuzm8s1ceuBUnMUAeoAHHw,5,4,3,0,2,0,1,0,10,1.4285714285714286,1,0.0,0,3,0,2,4,0,0,1,0,5,5,1
13883,194382,Vnz3YQtaGP9Lud4eJsx4REuNf7a7Z6K7,SpATywNh6bZuzm8s1ceuBUnMUAeoAHHw,2,0,0,0,0,0,4,0,4,0.5714285714285714,1,0.0,0,0,0,0,0,0,0,4,0,0,4,1
13884,194391,bdUXVrhZKpaP1VpbMxVaAFkizIqnujVe,A3fsA9Zfv1X2fVEQhTw51lKENdNrEqT3,7,3,2,0,2,0,2,0,9,1.2857142857142858,1,0.0,0,2,0,2,3,0,0,2,0,4,5,1
13885,194402,HR018KR2tBP057NQs8ykDSVXzmSvDGhY,SpATywNh6bZuzm8s1ceuBUnMUAeoAHHw,1,0,0,0,0,0,1,0,1,0.14285714285714285,1,0.0,0,0,0,0,0,0,0,1,0,0,1,1
13886,194403,UF7B9M1202zm8vZITrztmSzM22WJBlYD,bWdj2GDclj5ofokWjzoa5jAwMkxCykd6,2,0,0,0,0,0,2,0,2,0.2857142857142857,1,0.0,0,0,0,0,0,0,0,2,0,0,2,1
13887,194443,InBEEGDWD99h4yXK2rL9tIFIqmzEV1Dr,SpATywNh6bZuzm8s1ceuBUnMUAeoAHHw,1,0,0,0,0,0,1,0,1,0.14285714285714285,1,0.0,0,0,0,0,0,0,0,1,0,0,1,1
13888,194464,kMcdY0ONNEzYAx15mWphYUVwn71ZDd1H,A3fsA9Zfv1X2fVEQhTw51lKENdNrEqT3,9,7,5,0,0,0,14,0,26,3.7142857142857144,1,0.0,0,5,0,0,7,0,0,14,0,5,21,1
13889,194468,3zCxXtKsxr4Va4aHW0QJdJglnVCQNojy,A3fsA9Zfv1X2fVEQhTw51lKENdNrEqT3,4,1,1,0,0,0,2,0,4,0.5714285714285714,1,0.0,0,1,0,0,1,0,0,2,0,1,3,1
13890,194475,EUmZ5qzjwgko2PIWEnctkvYh7APnUrX9,5X6FeZozNMgE2VRi3MJYjkkFK8SETtu2,1,0,0,0,0,0,1,0,1,0.14285714285714285,1,0.0,0,0,0,0,0,0,0,1,0,0,1,1
13891,194505,j5jVj2bcu5kXIDJr17WzWDRjLxNGLUuO,SpATywNh6bZuzm8s1ceuBUnMUAeoAHHw,11,9,1,3,0,0,2,0,15,2.142857142857143,1,0.0,2,1,3,0,7,0,0,2,0,6,9,1
13892,194513,0SWFrShD2Nk1V8wWNIvbhD4Wg61qxonB,SpATywNh6bZuzm8s1ceuBUnMUAeoAHHw,4,2,0,0,1,0,2,0,5,0.7142857142857143,1,0.0,1,0,0,1,1,0,0,2,0,2,3,1
13893,194532,K5Sy6doI03r5uctdEcvObhW1bpzNGROt,SpATywNh6bZuzm8s1ceuBUnMUAeoAHHw,1,0,0,0,0,0,1,0,1,0.14285714285714285,1,0.0,0,0,0,0,0,0,0,1,0,0,1,1
13894,194535,fHK2jlK24YNeyNqHHz5jsgZSw0Zz3G3h,G8EPVSXsOYB5YQWZGiz1aVq5Pgr2GrQu,9,6,4,0,2,0,3,0,15,2.142857142857143,1,0.0,0,4,0,2,6,0,0,3,0,6,9,1
13895,194537,H3KvIatiAwzsCPQBVABALz431TkTR6tW,A3fsA9Zfv1X2fVEQhTw51lKENdNrEqT3,5,4,0,0,0,0,3,0,7,1.0,1,0.0,0,0,0,0,4,0,0,3,0,0,7,1
13896,194547,CBNFR2yvlMJ76Qf0H5A5aLcRXIsTpjTt,A3fsA9Zfv1X2fVEQhTw51lKENdNrEqT3,8,2,1,0,1,0,6,0,10,1.4285714285714286,1,0.0,0,1,0,1,2,0,0,6,0,2,8,1
13897,194552,VJiHrUKuVkG2Wd7Jui04ER4qa9ZGvV1t,RXDvfPUBYFlVdlueBFbLW0mhhAyGEqpt,1,0,0,0,0,0,1,0,1,0.14285714285714285,1,0.0,0,0,0,0,0,0,0,1,0,0,1,1
13898,194559,AZZvRPcRkLSa6vwofzfwsEULTUhiKy0E,bWdj2GDclj5ofokWjzoa5jAwMkxCykd6,1,0,0,0,0,0,1,0,1,0.14285714285714285,1,0.0,0,0,0,0,0,0,0,1,0,0,1,1
13899,194561,n5wUv34AuAx6Xa4DLYxEIV5L4Btui37s,SpATywNh6bZuzm8s1ceuBUnMUAeoAHHw,3,2,0,0,0,0,2,0,4,0.5714285714285714,1,0.0,0,0,0,0,2,0,0,2,0,0,4,1
13900,194575,0a9LRwLYq2zam4NcdU9Yh5C7IQvHBC1m,bWdj2GDclj5ofokWjzoa5jAwMkxCykd6,1,0,0,0,0,0,2,0,2,0.2857142857142857,1,0.0,0,0,0,0,0,0,0,2,0,0,2,0
13901,194594,GzXqA08hGJ8jcoopZQLhcubV2m4jl8LU,SpATywNh6bZuzm8s1ceuBUnMUAeoAHHw,8,7,3,0,0,1,8,1,20,2.857142857142857,1,0.0,0,3,0,0,7,1,0,8,1,3,17,1
13902,194598,fQCBMBoRMdmYhgrCFbeJRBZ7kML0GboZ,SpATywNh6bZuzm8s1ceuBUnMUAeoAHHw,10,6,5,0,4,0,2,0,17,2.4285714285714284,1,0.0,0,5,0,4,6,0,0,2,0,9,8,1
13903,194605,L7tS5WxhPVvFnR9bkUR4sVMKwjpwOVxP,bWdj2GDclj5ofokWjzoa5jAwMkxCykd6,6,11,1,0,1,0,5,0,18,2.5714285714285716,1,0.0,0,1,0,1,11,0,0,5,0,2,16,1
13904,194606,fQCBMBoRMdmYhgrCFbeJRBZ7kML0GboZ,RXDvfPUBYFlVdlueBFbLW0mhhAyGEqpt,1,0,0,0,0,0,1,0,1,0.14285714285714285,1,0.0,0,0,0,0,0,0,0,1,0,0,1,1
13905,194612,QbCiNdlMyqDCsAbTGmu0rgI2d2IPTQYV,SpATywNh6bZuzm8s1ceuBUnMUAeoAHHw,1,0,0,0,0,0,1,0,1,0.14285714285714285,1,0.0,0,0,0,0,0,0,0,1,0,0,1,1
13906,194616,0RzZnN2VlQfnUgC4UWcMDxWp2iZsqlCl,SpATywNh6bZuzm8s1ceuBUnMUAeoAHHw,9,6,3,0,1,2,7,1,20,2.857142857142857,1,0.0,0,3,0,1,6,2,0,7,1,4,16,1
13907,194620,aZ7bXLhm88jb64CpmaMPaGfxwPdIjnoI,SpATywNh6bZuzm8s1ceuBUnMUAeoAHHw,2,0,0,0,0,0,2,0,2,0.2857142857142857,1,0.0,0,0,0,0,0,0,0,2,0,0,2,1
13908,194660,6S42i3UQWxx5Vy8tElcT4nwPzZzrdR85,SpATywNh6bZuzm8s1ceuBUnMUAeoAHHw,2,0,0,0,0,0,2,0,2,0.2857142857142857,1,0.0,0,0,0,0,0,0,0,2,0,0,2,1
13909,194671,HPJrmwivOMEDkgdyN7JDkONun7b8CtmQ,SpATywNh6bZuzm8s1ceuBUnMUAeoAHHw,5,3,1,0,1,0,1,0,6,0.8571428571428571,1,0.0,0,1,0,1,3,0,0,1,0,2,4,1
13910,194673,4sHw1UrsiyaJNXlPeVCwFs89kPI7rFXb,SpATywNh6bZuzm8s1ceuBUnMUAeoAHHw,10,8,2,0,2,0,5,1,18,2.5714285714285716,1,0.0,5,2,0,2,3,0,0,5,1,9,9,1
13911,194682,fOtwdZktYnpxoylqFRzXhWQ4IRQZkjMB,A3fsA9Zfv1X2fVEQhTw51lKENdNrEqT3,10,6,4,0,3,0,3,0,16,2.2857142857142856,2,0.0,0,4,0,3,6,0,0,3,0,7,9,1
13912,194683,BoPqpHAIR2FQ1yjN5I6jPiYn67RLyUD3,A3fsA9Zfv1X2fVEQhTw51lKENdNrEqT3,3,2,0,0,0,0,1,0,3,0.42857142857142855,1,0.0,0,0,0,0,2,0,0,1,0,0,3,1
13913,194687,zeGNUT3jrsWIuoEonUpuQekYC6uAy3VD,SpATywNh6bZuzm8s1ceuBUnMUAeoAHHw,10,17,5,0,3,0,2,0,27,3.857142857142857,1,0.0,11,5,0,3,6,0,0,2,0,19,8,1
13914,194689,jWHZ4vPCIn46Q1yqOYKTzhu7yXXPh48K,SpATywNh6bZuzm8s1ceuBUnMUAeoAHHw,4,2,1,0,1,0,1,0,5,0.7142857142857143,1,0.0,0,1,0,1,2,0,0,1,0,2,3,1
13915,194700,UV3gRhbCQYEkFRwtzHQKR8Uz1PLcy3Cv,A3fsA9Zfv1X2fVEQhTw51lKENdNrEqT3,9,3,2,0,2,0,6,1,14,2.0,1,0.0,0,2,0,2,3,0,0,6,1,4,10,1
13916,194704,aBLoyZmvDn4bo6KaMYT6oQr1olyWZk2d,SpATywNh6bZuzm8s1ceuBUnMUAeoAHHw,6,3,1,0,1,0,2,0,7,1.0,1,0.0,0,1,0,1,3,0,0,2,0,2,5,1
13917,194707,JlZc44brK6lbQxfSfaJSAohGFJLWA41f,SpATywNh6bZuzm8s1ceuBUnMUAeoAHHw,1,0,0,0,0,0,1,0,1,0.14285714285714285,1,0.0,0,0,0,0,0,0,0,1,0,0,1,1
13918,194708,9T6sJuPiEkwFHn4VyREnKyR6Ni1hFol4,bWdj2GDclj5ofokWjzoa5jAwMkxCykd6,5,2,1,0,1,0,3,0,7,1.0,1,0.0,0,1,0,1,2,0,0,3,0,2,5,1
13919,194715,Ynti1kEVPZ88eymZgi4Ldsdb7WhG2uKG,SpATywNh6bZuzm8s1ceuBUnMUAeoAHHw,6,7,3,0,3,0,1,0,14,2.0,1,0.0,0,3,0,3,7,0,0,1,0,6,8,0
13920,194718,We3kejZMHXKEdbxhEAiN4oVd8fYmz3y9,A3fsA9Zfv1X2fVEQhTw51lKENdNrEqT3,2,0,0,0,0,0,3,0,3,0.42857142857142855,1,0.0,0,0,0,0,0,0,0,3,0,0,3,1
13921,194750,I2ghGumCKIaVsnJOGZA0xyJzTnEm5KtW,A3fsA9Zfv1X2fVEQhTw51lKENdNrEqT3,32,27,14,50,2,2,14,1,110,15.714285714285714,2,0.0,8,14,47,2,19,2,3,14,1,71,39,1
13922,194769,6bu6C39hyqa2rqkbngsN91OKjCxnxMLI,SpATywNh6bZuzm8s1ceuBUnMUAeoAHHw,10,12,4,16,0,0,2,0,34,4.857142857142857,1,0.0,7,4,14,0,5,0,2,2,0,25,9,1
13923,194770,L7M3Ksh9UBx3xOMl31gqtqz6gfclvqlN,G8EPVSXsOYB5YQWZGiz1aVq5Pgr2GrQu,4,3,1,0,1,0,1,0,6,0.8571428571428571,1,0.0,0,1,0,1,3,0,0,1,0,2,4,1
13924,194797,NFBFv8TG60SG6ScKXY2TuDjWLm29gAEO,G8EPVSXsOYB5YQWZGiz1aVq5Pgr2GrQu,21,19,10,18,4,2,7,1,61,8.714285714285714,1,0.0,5,10,15,4,14,2,3,7,1,34,27,0
13925,194812,U1JFUNAXc1AkReOZ8wdY4hTFUY2t5lXd,SpATywNh6bZuzm8s1ceuBUnMUAeoAHHw,4,3,1,0,1,0,1,0,6,0.8571428571428571,1,0.0,0,1,0,1,3,0,0,1,0,2,4,1
13926,194819,8mJzNtbbhYVCgZPRtpQ3nYyV12q5x7iP,SpATywNh6bZuzm8s1ceuBUnMUAeoAHHw,6,3,1,0,1,0,2,0,7,1.0,1,0.0,0,1,0,1,3,0,0,2,0,2,5,1
13927,194838,0Rc9QmalpGXvwxh2iIaT1Kf7aHCEMOJW,bWdj2GDclj5ofokWjzoa5jAwMkxCykd6,2,0,0,0,0,0,2,0,2,0.2857142857142857,1,0.0,0,0,0,0,0,0,0,2,0,0,2,1
13928,194840,9uetg4jrkfyr9l65M4782Ix4xyAceyAw,SpATywNh6bZuzm8s1ceuBUnMUAeoAHHw,4,2,1,0,0,0,2,0,5,0.7142857142857143,1,0.0,0,1,0,0,2,0,0,2,0,1,4,1
13929,194856,TfgVRC9skFsGu3qq14caEQmfjmrp7rot,SpATywNh6bZuzm8s1ceuBUnMUAeoAHHw,1,0,0,0,0,0,1,0,1,0.14285714285714285,1,0.0,0,0,0,0,0,0,0,1,0,0,1,1
13930,194884,hjZ9Xmjh9fy8zpJXBG9oc3s2Pno9M1Qj,G8EPVSXsOYB5YQWZGiz1aVq5Pgr2GrQu,16,14,5,12,5,0,9,1,46,6.571428571428571,1,0.0,8,5,10,5,6,0,2,9,1,28,18,1
13931,194894,KpYtE2oiCacGgvHDiOR9EPHvEG8K5VAH,A3fsA9Zfv1X2fVEQhTw51lKENdNrEqT3,14,4,3,42,1,0,1,0,51,7.285714285714286,1,0.0,0,3,37,1,4,0,5,1,0,41,10,1
13932,194898,EoYsxsuekHFOGMEOJolKStlPHqzqAJps,SpATywNh6bZuzm8s1ceuBUnMUAeoAHHw,1,0,0,0,0,0,1,0,1,0.14285714285714285,1,0.0,0,0,0,0,0,0,0,1,0,0,1,1
13933,194899,CJ8rz0JWIuI4wzHfaCoKLPdQC5hP7L8o,SpATywNh6bZuzm8s1ceuBUnMUAeoAHHw,2,0,0,0,0,0,2,0,2,0.2857142857142857,1,0.0,0,0,0,0,0,0,0,2,0,0,2,1
13934,194911,coZTr10eytnE55me2AxqRWq6qrVXEB7M,A3fsA9Zfv1X2fVEQhTw51lKENdNrEqT3,6,6,3,0,1,0,3,0,13,1.8571428571428572,1,0.0,0,3,0,1,6,0,0,3,0,4,9,1
13935,194920,nAKoJ3KJH4tNdKl2KzEFM3pKVZsfxNEo,SpATywNh6bZuzm8s1ceuBUnMUAeoAHHw,9,7,1,0,1,0,3,0,12,1.7142857142857142,1,0.0,0,1,0,1,7,0,0,3,0,2,10,1
13936,194938,iUqEEHE7KFlYvrJ9lttneq6sdDOxoE0o,A3fsA9Zfv1X2fVEQhTw51lKENdNrEqT3,1,0,0,0,0,0,1,0,1,0.14285714285714285,1,0.0,0,0,0,0,0,0,0,1,0,0,1,1
13937,194944,5yeJY3nTHKOfgXEh2NQejnxfnR8LFeFo,SpATywNh6bZuzm8s1ceuBUnMUAeoAHHw,6,5,2,0,2,0,1,0,10,1.4285714285714286,1,0.0,0,2,0,2,5,0,0,1,0,4,6,1
13938,194964,i0Fe8GkgETgJLYZf4oG1MMDT0SsDr0Jw,G8EPVSXsOYB5YQWZGiz1aVq5Pgr2GrQu,13,5,4,8,3,0,1,0,21,3.0,1,0.0,0,4,8,3,5,0,0,1,0,15,6,1
13939,194990,ULvgH0dn9cMQ7RqvqnSWbMcAlKJJQ0Fk,A3fsA9Zfv1X2fVEQhTw51lKENdNrEqT3,4,3,1,0,1,0,2,0,7,1.0,1,0.0,0,1,0,1,3,0,0,2,0,2,5,0
13940,194991,ULvgH0dn9cMQ7RqvqnSWbMcAlKJJQ0Fk,RXDvfPUBYFlVdlueBFbLW0mhhAyGEqpt,4,3,1,0,1,0,2,0,7,1.0,1,0.0,0,1,0,1,3,0,0,2,0,2,5,1
13941,195000,h2BiSzi5m6dXS3KusokZajeewmz5ASZK,SpATywNh6bZuzm8s1ceuBUnMUAeoAHHw,1,0,0,0,0,0,1,0,1,0.14285714285714285,1,0.0,0,0,0,0,0,0,0,1,0,0,1,1
13942,195011,NgAo8zTwzEL5kdUZa1oY4oYdY9RywdJx,bWdj2GDclj5ofokWjzoa5jAwMkxCykd6,1,0,0,0,0,0,1,0,1,0.14285714285714285,1,0.0,0,0,0,0,0,0,0,1,0,0,1,1
13943,195028,A7Dy7wBvIZYcTIZR94lL6Ks9jKNwU0Wy,bWdj2GDclj5ofokWjzoa5jAwMkxCykd6,6,2,1,0,1,0,3,0,7,1.0,1,0.0,0,1,0,1,2,0,0,3,0,2,5,1
13944,195048,KGzfXe849hKjIs0BHn7D33gnH3hOFhhi,A3fsA9Zfv1X2fVEQhTw51lKENdNrEqT3,1,0,0,0,0,0,1,0,1,0.14285714285714285,1,0.0,0,0,0,0,0,0,0,1,0,0,1,1
13945,195050,1qqlfnvXgcooPyZOwWYRIPDMSQDSWipF,A3fsA9Zfv1X2fVEQhTw51lKENdNrEqT3,8,4,3,0,2,0,2,0,11,1.5714285714285714,1,0.0,0,3,0,2,4,0,0,2,0,5,6,1
13946,195054,EboqTOLce3Kcnbr13rePsINEM3noHrcD,SpATywNh6bZuzm8s1ceuBUnMUAeoAHHw,1,0,0,0,0,0,3,0,3,0.42857142857142855,1,0.0,0,0,0,0,0,0,0,3,0,0,3,1
13947,195067,0hhH7SwEpwXhVryAlzllJZZoxMiaryTB,A3fsA9Zfv1X2fVEQhTw51lKENdNrEqT3,2,0,0,0,0,0,3,0,3,0.42857142857142855,1,0.0,0,0,0,0,0,0,0,3,0,0,3,1
13948,195070,LcDHI9VirEpxfDmLtYSK63dNG6QfI1o9,bWdj2GDclj5ofokWjzoa5jAwMkxCykd6,1,0,0,0,0,0,2,0,2,0.2857142857142857,1,0.0,0,0,0,0,0,0,0,2,0,0,2,1
13949,195096,VblkSmB0qnt2Sn7mKykILqjl5hQ7D7Rd,SpATywNh6bZuzm8s1ceuBUnMUAeoAHHw,8,3,0,0,0,4,5,1,13,1.8571428571428572,1,0.0,0,0,0,0,3,4,0,5,1,0,13,1
13950,195105,L8lHLh6Mth1S7I3sErP5oDZD885a1BOh,RXDvfPUBYFlVdlueBFbLW0mhhAyGEqpt,4,4,3,0,2,0,1,0,10,1.4285714285714286,1,0.0,0,3,0,2,4,0,0,1,0,5,5,1
13951,195123,9bRCoX5aFYQHE9DZm9jyLHKfMlQ7Zegu,A3fsA9Zfv1X2fVEQhTw51lKENdNrEqT3,15,10,8,0,6,0,19,1,44,6.285714285714286,1,0.0,0,8,0,6,10,0,0,19,1,14,30,1
13952,195133,0vh8eAAsIFnTSYCbme0HYH2GZabOpyjO,SpATywNh6bZuzm8s1ceuBUnMUAeoAHHw,6,4,3,0,0,0,2,0,9,1.2857142857142858,1,0.0,0,3,0,0,4,0,0,2,0,3,6,1
13953,195134,lIXwq3JER4SWrE0O7y1NzGhial9PDy2H,RXDvfPUBYFlVdlueBFbLW0mhhAyGEqpt,9,4,3,0,3,0,2,0,12,1.7142857142857142,1,0.0,0,3,0,3,4,0,0,2,0,6,6,1
13954,195138,zcYW5hQJaAne538I54YBHKKIHPYdcKzR,SpATywNh6bZuzm8s1ceuBUnMUAeoAHHw,3,0,0,0,0,0,3,0,3,0.42857142857142855,1,0.0,0,0,0,0,0,0,0,3,0,0,3,1
13955,195139,WKjm9NNrYTUj7AQwUBj4LGUEStoUuQbI,A3fsA9Zfv1X2fVEQhTw51lKENdNrEqT3,5,2,1,0,1,0,3,0,7,1.0,1,0.0,0,1,0,1,2,0,0,3,0,2,5,1
13956,195143,ZD6KzBJPXfWBkZLRMcl4p14dD6WWX4Ih,SpATywNh6bZuzm8s1ceuBUnMUAeoAHHw,10,14,0,2,0,0,4,0,20,2.857142857142857,1,0.0,2,0,2,0,12,0,0,4,0,4,16,1
13957,195148,AH5vrBLwc7s7uQQh3dO8uaZFfBQDcQxi,SpATywNh6bZuzm8s1ceuBUnMUAeoAHHw,1,0,0,0,0,0,1,0,1,0.14285714285714285,1,0.0,0,0,0,0,0,0,0,1,0,0,1,1
13958,195168,lk6sSo2mEoREiTaQjIlY6dKahZkFRKmP,A3fsA9Zfv1X2fVEQhTw51lKENdNrEqT3,1,0,0,0,0,0,1,0,1,0.14285714285714285,1,0.0,0,0,0,0,0,0,0,1,0,0,1,1
13959,195172,TzUoSJ3pyMjwCKLIHuVSKLad9h9hLr5U,A3fsA9Zfv1X2fVEQhTw51lKENdNrEqT3,4,4,0,0,0,0,1,0,5,0.7142857142857143,1,0.0,0,0,0,0,4,0,0,1,0,0,5,1
13960,195192,hT3gwKIRPmJxcgYf5liQovlZBdIJz1xq,SpATywNh6bZuzm8s1ceuBUnMUAeoAHHw,1,0,0,0,0,0,1,0,1,0.14285714285714285,1,0.0,0,0,0,0,0,0,0,1,0,0,1,1
13961,195202,FVkmb2ERZAYNUD3Q1ZAc0irCEUsLVQQz,SpATywNh6bZuzm8s1ceuBUnMUAeoAHHw,5,2,1,0,1,0,2,0,6,0.8571428571428571,1,0.0,0,1,0,1,2,0,0,2,0,2,4,1
13962,195215,MTAnkeTQnWs9GdHH6O5LRyYCh9iX5uP4,RXDvfPUBYFlVdlueBFbLW0mhhAyGEqpt,1,0,0,0,0,0,2,0,2,0.2857142857142857,1,0.0,0,0,0,0,0,0,0,2,0,0,2,1
13963,195218,abz0JUG7GWWef4jRyaayLqZkxtxXeHAT,SpATywNh6bZuzm8s1ceuBUnMUAeoAHHw,5,3,2,0,2,0,2,0,9,1.2857142857142858,1,0.0,0,2,0,2,3,0,0,2,0,4,5,1
13964,195226,xQ2ZtBKsHIRujsTwaOBWpiIEohBtlo5W,SpATywNh6bZuzm8s1ceuBUnMUAeoAHHw,7,10,5,0,1,0,2,0,18,2.5714285714285716,1,0.0,3,5,0,1,7,0,0,2,0,9,9,1
13965,195234,r0nvOJG3TaeLm69nhbeK6crtYznkTFB2,SpATywNh6bZuzm8s1ceuBUnMUAeoAHHw,7,5,2,0,2,0,4,0,13,1.8571428571428572,1,0.0,2,2,0,2,3,0,0,4,0,6,7,1
13966,195236,fIET0xNMcDIlnjd0AnC9TZEnn5s3AA6i,A3fsA9Zfv1X2fVEQhTw51lKENdNrEqT3,1,0,0,0,0,0,1,0,1,0.14285714285714285,1,0.0,0,0,0,0,0,0,0,1,0,0,1,1
13967,195239,bONRCO0uATZ9orvOXASjWia0swY9AaMZ,bWdj2GDclj5ofokWjzoa5jAwMkxCykd6,6,2,1,0,1,0,3,0,7,1.0,1,0.0,0,1,0,1,2,0,0,3,0,2,5,1
13968,195258,JIBg2bFQYc7ncSPQhvBWrAlcobShyiXA,G8EPVSXsOYB5YQWZGiz1aVq5Pgr2GrQu,5,2,0,0,0,0,3,1,6,0.8571428571428571,1,0.0,0,0,0,0,2,0,0,3,1,0,6,1
13969,195271,H9TBxem7IeyaJ30CPoPNOnkpc9xO2MQu,SpATywNh6bZuzm8s1ceuBUnMUAeoAHHw,1,0,0,0,0,0,1,0,1,0.14285714285714285,1,0.0,0,0,0,0,0,0,0,1,0,0,1,1
13970,195274,83JPfkin3GX4GLKqML2uaHSZ5KvsuJhM,G8EPVSXsOYB5YQWZGiz1aVq5Pgr2GrQu,2,0,0,0,0,3,1,0,4,0.5714285714285714,1,0.0,0,0,0,0,0,3,0,1,0,0,4,1
13971,195281,JHMFz2Gy459G1ldyhA75ALSO8YlPxA4n,bWdj2GDclj5ofokWjzoa5jAwMkxCykd6,9,7,3,0,3,0,2,0,15,2.142857142857143,1,0.0,0,3,0,3,7,0,0,2,0,6,9,1
13972,195287,ouhJVRUNWH7xFlD4xC7qUWcBbb5kOVSM,G8EPVSXsOYB5YQWZGiz1aVq5Pgr2GrQu,4,2,0,0,0,1,6,0,9,1.2857142857142858,1,0.0,0,0,0,0,2,1,0,6,0,0,9,1
13973,195305,jvZodiJQZU7RrA7XB4M3G0LE2sozlnz7,SpATywNh6bZuzm8s1ceuBUnMUAeoAHHw,10,22,2,0,2,1,10,0,37,5.285714285714286,1,0.0,9,2,0,2,13,1,0,10,0,13,24,1
13974,195310,a4n3ibeXbsub5EdlaCwB08x9krqRlEDa,A3fsA9Zfv1X2fVEQhTw51lKENdNrEqT3,1,0,0,0,0,0,1,0,1,0.14285714285714285,1,0.0,0,0,0,0,0,0,0,1,0,0,1,1
13975,195330,0htbMyPoZSLGh1Ogweb6zD7W8pfwScFx,SpATywNh6bZuzm8s1ceuBUnMUAeoAHHw,6,0,0,0,0,0,6,1,7,1.0,1,0.0,0,0,0,0,0,0,0,6,1,0,7,1
13976,195344,cA8asOLHRHcK3Kr0VMyGtrDdcfovAiM5,SpATywNh6bZuzm8s1ceuBUnMUAeoAHHw,10,4,4,0,4,0,3,0,15,2.142857142857143,1,0.0,0,4,0,4,4,0,0,3,0,8,7,1
13977,195347,P608wg2hLiaVE1CUhuKbnmhkIP7IEvsI,A3fsA9Zfv1X2fVEQhTw51lKENdNrEqT3,1,0,0,0,0,0,1,0,1,0.14285714285714285,1,0.0,0,0,0,0,0,0,0,1,0,0,1,1
13978,195366,EnaSTRqxkWjMR8pSWQe4ipdWniwPtGKE,SpATywNh6bZuzm8s1ceuBUnMUAeoAHHw,9,8,2,0,2,0,4,0,16,2.2857142857142856,1,0.0,0,2,0,2,8,0,0,4,0,4,12,1
13979,195370,OxLv0CDANbcaaaoNVUlIdXfqEbT45GpW,SpATywNh6bZuzm8s1ceuBUnMUAeoAHHw,1,0,0,0,0,0,3,0,3,0.42857142857142855,1,0.0,0,0,0,0,0,0,0,3,0,0,3,1
13980,195381,KMHV70a7rpZuAmNpI2Il8aVBDDazbOMO,A3fsA9Zfv1X2fVEQhTw51lKENdNrEqT3,5,2,1,0,1,1,2,0,7,1.0,1,0.0,0,1,0,1,2,1,0,2,0,2,5,1
13981,195383,NXEwBXbU6vvce77sujWgRB6LivhFJvRb,G8EPVSXsOYB5YQWZGiz1aVq5Pgr2GrQu,1,0,0,0,0,0,1,0,1,0.14285714285714285,1,0.0,0,0,0,0,0,0,0,1,0,0,1,1
13982,195392,e5lpY3trke6nXvypvGSIiUjB91TX04sJ,G8EPVSXsOYB5YQWZGiz1aVq5Pgr2GrQu,11,7,4,0,4,0,3,0,18,2.5714285714285716,1,0.0,2,4,0,4,5,0,0,3,0,10,8,1
13983,195405,GR3TNNEdaPxz3Wim5wCYlS1FUuZ9ygFu,SpATywNh6bZuzm8s1ceuBUnMUAeoAHHw,6,2,1,0,1,1,4,0,9,1.2857142857142858,1,0.0,0,1,0,1,2,1,0,4,0,2,7,1
13984,195420,c8hHWOR1LOb1dNnGiimGKTmT5f2lhdqf,G8EPVSXsOYB5YQWZGiz1aVq5Pgr2GrQu,2,1,0,0,0,0,1,0,2,0.2857142857142857,1,0.0,0,0,0,0,1,0,0,1,0,0,2,1
13985,195431,uo6XWLpCc9aLEsRInaYzNhRYRrPEd76a,A3fsA9Zfv1X2fVEQhTw51lKENdNrEqT3,13,6,5,0,5,0,3,0,19,2.7142857142857144,1,0.0,0,5,0,5,6,0,0,3,0,10,9,1
13986,195433,nJkkRmbTjzmjz5X8FxdffFf8Y1I78bGw,SpATywNh6bZuzm8s1ceuBUnMUAeoAHHw,6,4,2,0,2,0,2,0,10,1.4285714285714286,1,0.0,0,2,0,2,4,0,0,2,0,4,6,0
13987,195439,rwvZ7FfuNpbh9VhQHt7eVb6FQWLjKGy4,SpATywNh6bZuzm8s1ceuBUnMUAeoAHHw,1,0,0,0,0,0,1,0,1,0.14285714285714285,1,0.0,0,0,0,0,0,0,0,1,0,0,1,1
13988,195455,HIY4CHwa8u7VF0AwJglD4ImtKKzbU3gm,G8EPVSXsOYB5YQWZGiz1aVq5Pgr2GrQu,8,9,0,0,1,13,6,2,31,4.428571428571429,1,0.0,2,0,0,1,7,13,0,6,2,3,28,1
13989,195459,IyN6z4xrJLEbmfDFZipqdcIPNBoMNgik,SpATywNh6bZuzm8s1ceuBUnMUAeoAHHw,5,2,1,0,1,0,2,0,6,0.8571428571428571,1,0.0,0,1,0,1,2,0,0,2,0,2,4,1
13990,195462,x5Bs4lB8d8XfmyyIE5x0cYPvnoiorBpL,SpATywNh6bZuzm8s1ceuBUnMUAeoAHHw,5,3,2,0,1,0,1,0,7,1.0,1,0.0,0,2,0,1,3,0,0,1,0,3,4,1
13991,195485,WnSnDWbUpPwgyOqh9KapbEmhFpxGdgxn,SpATywNh6bZuzm8s1ceuBUnMUAeoAHHw,1,0,0,0,0,0,1,0,1,0.14285714285714285,1,0.0,0,0,0,0,0,0,0,1,0,0,1,1
13992,195504,dfSV6MVOjiUgDK7JKupNIc842GwgOkeF,A3fsA9Zfv1X2fVEQhTw51lKENdNrEqT3,1,0,0,0,0,0,1,0,1,0.14285714285714285,1,0.0,0,0,0,0,0,0,0,1,0,0,1,1
13993,195532,7ckF3LPSV13LgZ2Fg6VdSWg1opJZgrXH,SpATywNh6bZuzm8s1ceuBUnMUAeoAHHw,2,0,0,0,0,0,2,0,2,0.2857142857142857,1,0.0,0,0,0,0,0,0,0,2,0,0,2,1
13994,195537,EaFWRMbtKR52j7nbPydGVwuzgPsml9aN,RXDvfPUBYFlVdlueBFbLW0mhhAyGEqpt,1,0,0,0,0,0,1,0,1,0.14285714285714285,1,0.0,0,0,0,0,0,0,0,1,0,0,1,1
13995,195556,GmAgRxUlxl118Xo8rOFwbcuTp9uDnYde,SpATywNh6bZuzm8s1ceuBUnMUAeoAHHw,17,14,8,16,5,1,9,1,54,7.714285714285714,1,0.0,5,8,13,5,9,1,3,9,1,31,23,1
13996,195561,iZqC3Cf6t3CzqiiohlVddd9vHxMr4jyG,bWdj2GDclj5ofokWjzoa5jAwMkxCykd6,8,2,1,0,1,0,6,1,11,1.5714285714285714,1,0.0,0,1,0,1,2,0,0,6,1,2,9,1
13997,195564,augCFReFBQs2gO1ZsbARNIDALhMdNkTr,SpATywNh6bZuzm8s1ceuBUnMUAeoAHHw,1,0,0,0,0,0,2,0,2,0.2857142857142857,1,0.0,0,0,0,0,0,0,0,2,0,0,2,1
13998,195566,V7zoEtLfhU5rtj42pQGAui9L72mSu8fB,SpATywNh6bZuzm8s1ceuBUnMUAeoAHHw,5,3,1,0,1,0,1,0,6,0.8571428571428571,1,0.0,0,1,0,1,3,0,0,1,0,2,4,1
13999,195588,W0l0kkHKvJN0FIadhzrU1LfDb4EzwebA,5X6FeZozNMgE2VRi3MJYjkkFK8SETtu2,2,0,0,0,0,0,3,0,3,0.42857142857142855,1,0.0,0,0,0,0,0,0,0,3,0,0,3,1
14000,195612,v5ZclElew7ejFho1P7oX3s4a7TxNLCyF,7GRhBDsirIGkRZBtSMEzNTyDr2JQm4xx,1,0,0,0,0,0,1,0,1,0.14285714285714285,1,0.0,0,0,0,0,0,0,0,1,0,0,1,1
14001,195629,wnskylPQEd73X69h6kGVzeSF3KYHcgop,7GRhBDsirIGkRZBtSMEzNTyDr2JQm4xx,1,0,0,0,0,0,1,0,1,0.14285714285714285,1,0.0,0,0,0,0,0,0,0,1,0,0,1,1
14002,195650,juzfwxHXCKii6ul7funGUBQbDVPCyrBB,5X6FeZozNMgE2VRi3MJYjkkFK8SETtu2,1,0,0,0,0,0,1,0,1,0.14285714285714285,1,0.0,0,0,0,0,0,0,0,1,0,0,1,1
14003,195677,CnWkaEKTjMJzfUHjUWYYcuY1pest8HcE,7GRhBDsirIGkRZBtSMEzNTyDr2JQm4xx,2,0,0,0,0,0,2,0,2,0.2857142857142857,1,0.0,0,0,0,0,0,0,0,2,0,0,2,1
14004,195683,nT6QAy9LYRgx8ymnax3zVsoU2kI3RSib,7GRhBDsirIGkRZBtSMEzNTyDr2JQm4xx,4,0,0,0,0,0,3,1,4,0.5714285714285714,1,0.0,0,0,0,0,0,0,0,3,1,0,4,1
14005,195684,bLcbvKDRM6lji8wmeDJkPOBB2b9eyXBH,5X6FeZozNMgE2VRi3MJYjkkFK8SETtu2,1,0,0,0,0,0,1,0,1,0.14285714285714285,1,0.0,0,0,0,0,0,0,0,1,0,0,1,1
14006,195698,Wn6M5pDE1BQQohcN99ynI9TPsF44SXAJ,7GRhBDsirIGkRZBtSMEzNTyDr2JQm4xx,4,2,1,0,1,0,1,0,5,0.7142857142857143,1,0.0,0,1,0,1,2,0,0,1,0,2,3,1
14007,195703,C800geUBh3GYBhoh4cW6ReKUGj5LAMGi,7GRhBDsirIGkRZBtSMEzNTyDr2JQm4xx,1,0,0,0,0,0,1,0,1,0.14285714285714285,1,0.0,0,0,0,0,0,0,0,1,0,0,1,1
14008,195722,pXGBcTffNYWAUeYw1RFCIuTgQsIvI4OJ,5X6FeZozNMgE2VRi3MJYjkkFK8SETtu2,5,2,1,0,1,0,2,0,6,0.8571428571428571,1,0.0,0,1,0,1,2,0,0,2,0,2,4,1
14009,195739,BBfiARXlf8DQ4mmAXStqrzMqGcJUzid6,7GRhBDsirIGkRZBtSMEzNTyDr2JQm4xx,5,2,1,0,1,1,2,0,7,1.0,1,0.0,0,1,0,1,2,1,0,2,0,2,5,1
14010,195747,LezrgeG2DMZV4p8bIqSrF4Mu5gNQ96cn,7GRhBDsirIGkRZBtSMEzNTyDr2JQm4xx,17,16,1,0,1,0,1,0,19,2.7142857142857144,1,0.0,0,1,0,1,16,0,0,1,0,2,17,1
14011,195775,P1HfpLPKTOaNYsIahqDQlk4Js6s95Iqe,5X6FeZozNMgE2VRi3MJYjkkFK8SETtu2,1,0,0,0,0,0,1,0,1,0.14285714285714285,1,0.0,0,0,0,0,0,0,0,1,0,0,1,1
14012,195776,8FprsZIzUCPJ79Vm84XE1F16D42ydNJH,5X6FeZozNMgE2VRi3MJYjkkFK8SETtu2,1,0,0,0,0,0,1,0,1,0.14285714285714285,1,0.0,0,0,0,0,0,0,0,1,0,0,1,1
14013,195799,cQIOkGZ64oWxmjLUWB6bjywMucqysG5O,7GRhBDsirIGkRZBtSMEzNTyDr2JQm4xx,2,0,0,0,0,0,2,0,2,0.2857142857142857,1,0.0,0,0,0,0,0,0,0,2,0,0,2,1
14014,196258,84Vtl9WYpWByLNGFNOb9qCQNJXmBTqXr,bWdj2GDclj5ofokWjzoa5jAwMkxCykd6,1,0,0,0,0,0,3,0,3,0.42857142857142855,1,0.0,0,0,0,0,0,0,0,3,0,0,3,1
14015,196262,cLn3Dpp0aQbPutL8r0rwRDwKL8qRpPtI,G8EPVSXsOYB5YQWZGiz1aVq5Pgr2GrQu,8,6,0,0,1,0,1,0,8,1.1428571428571428,1,0.0,0,0,0,1,6,0,0,1,0,1,7,1
14016,196269,haLWbgznwe0aHmDz0IMvty9PTNybgUSv,SpATywNh6bZuzm8s1ceuBUnMUAeoAHHw,1,0,0,0,0,0,1,0,1,0.14285714285714285,1,0.0,0,0,0,0,0,0,0,1,0,0,1,1
14017,196282,tiAmX1K64h27ePNFGBqIfOBXXekJTi6c,SpATywNh6bZuzm8s1ceuBUnMUAeoAHHw,36,80,24,20,14,0,3,0,141,20.142857142857142,1,0.0,15,24,20,14,65,0,0,3,0,73,68,1
14018,196300,dDrnWkPOwheElmX20c1gnDUNBZ1InueN,SpATywNh6bZuzm8s1ceuBUnMUAeoAHHw,1,0,0,0,0,0,1,0,1,0.14285714285714285,1,0.0,0,0,0,0,0,0,0,1,0,0,1,1
14019,196305,UAQ3dboSsAg7pJwESQdTYyBThwTnTM7A,SpATywNh6bZuzm8s1ceuBUnMUAeoAHHw,8,9,6,0,3,0,2,0,20,2.857142857142857,1,0.0,0,6,0,3,9,0,0,2,0,9,11,0
14020,196306,X6Lezij464ccKeng4uwKJTPF9kfTAT6Z,SpATywNh6bZuzm8s1ceuBUnMUAeoAHHw,32,51,21,0,14,0,13,0,99,14.142857142857142,2,0.0,0,21,0,14,51,0,0,13,0,35,64,1
14021,196307,X6Lezij464ccKeng4uwKJTPF9kfTAT6Z,RXDvfPUBYFlVdlueBFbLW0mhhAyGEqpt,50,79,39,0,22,4,12,0,156,22.285714285714285,2,0.0,1,39,0,22,78,4,0,12,0,62,94,1
14022,196336,F8NourXmuPtch9jRX8wdUzHLenRNVyCk,SpATywNh6bZuzm8s1ceuBUnMUAeoAHHw,2,0,0,0,0,0,2,0,2,0.2857142857142857,1,0.0,0,0,0,0,0,0,0,2,0,0,2,1
14023,196451,NxxDPJKBrjin9P0mTarKicUlILWB39Ed,A3fsA9Zfv1X2fVEQhTw51lKENdNrEqT3,9,4,3,0,3,0,3,0,13,1.8571428571428572,1,0.0,0,3,0,3,4,0,0,3,0,6,7,1
14024,196471,pCnoO6udDE2lNvhk435CUTW5xV3lxyMY,SpATywNh6bZuzm8s1ceuBUnMUAeoAHHw,17,32,2,22,2,11,10,1,80,11.428571428571429,1,0.0,13,2,17,2,19,11,5,10,1,34,46,0
14025,196493,akSMeLHCyBB67hfZDkn0NDR7Yy6L2FBq,5X6FeZozNMgE2VRi3MJYjkkFK8SETtu2,1,0,0,0,0,0,1,0,1,0.14285714285714285,1,0.0,0,0,0,0,0,0,0,1,0,0,1,1
14026,196507,AQ1HoOz5Jszv3gSTSyYNhVdJQFocvCtg,SpATywNh6bZuzm8s1ceuBUnMUAeoAHHw,1,0,0,0,0,0,1,0,1,0.14285714285714285,1,0.0,0,0,0,0,0,0,0,1,0,0,1,1
14027,196513,5pSf6XO1vHmSL6ykl0l21eWE2uvRzMTK,5X6FeZozNMgE2VRi3MJYjkkFK8SETtu2,1,0,0,0,0,0,1,0,1,0.14285714285714285,1,0.0,0,0,0,0,0,0,0,1,0,0,1,1
14028,196536,qCS4l8ob3EJw4urGwrYd9lZ7UNzXvZIE,SpATywNh6bZuzm8s1ceuBUnMUAeoAHHw,1,0,0,0,0,0,1,0,1,0.14285714285714285,1,0.0,0,0,0,0,0,0,0,1,0,0,1,1
14029,196565,YqxhOSST3QFN8TGdKOnOvd7Qo3x5cybT,SpATywNh6bZuzm8s1ceuBUnMUAeoAHHw,5,2,1,0,1,0,2,0,6,0.8571428571428571,1,0.0,0,1,0,1,2,0,0,2,0,2,4,1
14030,196595,3vnu5JUiIQfwcWSSeAtE6dAgHCr6iqRo,G8EPVSXsOYB5YQWZGiz1aVq5Pgr2GrQu,1,0,0,0,0,0,1,0,1,0.14285714285714285,1,0.0,0,0,0,0,0,0,0,1,0,0,1,1
14031,196596,3vnu5JUiIQfwcWSSeAtE6dAgHCr6iqRo,A3fsA9Zfv1X2fVEQhTw51lKENdNrEqT3,2,0,0,0,0,0,2,0,2,0.2857142857142857,1,0.0,0,0,0,0,0,0,0,2,0,0,2,1
14032,196601,3nd0w9cZzH1zDSzYM8nVIRaV4Lm6kaLu,G8EPVSXsOYB5YQWZGiz1aVq5Pgr2GrQu,8,4,3,0,2,0,2,0,11,1.5714285714285714,1,0.0,0,3,0,2,4,0,0,2,0,5,6,1
14033,196614,ajdXJNtmFj3djCMALYMagt4EstfNGU3t,A3fsA9Zfv1X2fVEQhTw51lKENdNrEqT3,7,3,2,0,2,0,3,0,10,1.4285714285714286,1,0.0,0,2,0,2,3,0,0,3,0,4,6,1
14034,196623,MTBFJm3bIEaE6OQdIPJiDEIIoJhDDIeA,bWdj2GDclj5ofokWjzoa5jAwMkxCykd6,2,0,0,0,0,0,5,0,5,0.7142857142857143,1,0.0,0,0,0,0,0,0,0,5,0,0,5,1
14035,196632,dO8ttSgZeYstM22uaeoinK9ApzwNbtvt,bWdj2GDclj5ofokWjzoa5jAwMkxCykd6,1,0,0,0,0,0,1,0,1,0.14285714285714285,1,0.0,0,0,0,0,0,0,0,1,0,0,1,1
14036,196657,Z5hJjHEs9vVOECSboB00kryTTWAg0llD,A3fsA9Zfv1X2fVEQhTw51lKENdNrEqT3,8,2,1,0,1,0,8,2,14,2.0,1,0.0,0,1,0,1,2,0,0,8,2,2,12,1
14037,196672,fGQQbYTikGmxkwGX9ObcXKMW9Jbs5Gag,SpATywNh6bZuzm8s1ceuBUnMUAeoAHHw,8,9,1,0,1,0,3,0,14,2.0,1,0.0,3,1,0,1,6,0,0,3,0,5,9,1
14038,196692,UcZBtTCWAGtCSktUpbQvdWSPIBBv8Gr5,SpATywNh6bZuzm8s1ceuBUnMUAeoAHHw,12,10,1,17,0,0,3,0,31,4.428571428571429,1,0.0,2,1,16,0,8,0,1,3,0,19,12,0
14039,196695,bLDIg7orV5sh30oIBmQ342IswZTJ8Q5l,SpATywNh6bZuzm8s1ceuBUnMUAeoAHHw,9,6,4,0,2,0,4,0,16,2.2857142857142856,1,0.0,0,4,0,2,6,0,0,4,0,6,10,1
14040,196701,xqjSceutXm0Ow6i5RJNNfbOkv3g0VYZN,G8EPVSXsOYB5YQWZGiz1aVq5Pgr2GrQu,1,0,0,0,0,0,1,0,1,0.14285714285714285,1,0.0,0,0,0,0,0,0,0,1,0,0,1,1
14041,196705,bZa2cKnNlVdaH2zh1KBEDwy94lOurAbl,A3fsA9Zfv1X2fVEQhTw51lKENdNrEqT3,9,6,3,0,2,0,5,0,16,2.2857142857142856,2,0.0,0,3,0,2,6,0,0,5,0,5,11,1
14042,196710,7gxdF7npc77h7z0KnU9ezGYqtBJqY4fQ,SpATywNh6bZuzm8s1ceuBUnMUAeoAHHw,7,2,1,0,1,0,6,0,10,1.4285714285714286,1,0.0,0,1,0,1,2,0,0,6,0,2,8,0
14043,196731,Pdvh6UTK9FXuCE4WVrV5Y121aJBdVbkt,A3fsA9Zfv1X2fVEQhTw51lKENdNrEqT3,47,26,19,42,11,6,6,2,112,16.0,1,0.0,3,19,40,11,23,6,2,6,2,73,39,1
14044,196733,uezUPAEnUXcq0NFGSBeQpbbQT3cqmDAT,SpATywNh6bZuzm8s1ceuBUnMUAeoAHHw,6,7,2,0,2,0,4,0,15,2.142857142857143,1,0.0,0,2,0,2,7,0,0,4,0,4,11,1
14045,196737,oOZsAqJaDOJSFMbRG35wrloFbTEIc8dR,5X6FeZozNMgE2VRi3MJYjkkFK8SETtu2,2,0,0,0,0,0,2,0,2,0.2857142857142857,1,0.0,0,0,0,0,0,0,0,2,0,0,2,1
14046,196742,6OBDZBJWfzsxgHkTnhPzN431QvCxfANm,SpATywNh6bZuzm8s1ceuBUnMUAeoAHHw,8,6,3,0,2,0,3,0,14,2.0,1,0.0,0,3,0,2,6,0,0,3,0,5,9,1
14047,196780,RthO8kTkOrnZ3vUDn574hHyfG3vroBt1,SpATywNh6bZuzm8s1ceuBUnMUAeoAHHw,36,25,23,8,17,0,10,0,83,11.857142857142858,1,0.0,0,23,6,17,25,0,2,10,0,46,37,1
14048,196806,bxQOsXuG5NC6VnG6YiODH6WuXuneq0dF,SpATywNh6bZuzm8s1ceuBUnMUAeoAHHw,5,2,1,0,1,0,2,0,6,0.8571428571428571,1,0.0,0,1,0,1,2,0,0,2,0,2,4,1
14049,196809,5O3ZOoVLu7tCWnWkJSW2V8ftVrXqVxvg,A3fsA9Zfv1X2fVEQhTw51lKENdNrEqT3,7,4,1,0,1,0,4,0,10,1.4285714285714286,1,0.0,0,1,0,1,4,0,0,4,0,2,8,1
14050,196823,RthO8kTkOrnZ3vUDn574hHyfG3vroBt1,bWdj2GDclj5ofokWjzoa5jAwMkxCykd6,1,0,0,0,0,0,1,0,1,0.14285714285714285,1,0.0,0,0,0,0,0,0,0,1,0,0,1,1
14051,196824,RthO8kTkOrnZ3vUDn574hHyfG3vroBt1,5X6FeZozNMgE2VRi3MJYjkkFK8SETtu2,1,0,0,0,0,0,1,0,1,0.14285714285714285,1,0.0,0,0,0,0,0,0,0,1,0,0,1,1
14052,196844,5qqD2T2EPDkmG2MZPytXSe6fK2Jo7BmS,SpATywNh6bZuzm8s1ceuBUnMUAeoAHHw,1,0,0,0,0,0,1,0,1,0.14285714285714285,1,0.0,0,0,0,0,0,0,0,1,0,0,1,1
14053,196846,OYWBopBO2n38CA6GRAaDJRfIHV9b0dQs,5X6FeZozNMgE2VRi3MJYjkkFK8SETtu2,1,0,0,0,0,0,1,0,1,0.14285714285714285,1,0.0,0,0,0,0,0,0,0,1,0,0,1,1
14054,196853,lCyf3TRKW0i3K1mBgKz23OONMdCWqNsI,A3fsA9Zfv1X2fVEQhTw51lKENdNrEqT3,1,0,0,0,0,0,1,0,1,0.14285714285714285,1,0.0,0,0,0,0,0,0,0,1,0,0,1,1
14055,196870,KnW2kJ7r9bHFOiSNCXRF5RLyLQjhYTtF,SpATywNh6bZuzm8s1ceuBUnMUAeoAHHw,2,0,0,0,0,0,2,0,2,0.2857142857142857,1,0.0,0,0,0,0,0,0,0,2,0,0,2,1
14056,196879,olMbWc9RSQc0Tu4bEWQzOnwezTDWcrs8,SpATywNh6bZuzm8s1ceuBUnMUAeoAHHw,5,2,1,0,1,0,2,0,6,0.8571428571428571,1,0.0,0,1,0,1,2,0,0,2,0,2,4,1
14057,196884,esy4b6bETmasLl5DFctrDy15ZWYpffCf,G8EPVSXsOYB5YQWZGiz1aVq5Pgr2GrQu,1,0,0,0,0,0,1,0,1,0.14285714285714285,1,0.0,0,0,0,0,0,0,0,1,0,0,1,1
14058,196890,9iPKlVFwenbwmn1nXcYJERwuTRxTRQK5,5X6FeZozNMgE2VRi3MJYjkkFK8SETtu2,4,2,1,0,1,0,2,0,6,0.8571428571428571,1,0.0,0,1,0,1,2,0,0,2,0,2,4,1
14059,196895,9iPKlVFwenbwmn1nXcYJERwuTRxTRQK5,A3fsA9Zfv1X2fVEQhTw51lKENdNrEqT3,1,0,0,0,0,0,1,0,1,0.14285714285714285,1,0.0,0,0,0,0,0,0,0,1,0,0,1,1
14060,196907,wXz4TbCpuPApw4hHC9Aow8xAscaoMUnc,A3fsA9Zfv1X2fVEQhTw51lKENdNrEqT3,1,0,0,0,0,0,1,0,1,0.14285714285714285,1,0.0,0,0,0,0,0,0,0,1,0,0,1,1
14061,196914,DcV7U0eIIh5HACuGyVVgSsAMkcu77YoX,SpATywNh6bZuzm8s1ceuBUnMUAeoAHHw,2,0,0,0,0,0,2,0,2,0.2857142857142857,1,0.0,0,0,0,0,0,0,0,2,0,0,2,1
14062,196923,EGJ0Z8XNH50h8WP7Cnpy6YQaaehVY90R,bWdj2GDclj5ofokWjzoa5jAwMkxCykd6,6,1,1,0,1,0,3,0,6,0.8571428571428571,1,0.0,0,1,0,1,1,0,0,3,0,2,4,1
14063,196934,RNEuStAlTxZHIZFwvfCfasMOM5Hny2Pn,G8EPVSXsOYB5YQWZGiz1aVq5Pgr2GrQu,1,0,0,0,0,0,1,0,1,0.14285714285714285,1,0.0,0,0,0,0,0,0,0,1,0,0,1,1
14064,196947,qREvGviufJ3VVxNkA2MjB1npr7InnyIq,RXDvfPUBYFlVdlueBFbLW0mhhAyGEqpt,1,0,0,0,0,0,1,0,1,0.14285714285714285,1,0.0,0,0,0,0,0,0,0,1,0,0,1,1
14065,196950,cF44PnrtdTjFKWs1ZjUvQj5VSTPqnlKA,SpATywNh6bZuzm8s1ceuBUnMUAeoAHHw,2,0,0,0,0,0,2,0,2,0.2857142857142857,1,0.0,0,0,0,0,0,0,0,2,0,0,2,1
14066,196952,Ep4sRinGGd3gfdKOkqpq2EkPdP58g9jj,G8EPVSXsOYB5YQWZGiz1aVq5Pgr2GrQu,1,0,0,0,0,0,1,0,1,0.14285714285714285,1,0.0,0,0,0,0,0,0,0,1,0,0,1,1
14067,196991,L60eSOdOjLwIo5deBWfwh8FwoeNxsxnx,SpATywNh6bZuzm8s1ceuBUnMUAeoAHHw,3,2,0,0,0,0,2,0,4,0.5714285714285714,1,0.0,0,0,0,0,2,0,0,2,0,0,4,1
14068,197006,9Nmjm4BvnbKTQ3ZZwECYdKy9zBNGmQNW,bWdj2GDclj5ofokWjzoa5jAwMkxCykd6,1,0,0,0,0,0,1,0,1,0.14285714285714285,1,0.0,0,0,0,0,0,0,0,1,0,0,1,1
14069,197007,9Nmjm4BvnbKTQ3ZZwECYdKy9zBNGmQNW,RXDvfPUBYFlVdlueBFbLW0mhhAyGEqpt,1,0,0,0,0,0,1,0,1,0.14285714285714285,1,0.0,0,0,0,0,0,0,0,1,0,0,1,1
14070,197032,UEQN2HGxEQ2XAToBZQskm8PnDddiQLUX,3VkHkmOtom3jM2wCu94xgzzu1d6Dn7or,8,4,2,0,1,0,3,0,10,1.4285714285714286,1,0.0,0,2,0,1,4,0,0,3,0,3,7,1
14071,197042,b368QIVjprjeB2VvkSphHxBQ1vMMPCnN,3VkHkmOtom3jM2wCu94xgzzu1d6Dn7or,1,0,0,0,0,0,1,0,1,0.14285714285714285,1,0.0,0,0,0,0,0,0,0,1,0,0,1,1
14072,197065,7wafENWJse7aLGqZkSyB60mvQb04ubG3,3VkHkmOtom3jM2wCu94xgzzu1d6Dn7or,7,1,1,0,1,0,6,0,9,1.2857142857142858,1,0.0,0,1,0,1,1,0,0,6,0,2,7,1
14073,197091,MkuOhOGQZMKVoaai2QMWHpcffMs2EIo9,3VkHkmOtom3jM2wCu94xgzzu1d6Dn7or,10,13,3,2,1,0,3,1,23,3.2857142857142856,1,0.0,1,3,2,1,12,0,0,3,1,7,16,1
14074,197093,hU0vMLUveVfvdzQOepSoXd0xPBO7HZY4,3VkHkmOtom3jM2wCu94xgzzu1d6Dn7or,6,6,1,0,0,4,5,1,17,2.4285714285714284,1,0.0,0,1,0,0,6,4,0,5,1,1,16,1
14075,197110,DyCEpdQiIAZj6yZylLF5ezLKYJiUKony,3VkHkmOtom3jM2wCu94xgzzu1d6Dn7or,7,2,1,0,1,1,9,1,15,2.142857142857143,1,0.0,0,1,0,1,2,1,0,9,1,2,13,1
14076,197112,nyCtoNdidkfUkWKecIRLfZNmg6o2kghj,3VkHkmOtom3jM2wCu94xgzzu1d6Dn7or,1,0,0,0,0,0,1,0,1,0.14285714285714285,1,0.0,0,0,0,0,0,0,0,1,0,0,1,1
14077,197156,S91ugK7RyjPXdIklMWItqmg7JB7T9PzZ,3VkHkmOtom3jM2wCu94xgzzu1d6Dn7or,7,3,2,0,2,0,2,0,9,1.2857142857142858,1,0.0,0,2,0,2,3,0,0,2,0,4,5,1
14078,197161,om0KjvovtBK0gZUSboAPRv5A6Jkm00Ei,3VkHkmOtom3jM2wCu94xgzzu1d6Dn7or,1,0,0,0,0,0,1,0,1,0.14285714285714285,1,0.0,0,0,0,0,0,0,0,1,0,0,1,1
14079,197196,kXKedIAlLk4nnLOObHVKEfusEbZyfe2f,3VkHkmOtom3jM2wCu94xgzzu1d6Dn7or,4,2,1,0,1,0,1,0,5,0.7142857142857143,1,0.0,0,1,0,1,2,0,0,1,0,2,3,1
14080,197221,iMSX1uHcSxcasOlc9agP5kI5TmyEQeiD,3VkHkmOtom3jM2wCu94xgzzu1d6Dn7or,1,0,0,0,0,0,1,0,1,0.14285714285714285,1,0.0,0,0,0,0,0,0,0,1,0,0,1,1
14081,197222,bGTCuLlM7XNGsLwApvdGmFukokfLu8F6,3VkHkmOtom3jM2wCu94xgzzu1d6Dn7or,1,0,0,0,0,0,1,0,1,0.14285714285714285,1,0.0,0,0,0,0,0,0,0,1,0,0,1,1
14082,197238,PSIpPoYTh8FnRkdm6jqihrIpnQnKF64y,3VkHkmOtom3jM2wCu94xgzzu1d6Dn7or,6,2,1,0,1,0,6,0,10,1.4285714285714286,1,0.0,0,1,0,1,2,0,0,6,0,2,8,1
14083,197265,0bTIvFPWlzp2dye0hIyZeexgN1LOjDU7,3VkHkmOtom3jM2wCu94xgzzu1d6Dn7or,5,6,3,0,4,0,2,0,15,2.142857142857143,1,0.0,0,3,0,4,6,0,0,2,0,7,8,1
14084,197274,pgd9bEAcOWgYToOxgTtzDobYZggS41Kp,3VkHkmOtom3jM2wCu94xgzzu1d6Dn7or,1,0,0,0,0,0,1,0,1,0.14285714285714285,1,0.0,0,0,0,0,0,0,0,1,0,0,1,1
14085,197284,lA8ZN74fx6NMNuhu16jepJP11Qw4Kgx2,3VkHkmOtom3jM2wCu94xgzzu1d6Dn7or,1,0,0,0,0,0,2,0,2,0.2857142857142857,1,0.0,0,0,0,0,0,0,0,2,0,0,2,1
14086,197289,3dVMClOA1muAVees6Vf9EBxcxFuosktC,3VkHkmOtom3jM2wCu94xgzzu1d6Dn7or,1,0,0,0,0,0,2,0,2,0.2857142857142857,1,0.0,0,0,0,0,0,0,0,2,0,0,2,1
14087,197340,e9AdEIjRVhyvhp0203NpitM74rcVK0BB,3VkHkmOtom3jM2wCu94xgzzu1d6Dn7or,5,5,2,0,3,0,3,0,13,1.8571428571428572,1,0.0,2,2,0,3,3,0,0,3,0,7,6,1
14088,197401,IhZdPOtOeXyg0OwsQIkD0XHc4IVBLzMp,3VkHkmOtom3jM2wCu94xgzzu1d6Dn7or,1,0,0,0,0,0,1,0,1,0.14285714285714285,1,0.0,0,0,0,0,0,0,0,1,0,0,1,1
14089,197462,8tnOMyXbXKGJjP9QLxPmUvVpjznov0vV,3VkHkmOtom3jM2wCu94xgzzu1d6Dn7or,4,0,0,0,0,0,4,0,4,0.5714285714285714,1,0.0,0,0,0,0,0,0,0,4,0,0,4,1
14090,197479,Xw2tDCOd1ii30IR6RwFNApooN5ycfzY2,3VkHkmOtom3jM2wCu94xgzzu1d6Dn7or,1,0,0,0,0,0,1,0,1,0.14285714285714285,1,0.0,0,0,0,0,0,0,0,1,0,0,1,1
14091,197539,KgsFs481TCjQwvLPKxf7Q7ylhhpHCPhV,A3fsA9Zfv1X2fVEQhTw51lKENdNrEqT3,1,0,0,0,0,0,1,0,1,0.14285714285714285,1,0.0,0,0,0,0,0,0,0,1,0,0,1,1
14092,197555,mI8VCRBSYdxznLkfNYlx0gUNvZ04sNfj,SpATywNh6bZuzm8s1ceuBUnMUAeoAHHw,1,0,0,0,0,0,1,0,1,0.14285714285714285,1,0.0,0,0,0,0,0,0,0,1,0,0,1,1
14093,197567,zGQkx7I5R9FuZgfmXPXAegIJkfQnaSVg,SpATywNh6bZuzm8s1ceuBUnMUAeoAHHw,9,4,2,0,2,0,4,3,15,2.142857142857143,1,0.0,1,2,0,2,3,0,0,4,3,5,10,1
14094,197568,fBs8B9TyWeZ3NFnjocJnCJ1lDFqvyofp,SpATywNh6bZuzm8s1ceuBUnMUAeoAHHw,1,0,0,0,0,0,1,0,1,0.14285714285714285,1,0.0,0,0,0,0,0,0,0,1,0,0,1,1
14095,197590,sszCBt8cghX6qgFnXDzG8r5isZBGG9No,bWdj2GDclj5ofokWjzoa5jAwMkxCykd6,1,0,0,0,0,0,1,0,1,0.14285714285714285,1,0.0,0,0,0,0,0,0,0,1,0,0,1,1
14096,197605,xWQhq9RZKw08hANIa0LgFXN2DnwycQf4,A3fsA9Zfv1X2fVEQhTw51lKENdNrEqT3,1,0,0,0,0,0,1,0,1,0.14285714285714285,1,0.0,0,0,0,0,0,0,0,1,0,0,1,1
14097,197607,oarWFl12GJz5VOCw3d9cT9LuNMnlfaty,SpATywNh6bZuzm8s1ceuBUnMUAeoAHHw,9,11,1,8,0,5,7,0,32,4.571428571428571,1,0.0,0,1,6,0,11,5,2,7,0,7,25,1
14098,197610,PsqZXIXDMOG5Y38IYf7VtFHU6aWciJTC,A3fsA9Zfv1X2fVEQhTw51lKENdNrEqT3,4,2,0,0,0,0,3,0,5,0.7142857142857143,1,0.0,0,0,0,0,2,0,0,3,0,0,5,1
14099,197613,McYATdhZDDMDpni6a4GbjI06ustMpvdV,RXDvfPUBYFlVdlueBFbLW0mhhAyGEqpt,5,2,1,0,1,0,2,0,6,0.8571428571428571,1,0.0,0,1,0,1,2,0,0,2,0,2,4,1
14100,197630,GlVmjWGZ8XsOuLGdZvtzRw0xzELGNzxx,A3fsA9Zfv1X2fVEQhTw51lKENdNrEqT3,1,0,0,0,0,0,1,0,1,0.14285714285714285,1,0.0,0,0,0,0,0,0,0,1,0,0,1,1
14101,197637,y0PkAopIdLmRFrkWC9eBHvWT77KfVWMh,bWdj2GDclj5ofokWjzoa5jAwMkxCykd6,5,5,2,0,2,0,2,0,11,1.5714285714285714,1,0.0,0,2,0,2,5,0,0,2,0,4,7,1
14102,197647,yJyieqiQ74x4K1fGefSNl8T336TNyMah,G8EPVSXsOYB5YQWZGiz1aVq5Pgr2GrQu,7,5,3,0,1,0,3,0,12,1.7142857142857142,1,0.0,0,3,0,1,5,0,0,3,0,4,8,1
14103,197666,NXEwBXbU6vvce77sujWgRB6LivhFJvRb,bWdj2GDclj5ofokWjzoa5jAwMkxCykd6,4,2,1,0,1,0,2,0,6,0.8571428571428571,1,0.0,0,1,0,1,2,0,0,2,0,2,4,0
14104,197686,IlMRFFFNuG5w9EpYG3Dyt8Sj1nCtwb6Z,SpATywNh6bZuzm8s1ceuBUnMUAeoAHHw,6,8,4,0,0,0,1,0,13,1.8571428571428572,1,0.0,0,4,0,0,8,0,0,1,0,4,9,1
14105,197694,CLJmxLRlSw5V2HPI140IDE0f4EOszt4Y,SpATywNh6bZuzm8s1ceuBUnMUAeoAHHw,1,0,0,0,0,0,1,0,1,0.14285714285714285,1,0.0,0,0,0,0,0,0,0,1,0,0,1,1
14106,197701,irsB3oA9q2Yuz0rnZheRoFNJtkEWBPEv,SpATywNh6bZuzm8s1ceuBUnMUAeoAHHw,1,0,0,0,0,0,1,0,1,0.14285714285714285,1,0.0,0,0,0,0,0,0,0,1,0,0,1,1
14107,197705,Q2m4p3E1xU5tjACIAMpsbnVuTeuD9Zj8,RXDvfPUBYFlVdlueBFbLW0mhhAyGEqpt,1,0,0,0,0,0,1,0,1,0.14285714285714285,1,0.0,0,0,0,0,0,0,0,1,0,0,1,1
14108,197748,lvB2HAmzN6WpjnZWZKcaAAjy9p9VjGaG,SpATywNh6bZuzm8s1ceuBUnMUAeoAHHw,4,4,1,0,0,0,1,0,6,0.8571428571428571,1,0.0,1,1,0,0,3,0,0,1,0,2,4,1
14109,197754,DIr3Wrj5z4hYJwtDO9ijYT7A5ei5kcOt,SpATywNh6bZuzm8s1ceuBUnMUAeoAHHw,5,4,0,0,0,1,2,0,7,1.0,1,0.0,0,0,0,0,4,1,0,2,0,0,7,1
14110,197760,syyc0SZ7JGCYLXzo3H6grsNKbnA69vWI,SpATywNh6bZuzm8s1ceuBUnMUAeoAHHw,15,14,4,12,3,1,6,1,41,5.857142857142857,1,0.0,9,4,12,3,5,1,0,6,1,28,13,1
14111,197775,ate9cHga4fvGZQe84ZmaH3duYZ3g1R1F,G8EPVSXsOYB5YQWZGiz1aVq5Pgr2GrQu,9,5,4,0,3,2,4,0,18,2.5714285714285716,1,0.0,0,4,0,3,5,2,0,4,0,7,11,1
14112,197793,BxOnqjgkTpP6bgtURLXQygVvMj5N3Ti3,SpATywNh6bZuzm8s1ceuBUnMUAeoAHHw,7,4,0,0,0,0,5,1,10,1.4285714285714286,1,0.0,0,0,0,0,4,0,0,5,1,0,10,1
14113,197798,ZECsrQDWNf4nPUfo4HpZsLiXc2swEQ6q,SpATywNh6bZuzm8s1ceuBUnMUAeoAHHw,5,4,3,0,1,0,1,0,9,1.2857142857142858,1,0.0,0,3,0,1,4,0,0,1,0,4,5,1
14114,197810,doaL1TzO9FZY2ziOksLPhVRKrqvsMpej,SpATywNh6bZuzm8s1ceuBUnMUAeoAHHw,6,2,1,0,1,0,3,0,7,1.0,1,0.0,0,1,0,1,2,0,0,3,0,2,5,1
14115,197820,6WpUAvOn0104PVGU1qRupfdkikcVBl8O,SpATywNh6bZuzm8s1ceuBUnMUAeoAHHw,7,11,3,6,0,0,2,0,22,3.142857142857143,1,0.0,2,3,5,0,9,0,1,2,0,10,12,1
14116,197829,4ZyQJ5jYIytY6BbDJp7B3MYaAhi1NvbZ,SpATywNh6bZuzm8s1ceuBUnMUAeoAHHw,1,0,0,0,0,0,1,0,1,0.14285714285714285,1,0.0,0,0,0,0,0,0,0,1,0,0,1,1
14117,197846,qePcgnp7eGbGREyZzIMf7xZBiRdT6s9H,SpATywNh6bZuzm8s1ceuBUnMUAeoAHHw,5,2,1,0,1,0,2,0,6,0.8571428571428571,1,0.0,0,1,0,1,2,0,0,2,0,2,4,1
14118,197851,HwQlDqQYrfHrBUx2SSkCNQ3Dej1xgfkf,A3fsA9Zfv1X2fVEQhTw51lKENdNrEqT3,4,3,0,0,0,0,5,0,8,1.1428571428571428,1,0.0,0,0,0,0,3,0,0,5,0,0,8,1
14119,197889,bjP4zb5x0G9Cc1USSNLgNUtaJAQzeUAu,A3fsA9Zfv1X2fVEQhTw51lKENdNrEqT3,4,4,0,0,0,0,2,0,6,0.8571428571428571,1,0.0,0,0,0,0,4,0,0,2,0,0,6,1
14120,197898,QTE6XpirXhdZj0nCidu516iE2M5a9YWy,SpATywNh6bZuzm8s1ceuBUnMUAeoAHHw,4,3,2,0,2,0,1,0,8,1.1428571428571428,1,0.0,0,2,0,2,3,0,0,1,0,4,4,1
14121,197940,pXqF8hGJZiVQMekFKWzwpXptQULIbit3,A3fsA9Zfv1X2fVEQhTw51lKENdNrEqT3,1,0,0,0,0,0,1,0,1,0.14285714285714285,1,0.0,0,0,0,0,0,0,0,1,0,0,1,1
14122,197946,hICMvevjXddBWDZc80Udm3Jkv903MANA,A3fsA9Zfv1X2fVEQhTw51lKENdNrEqT3,7,4,2,0,2,0,1,0,9,1.2857142857142858,1,0.0,0,2,0,2,4,0,0,1,0,4,5,1
14123,197948,hw7IvcaYFJuJeZABsZjmbMK4OkcJdM6i,bWdj2GDclj5ofokWjzoa5jAwMkxCykd6,6,5,4,0,4,0,2,0,15,2.142857142857143,1,0.0,0,4,0,4,5,0,0,2,0,8,7,1
14124,197962,xp0PGlV4qhp60qYyxRe8xCxRmmPbM3Jj,A3fsA9Zfv1X2fVEQhTw51lKENdNrEqT3,2,0,0,0,0,0,4,0,4,0.5714285714285714,1,0.0,0,0,0,0,0,0,0,4,0,0,4,1
14125,197980,lQYiHkk4y0zDXyHNzb0tlv73qls5L2Vm,SpATywNh6bZuzm8s1ceuBUnMUAeoAHHw,5,4,0,0,0,0,4,0,8,1.1428571428571428,1,0.0,0,0,0,0,4,0,0,4,0,0,8,1
14126,198003,mJztKjO5nESo6T2c5pukm2m7KLliSS8S,A3fsA9Zfv1X2fVEQhTw51lKENdNrEqT3,10,5,3,0,3,4,3,0,18,2.5714285714285716,1,0.0,0,3,0,3,5,4,0,3,0,6,12,1
14127,198006,zkqKiyV6OvwyKPkyCN37KC4hTRCpZYCH,A3fsA9Zfv1X2fVEQhTw51lKENdNrEqT3,10,7,5,0,4,0,3,0,19,2.7142857142857144,1,0.0,0,5,0,4,7,0,0,3,0,9,10,1
14128,198018,XwJMK5oKK2pkH5F1a5Sx8BXHH3EqGmzs,A3fsA9Zfv1X2fVEQhTw51lKENdNrEqT3,25,3,1,56,1,0,4,0,65,9.285714285714286,1,0.0,1,1,55,1,2,0,1,4,0,58,7,1
14129,198022,Mv7lfepPwMiuMAg4tPzXsqZKJDYbRo5M,RXDvfPUBYFlVdlueBFbLW0mhhAyGEqpt,6,3,1,0,0,0,5,0,9,1.2857142857142858,1,0.0,0,1,0,0,3,0,0,5,0,1,8,1
14130,198026,NrHk4qmJXuD0TsjkQSnghKpk9ZjGAOyU,A3fsA9Zfv1X2fVEQhTw51lKENdNrEqT3,8,9,6,0,6,0,1,0,22,3.142857142857143,1,0.0,0,6,0,6,9,0,0,1,0,12,10,1
14131,198028,HePRyod5aTSIcFeoVudB8huyR12d5o5i,A3fsA9Zfv1X2fVEQhTw51lKENdNrEqT3,7,3,2,0,2,0,4,0,11,1.5714285714285714,1,0.0,0,2,0,2,3,0,0,4,0,4,7,0
14132,198029,4SbF4DhXcYorYYyJ4XmwwPJZFVh1ZUhY,A3fsA9Zfv1X2fVEQhTw51lKENdNrEqT3,6,3,2,0,1,0,5,0,11,1.5714285714285714,1,0.0,0,2,0,1,3,0,0,5,0,3,8,1
14133,198046,aDI9D7tn5adCCbKFB0sAA8QdbVuXFqVk,RXDvfPUBYFlVdlueBFbLW0mhhAyGEqpt,17,16,11,31,7,0,1,0,66,9.428571428571429,1,0.0,4,11,29,7,12,0,2,1,0,51,15,1
14134,198047,26YSBPGFrjIOM80TFQ5XwHijdAXAx6uk,bWdj2GDclj5ofokWjzoa5jAwMkxCykd6,12,5,3,0,3,0,5,2,18,2.5714285714285716,1,0.0,0,3,0,3,5,0,0,5,2,6,12,1
14135,198073,tBWD1VTj6Jcj3AQ0AXY8eZtUzkjmoiNH,A3fsA9Zfv1X2fVEQhTw51lKENdNrEqT3,34,31,1,62,1,0,10,1,106,15.142857142857142,1,0.0,3,1,54,1,28,0,8,10,1,59,47,1
14136,198086,xq1s7UZZ1wrCX5Lo1UzeFrdUUjRT403R,SpATywNh6bZuzm8s1ceuBUnMUAeoAHHw,11,12,1,12,0,0,3,1,29,4.142857142857143,1,0.0,6,1,12,0,6,0,0,3,1,19,10,1
14137,198098,AjlQRJzysjPIR7iVlK5KoW1nu66aTyed,SpATywNh6bZuzm8s1ceuBUnMUAeoAHHw,1,0,0,0,0,0,1,0,1,0.14285714285714285,1,0.0,0,0,0,0,0,0,0,1,0,0,1,0
14138,198105,gMfSnnrpIllvTRFx8lm7ezHNF6v0Kz0J,A3fsA9Zfv1X2fVEQhTw51lKENdNrEqT3,8,4,2,0,1,4,9,2,22,3.142857142857143,1,0.0,0,2,0,1,4,4,0,9,2,3,19,1
14139,198115,qB4NKZzfw5ku2R1El6nAmpvYSqoEp884,SpATywNh6bZuzm8s1ceuBUnMUAeoAHHw,4,3,1,0,0,0,2,0,6,0.8571428571428571,1,0.0,0,1,0,0,3,0,0,2,0,1,5,0
14140,198145,4GJSwwikGuUWXSajcKoSlvfsoiC8eEZq,bWdj2GDclj5ofokWjzoa5jAwMkxCykd6,13,17,7,0,3,3,7,1,38,5.428571428571429,1,0.0,1,7,0,3,16,3,0,7,1,11,27,1
14141,198154,S0gkXMGtXyRSx8zYg1gsCVaZEuGxgZkA,bWdj2GDclj5ofokWjzoa5jAwMkxCykd6,4,2,1,0,1,0,3,0,7,1.0,1,0.0,0,1,0,1,2,0,0,3,0,2,5,1
14142,198161,T6EWQ7jVP89JlHzj41KN1gEtGYevpSQM,A3fsA9Zfv1X2fVEQhTw51lKENdNrEqT3,12,8,6,0,4,0,2,0,20,2.857142857142857,1,0.0,0,6,0,4,8,0,0,2,0,10,10,1
14143,198163,plvcgi97Dmyn6KmfywjhqH2jaOdxU3cF,SpATywNh6bZuzm8s1ceuBUnMUAeoAHHw,8,5,3,0,0,1,5,1,15,2.142857142857143,1,0.0,0,3,0,0,5,1,0,5,1,3,12,1
14144,198180,gykRbA7iJUFygOkXv9mNdsHLTYvvd4jI,A3fsA9Zfv1X2fVEQhTw51lKENdNrEqT3,9,7,0,0,0,5,3,0,15,2.142857142857143,1,0.0,0,0,0,0,7,5,0,3,0,0,15,1
14145,198184,XeY97U0dths6K286UoEX2Zr2QUaKKAXx,SpATywNh6bZuzm8s1ceuBUnMUAeoAHHw,1,0,0,0,0,0,1,0,1,0.14285714285714285,1,0.0,0,0,0,0,0,0,0,1,0,0,1,1
14146,198186,73Lo5aiYTeasg8R5eGVwIsechNk0OHx6,G8EPVSXsOYB5YQWZGiz1aVq5Pgr2GrQu,9,4,3,0,3,0,2,0,12,1.7142857142857142,1,0.0,0,3,0,3,4,0,0,2,0,6,6,1
14147,198189,OtQITYEhL1ZwLf1P3GqZbaC4QV1QHl7a,A3fsA9Zfv1X2fVEQhTw51lKENdNrEqT3,9,15,7,0,0,0,2,0,24,3.4285714285714284,1,0.0,0,7,0,0,15,0,0,2,0,7,17,1
14148,198208,G2J62R4OLusX5hri0oMn1VajtiIn6i9q,bWdj2GDclj5ofokWjzoa5jAwMkxCykd6,6,1,1,0,1,0,3,0,6,0.8571428571428571,1,0.0,0,1,0,1,1,0,0,3,0,2,4,1
14149,198215,nrvDpyOlV5T6ZU5wiBAqPXpBwJOtawqO,A3fsA9Zfv1X2fVEQhTw51lKENdNrEqT3,20,17,9,0,7,8,8,0,49,7.0,1,0.0,1,9,0,7,16,8,0,8,0,17,32,1
14150,198221,9Mbi6CksSOlTvzJd1jV7pzorOP4mmF9E,A3fsA9Zfv1X2fVEQhTw51lKENdNrEqT3,5,2,1,0,1,0,2,0,6,0.8571428571428571,1,0.0,0,1,0,1,2,0,0,2,0,2,4,1
14151,198226,So8gZ8cXseEZ7lXf4idNMqcN46bXtlIA,A3fsA9Zfv1X2fVEQhTw51lKENdNrEqT3,8,8,5,0,1,0,6,0,20,2.857142857142857,1,0.0,1,5,0,1,7,0,0,6,0,7,13,1
14152,198241,qq2f8Akny1ajULPtgXYv9fMRWduKMr9q,bWdj2GDclj5ofokWjzoa5jAwMkxCykd6,1,0,0,0,0,0,1,0,1,0.14285714285714285,1,0.0,0,0,0,0,0,0,0,1,0,0,1,1
14153,198265,tblYMREbAeB7j9qmk5L4ctIeWrhD9ybH,bWdj2GDclj5ofokWjzoa5jAwMkxCykd6,3,2,1,0,0,0,2,0,5,0.7142857142857143,1,0.0,0,1,0,0,2,0,0,2,0,1,4,1
14154,198305,XMS4dHK4VF2mldxN8JQikVR6RXER8Fkw,bWdj2GDclj5ofokWjzoa5jAwMkxCykd6,5,3,1,0,1,0,2,0,7,1.0,1,0.0,0,1,0,1,3,0,0,2,0,2,5,1
14155,198318,6I2t4qPvSGFHgotoOOeNtMQj1MijCM5Q,A3fsA9Zfv1X2fVEQhTw51lKENdNrEqT3,10,7,5,0,5,0,2,0,19,2.7142857142857144,1,0.0,1,5,0,5,6,0,0,2,0,11,8,1
14156,198321,VLCI0RtMsYSrwlXRiyKxAF4TijVOF7sG,G8EPVSXsOYB5YQWZGiz1aVq5Pgr2GrQu,6,10,0,2,0,0,1,0,13,1.8571428571428572,1,0.0,1,0,2,0,9,0,0,1,0,3,10,1
14157,198326,Dq2cCGdJlkpRnI9Tq5kE4JyzjGIGvpDz,bWdj2GDclj5ofokWjzoa5jAwMkxCykd6,3,2,0,0,0,0,1,0,3,0.42857142857142855,1,0.0,0,0,0,0,2,0,0,1,0,0,3,1
14158,198371,LWF5YNBuaLmRzZBpMALW00OMClXmBQ67,SpATywNh6bZuzm8s1ceuBUnMUAeoAHHw,2,0,0,0,0,0,2,0,2,0.2857142857142857,1,0.0,0,0,0,0,0,0,0,2,0,0,2,1
14159,198409,ipd4iDlo57xlncm3PxcBpEpu3rjoDaW0,SpATywNh6bZuzm8s1ceuBUnMUAeoAHHw,7,4,2,0,0,3,5,2,16,2.2857142857142856,1,0.0,0,2,0,0,4,3,0,5,2,2,14,1
14160,198412,MW1CCUAVszgiBJBxxvrBhzMkhEDfscQF,SpATywNh6bZuzm8s1ceuBUnMUAeoAHHw,6,0,0,0,0,0,11,8,19,2.7142857142857144,1,0.0,0,0,0,0,0,0,0,11,8,0,19,1
14161,198425,Im7Gqlg4DTaApzafTWanJWaOLzYDgQ9W,A3fsA9Zfv1X2fVEQhTw51lKENdNrEqT3,3,2,0,0,0,0,1,0,3,0.42857142857142855,1,0.0,0,0,0,0,2,0,0,1,0,0,3,1
14162,198427,LUXdrYaxg0yAPMJIVFuGpyCbBaRkWcyF,G8EPVSXsOYB5YQWZGiz1aVq5Pgr2GrQu,1,0,0,0,0,0,1,0,1,0.14285714285714285,1,0.0,0,0,0,0,0,0,0,1,0,0,1,1
14163,198437,itsIv2TK9169ecmSXMRGqFj2himLJ6iM,A3fsA9Zfv1X2fVEQhTw51lKENdNrEqT3,6,2,1,0,1,0,3,0,7,1.0,1,0.0,0,1,0,1,2,0,0,3,0,2,5,1
14164,198439,ap1pnANC6OX2VWawEUL9RM8TJxJj0bNk,SpATywNh6bZuzm8s1ceuBUnMUAeoAHHw,5,2,1,0,1,0,2,0,6,0.8571428571428571,1,0.0,0,1,0,1,2,0,0,2,0,2,4,1
14165,198451,hB4kfP3FOz99INk6teFtXjDJ0tVrgCfz,A3fsA9Zfv1X2fVEQhTw51lKENdNrEqT3,7,4,1,0,1,0,3,1,10,1.4285714285714286,1,0.0,0,1,0,1,4,0,0,3,1,2,8,1
14166,198471,rVGqmbwIRU16AVLpkBRDBFOfZ4AeaSVo,G8EPVSXsOYB5YQWZGiz1aVq5Pgr2GrQu,8,2,0,0,0,4,6,1,13,1.8571428571428572,1,0.0,0,0,0,0,2,4,0,6,1,0,13,1
14167,198513,h4OSpklHSinT7B8HRJJ34ZVL6q4IdQwV,A3fsA9Zfv1X2fVEQhTw51lKENdNrEqT3,10,7,1,0,1,0,6,1,16,2.2857142857142856,1,0.0,0,1,0,1,7,0,0,6,1,2,14,1
14168,198521,I3IP7zznUTOp2SzpkCoD3Y916MRFIMEQ,G8EPVSXsOYB5YQWZGiz1aVq5Pgr2GrQu,17,18,1,24,3,0,2,0,48,6.857142857142857,1,0.0,12,1,14,3,6,0,10,2,0,30,18,1
14169,198524,3nkAYJy31glMu7RttArFOqU7gmkfxNPM,RXDvfPUBYFlVdlueBFbLW0mhhAyGEqpt,1,0,0,0,0,0,1,0,1,0.14285714285714285,1,0.0,0,0,0,0,0,0,0,1,0,0,1,1
14170,198527,7UnGK0lAfGMjUxMyS4n60DI4CBHlFUHS,SpATywNh6bZuzm8s1ceuBUnMUAeoAHHw,4,2,0,0,0,1,2,0,5,0.7142857142857143,1,0.0,0,0,0,0,2,1,0,2,0,0,5,1
14171,198540,PQpooRd3Dcd7MsTxOspuuB35YLvA2JZK,SpATywNh6bZuzm8s1ceuBUnMUAeoAHHw,5,5,4,0,2,0,2,0,13,1.8571428571428572,1,0.0,0,4,0,2,5,0,0,2,0,6,7,1
14172,198541,cIviUx1oarGZRWOqPuxscIM6aOUp7v5L,G8EPVSXsOYB5YQWZGiz1aVq5Pgr2GrQu,11,3,3,0,3,0,5,0,14,2.0,1,0.0,0,3,0,3,3,0,0,5,0,6,8,1
14173,198543,7UnGK0lAfGMjUxMyS4n60DI4CBHlFUHS,bWdj2GDclj5ofokWjzoa5jAwMkxCykd6,1,0,0,0,0,0,1,0,1,0.14285714285714285,1,0.0,0,0,0,0,0,0,0,1,0,0,1,1
14174,198563,IR9p9WuPGPaaA4f6RkgkUYRRmOTg8aPE,bWdj2GDclj5ofokWjzoa5jAwMkxCykd6,3,2,1,0,0,0,1,0,4,0.5714285714285714,1,0.0,0,1,0,0,2,0,0,1,0,1,3,1
14175,198573,0Rc9QmalpGXvwxh2iIaT1Kf7aHCEMOJW,A3fsA9Zfv1X2fVEQhTw51lKENdNrEqT3,1,0,0,0,0,0,1,0,1,0.14285714285714285,1,0.0,0,0,0,0,0,0,0,1,0,0,1,1
14176,198585,pHj2ScU15UNB28eYcbm9r11wq0WKivrS,bWdj2GDclj5ofokWjzoa5jAwMkxCykd6,4,5,2,0,2,0,1,0,10,1.4285714285714286,1,0.0,2,2,0,2,3,0,0,1,0,6,4,1
14177,198590,Zr4KLz2ZL4aSF5gVvs5p4LZP1ixAwF6u,SpATywNh6bZuzm8s1ceuBUnMUAeoAHHw,8,3,1,0,1,1,5,1,12,1.7142857142857142,1,0.0,0,1,0,1,3,1,0,5,1,2,10,1
14178,198592,CiLev4iw4aDKDkfbO8GSdlCCB3fQXQsY,A3fsA9Zfv1X2fVEQhTw51lKENdNrEqT3,10,4,3,0,2,0,4,0,13,1.8571428571428572,1,0.0,0,3,0,2,4,0,0,4,0,5,8,1
14179,198611,lMscwAq4rucD5Y2Dxs1NCZ0Ax6V2NgJ7,SpATywNh6bZuzm8s1ceuBUnMUAeoAHHw,5,3,2,0,1,0,1,0,7,1.0,1,0.0,0,2,0,1,3,0,0,1,0,3,4,1
14180,198616,odybwv6zTY9TMhO6yi1EIRr2WfIsx8N5,SpATywNh6bZuzm8s1ceuBUnMUAeoAHHw,1,0,0,0,0,0,1,0,1,0.14285714285714285,1,0.0,0,0,0,0,0,0,0,1,0,0,1,1
14181,198622,WV3YkTyrIBT24sYf1NcBchbLSWfuPseq,A3fsA9Zfv1X2fVEQhTw51lKENdNrEqT3,4,3,2,0,2,0,1,0,8,1.1428571428571428,1,0.0,0,2,0,2,3,0,0,1,0,4,4,1
14182,198623,Dzu6GQmc5vuwFq9gJBuCSSuvGPsIdsSj,SpATywNh6bZuzm8s1ceuBUnMUAeoAHHw,6,0,0,0,0,0,7,2,9,1.2857142857142858,1,0.0,0,0,0,0,0,0,0,7,2,0,9,1
14183,198631,Jvu0Hx9YHJ8mxetJAU2xMbziN16z8eDf,SpATywNh6bZuzm8s1ceuBUnMUAeoAHHw,12,7,5,0,4,1,5,1,23,3.2857142857142856,1,0.0,0,5,0,4,7,1,0,5,1,9,14,1
14184,198633,v8AEmfj5ScfNiqWSiB9twce4e05jQ9FQ,bWdj2GDclj5ofokWjzoa5jAwMkxCykd6,1,0,0,0,0,0,1,0,1,0.14285714285714285,1,0.0,0,0,0,0,0,0,0,1,0,0,1,1
14185,198639,9Nsgp7LQN84rKL9niMUlqjv8b2ci26i2,A3fsA9Zfv1X2fVEQhTw51lKENdNrEqT3,1,0,0,0,0,0,1,0,1,0.14285714285714285,1,0.0,0,0,0,0,0,0,0,1,0,0,1,1
14186,198641,boqZBuL5xdPgOX9TFr0s595aQRVHTZHS,SpATywNh6bZuzm8s1ceuBUnMUAeoAHHw,1,0,0,0,0,0,1,0,1,0.14285714285714285,1,0.0,0,0,0,0,0,0,0,1,0,0,1,1
14187,198648,pGAAxK6WZxbSHdtKKBvQSoYltPRqe43C,SpATywNh6bZuzm8s1ceuBUnMUAeoAHHw,6,3,1,0,1,0,2,0,7,1.0,1,0.0,0,1,0,1,3,0,0,2,0,2,5,1
14188,198672,GSkYUOcl4XzYMWSWhE6gXRGQ9kqPeXsi,bWdj2GDclj5ofokWjzoa5jAwMkxCykd6,9,5,3,28,3,0,2,0,41,5.857142857142857,1,0.0,1,3,27,3,4,0,1,2,0,34,7,1
14189,198675,34cVbMGyVO1SqQjOK9RNk00q4uKA3nIE,A3fsA9Zfv1X2fVEQhTw51lKENdNrEqT3,5,3,1,0,1,2,4,0,11,1.5714285714285714,1,0.0,1,1,0,1,2,2,0,4,0,3,8,1
14190,198714,MZXb9jchKEtLA37ZVUIxBtaUGdZhYeJT,G8EPVSXsOYB5YQWZGiz1aVq5Pgr2GrQu,4,2,1,0,1,0,1,0,5,0.7142857142857143,1,0.0,0,1,0,1,2,0,0,1,0,2,3,1
14191,198717,I2yihQ33CDsuDBZLIV6bzhSjVdIOvgGC,bWdj2GDclj5ofokWjzoa5jAwMkxCykd6,7,3,0,0,2,0,4,0,9,1.2857142857142858,1,0.0,2,0,0,2,1,0,0,4,0,4,5,1
14192,198720,GdwsSQDD3RD1ds1JuZBmFzmfEkBslekC,SpATywNh6bZuzm8s1ceuBUnMUAeoAHHw,4,3,0,0,0,0,2,0,5,0.7142857142857143,1,0.0,0,0,0,0,3,0,0,2,0,0,5,1
14193,198721,foGVhKIFjMIFQYicH2TLfLzHHE7pM4bi,A3fsA9Zfv1X2fVEQhTw51lKENdNrEqT3,7,2,1,0,0,1,6,1,11,1.5714285714285714,1,0.0,0,1,0,0,2,1,0,6,1,1,10,1
14194,198753,xX0iYdUwlCBlooAwOCU3ud9UtqInVGRm,A3fsA9Zfv1X2fVEQhTw51lKENdNrEqT3,12,8,6,0,3,7,6,1,31,4.428571428571429,1,0.0,0,6,0,3,8,7,0,6,1,9,22,1
14195,198758,7FTb8qcMeGic1m25RrAdw1gNnGsbUnQN,SpATywNh6bZuzm8s1ceuBUnMUAeoAHHw,13,17,7,0,3,0,8,1,36,5.142857142857143,1,0.0,4,7,0,3,13,0,0,8,1,14,22,1
14196,198767,rdXBX56hdm6MgOkqvDTZw84EG2v9Ij01,A3fsA9Zfv1X2fVEQhTw51lKENdNrEqT3,5,2,1,0,1,0,4,0,8,1.1428571428571428,1,0.0,0,1,0,1,2,0,0,4,0,2,6,1
14197,198777,bWklEyYoSpuuB2ZTCwBPrnaJDLkOGTMp,SpATywNh6bZuzm8s1ceuBUnMUAeoAHHw,1,0,0,0,0,0,1,0,1,0.14285714285714285,1,0.0,0,0,0,0,0,0,0,1,0,0,1,1
14198,198781,hkPW1meCvutegNytZP5zAHZkZdu7wM1N,G8EPVSXsOYB5YQWZGiz1aVq5Pgr2GrQu,6,7,5,0,4,0,4,0,20,2.857142857142857,1,0.0,0,5,0,4,7,0,0,4,0,9,11,1
14199,198795,v4qKKz4EWeiMbiMd1pppvrFEFDQHnpRJ,G8EPVSXsOYB5YQWZGiz1aVq5Pgr2GrQu,8,7,3,0,3,0,1,0,14,2.0,1,0.0,3,3,0,3,4,0,0,1,0,9,5,1
14200,198797,u601bf5LgTloUnzWrvF8VsEbNdAIplE1,A3fsA9Zfv1X2fVEQhTw51lKENdNrEqT3,1,0,0,0,0,0,2,0,2,0.2857142857142857,1,0.0,0,0,0,0,0,0,0,2,0,0,2,1
14201,198800,wnDMDigjN4PlQ0HWg6PwACxEoBUS4Gx4,A3fsA9Zfv1X2fVEQhTw51lKENdNrEqT3,4,2,0,0,0,0,2,0,4,0.5714285714285714,1,0.0,0,0,0,0,2,0,0,2,0,0,4,1
14202,198803,9N7TqBwx16hmfqT5WweyvUVrAeU2Gds6,SpATywNh6bZuzm8s1ceuBUnMUAeoAHHw,10,15,6,0,4,1,1,0,27,3.857142857142857,1,0.0,3,6,0,4,12,1,0,1,0,13,14,1
14203,198804,oOPW8b1yKsHdoM2CKb7DyH4zCUGTI2L7,G8EPVSXsOYB5YQWZGiz1aVq5Pgr2GrQu,7,3,2,0,2,0,4,0,11,1.5714285714285714,1,0.0,0,2,0,2,3,0,0,4,0,4,7,1
14204,198813,bu3K5v9qe8b55yPk6H1Kzu2kZgUnBQeS,bWdj2GDclj5ofokWjzoa5jAwMkxCykd6,1,0,0,0,0,0,1,0,1,0.14285714285714285,1,0.0,0,0,0,0,0,0,0,1,0,0,1,1
14205,198818,4JyZWYWxxqGCPr9dTz7bgpLcCXWs003A,G8EPVSXsOYB5YQWZGiz1aVq5Pgr2GrQu,7,1,1,0,1,0,5,0,8,1.1428571428571428,1,0.0,0,1,0,1,1,0,0,5,0,2,6,1
14206,198824,AG3Ywlgg0zeoJMMzx5kl7d9PzkM3xyjk,A3fsA9Zfv1X2fVEQhTw51lKENdNrEqT3,18,9,7,0,6,0,6,1,29,4.142857142857143,1,0.0,0,7,0,6,9,0,0,6,1,13,16,1
14207,198827,2ULjUBKcAnyQSi1NZFeDGBWEU4kETCtv,G8EPVSXsOYB5YQWZGiz1aVq5Pgr2GrQu,18,24,11,40,5,3,4,0,87,12.428571428571429,1,0.0,7,11,33,5,17,3,7,4,0,56,31,1
14208,198843,nhKo3n0QtoNri1dTW77ZJUsuajlfq52l,SpATywNh6bZuzm8s1ceuBUnMUAeoAHHw,6,4,3,0,3,0,1,0,11,1.5714285714285714,1,0.0,0,3,0,3,4,0,0,1,0,6,5,1
14209,198861,HhUNMDqxiy7U4QVsVWLmXLfoPctCDoGr,SpATywNh6bZuzm8s1ceuBUnMUAeoAHHw,3,0,0,0,0,1,2,0,3,0.42857142857142855,1,0.0,0,0,0,0,0,1,0,2,0,0,3,1
14210,198876,3FwKlBDtKGlNAYyQNzHL1qfkuXpNOPVW,bWdj2GDclj5ofokWjzoa5jAwMkxCykd6,1,0,0,0,0,0,1,0,1,0.14285714285714285,1,0.0,0,0,0,0,0,0,0,1,0,0,1,1
14211,198881,R2bf9dlDhtEUgfKzXR1GPBa12LhUfZ8W,A3fsA9Zfv1X2fVEQhTw51lKENdNrEqT3,6,4,3,0,2,0,1,0,10,1.4285714285714286,1,0.0,0,3,0,2,4,0,0,1,0,5,5,1
14212,198883,TwsuaxQpuQH4X71hofoKVQ1FXkHOyr0Z,bWdj2GDclj5ofokWjzoa5jAwMkxCykd6,8,2,1,0,1,0,5,1,10,1.4285714285714286,1,0.0,1,1,0,1,1,0,0,5,1,3,7,1
14213,198887,IGs2FsXHkQDnXVyqCPa0nawJqdQ0PAsD,SpATywNh6bZuzm8s1ceuBUnMUAeoAHHw,1,0,0,0,0,0,1,0,1,0.14285714285714285,1,0.0,0,0,0,0,0,0,0,1,0,0,1,1
14214,198897,Isy1saDmyEIfHHr1kPm1JUuUBknEItqI,SpATywNh6bZuzm8s1ceuBUnMUAeoAHHw,1,0,0,0,0,0,1,0,1,0.14285714285714285,1,0.0,0,0,0,0,0,0,0,1,0,0,1,1
14215,198900,r4qXpyLtUsV0WLMpP48wcQ1UcY1so2Nu,G8EPVSXsOYB5YQWZGiz1aVq5Pgr2GrQu,10,5,4,0,3,0,2,0,14,2.0,1,0.0,0,4,0,3,5,0,0,2,0,7,7,1
14216,198908,pSRqXJrhW3cpcIMqshrNJY13lAR5UPwX,bWdj2GDclj5ofokWjzoa5jAwMkxCykd6,1,0,0,0,0,0,1,0,1,0.14285714285714285,1,0.0,0,0,0,0,0,0,0,1,0,0,1,1
14217,198912,nKVAY2GHYnzf4BfG261ddlVdtqvsIA9B,bWdj2GDclj5ofokWjzoa5jAwMkxCykd6,4,2,1,0,1,0,2,0,6,0.8571428571428571,1,0.0,0,1,0,1,2,0,0,2,0,2,4,1
14218,198919,1j8gbclC0lfQw1ATQbildJE9fULo0ecU,A3fsA9Zfv1X2fVEQhTw51lKENdNrEqT3,5,2,1,0,1,0,2,0,6,0.8571428571428571,1,0.0,0,1,0,1,2,0,0,2,0,2,4,1
14219,198934,YQQ0U1ySGhxQGw2MpzkqAJru8VuefP0L,A3fsA9Zfv1X2fVEQhTw51lKENdNrEqT3,6,2,1,0,1,7,7,1,19,2.7142857142857144,1,0.0,0,1,0,1,2,7,0,7,1,2,17,1
14220,198949,sNbuAEBvvCL9s1FspvGXLJVjQkFzxwpw,bWdj2GDclj5ofokWjzoa5jAwMkxCykd6,4,2,0,0,0,0,2,0,4,0.5714285714285714,1,0.0,0,0,0,0,2,0,0,2,0,0,4,1
14221,198961,mJt5KMSSr7JvGBEQNnS7zxJqeuNThNSs,SpATywNh6bZuzm8s1ceuBUnMUAeoAHHw,7,5,4,0,4,0,2,0,15,2.142857142857143,1,0.0,0,4,0,4,5,0,0,2,0,8,7,1
14222,198967,2oTvbzieHn2y5oozeOgSnruqE6N0BtR5,SpATywNh6bZuzm8s1ceuBUnMUAeoAHHw,7,3,2,0,2,3,2,0,12,1.7142857142857142,1,0.0,0,2,0,2,3,3,0,2,0,4,8,1
14223,198990,2SHX7pefWKxAdle5f43dow0MyPOF6YGF,SpATywNh6bZuzm8s1ceuBUnMUAeoAHHw,6,3,0,0,0,1,4,0,8,1.1428571428571428,1,0.0,0,0,0,0,3,1,0,4,0,0,8,1
14224,198997,37OFfdd4jVDH9Wkzlzun8gwzZeYEoVZi,SpATywNh6bZuzm8s1ceuBUnMUAeoAHHw,7,3,2,0,2,0,2,0,9,1.2857142857142858,1,0.0,0,2,0,2,3,0,0,2,0,4,5,1
14225,198998,2oTvbzieHn2y5oozeOgSnruqE6N0BtR5,G8EPVSXsOYB5YQWZGiz1aVq5Pgr2GrQu,11,6,4,0,4,8,2,0,24,3.4285714285714284,1,0.0,1,4,0,4,5,8,0,2,0,9,15,1
14226,199003,z8AZNvy0mvqias2V5LoDHYpS46oKfDaS,RXDvfPUBYFlVdlueBFbLW0mhhAyGEqpt,2,0,0,0,0,0,2,0,2,0.2857142857142857,1,0.0,0,0,0,0,0,0,0,2,0,0,2,1
14227,199007,TqIBAk7ZVNx5vdURE7Yh8YGgkMcauYpn,A3fsA9Zfv1X2fVEQhTw51lKENdNrEqT3,5,4,3,0,0,0,2,0,9,1.2857142857142858,1,0.0,0,3,0,0,4,0,0,2,0,3,6,1
14228,199048,seGsWY5pHJdYc0dygxkfgWkiK3wzJxVH,A3fsA9Zfv1X2fVEQhTw51lKENdNrEqT3,5,3,1,0,1,0,2,0,7,1.0,1,0.0,1,1,0,1,2,0,0,2,0,3,4,1
14229,199063,ODCx2UO2z0ldelF48alKkiQzrvYMM8sJ,G8EPVSXsOYB5YQWZGiz1aVq5Pgr2GrQu,9,6,3,2,1,0,9,0,21,3.0,1,0.0,3,3,2,1,3,0,0,9,0,9,12,1
14230,199068,TTLR6K3ZlbSrGOfX2kjd2U4ChldGiopU,RXDvfPUBYFlVdlueBFbLW0mhhAyGEqpt,5,3,1,0,0,0,3,0,7,1.0,1,0.0,0,1,0,0,3,0,0,3,0,1,6,1
14231,199070,mne1Bu1F2f0U7iravmS4eQYQtLTkVvPe,A3fsA9Zfv1X2fVEQhTw51lKENdNrEqT3,9,4,3,0,3,0,3,0,13,1.8571428571428572,1,0.0,0,3,0,3,4,0,0,3,0,6,7,1
14232,199075,zmFq2MrnMqSFLtSy4w1SV24s7OiYosym,A3fsA9Zfv1X2fVEQhTw51lKENdNrEqT3,4,2,1,0,1,0,1,0,5,0.7142857142857143,1,0.0,0,1,0,1,2,0,0,1,0,2,3,1
14233,199106,SiuLrWlkxnvAIxxemPagy5NF7ku6UPbb,3VkHkmOtom3jM2wCu94xgzzu1d6Dn7or,1,0,0,0,0,0,1,0,1,0.14285714285714285,1,0.0,0,0,0,0,0,0,0,1,0,0,1,1
14234,199107,je9A6l6tP7wnbFhNJD7vbbHTYhqshuqB,3VkHkmOtom3jM2wCu94xgzzu1d6Dn7or,1,0,0,0,0,0,2,0,2,0.2857142857142857,1,0.0,0,0,0,0,0,0,0,2,0,0,2,1
14235,199140,pOty3QQDllRwRazWobs7f0vqF0FmSOua,3VkHkmOtom3jM2wCu94xgzzu1d6Dn7or,5,4,1,0,2,0,3,0,10,1.4285714285714286,1,0.0,0,1,0,2,4,0,0,3,0,3,7,1
14236,199154,OmnGU6PMoN6e39FHFSUGdW5cfWtL8mqG,3VkHkmOtom3jM2wCu94xgzzu1d6Dn7or,2,0,0,0,0,0,2,0,2,0.2857142857142857,1,0.0,0,0,0,0,0,0,0,2,0,0,2,1
14237,199160,7xkNb6KJSLd7yj2URUDx5hnJcWKsFiLF,3VkHkmOtom3jM2wCu94xgzzu1d6Dn7or,5,2,1,0,1,0,2,0,6,0.8571428571428571,1,0.0,0,1,0,1,2,0,0,2,0,2,4,1
14238,199166,nJP0RkZArz7wt5CxQJwMSO1fszv6Y5BK,3VkHkmOtom3jM2wCu94xgzzu1d6Dn7or,1,0,0,0,0,0,1,0,1,0.14285714285714285,1,0.0,0,0,0,0,0,0,0,1,0,0,1,1
14239,199168,24FeJHCcaxGLJuxScZB7YwqwrlHIVJm5,3VkHkmOtom3jM2wCu94xgzzu1d6Dn7or,6,2,1,0,1,0,6,0,10,1.4285714285714286,1,0.0,0,1,0,1,2,0,0,6,0,2,8,1
14240,199174,OdYISCyCgpEqvbE1G8dyalKevNPP8czy,3VkHkmOtom3jM2wCu94xgzzu1d6Dn7or,8,7,3,0,2,0,6,1,19,2.7142857142857144,1,0.0,2,3,0,2,5,0,0,6,1,7,12,1
14241,199229,BUjlAGT73sG03Srb3M3It2PuOU8Q0k35,3VkHkmOtom3jM2wCu94xgzzu1d6Dn7or,18,19,10,0,9,0,1,0,39,5.571428571428571,1,0.0,3,10,0,9,16,0,0,1,0,22,17,1
14242,199236,LzhaTOq4fJ50XldNzYaXGXnICepz6ZYf,3VkHkmOtom3jM2wCu94xgzzu1d6Dn7or,1,0,0,0,0,0,2,0,2,0.2857142857142857,1,0.0,0,0,0,0,0,0,0,2,0,0,2,1
14243,199239,56UtPIpXd8ixbNQcWObTP7HxM6iN5elx,3VkHkmOtom3jM2wCu94xgzzu1d6Dn7or,1,0,0,0,0,0,2,0,2,0.2857142857142857,1,0.0,0,0,0,0,0,0,0,2,0,0,2,1
14244,199240,Z5NEEpjFeROWqiDp0HOSTktYCRzmsm1W,3VkHkmOtom3jM2wCu94xgzzu1d6Dn7or,3,4,0,0,0,0,2,0,6,0.8571428571428571,1,0.0,2,0,0,0,2,0,0,2,0,2,4,1
14245,199241,nLVkMUicIATb5XjlrKkVLbPcf3PrrUv6,3VkHkmOtom3jM2wCu94xgzzu1d6Dn7or,1,0,0,0,0,0,1,0,1,0.14285714285714285,1,0.0,0,0,0,0,0,0,0,1,0,0,1,1
14246,199251,x6sH9u50F7syAJPTHXIYL85GeymcvPzL,3VkHkmOtom3jM2wCu94xgzzu1d6Dn7or,1,0,0,0,0,0,1,0,1,0.14285714285714285,1,0.0,0,0,0,0,0,0,0,1,0,0,1,1
14247,199254,t3zvUCA13KEbypSsHPCNMLfju0mDYp54,3VkHkmOtom3jM2wCu94xgzzu1d6Dn7or,5,3,1,0,1,0,3,1,9,1.2857142857142858,1,0.0,0,1,0,1,3,0,0,3,1,2,7,1
14248,199258,izrdat4Yj85eaRHmVTCDNoz6YDxPaMtF,3VkHkmOtom3jM2wCu94xgzzu1d6Dn7or,4,2,1,0,1,0,2,0,6,0.8571428571428571,1,0.0,0,1,0,1,2,0,0,2,0,2,4,1
14249,199262,8UBuXoKnbGMq6Q0kIIWDMawKN4aOMWdt,3VkHkmOtom3jM2wCu94xgzzu1d6Dn7or,11,11,5,10,3,1,2,0,32,4.571428571428571,1,0.0,5,5,8,3,6,1,2,2,0,21,11,1
14250,199263,ZJJQNdxLDmBSvSNBsbDtRYzTStN0dM4J,3VkHkmOtom3jM2wCu94xgzzu1d6Dn7or,7,4,2,0,2,0,2,0,10,1.4285714285714286,1,0.0,1,2,0,2,3,0,0,2,0,5,5,1
14251,199268,g7DIn7NzgCH1p1YBvAIg5IvU7czfyOX2,3VkHkmOtom3jM2wCu94xgzzu1d6Dn7or,1,0,0,0,0,0,2,0,2,0.2857142857142857,1,0.0,0,0,0,0,0,0,0,2,0,0,2,1
14252,199269,Rc8vyRlCQCbmH4EGB961YSkmrRByTTea,3VkHkmOtom3jM2wCu94xgzzu1d6Dn7or,8,5,2,0,1,1,6,1,16,2.2857142857142856,1,0.0,1,2,0,1,4,1,0,6,1,4,12,1
14253,199279,ibyVg0BxZIPKqINiDIiPPKNrRCjhA1dh,3VkHkmOtom3jM2wCu94xgzzu1d6Dn7or,1,0,0,0,0,0,1,0,1,0.14285714285714285,1,0.0,0,0,0,0,0,0,0,1,0,0,1,1
14254,199289,Xfg9JFG3AAEpBrN4qCMcAzrG9oqclxVX,3VkHkmOtom3jM2wCu94xgzzu1d6Dn7or,5,3,1,0,1,0,4,0,9,1.2857142857142858,1,0.0,1,1,0,1,2,0,0,4,0,3,6,1
14255,199290,hKDpmQWfhp0c74MNjB0QfOimQ7UCOHJg,3VkHkmOtom3jM2wCu94xgzzu1d6Dn7or,11,20,5,6,9,4,9,0,53,7.571428571428571,1,0.0,13,5,4,9,7,4,2,9,0,31,22,1
14256,199295,5MAyxqAkQoCv9jWmfdBsZmxlxyfszUFL,3VkHkmOtom3jM2wCu94xgzzu1d6Dn7or,8,16,9,0,0,0,8,0,33,4.714285714285714,1,0.0,2,9,0,0,14,0,0,8,0,11,22,1
14257,199305,xI45WBcqRSFYdtQ43ysRc22u3JLJWNvD,3VkHkmOtom3jM2wCu94xgzzu1d6Dn7or,1,0,0,0,0,0,1,0,1,0.14285714285714285,1,0.0,0,0,0,0,0,0,0,1,0,0,1,1
14258,199307,6MWUDMLC3Hnx6DASyTWDKrqwJvaSqV7s,3VkHkmOtom3jM2wCu94xgzzu1d6Dn7or,1,0,0,0,0,0,1,0,1,0.14285714285714285,1,0.0,0,0,0,0,0,0,0,1,0,0,1,1
14259,199309,E9EDiL5FdsaYLmbLpW4Gm4jZTeooFwDr,3VkHkmOtom3jM2wCu94xgzzu1d6Dn7or,1,0,0,0,0,0,1,0,1,0.14285714285714285,1,0.0,0,0,0,0,0,0,0,1,0,0,1,1
14260,199312,srirlXn6abjaBVVW0BAYG4BR3V5mYUPA,3VkHkmOtom3jM2wCu94xgzzu1d6Dn7or,4,3,0,0,0,0,4,0,7,1.0,1,0.0,0,0,0,0,3,0,0,4,0,0,7,1
14261,199316,2GVls3TyRLjTcZJwoD8SWl4QqoVZQwlQ,3VkHkmOtom3jM2wCu94xgzzu1d6Dn7or,1,0,0,0,0,0,1,0,1,0.14285714285714285,1,0.0,0,0,0,0,0,0,0,1,0,0,1,1
14262,199319,YWz36L1YY4zp6wTHvv7N4sKmhgmOHm30,3VkHkmOtom3jM2wCu94xgzzu1d6Dn7or,1,0,0,0,0,0,1,0,1,0.14285714285714285,1,0.0,0,0,0,0,0,0,0,1,0,0,1,1
14263,199342,HWEmScBu6kOujSZdv1uqTj45KBzx6va1,3VkHkmOtom3jM2wCu94xgzzu1d6Dn7or,1,0,0,0,0,0,2,0,2,0.2857142857142857,1,0.0,0,0,0,0,0,0,0,2,0,0,2,1
14264,199363,CQEk00TcDoCDBANAoiHWBC0wD3a3tm2t,3VkHkmOtom3jM2wCu94xgzzu1d6Dn7or,4,2,1,0,1,0,1,0,5,0.7142857142857143,1,0.0,0,1,0,1,2,0,0,1,0,2,3,1
14265,199369,Ns60nnOcHzm6CwEshEoSzbGFnBGMdPbf,3VkHkmOtom3jM2wCu94xgzzu1d6Dn7or,1,0,0,0,0,0,1,0,1,0.14285714285714285,1,0.0,0,0,0,0,0,0,0,1,0,0,1,1
14266,199386,uNxZwlwcjCXOgxUE9EtXjrX9Cep7hKAG,3VkHkmOtom3jM2wCu94xgzzu1d6Dn7or,6,3,2,0,2,0,1,0,8,1.1428571428571428,1,0.0,0,2,0,2,3,0,0,1,0,4,4,1
14267,199419,aesfEl5dCp5H9uEcPNHUp7OzsLtD37Qr,3VkHkmOtom3jM2wCu94xgzzu1d6Dn7or,1,0,0,0,0,0,1,0,1,0.14285714285714285,1,0.0,0,0,0,0,0,0,0,1,0,0,1,1
14268,199423,KJoE9unyVuT2DeHS57E6xLFn5ZLvwVq9,3VkHkmOtom3jM2wCu94xgzzu1d6Dn7or,1,0,0,0,0,0,2,0,2,0.2857142857142857,1,0.0,0,0,0,0,0,0,0,2,0,0,2,1
14269,199446,PZtTTaYrd6B4cAH5tmOBvlRaiVcoBrXm,3VkHkmOtom3jM2wCu94xgzzu1d6Dn7or,7,6,0,4,2,2,7,0,21,3.0,1,0.0,3,0,3,2,3,2,1,7,0,8,13,1
14270,199447,M4srLYpsZNHwQDiipREYwVsfQ9vN7ZoW,3VkHkmOtom3jM2wCu94xgzzu1d6Dn7or,1,0,0,0,0,0,1,0,1,0.14285714285714285,1,0.0,0,0,0,0,0,0,0,1,0,0,1,1
14271,199490,DR0coD7ZBHQMFzqolW7VCZpfMQZOSwFT,3VkHkmOtom3jM2wCu94xgzzu1d6Dn7or,5,2,0,0,1,0,2,0,5,0.7142857142857143,1,0.0,0,0,0,1,2,0,0,2,0,1,4,1
14272,199501,d62Uk1Mhp2bbkE3cDJ4nv3oJFCyri7BK,5Gyp41oLVo7Gg7vF4vpmggWP5MU70QO6,1,0,0,0,0,0,1,0,1,0.14285714285714285,1,0.0,0,0,0,0,0,0,0,1,0,0,1,1
14273,199546,kNdT4Mob6J1VkdvqbhmS4aPzbDLqNeYP,5Gyp41oLVo7Gg7vF4vpmggWP5MU70QO6,7,5,3,0,0,0,4,0,12,1.7142857142857142,1,0.0,0,3,0,0,5,0,0,4,0,3,9,1
14274,199550,KuJKHOLN9aBUzPlq0QGnPrqYbHBlyCQo,5Gyp41oLVo7Gg7vF4vpmggWP5MU70QO6,6,3,2,0,1,0,2,0,8,1.1428571428571428,1,0.0,0,2,0,1,3,0,0,2,0,3,5,1
14275,199567,NKFg1XrxaHlNSaxBdS9mZqwYNutEatUN,5Gyp41oLVo7Gg7vF4vpmggWP5MU70QO6,6,4,2,0,1,0,3,0,10,1.4285714285714286,1,0.0,1,2,0,1,3,0,0,3,0,4,6,1
14276,199578,elygdCrncWcn7OVBrJtJE9XwX8vVnXuv,5Gyp41oLVo7Gg7vF4vpmggWP5MU70QO6,10,5,4,0,3,0,2,0,14,2.0,1,0.0,0,4,0,3,5,0,0,2,0,7,7,1
14277,199585,TTUjbbDzAqmAeHUBfmRKT3OMlCTJVckJ,5Gyp41oLVo7Gg7vF4vpmggWP5MU70QO6,7,3,2,0,2,0,2,0,9,1.2857142857142858,1,0.0,0,2,0,2,3,0,0,2,0,4,5,1
14278,199601,Vh6koZSt1BGKgPAtYZGyVcQyArmS9YIg,5Gyp41oLVo7Gg7vF4vpmggWP5MU70QO6,15,13,7,8,3,0,2,0,33,4.714285714285714,1,0.0,4,7,7,3,9,0,1,2,0,21,12,1
14279,199607,c530IAX94rud3KYXrAnFqCf1qhIa2Krd,5Gyp41oLVo7Gg7vF4vpmggWP5MU70QO6,6,6,1,0,0,0,2,0,9,1.2857142857142858,1,0.0,0,1,0,0,6,0,0,2,0,1,8,1
14280,199635,jm7nchDCGNkzIbLvW4KORNHkW3D0Ma5N,5Gyp41oLVo7Gg7vF4vpmggWP5MU70QO6,1,0,0,0,0,0,1,0,1,0.14285714285714285,1,0.0,0,0,0,0,0,0,0,1,0,0,1,1
14281,199672,Ir0bQdDk1WYdGh3nD12MnfxMZwmCyvqY,5Gyp41oLVo7Gg7vF4vpmggWP5MU70QO6,5,2,1,0,1,3,3,0,10,1.4285714285714286,1,0.0,0,1,0,1,2,3,0,3,0,2,8,1
14282,199676,6AdntZ1YwSpIzfN8IkKhUxEEVllXQtUz,5Gyp41oLVo7Gg7vF4vpmggWP5MU70QO6,1,0,0,0,0,0,1,0,1,0.14285714285714285,1,0.0,0,0,0,0,0,0,0,1,0,0,1,1
14283,199701,LcrUg06CUMdhHcZmdzv0RIRRX4y16mTE,5Gyp41oLVo7Gg7vF4vpmggWP5MU70QO6,5,2,1,0,1,0,3,0,7,1.0,1,0.0,0,1,0,1,2,0,0,3,0,2,5,1
14284,199721,ixjSfLZyzKPW5rzdlNMYGdodlMV78vkC,5Gyp41oLVo7Gg7vF4vpmggWP5MU70QO6,7,3,2,0,2,0,2,0,9,1.2857142857142858,1,0.0,0,2,0,2,3,0,0,2,0,4,5,1
14285,199723,2HBnl1pMr4wAnZxFzwkIUnuIa96G1Ecq,5Gyp41oLVo7Gg7vF4vpmggWP5MU70QO6,1,0,0,0,0,0,1,0,1,0.14285714285714285,1,0.0,0,0,0,0,0,0,0,1,0,0,1,1
14286,199770,V4DFRRm44qhSrvCEIFd4pjLSSWKcBxUl,5Gyp41oLVo7Gg7vF4vpmggWP5MU70QO6,10,11,2,0,1,2,9,1,26,3.7142857142857144,2,0.0,0,2,0,1,11,2,0,9,1,3,23,0
14287,199802,8zuZeBODltlYx6gcd6dPnNXLDXb8sH6b,5Gyp41oLVo7Gg7vF4vpmggWP5MU70QO6,1,0,0,0,0,0,1,0,1,0.14285714285714285,1,0.0,0,0,0,0,0,0,0,1,0,0,1,1
14288,199815,RIXSuS9h1XpYRMLAK5sqek3oEF8Sik9A,5Gyp41oLVo7Gg7vF4vpmggWP5MU70QO6,1,0,0,0,0,0,1,0,1,0.14285714285714285,1,0.0,0,0,0,0,0,0,0,1,0,0,1,1
14289,199830,zqMb5GcH4NLBJytjLvjEwIumSES5DKBS,5Gyp41oLVo7Gg7vF4vpmggWP5MU70QO6,4,2,0,0,0,0,3,0,5,0.7142857142857143,2,0.0,0,0,0,0,2,0,0,3,0,0,5,1
14290,199837,e5WBFaW97P5SB4u9kJ6uPxmLMsZkxgHF,5Gyp41oLVo7Gg7vF4vpmggWP5MU70QO6,2,0,0,0,0,0,2,0,2,0.2857142857142857,1,0.0,0,0,0,0,0,0,0,2,0,0,2,1
14291,199848,F1JFhxE9defmDqDZ43P468elvks5NkEB,5Gyp41oLVo7Gg7vF4vpmggWP5MU70QO6,1,0,0,0,0,0,1,0,1,0.14285714285714285,1,0.0,0,0,0,0,0,0,0,1,0,0,1,1
14292,199849,8tWMGcZPhvNTS06JyFfXdfvoax4LQs0G,5Gyp41oLVo7Gg7vF4vpmggWP5MU70QO6,5,2,1,0,0,0,3,0,6,0.8571428571428571,1,0.0,0,1,0,0,2,0,0,3,0,1,5,1
14293,199887,sEqqQzJgfFwEJ59pjhsH9YLQDd58mQLD,5Gyp41oLVo7Gg7vF4vpmggWP5MU70QO6,1,0,0,0,0,0,1,0,1,0.14285714285714285,1,0.0,0,0,0,0,0,0,0,1,0,0,1,1
14294,199966,UXmVmknHAyMhqmhIGaA9GmsQ8nc5udTu,5Gyp41oLVo7Gg7vF4vpmggWP5MU70QO6,1,0,0,0,0,0,1,0,1,0.14285714285714285,1,0.0,0,0,0,0,0,0,0,1,0,0,1,1
14295,199977,HCwB0C2JKEdLvoVwTd75X8I8tYIzHhIM,5Gyp41oLVo7Gg7vF4vpmggWP5MU70QO6,1,0,0,0,0,0,1,0,1,0.14285714285714285,1,0.0,0,0,0,0,0,0,0,1,0,0,1,1
14296,199995,zCpagk9PxfOocuFuBu0Ac85RSLgivgoq,5Gyp41oLVo7Gg7vF4vpmggWP5MU70QO6,1,0,0,0,0,0,1,0,1,0.14285714285714285,1,0.0,0,0,0,0,0,0,0,1,0,0,1,1
14297,200023,ta4s7Ul83oGtj5gRUZr1SGBrSbL1ESRg,5Gyp41oLVo7Gg7vF4vpmggWP5MU70QO6,7,3,2,0,2,0,2,0,9,1.2857142857142858,1,0.0,0,2,0,2,3,0,0,2,0,4,5,1
14298,200033,y20f09CxhvS55Wblm8XZJQuRockZgjId,5Gyp41oLVo7Gg7vF4vpmggWP5MU70QO6,1,0,0,0,0,0,1,0,1,0.14285714285714285,1,0.0,0,0,0,0,0,0,0,1,0,0,1,1
14299,200040,toiqn6LPCS99iRSdrd2LEPmUKg5mrnoq,5Gyp41oLVo7Gg7vF4vpmggWP5MU70QO6,4,3,1,0,1,0,1,0,6,0.8571428571428571,1,0.0,0,1,0,1,3,0,0,1,0,2,4,1
14300,200067,3YQpliwjSA8AK3ol8NDBXglcswt2oFEG,5Gyp41oLVo7Gg7vF4vpmggWP5MU70QO6,15,34,14,4,8,6,18,1,85,12.142857142857142,1,0.0,10,14,2,8,24,6,2,18,1,34,51,1
14301,200077,rCsUqWLhKle1EqenEkn3BmRW45I7EKcI,5Gyp41oLVo7Gg7vF4vpmggWP5MU70QO6,1,0,0,0,0,0,1,0,1,0.14285714285714285,1,0.0,0,0,0,0,0,0,0,1,0,0,1,1
14302,200085,7DufOZH7uJb86RSw7kwej322YsuvsAOn,5Gyp41oLVo7Gg7vF4vpmggWP5MU70QO6,7,3,2,0,2,0,2,0,9,1.2857142857142858,1,0.0,0,2,0,2,3,0,0,2,0,4,5,0
14303,200088,wxOgTM0U8atO7FTCY8VhNuh0fylTpPFX,5Gyp41oLVo7Gg7vF4vpmggWP5MU70QO6,1,0,0,0,0,0,1,0,1,0.14285714285714285,1,0.0,0,0,0,0,0,0,0,1,0,0,1,1
14304,200106,J4CQZgZBlOmytRfPs9vqhW9gDDIzfvcP,5Gyp41oLVo7Gg7vF4vpmggWP5MU70QO6,2,0,0,0,0,0,4,0,4,0.5714285714285714,1,0.0,0,0,0,0,0,0,0,4,0,0,4,1
14305,200108,4OVJ3xihQbiVQL93GzejnSZNc6TEGKTV,5Gyp41oLVo7Gg7vF4vpmggWP5MU70QO6,1,0,0,0,0,0,1,0,1,0.14285714285714285,1,0.0,0,0,0,0,0,0,0,1,0,0,1,1
14306,200120,nWKh3KZfWpFp8N0w0wAnq7QosofiiWHZ,5Gyp41oLVo7Gg7vF4vpmggWP5MU70QO6,4,7,1,0,0,0,2,0,10,1.4285714285714286,1,0.0,5,1,0,0,2,0,0,2,0,6,4,1
14307,200156,VlDniFDr4BUyYYqSDi6VTSgVdE4PjFNm,fbPkOYLVPtPgIt0MxizjfFJov3JbHyAi,2,0,0,0,0,0,4,0,4,0.5714285714285714,1,0.0,0,0,0,0,0,0,0,4,0,0,4,1
14308,200158,OBrE671jmAa0zcKhOwZbsgknJEYhO9ZQ,fbPkOYLVPtPgIt0MxizjfFJov3JbHyAi,13,8,5,0,5,0,4,0,22,3.142857142857143,2,0.0,0,5,0,5,8,0,0,4,0,10,12,1
14309,200160,WY8ZjTYNIGxqmEBUqyR8YNe7kour5nSN,fbPkOYLVPtPgIt0MxizjfFJov3JbHyAi,2,0,0,0,0,0,2,0,2,0.2857142857142857,1,0.0,0,0,0,0,0,0,0,2,0,0,2,1
14310,200161,3GyPhLgeVf6ayT8WwMOzrwG0vX3cMBOI,fbPkOYLVPtPgIt0MxizjfFJov3JbHyAi,14,14,7,8,6,1,14,2,52,7.428571428571429,1,0.0,4,7,6,6,10,1,2,14,2,23,29,1
14311,200164,SEHcNh1vMg4ZLYiSoUqvCFsKMsJ8CB2i,fbPkOYLVPtPgIt0MxizjfFJov3JbHyAi,1,0,0,0,0,0,1,0,1,0.14285714285714285,1,0.0,0,0,0,0,0,0,0,1,0,0,1,1
14312,200167,iwXVrgcqAKROauUa9mk2BApUHKtwoacr,fbPkOYLVPtPgIt0MxizjfFJov3JbHyAi,5,2,1,0,1,0,2,0,6,0.8571428571428571,1,0.0,0,1,0,1,2,0,0,2,0,2,4,1
14313,200168,AYthRqjUqxgBOMkMdZlsA0hn0RkYMhX1,fbPkOYLVPtPgIt0MxizjfFJov3JbHyAi,11,14,9,0,8,1,3,0,35,5.0,1,0.0,3,9,0,8,11,1,0,3,0,20,15,1
14314,200170,8uvIif4A5L5EPYASYSg4Tx0sVAF45af4,fbPkOYLVPtPgIt0MxizjfFJov3JbHyAi,2,2,0,0,0,0,0,0,2,0.2857142857142857,1,0.0,0,0,0,0,2,0,0,0,0,0,2,1
14315,200172,TNhUrfYcya3yxRpJxMcmjGjIL7iLVR1R,fbPkOYLVPtPgIt0MxizjfFJov3JbHyAi,1,0,0,0,0,0,1,0,1,0.14285714285714285,1,0.0,0,0,0,0,0,0,0,1,0,0,1,1
14316,200174,5OFiMxDgE4Mm8y2SD0A2gGR1Jne1kbKh,fbPkOYLVPtPgIt0MxizjfFJov3JbHyAi,4,2,1,0,0,0,2,0,5,0.7142857142857143,1,0.0,0,1,0,0,2,0,0,2,0,1,4,1
14317,200176,pzhB8LO3WWjbU215lU1c8Ly5btvgYfuP,fbPkOYLVPtPgIt0MxizjfFJov3JbHyAi,6,0,0,0,0,2,7,1,10,1.4285714285714286,1,0.0,0,0,0,0,0,2,0,7,1,0,10,1
14318,200183,ajSnZNRHXRc8Lp3Apzl9jhBHJ93vaNPi,fbPkOYLVPtPgIt0MxizjfFJov3JbHyAi,2,0,0,0,0,0,2,0,2,0.2857142857142857,1,0.0,0,0,0,0,0,0,0,2,0,0,2,1
14319,200187,aGnJR132vfJUJhCgWPqNCfjSqAKTceP7,fbPkOYLVPtPgIt0MxizjfFJov3JbHyAi,4,2,0,0,0,0,2,0,4,0.5714285714285714,1,0.0,0,0,0,0,2,0,0,2,0,0,4,1
14320,200190,GMz0p3R0olFf93OHzhoRfm6K9FYjtVBr,fbPkOYLVPtPgIt0MxizjfFJov3JbHyAi,1,0,0,0,0,0,1,0,1,0.14285714285714285,1,0.0,0,0,0,0,0,0,0,1,0,0,1,1
14321,200195,aDECjDNmXQqgYm6JtRqkv0Su4uv6syvb,fbPkOYLVPtPgIt0MxizjfFJov3JbHyAi,7,5,2,0,3,0,3,0,13,1.8571428571428572,1,0.0,2,2,0,3,3,0,0,3,0,7,6,1
14322,200196,kerB5RBuhvb9QV0DhYFh8GpXXRfYT6uv,fbPkOYLVPtPgIt0MxizjfFJov3JbHyAi,1,0,0,0,0,0,1,0,1,0.14285714285714285,1,0.0,0,0,0,0,0,0,0,1,0,0,1,1
14323,200197,9LWdgptEOEdv2w8R0wKWL5CMrKtWuBl6,fbPkOYLVPtPgIt0MxizjfFJov3JbHyAi,1,0,0,0,0,0,1,0,1,0.14285714285714285,1,0.0,0,0,0,0,0,0,0,1,0,0,1,1
14324,200200,UW5vT7Adnn4gq5148M0Kd0fNJNqIxYNZ,fbPkOYLVPtPgIt0MxizjfFJov3JbHyAi,2,0,0,0,0,0,3,0,3,0.42857142857142855,1,0.0,0,0,0,0,0,0,0,3,0,0,3,1
14325,200214,t7fmofRfEDFaZ2tcdJoy6YnZtr04n4TA,5Gyp41oLVo7Gg7vF4vpmggWP5MU70QO6,2,0,0,0,0,0,2,0,2,0.2857142857142857,1,0.0,0,0,0,0,0,0,0,2,0,0,2,1
14326,200265,8ojbEZcVo2OtR30EqyHwuNwkgTMa7xeO,5Gyp41oLVo7Gg7vF4vpmggWP5MU70QO6,1,0,0,0,0,0,1,0,1,0.14285714285714285,1,0.0,0,0,0,0,0,0,0,1,0,0,1,1
14327,200310,2qmRjwcRaJSCoGstnt322AsuzCqrXoxT,5Gyp41oLVo7Gg7vF4vpmggWP5MU70QO6,7,6,2,0,4,0,2,0,14,2.0,1,0.0,3,2,0,4,3,0,0,2,0,9,5,1
14328,200335,FOtv6xDKHzFqDhbDD4xQWlZpphWR2KSb,5Gyp41oLVo7Gg7vF4vpmggWP5MU70QO6,10,8,5,0,6,0,1,0,20,2.857142857142857,1,0.0,2,5,0,6,6,0,0,1,0,13,7,1
14329,200346,B9qFxcRNIbCTDthnIzWFOAMqHaN5yHtV,5Gyp41oLVo7Gg7vF4vpmggWP5MU70QO6,1,0,0,0,0,0,1,0,1,0.14285714285714285,1,0.0,0,0,0,0,0,0,0,1,0,0,1,1
14330,200350,rsvoGlABSxMfCZAMU5AdZU7fKJUkZXC9,5Gyp41oLVo7Gg7vF4vpmggWP5MU70QO6,1,0,0,0,0,0,1,0,1,0.14285714285714285,1,0.0,0,0,0,0,0,0,0,1,0,0,1,1
14331,200370,yUDBZYpD5ZCQiJA6cgTmTyE1UqJsgt3l,5Gyp41oLVo7Gg7vF4vpmggWP5MU70QO6,1,0,0,0,0,0,1,0,1,0.14285714285714285,1,0.0,0,0,0,0,0,0,0,1,0,0,1,1
14332,200391,yKhFnQAdnTFnHpBqMNeexFC5CORiLzu5,5Gyp41oLVo7Gg7vF4vpmggWP5MU70QO6,13,13,10,0,7,0,6,0,36,5.142857142857143,1,0.0,0,10,0,7,13,0,0,6,0,17,19,1
14333,200424,2FKmhUQkD4Jl8hWDPtmkKeErEkvByKdi,5Gyp41oLVo7Gg7vF4vpmggWP5MU70QO6,1,0,0,0,0,0,1,0,1,0.14285714285714285,1,0.0,0,0,0,0,0,0,0,1,0,0,1,1
14334,200455,G8jgnHTeLf1hE7XVTYSEeVS9aL3UBLQd,5Gyp41oLVo7Gg7vF4vpmggWP5MU70QO6,2,0,0,0,0,0,2,0,2,0.2857142857142857,1,0.0,0,0,0,0,0,0,0,2,0,0,2,0
14335,200474,tuwFpVRxydP7ukF3l7WQ2j9F6pGAbPqc,5Gyp41oLVo7Gg7vF4vpmggWP5MU70QO6,12,6,5,0,3,3,3,0,20,2.857142857142857,1,0.0,0,5,0,3,6,3,0,3,0,8,12,1
14336,200479,IPInQHBD1Sob6EZGyGGciiLir6vAFL6F,5Gyp41oLVo7Gg7vF4vpmggWP5MU70QO6,5,5,1,0,2,1,1,0,10,1.4285714285714286,1,0.0,0,1,0,2,5,1,0,1,0,3,7,1
14337,200486,hUoOQP103jtoSjE8huNXPy5FlXS050j3,5Gyp41oLVo7Gg7vF4vpmggWP5MU70QO6,5,4,1,0,0,0,2,0,7,1.0,1,0.0,0,1,0,0,4,0,0,2,0,1,6,1
14338,200517,n7yQ1FvfAXqDnBpszfIUjZkrvw3J2aJC,5Gyp41oLVo7Gg7vF4vpmggWP5MU70QO6,5,2,1,0,1,0,2,0,6,0.8571428571428571,1,0.0,0,1,0,1,2,0,0,2,0,2,4,0
14339,200585,ZpIPcydiES9PFQvbCzLJLin5Jt1uIJC6,5Gyp41oLVo7Gg7vF4vpmggWP5MU70QO6,3,2,1,0,0,0,1,0,4,0.5714285714285714,1,0.0,0,1,0,0,2,0,0,1,0,1,3,1
14340,200587,MymZPJWcJvHuJMrRYcmywxRVhQFAj4Sr,5Gyp41oLVo7Gg7vF4vpmggWP5MU70QO6,4,0,0,0,0,0,4,0,4,0.5714285714285714,1,0.0,0,0,0,0,0,0,0,4,0,0,4,1
14341,200613,F7AXONZ3TpGkisi8zy5Q1Qe95Pxbm1oq,5Gyp41oLVo7Gg7vF4vpmggWP5MU70QO6,3,0,0,0,0,1,2,0,3,0.42857142857142855,1,0.0,0,0,0,0,0,1,0,2,0,0,3,1
14342,200668,DuhdXcjzufckORvT0wE8ArWYujylxbnx,5Gyp41oLVo7Gg7vF4vpmggWP5MU70QO6,1,0,0,0,0,0,1,0,1,0.14285714285714285,1,0.0,0,0,0,0,0,0,0,1,0,0,1,1
14343,200704,CqFrhuoYEjE6MH9AuUp4nwHEmwAlC9zU,5Gyp41oLVo7Gg7vF4vpmggWP5MU70QO6,6,3,2,5,1,0,1,0,12,1.7142857142857142,1,0.0,0,2,3,1,3,0,2,1,0,6,6,1
14344,200707,zv1MTlqEl4Nw73cGpyMcdRKThLliUAlA,5Gyp41oLVo7Gg7vF4vpmggWP5MU70QO6,4,2,0,0,0,0,2,0,4,0.5714285714285714,1,0.0,0,0,0,0,2,0,0,2,0,0,4,1
14345,200749,heWJRVg7rEQJKctb9hAqhrrVJgE71Gu9,5Gyp41oLVo7Gg7vF4vpmggWP5MU70QO6,13,7,5,4,3,0,3,0,22,3.142857142857143,1,0.0,1,5,2,3,6,0,2,3,0,11,11,1
14346,200761,QNA44zjiZdozxT5YpeINlRZRlMKPMkhp,5Gyp41oLVo7Gg7vF4vpmggWP5MU70QO6,6,7,6,0,4,0,1,0,18,2.5714285714285716,1,0.0,0,6,0,4,7,0,0,1,0,10,8,1
14347,200782,hyOYv4rmSRnv16UkVW9gdxwUgBZxYdhv,7GRhBDsirIGkRZBtSMEzNTyDr2JQm4xx,5,2,1,0,1,0,2,0,6,0.8571428571428571,1,0.0,0,1,0,1,2,0,0,2,0,2,4,1
14348,200800,7nzr7mwsX3K7BiOtdIcVBSR6zEXVIYI1,7GRhBDsirIGkRZBtSMEzNTyDr2JQm4xx,4,3,1,0,0,0,2,0,6,0.8571428571428571,1,0.0,0,1,0,0,3,0,0,2,0,1,5,1
14349,200806,4h79uMcS1iYROsRps1078ngx78w376cH,7GRhBDsirIGkRZBtSMEzNTyDr2JQm4xx,2,0,0,0,0,0,3,0,3,0.42857142857142855,1,0.0,0,0,0,0,0,0,0,3,0,0,3,0
14350,200817,vDNo4mQAZOC4PWVxrxTTUTLEt0bpNinW,7GRhBDsirIGkRZBtSMEzNTyDr2JQm4xx,12,6,5,0,5,0,1,0,17,2.4285714285714284,1,0.0,0,5,0,5,6,0,0,1,0,10,7,1
14351,200829,JLn36xalC1eIUd4jm6gux9oEgx3gpDxA,7GRhBDsirIGkRZBtSMEzNTyDr2JQm4xx,2,0,0,0,0,0,2,0,2,0.2857142857142857,1,0.0,0,0,0,0,0,0,0,2,0,0,2,1
